"freqm";"freqf";"firstname";"totalfreq";"percm";"percf"
96;0;"aaban";96;100;0
0;35;"aabha";35;0;100
10;0;"aabid";10;100;0
5;0;"aabir";5;100;0
0;26;"aabriella";26;0;100
0;5;"aada";5;0;100
236;0;"aadam";236;100;0
122;0;"aadan";122;100;0
184;0;"aadarsh";184;100;0
4409;5;"aaden";4414;99.8867240598097;0.113275940190304
15;0;"aadesh";15;100;0
161;0;"aadhav";161;100;0
30;0;"aadhavan";30;100;0
28;0;"aadhi";28;100;0
0;51;"aadhira";51;0;100
28;0;"aadhvik";28;100;0
0;9;"aadhvika";9;0;100
0;1188;"aadhya";1188;0;100
12;0;"aadhyan";12;100;0
765;16;"aadi";781;97.9513444302177;2.04865556978233
5;0;"aadian";5;100;0
326;0;"aadil";326;100;0
117;0;"aadin";117;100;0
22;0;"aadish";22;100;0
0;11;"aadison";11;0;100
313;0;"aadit";313;100;0
61;0;"aadith";61;100;0
11;0;"aadithya";11;100;0
0;37;"aaditri";37;0;100
524;0;"aaditya";524;100;0
17;0;"aadiv";17;100;0
117;0;"aadon";117;100;0
12;0;"aadrian";12;100;0
0;19;"aadrika";19;0;100
10;0;"aadrit";10;100;0
0;5;"aadriti";5;0;100
0;7;"aadvi";7;0;100
137;0;"aadvik";137;100;0
0;33;"aadvika";33;0;100
0;876;"aadya";876;0;100
467;16;"aadyn";483;96.6873706004141;3.31262939958592
0;6;"aafia";6;0;100
0;6;"aafiya";6;0;100
0;5;"aafiyah";5;0;100
0;5;"aafreen";5;0;100
20;0;"aagam";20;100;0
7;0;"aage";7;100;0
0;7;"aagna";7;0;100
0;5;"aagot";5;0;100
27;0;"aahaan";27;100;0
227;0;"aahan";227;100;0
0;459;"aahana";459;0;100
488;0;"aahil";488;100;0
6;0;"aahir";6;100;0
0;24;"aahliyah";24;0;100
0;84;"aahna";84;0;100
5;0;"aahron";5;100;0
38;0;"aaidan";38;100;0
704;0;"aaiden";704;100;0
54;0;"aaidyn";54;100;0
0;36;"aaila";36;0;100
0;15;"aailiyah";15;0;100
0;184;"aailyah";184;0;100
0;54;"aaima";54;0;100
0;128;"aaira";128;0;100
0;71;"aairah";71;0;100
0;182;"aaisha";182;0;100
0;18;"aaishah";18;0;100
0;5;"aaiyana";5;0;100
0;16;"aaiza";16;0;100
0;5;"aaja";5;0;100
0;29;"aajah";29;0;100
0;20;"aajaylah";20;0;100
8;0;"aajon";8;100;0
0;10;"aakanksha";10;0;100
53;0;"aakarsh";53;100;0
915;0;"aakash";915;100;0
16;0;"aakeem";16;100;0
0;18;"aakilah";18;0;100
0;5;"aakira";5;0;100
0;5;"aakiyah";5;0;100
0;43;"aakriti";43;0;100
0;79;"aala";79;0;100
0;7;"aalaiya";7;0;100
0;60;"aalaiyah";60;0;100
0;43;"aalana";43;0;100
0;21;"aalanah";21;0;100
0;67;"aalani";67;0;100
6;0;"aalap";6;100;0
0;127;"aalaya";127;0;100
0;728;"aalayah";728;0;100
0;20;"aalayiah";20;0;100
0;6;"aalayjah";6;0;100
0;40;"aalayna";40;0;100
0;17;"aalaysha";17;0;100
0;127;"aalaysia";127;0;100
0;7;"aalea";7;0;100
0;262;"aaleah";262;0;100
0;20;"aaleahya";20;0;100
0;5;"aaleayah";5;0;100
0;5;"aaleena";5;0;100
0;5;"aaleeya";5;0;100
0;114;"aaleeyah";114;0;100
0;6;"aaleiah";6;0;100
0;155;"aaleigha";155;0;100
0;37;"aaleiyah";37;0;100
0;5;"aalena";5;0;100
0;20;"aalexis";20;0;100
0;6;"aalexus";6;0;100
0;16;"aaleya";16;0;100
0;1022;"aaleyah";1022;0;100
6;0;"aali";6;100;0
0;421;"aalia";421;0;100
0;863;"aaliah";863;0;100
0;18;"aaliana";18;0;100
5;0;"aalias";5;100;0
0;124;"aaliayah";124;0;100
0;47;"aaliayh";47;0;100
0;5;"aalicia";5;0;100
0;12;"aaliha";12;0;100
183;127;"aalijah";310;59.0322580645161;40.9677419354839
28;0;"aalim";28;100;0
0;11;"aalimah";11;0;100
0;51;"aalina";51;0;100
0;6;"aalinah";6;0;100
0;5;"aalisa";5;0;100
0;35;"aalisha";35;0;100
0;54;"aalivia";54;0;100
0;1132;"aaliya";1132;0;100
0;5;"aaliyaa";5;0;100
89;79367;"aaliyah";79456;0.112011679420056;99.88798832058
0;21;"aaliyaha";21;0;100
0;28;"aaliyahmarie";28;0;100
0;22;"aaliyahrose";22;0;100
5;103;"aaliyan";108;4.62962962962963;95.3703703703704
0;107;"aaliyana";107;0;100
0;5;"aaliyanna";5;0;100
0;428;"aaliyha";428;0;100
0;41;"aaliyiah";41;0;100
0;164;"aalliyah";164;0;100
0;5;"aallyah";5;0;100
10;0;"aalok";10;100;0
5;0;"aalon";5;100;0
0;5;"aaloni";5;0;100
0;41;"aalya";41;0;100
0;627;"aalyah";627;0;100
0;25;"aalycia";25;0;100
0;19;"aalyha";19;0;100
0;5;"aalyia";5;0;100
0;711;"aalyiah";711;0;100
0;5;"aalyna";5;0;100
0;6;"aalysia";6;0;100
0;115;"aalyssa";115;0;100
0;5;"aalyvia";5;0;100
0;10;"aamanda";10;0;100
0;10;"aamanee";10;0;100
0;157;"aamani";157;0;100
5;0;"aamar";5;100;0
109;81;"aamari";190;57.3684210526316;42.6315789473684
10;0;"aamarion";10;100;0
0;5;"aamaya";5;0;100
0;14;"aamber";14;0;100
0;10;"aamena";10;0;100
35;0;"aamer";35;100;0
0;16;"aamia";16;0;100
22;0;"aamil";22;100;0
0;59;"aamilah";59;0;100
0;280;"aamina";280;0;100
0;342;"aaminah";342;0;100
1704;6;"aamir";1710;99.6491228070175;0.350877192982456
0;275;"aamira";275;0;100
0;164;"aamirah";164;0;100
0;44;"aamiya";44;0;100
0;357;"aamiyah";357;0;100
0;207;"aamna";207;0;100
0;10;"aamoni";10;0;100
0;5;"aamora";5;0;100
0;101;"aamori";101;0;100
0;121;"aamya";121;0;100
0;57;"aamyah";57;0;100
0;7;"aana";7;0;100
5;0;"aanand";5;100;0
15;0;"aanav";15;100;0
9;0;"aanay";9;100;0
0;29;"aanaya";29;0;100
0;67;"aanchal";67;0;100
0;47;"aania";47;0;100
0;33;"aaniah";33;0;100
0;5;"aanijah";5;0;100
0;258;"aanika";258;0;100
0;39;"aanisah";39;0;100
0;297;"aaniya";297;0;100
0;1128;"aaniyah";1128;0;100
0;11;"aaniylah";11;0;100
20;0;"aansh";20;100;0
0;72;"aanshi";72;0;100
0;169;"aanvi";169;0;100
0;2390;"aanya";2390;0;100
0;78;"aanyah";78;0;100
0;7;"aanyla";7;0;100
0;5;"aapri";5;0;100
22;0;"aaqib";22;100;0
42;0;"aaqil";42;100;0
0;78;"aara";78;0;100
0;17;"aarabella";17;0;100
0;5;"aarabhi";5;0;100
0;38;"aaradhana";38;0;100
5;0;"aaradhy";5;100;0
0;406;"aaradhya";406;0;100
10;0;"aaraf";10;100;0
6;0;"aaraiz";6;100;0
0;1168;"aaralyn";1168;0;100
0;259;"aaralynn";259;0;100
201;0;"aaran";201;100;0
5;0;"aaraon";5;100;0
0;5;"aaratrika";5;0;100
4329;0;"aarav";4329;100;0
0;12;"aaravi";12;0;100
6;0;"aaravreddy";6;100;0
0;5;"aaraya";5;0;100
770;282;"aaren";1052;73.1939163498099;26.8060836501901
33;10;"aareon";43;76.7441860465116;23.2558139534884
0;7;"aareona";7;0;100
10;9;"aari";19;52.6315789473684;47.3684210526316
0;255;"aaria";255;0;100
0;221;"aariah";221;0;100
106;53;"aarian";159;66.6666666666667;33.3333333333333
0;396;"aariana";396;0;100
0;195;"aarianna";195;0;100
61;0;"aarib";61;100;0
445;0;"aaric";445;100;0
0;95;"aarica";95;0;100
28;0;"aarick";28;100;0
0;5;"aarie";5;0;100
0;181;"aariel";181;0;100
0;5;"aariella";5;0;100
0;42;"aarielle";42;0;100
7;0;"aarien";7;100;0
142;0;"aarik";142;100;0
0;755;"aarika";755;0;100
6;0;"aariketh";6;100;0
0;107;"aarilyn";107;0;100
0;10;"aarilynn";10;0;100
501;302;"aarin";803;62.3910336239103;37.6089663760897
0;85;"aarini";85;0;100
454;140;"aarion";594;76.4309764309764;23.5690235690236
0;237;"aariona";237;0;100
0;133;"aarionna";133;0;100
37;41;"aaris";78;47.4358974358974;52.5641025641026
146;0;"aarish";146;100;0
93;0;"aarit";93;100;0
206;0;"aariv";206;100;0
0;102;"aariya";102;0;100
0;402;"aariyah";402;0;100
5;0;"aariyan";5;100;0
0;92;"aariyana";92;0;100
0;14;"aariyanna";14;0;100
0;5;"aariyona";5;0;100
0;5;"aariyonna";5;0;100
531;0;"aariz";531;100;0
28;0;"aarjav";28;100;0
17;0;"aarn";17;100;0
0;1125;"aarna";1125;0;100
430;0;"aarnav";430;100;0
0;39;"aarnavi";39;0;100
10;0;"aarne";10;100;0
34;0;"aaro";34;100;0
5;0;"aaroh";5;100;0
16;0;"aarohan";16;100;0
0;438;"aarohi";438;0;100
0;11;"aarolyn";11;0;100
566317;4269;"aaron";570586;99.2518218112607;0.748178188739296
0;5;"aarona";5;0;100
0;5;"aaronae";5;0;100
0;5;"aaronda";5;0;100
0;11;"aaronette";11;0;100
0;6;"aaronisha";6;0;100
5;0;"aaronjacob";5;100;0
100;0;"aaronjames";100;100;0
21;0;"aaronjohn";21;100;0
7;0;"aaronjoseph";7;100;0
5;0;"aaronjosh";5;100;0
10;0;"aaronjoshua";10;100;0
5;0;"aaronlee";5;100;0
74;0;"aaronmichael";74;100;0
22;0;"aaronn";22;100;0
6;0;"aaroosh";6;100;0
5;0;"aarren";5;100;0
1220;0;"aarron";1220;100;0
50;0;"aarsh";50;100;0
0;21;"aarshi";21;0;100
0;5;"aarshiya";5;0;100
0;104;"aarthi";104;0;100
0;437;"aarti";437;0;100
0;12;"aaruhi";12;0;100
1885;0;"aarush";1885;100;0
0;653;"aarushi";653;0;100
0;95;"aarvi";95;0;100
5;0;"aarvin";5;100;0
301;1319;"aarya";1620;18.5802469135802;81.4197530864198
0;47;"aaryah";47;0;100
0;12;"aaryahi";12;0;100
1235;6;"aaryan";1241;99.5165189363417;0.48348106365834
0;107;"aaryana";107;0;100
0;201;"aaryanna";201;0;100
6;0;"aaryash";6;100;0
110;0;"aaryav";110;100;0
634;1029;"aaryn";1663;38.123872519543;61.876127480457
0;5;"aarynn";5;0;100
15;0;"aaryon";15;100;0
0;10;"aaryona";10;0;100
0;5;"aarza";5;0;100
5;0;"aaseem";5;100;0
12;0;"aaser";12;100;0
0;277;"aasha";277;0;100
0;5;"aashana";5;0;100
31;0;"aashay";31;100;0
0;523;"aashi";523;0;100
0;6;"aashia";6;0;100
0;79;"aashika";79;0;100
0;5;"aashini";5;0;100
103;0;"aashir";103;100;0
0;20;"aashirya";20;0;100
132;0;"aashish";132;100;0
0;6;"aashita";6;0;100
0;12;"aashiyana";12;0;100
0;140;"aashka";140;0;100
5;0;"aashman";5;100;0
0;608;"aashna";608;0;100
0;52;"aashni";52;0;100
14;0;"aashray";14;100;0
0;46;"aashrita";46;0;100
112;0;"aashrith";112;100;0
0;128;"aashritha";128;0;100
0;273;"aashvi";273;0;100
0;219;"aasia";219;0;100
231;0;"aasim";231;100;0
52;0;"aasin";52;100;0
62;0;"aasir";62;100;0
0;153;"aasiya";153;0;100
0;417;"aasiyah";417;0;100
32;0;"aason";32;100;0
0;260;"aastha";260;0;100
5;0;"aathan";5;100;0
10;0;"aatif";10;100;0
16;0;"aatish";16;100;0
0;89;"aava";89;0;100
0;43;"aavah";43;0;100
10;0;"aavash";10;100;0
36;0;"aaven";36;100;0
17;0;"aavi";17;100;0
22;0;"aavin";22;100;0
26;0;"aavion";26;100;0
5;0;"aavish";5;100;0
0;118;"aavya";118;0;100
11;0;"aavyan";11;100;0
6;5;"aavyn";11;54.5454545454545;45.4545454545455
0;45;"aaya";45;0;100
44;0;"aayaan";44;100;0
0;31;"aayah";31;0;100
20;0;"aayam";20;100;0
1197;0;"aayan";1197;100;0
0;114;"aayana";114;0;100
0;10;"aayanah";10;0;100
0;38;"aayanna";38;0;100
110;0;"aayansh";110;100;0
0;77;"aayat";77;0;100
11;0;"aaydan";11;100;0
1322;5;"aayden";1327;99.6232102486812;0.376789751318764
0;367;"aayla";367;0;100
0;67;"aaylah";67;0;100
0;81;"aayliah";81;0;100
0;21;"aayra";21;0;100
6;0;"aayu";6;100;0
1099;0;"aayush";1099;100;0
0;11;"aayusha";11;0;100
0;215;"aayushi";215;0;100
5;0;"aazan";5;100;0
0;5;"aazeen";5;0;100
6;0;"aazil";6;100;0
21;0;"aazim";21;100;0
0;28;"aaziyah";28;0;100
341;0;"ab";341;100;0
5;22;"aba";27;18.5185185185185;81.4814814814815
36;0;"abaan";36;100;0
6;0;"abaas";6;100;0
82;0;"abad";82;100;0
0;210;"abagael";210;0;100
0;5549;"abagail";5549;0;100
0;15;"abagaile";15;0;100
0;366;"abagale";366;0;100
0;341;"abagayle";341;0;100
0;19;"abaigael";19;0;100
0;10;"abaigail";10;0;100
0;321;"abaigeal";321;0;100
24;0;"aban";24;100;0
138;0;"abanoub";138;100;0
71;0;"abas";71;100;0
40;0;"abasi";40;100;0
80;0;"abass";80;100;0
215;0;"abayomi";215;100;0
80;0;"abb";80;100;0
39;6;"abba";45;86.6666666666667;13.3333333333333
5;0;"abbaas";5;100;0
0;833;"abbagail";833;0;100
0;134;"abbagale";134;0;100
0;112;"abbagayle";112;0;100
1189;0;"abbas";1189;100;0
0;1325;"abbe";1325;0;100
0;163;"abbee";163;0;100
0;246;"abbegail";246;0;100
0;82;"abbegale";82;0;100
0;73;"abbegayle";73;0;100
35;17044;"abbey";17079;0.204930031032262;99.7950699689677
0;66;"abbeygail";66;0;100
0;22;"abbeygale";22;0;100
0;1984;"abbi";1984;0;100
310;19204;"abbie";19514;1.58860305421748;98.4113969457825
0;237;"abbiegail";237;0;100
0;58;"abbiegale";58;0;100
0;18;"abbiegayle";18;0;100
0;162;"abbigael";162;0;100
5;11286;"abbigail";11291;0.0442830573022761;99.9557169426977
0;91;"abbigaile";91;0;100
0;157;"abbigal";157;0;100
0;2102;"abbigale";2102;0;100
0;29;"abbigayl";29;0;100
0;1287;"abbigayle";1287;0;100
0;12;"abbilyn";12;0;100
23;0;"abbot";23;100;0
925;24;"abbott";949;97.4710221285564;2.52897787144363
0;36;"abbra";36;0;100
0;25;"abbriella";25;0;100
0;83;"abbrielle";83;0;100
181;56748;"abby";56929;0.317939890038469;99.6820601099615
0;184;"abbye";184;0;100
0;70;"abbygael";70;0;100
0;3299;"abbygail";3299;0;100
0;47;"abbygaile";47;0;100
0;762;"abbygale";762;0;100
0;6;"abbygayl";6;0;100
0;438;"abbygayle";438;0;100
0;18;"abbylynn";18;0;100
0;367;"abcde";367;0;100
17;0;"abd";17;100;0
6;0;"abdala";6;100;0
6;0;"abdalah";6;100;0
282;0;"abdalla";282;100;0
1189;0;"abdallah";1189;100;0
160;0;"abdalrahman";160;100;0
5;0;"abdalrhman";5;100;0
542;0;"abdel";542;100;0
100;0;"abdelaziz";100;100;0
5;0;"abdelhadi";5;100;0
5;0;"abdelhamid";5;100;0
10;0;"abdelkareem";10;100;0
32;0;"abdelkarim";32;100;0
24;0;"abdellah";24;100;0
554;0;"abdelrahman";554;100;0
6;0;"abdelrhman";6;100;0
5;0;"abderrahman";5;100;0
256;10;"abdi";266;96.2406015037594;3.7593984962406
0;5;"abdia";5;0;100
567;0;"abdias";567;100;0
6;0;"abdiasis";6;100;0
138;0;"abdiaziz";138;100;0
3776;0;"abdiel";3776;100;0
204;0;"abdifatah";204;100;0
16;0;"abdihafid";16;100;0
36;0;"abdihakim";36;100;0
5;0;"abdihamid";5;100;0
132;0;"abdikadir";132;100;0
21;0;"abdikarim";21;100;0
5;0;"abdikhaliq";5;100;0
10;0;"abdilahi";10;100;0
183;0;"abdimalik";183;100;0
5;0;"abdinajib";5;100;0
156;0;"abdinasir";156;100;0
27;0;"abdiqani";27;100;0
69;0;"abdirahim";69;100;0
6;0;"abdirahin";6;100;0
1526;0;"abdirahman";1526;100;0
32;0;"abdirashid";32;100;0
12;0;"abdirisaq";12;100;0
81;0;"abdirizak";81;100;0
5;0;"abdisalam";5;100;0
6;0;"abdisalan";6;100;0
23;0;"abdisamad";23;100;0
53;0;"abdishakur";53;100;0
19;0;"abdiwahab";19;100;0
5;0;"abdiwali";5;100;0
52;0;"abdo";52;100;0
359;0;"abdon";359;100;0
213;0;"abdou";213;100;0
418;0;"abdoul";418;100;0
622;0;"abdoulaye";622;100;0
10;0;"abdoulaziz";10;100;0
110;0;"abdoulie";110;100;0
5;0;"abdourahman";5;100;0
18;0;"abdourahmane";18;100;0
15;0;"abdrahman";15;100;0
6;0;"abdrew";6;100;0
32;0;"abdu";32;100;0
17;0;"abdual";17;100;0
32;0;"abduallah";32;100;0
5;0;"abduel";5;100;0
5594;0;"abdul";5594;100;0
39;0;"abdula";39;100;0
75;0;"abdulah";75;100;0
69;0;"abdulahad";69;100;0
395;0;"abdulahi";395;100;0
83;0;"abdulai";83;100;0
5;0;"abdulaye";5;100;0
5;0;"abdulazeem";5;100;0
25;0;"abdulazeez";25;100;0
1173;0;"abdulaziz";1173;100;0
5;0;"abdulbari";5;100;0
13;0;"abdulbasit";13;100;0
6;0;"abdule";6;100;0
28;0;"abdulelah";28;100;0
5;0;"abdulhaadi";5;100;0
108;0;"abdulhadi";108;100;0
38;0;"abdulhakeem";38;100;0
16;0;"abdulhakim";16;100;0
5;0;"abdulhalim";5;100;0
11;0;"abdulhameed";11;100;0
60;0;"abdulhamid";60;100;0
16;0;"abduljabbar";16;100;0
5;0;"abduljaleel";5;100;0
5;0;"abduljalil";5;100;0
115;0;"abdulkadir";115;100;0
172;0;"abdulkareem";172;100;0
134;0;"abdulkarim";134;100;0
13;0;"abdulkhaliq";13;100;0
5;0;"abdull";5;100;0
424;0;"abdulla";424;100;0
6536;0;"abdullah";6536;100;0
1258;0;"abdullahi";1258;100;0
34;0;"abdullatif";34;100;0
32;0;"abdulloh";32;100;0
27;0;"abdulmajeed";27;100;0
21;0;"abdulmajid";21;100;0
5;0;"abdulmalek";5;100;0
407;0;"abdulmalik";407;100;0
16;0;"abdulmohsen";16;100;0
5;0;"abdulnasir";5;100;0
38;0;"abdulqadir";38;100;0
98;0;"abdulraheem";98;100;0
87;0;"abdulrahim";87;100;0
1980;0;"abdulrahman";1980;100;0
5;0;"abdulrazaq";5;100;0
55;0;"abdulrehman";55;100;0
28;0;"abdulrhman";28;100;0
35;0;"abdulsalam";35;100;0
20;0;"abdulsamad";20;100;0
5;0;"abdulwadud";5;100;0
134;0;"abdulwahab";134;100;0
18;0;"abdulwahid";18;100;0
6;0;"abdulwali";6;100;0
249;0;"abdur";249;100;0
312;0;"abdurahman";312;100;0
5;0;"abdurahmon";5;100;0
22;0;"abdurraheem";22;100;0
27;0;"abdurrahim";27;100;0
5;0;"abdurrahmaan";5;100;0
736;0;"abdurrahman";736;100;0
30;0;"abdurrehman";30;100;0
6;0;"abdussamad";6;100;0
8132;0;"abe";8132;100;0
5;0;"abeal";5;100;0
193;0;"abed";193;100;0
16;0;"abedallah";16;100;0
11;0;"abedalrahman";11;100;0
59;0;"abednego";59;100;0
0;94;"abeeha";94;0;100
37;518;"abeer";555;6.66666666666667;93.3333333333333
0;45;"abeera";45;0;100
0;485;"abegail";485;0;100
0;5;"abegale";5;0;100
0;23;"abegayle";23;0;100
47187;113;"abel";47300;99.7610993657505;0.238900634249471
0;17;"abela";17;0;100
4320;0;"abelardo";4320;100;0
0;507;"abelina";507;0;100
831;0;"abelino";831;100;0
18;5;"abell";23;78.2608695652174;21.7391304347826
0;642;"abella";642;0;100
54;0;"abem";54;100;0
22;0;"aben";22;100;0
0;564;"abena";564;0;100
142;0;"abenezer";142;100;0
0;360;"abeni";360;0;100
0;5;"aber";5;0;100
0;131;"aberdeen";131;0;100
25;0;"aberham";25;100;0
0;33;"abernathy";33;0;100
15;0;"abert";15;100;0
0;7;"abery";7;0;100
10;17;"abey";27;37.037037037037;62.962962962963
0;29;"abgail";29;0;100
0;50;"abha";50;0;100
629;0;"abhay";629;100;0
7;0;"abheek";7;100;0
232;0;"abhi";232;100;0
0;41;"abhigna";41;0;100
95;0;"abhijay";95;100;0
45;0;"abhijeet";45;100;0
42;0;"abhijit";42;100;0
44;0;"abhijot";44;100;0
21;0;"abhik";21;100;0
22;0;"abhilash";22;100;0
175;0;"abhimanyu";175;100;0
1687;0;"abhinav";1687;100;0
5;0;"abhinay";5;100;0
0;5;"abhinaya";5;0;100
6;0;"abhiraam";6;100;0
67;0;"abhiraj";67;100;0
804;0;"abhiram";804;100;0
0;5;"abhirami";5;0;100
10;0;"abhirup";10;100;0
753;0;"abhishek";753;100;0
10;0;"abhyuday";10;100;0
22;488;"abi";510;4.31372549019608;95.6862745098039
0;92;"abia";92;0;100
0;138;"abiageal";138;0;100
0;36;"abiah";36;0;100
12;0;"abian";12;100;0
0;5;"abianna";5;0;100
0;6;"abibail";6;0;100
321;0;"abid";321;100;0
0;37;"abida";37;0;100
0;5;"abidah";5;0;100
16;0;"abidan";16;100;0
635;67;"abie";702;90.4558404558405;9.54415954415954
0;15;"abiegail";15;0;100
1057;23;"abiel";1080;97.8703703703704;2.12962962962963
0;20;"abiela";20;0;100
0;16;"abiella";16;0;100
12;0;"abiezer";12;100;0
5;1617;"abigael";1622;0.30826140567201;99.691738594328
0;120;"abigaelle";120;0;100
0;42;"abigahil";42;0;100
0;12;"abigai";12;0;100
621;345467;"abigail";346088;0.1794341323594;99.8205658676406
0;578;"abigaile";578;0;100
0;18;"abigailgrace";18;0;100
0;27;"abigaille";27;0;100
0;11;"abigailmarie";11;0;100
0;6;"abigailrose";6;0;100
0;751;"abigal";751;0;100
0;5427;"abigale";5427;0;100
0;21;"abigayil";21;0;100
0;335;"abigayl";335;0;100
5;5810;"abigayle";5815;0.0859845227858985;99.9140154772141
0;22;"abigeal";22;0;100
0;31;"abigel";31;0;100
0;161;"abigial";161;0;100
0;103;"abiha";103;0;100
0;29;"abihail";29;0;100
253;51;"abijah";304;83.2236842105263;16.7763157894737
0;976;"abilene";976;0;100
0;28;"abilgail";28;0;100
5;0;"abilio";5;100;0
0;5;"abilyn";5;0;100
0;6;"abilynn";6;0;100
1074;0;"abimael";1074;100;0
5;80;"abimbola";85;5.88235294117647;94.1176470588235
51;0;"abimelec";51;100;0
10;0;"abin";10;100;0
5;0;"abinadab";5;100;0
22;0;"abinadi";22;100;0
35;0;"abinav";35;100;0
0;53;"abinaya";53;0;100
18;0;"abiodun";18;100;0
44;151;"abiola";195;22.5641025641026;77.4358974358974
0;19;"abiona";19;0;100
286;97;"abir";383;74.6736292428198;25.3263707571802
0;21;"abira";21;0;100
12;0;"abiram";12;100;0
0;36;"abirami";36;0;100
0;16;"abisag";16;0;100
824;51;"abisai";875;94.1714285714286;5.82857142857143
5;0;"abisaid";5;100;0
0;24;"abish";24;0;100
0;53;"abisha";53;0;100
167;26;"abishai";193;86.5284974093264;13.4715025906736
50;0;"abishek";50;100;0
0;94;"abisola";94;0;100
6;0;"abiud";6;100;0
5;12;"abiyah";17;29.4117647058824;70.5882352941177
0;11;"abla";11;0;100
873;0;"able";873;100;0
6;0;"abnel";6;100;0
6969;0;"abner";6969;100;0
5;10;"abney";15;33.3333333333333;66.6666666666667
0;43;"abony";43;0;100
69;0;"abou";69;100;0
306;0;"aboubacar";306;100;0
36;0;"aboubakar";36;100;0
0;899;"abra";899;0;100
47;0;"abraam";47;100;0
12;0;"abraar";12;100;0
0;35;"abrah";35;0;100
84679;203;"abraham";84882;99.7608444664358;0.239155533564242
943;0;"abrahan";943;100;0
22;0;"abraheem";22;100;0
41;0;"abrahem";41;100;0
557;0;"abrahim";557;100;0
665;0;"abrahm";665;100;0
15236;0;"abram";15236;100;0
1972;0;"abran";1972;100;0
0;5;"abranda";5;0;100
328;363;"abrar";691;47.4674384949349;52.5325615050651
6;5;"abraxas";11;54.5454545454545;45.4545454545455
0;5;"abraya";5;0;100
0;179;"abrea";179;0;100
0;44;"abreana";44;0;100
0;256;"abreanna";256;0;100
0;531;"abree";531;0;100
0;6;"abreia";6;0;100
5;0;"abrem";5;100;0
11;0;"abren";11;100;0
0;6;"abreona";6;0;100
0;15;"abreonna";15;0;100
0;134;"abrey";134;0;100
0;5;"abreya";5;0;100
126;0;"abrham";126;100;0
0;185;"abri";185;0;100
0;820;"abria";820;0;100
0;30;"abriah";30;0;100
0;121;"abrial";121;0;100
5;0;"abriam";5;100;0
299;5;"abrian";304;98.3552631578947;1.64473684210526
0;2344;"abriana";2344;0;100
0;3901;"abrianna";3901;0;100
0;15;"abriannah";15;0;100
0;15;"abrianne";15;0;100
0;254;"abrie";254;0;100
358;602;"abriel";960;37.2916666666667;62.7083333333333
0;51;"abriela";51;0;100
0;5;"abriele";5;0;100
0;1209;"abriella";1209;0;100
0;3432;"abrielle";3432;0;100
27;0;"abrien";27;100;0
0;21;"abrienne";21;0;100
0;26;"abrigail";26;0;100
0;5;"abrihet";5;0;100
5;7259;"abril";7264;0.0688325991189427;99.9311674008811
0;10;"abrille";10;0;100
0;161;"abrina";161;0;100
11;0;"abrion";11;100;0
0;20;"abriona";20;0;100
0;54;"abrionna";54;0;100
0;43;"abrish";43;0;100
0;29;"abriya";29;0;100
0;11;"abriyah";11;0;100
0;6;"abriyana";6;0;100
6;0;"abrom";6;100;0
254;0;"abron";254;100;0
45;0;"abrum";45;100;0
0;13;"abry";13;0;100
0;177;"abryana";177;0;100
0;252;"abryanna";252;0;100
0;17;"abryella";17;0;100
0;32;"abryelle";32;0;100
0;14;"abryl";14;0;100
0;21;"absalat";21;0;100
149;0;"absalom";149;100;0
33;0;"absalon";33;100;0
61;0;"abshir";61;100;0
0;17;"absidy";17;0;100
6;0;"abtin";6;100;0
372;0;"abu";372;100;0
14;0;"abubacar";14;100;0
20;0;"abubacarr";20;100;0
534;0;"abubakar";534;100;0
28;0;"abubakarr";28;100;0
10;0;"abubakary";10;100;0
24;0;"abubaker";24;100;0
320;0;"abubakr";320;100;0
0;41;"abuk";41;0;100
28;0;"abukar";28;100;0
203;0;"abundio";203;100;0
56;202;"aby";258;21.7054263565891;78.2945736434108
0;10;"abyade";10;0;100
106;28;"abyan";134;79.1044776119403;20.8955223880597
0;43;"abygael";43;0;100
0;2491;"abygail";2491;0;100
0;13;"abygaile";13;0;100
0;332;"abygale";332;0;100
0;142;"abygayle";142;0;100
0;18;"abyssinia";18;0;100
119;0;"ac";119;100;0
0;3638;"acacia";3638;0;100
6;0;"acacius";6;100;0
0;755;"acadia";755;0;100
6;0;"acamas";6;100;0
19;0;"acari";19;100;0
0;120;"acasia";120;0;100
0;26;"accacia";26;0;100
0;76;"accalia";76;0;100
6;0;"access";6;100;0
5;0;"accie";5;100;0
5;0;"accursio";5;100;0
8215;23;"ace";8238;99.7208060208789;0.279193979121146
72;5;"acea";77;93.5064935064935;6.49350649350649
5;0;"acein";5;100;0
5;0;"aceion";5;100;0
68;0;"acel";68;100;0
0;5;"acelee";5;0;100
106;19;"acelin";125;84.8;15.2
7;0;"acelino";7;100;0
11;368;"acelyn";379;2.9023746701847;97.0976253298153
0;618;"acelynn";618;0;100
297;0;"acen";297;100;0
27;0;"acencion";27;100;0
27;0;"aceon";27;100;0
30;0;"acer";30;100;0
169;0;"aceson";169;100;0
6;0;"aceston";6;100;0
23;0;"acesyn";23;100;0
57;0;"aceton";57;100;0
404;22;"acey";426;94.8356807511737;5.16431924882629
66;0;"aceyn";66;100;0
6;0;"achai";6;100;0
0;62;"achaia";62;0;100
5;0;"achaius";5;100;0
0;5;"achan";5;0;100
0;35;"achante";35;0;100
0;5;"achanti";5;0;100
32;0;"achary";32;100;0
0;6;"achazia";6;0;100
0;39;"achel";39;0;100
49;0;"acheron";49;100;0
352;0;"achille";352;100;0
2084;0;"achilles";2084;100;0
5;0;"achilleus";5;100;0
81;0;"achillies";81;100;0
35;0;"achintya";35;100;0
0;55;"achol";55;0;100
10;0;"achraf";10;100;0
0;63;"achsah";63;0;100
58;0;"achyut";58;100;0
29;0;"achyuth";29;100;0
0;6;"acia";6;0;100
5;0;"aciano";5;100;0
1986;50;"acie";2036;97.5442043222004;2.45579567779961
7;0;"aciel";7;100;0
12;0;"acil";12;100;0
0;71;"acire";71;0;100
32;0;"ackeem";32;100;0
22;0;"ackley";22;100;0
5;0;"acob";5;100;0
0;254;"acquanetta";254;0;100
0;13;"acquanette";13;0;100
0;83;"acsa";83;0;100
0;26;"acura";26;0;100
210;0;"acxel";210;100;0
263;5;"acy";268;98.134328358209;1.86567164179104
68;0;"ad";68;100;0
206;74662;"ada";74868;0.275150932307528;99.7248490676925
0;26;"adabel";26;0;100
0;140;"adabella";140;0;100
0;313;"adabelle";313;0;100
0;5;"adacia";5;0;100
5;0;"adae";5;100;0
210;0;"adael";210;100;0
0;5;"adaela";5;0;100
0;6;"adaelyn";6;0;100
0;396;"adaeze";396;0;100
14;0;"adagio";14;100;0
0;2475;"adah";2475;0;100
56;0;"adahir";56;100;0
0;23;"adahli";23;0;100
0;100;"adahlia";100;0;100
6;0;"adahy";6;100;0
0;17;"adai";17;0;100
0;91;"adaia";91;0;100
39;222;"adaiah";261;14.9425287356322;85.0574712643678
0;34;"adaija";34;0;100
0;82;"adaijah";82;0;100
0;8;"adailyn";8;0;100
305;0;"adain";305;100;0
1401;1231;"adair";2632;53.2294832826748;46.7705167173252
0;153;"adaira";153;0;100
0;45;"adaire";45;0;100
0;5;"adairis";5;0;100
0;119;"adaisha";119;0;100
0;7;"adaisia";7;0;100
0;100;"adaja";100;0;100
0;77;"adajah";77;0;100
0;7;"adaku";7;0;100
321;0;"adal";321;100;0
0;5;"adala";5;0;100
0;5;"adalade";5;0;100
0;165;"adalae";165;0;100
0;84;"adalai";84;0;100
0;216;"adalaide";216;0;100
0;123;"adalay";123;0;100
0;62;"adalaya";62;0;100
0;7;"adalayde";7;0;100
94;0;"adalbert";94;100;0
4407;0;"adalberto";4407;100;0
0;10;"adale";10;0;100
0;56;"adalea";56;0;100
0;78;"adaleah";78;0;100
0;1828;"adalee";1828;0;100
0;72;"adaleen";72;0;100
0;68;"adaleena";68;0;100
0;122;"adalei";122;0;100
0;11;"adaleia";11;0;100
0;816;"adaleigh";816;0;100
0;12;"adaleine";12;0;100
0;39;"adalen";39;0;100
0;339;"adalena";339;0;100
0;528;"adalene";528;0;100
0;177;"adaley";177;0;100
0;17;"adaleya";17;0;100
0;23;"adaleyza";23;0;100
0;5;"adalhi";5;0;100
24;408;"adali";432;5.55555555555556;94.4444444444444
0;1549;"adalia";1549;0;100
0;113;"adaliah";113;0;100
0;22;"adalicia";22;0;100
99;11;"adalid";110;90;10
0;77;"adalida";77;0;100
0;1194;"adalie";1194;0;100
0;12;"adaliene";12;0;100
0;283;"adalin";283;0;100
0;1009;"adalina";1009;0;100
0;298;"adalind";298;0;100
0;10;"adalinda";10;0;100
0;6090;"adaline";6090;0;100
0;35;"adalinn";35;0;100
0;5;"adalinne";5;0;100
0;183;"adalis";183;0;100
0;6;"adalisa";6;0;100
0;49;"adalise";49;0;100
0;5;"adalisse";5;0;100
9;0;"adalius";9;100;0
0;20;"adaliyah";20;0;100
0;275;"adaliz";275;0;100
0;6;"adalize";6;0;100
0;29;"adallyn";29;0;100
0;503;"adaly";503;0;100
0;10;"adalya";10;0;100
0;10;"adalye";10;0;100
0;15367;"adalyn";15367;0;100
0;67;"adalyna";67;0;100
0;45;"adalynd";45;0;100
0;411;"adalyne";411;0;100
0;13856;"adalynn";13856;0;100
0;617;"adalynne";617;0;100
0;30;"adalys";30;0;100
0;6;"adalyse";6;0;100
542939;2024;"adam";544963;99.6285986388067;0.371401361193329
316;466;"adama";782;40.4092071611253;59.5907928388747
0;103;"adamae";103;0;100
0;1774;"adamari";1774;0;100
0;132;"adamarie";132;0;100
0;2841;"adamaris";2841;0;100
0;217;"adamariz";217;0;100
0;608;"adamary";608;0;100
0;206;"adamarys";206;0;100
0;20;"adamina";20;0;100
5;0;"adamjames";5;100;0
6;0;"adamm";6;100;0
0;5;"adamma";5;0;100
6;0;"adammichael";6;100;0
11;0;"adamo";11;100;0
1008;0;"adams";1008;100;0
25482;103;"adan";25585;99.5974203634942;0.402579636505765
0;202;"adana";202;0;100
0;11;"adaneli";11;0;100
0;28;"adanelly";28;0;100
0;88;"adanely";88;0;100
0;481;"adanna";481;0;100
0;20;"adannaya";20;0;100
165;0;"adante";165;100;0
0;159;"adanya";159;0;100
0;41;"adaobi";41;0;100
0;182;"adaora";182;0;100
61;34;"adar";95;64.2105263157895;35.7894736842105
0;1683;"adara";1683;0;100
0;26;"adarah";26;0;100
5;0;"adari";5;100;0
0;105;"adaria";105;0;100
211;0;"adarian";211;100;0
20;0;"adarien";20;100;0
38;0;"adarion";38;100;0
29;0;"adarious";29;100;0
1190;0;"adarius";1190;100;0
5;0;"adarrion";5;100;0
97;0;"adarrius";97;100;0
58;0;"adarryl";58;100;0
29;0;"adarryll";29;100;0
526;0;"adarsh";526;100;0
10;0;"adaryl";10;100;0
43;0;"adaryll";43;100;0
0;94;"adasha";94;0;100
0;20;"adashia";20;0;100
0;229;"adasia";229;0;100
5;5;"adason";10;50;50
0;29;"adassa";29;0;100
0;171;"adasyn";171;0;100
0;5;"adasynn";5;0;100
0;6;"adau";6;0;100
0;50;"adaugo";50;0;100
0;5;"adaure";5;0;100
0;5;"adavia";5;0;100
16;0;"adavion";16;100;0
0;645;"adaya";645;0;100
0;148;"adayah";148;0;100
0;35;"adayla";35;0;100
0;61;"adaysha";61;0;100
0;19;"adayshia";19;0;100
0;22;"adaysia";22;0;100
5;0;"adbeel";5;100;0
16;0;"adbiel";16;100;0
81;0;"add";81;100;0
0;570;"adda";570;0;100
0;5;"addah";5;0;100
22;0;"addai";22;100;0
0;149;"addalee";149;0;100
0;67;"addaleigh";67;0;100
0;34;"addaley";34;0;100
0;100;"addalie";100;0;100
0;14;"addalin";14;0;100
0;5;"addalina";5;0;100
0;115;"addaline";115;0;100
0;5;"addallee";5;0;100
0;5;"addaly";5;0;100
0;1655;"addalyn";1655;0;100
0;58;"addalyne";58;0;100
0;1088;"addalynn";1088;0;100
0;75;"addalynne";75;0;100
720;0;"addam";720;100;0
21;0;"addan";21;100;0
0;112;"addasyn";112;0;100
0;5;"addelaide";5;0;100
0;22;"addelin";22;0;100
0;18;"addelina";18;0;100
0;295;"addeline";295;0;100
0;16;"addell";16;0;100
0;1540;"addelyn";1540;0;100
0;12;"addelyne";12;0;100
0;495;"addelynn";495;0;100
0;32;"addelynne";32;0;100
108;0;"adden";108;100;0
11;0;"adderly";11;100;0
0;10;"addeson";10;0;100
0;18;"addesyn";18;0;100
0;11;"addey";11;0;100
0;341;"addi";341;0;100
0;6;"addia";6;0;100
25;0;"addicus";25;100;0
0;33;"addicyn";33;0;100
590;35324;"addie";35914;1.64281338753689;98.3571866124631
69;0;"addiel";69;100;0
0;23;"addielynn";23;0;100
0;5;"addiemae";5;0;100
0;5;"addieson";5;0;100
0;142;"addilee";142;0;100
0;32;"addileigh";32;0;100
0;30;"addiley";30;0;100
0;18;"addiline";18;0;100
5;4605;"addilyn";4610;0.108459869848156;99.8915401301518
0;46;"addilyne";46;0;100
0;2044;"addilynn";2044;0;100
0;78;"addilynne";78;0;100
0;22;"addine";22;0;100
8;5;"addington";13;61.5384615384615;38.4615384615385
381;152;"addis";533;71.4821763602251;28.5178236397749
0;16;"addisan";16;0;100
6;1075;"addisen";1081;0.555041628122109;99.4449583718779
0;30;"addisin";30;0;100
12317;110535;"addison";122852;10.0258848044802;89.9741151955198
0;91;"addisson";91;0;100
0;5;"addiston";5;0;100
0;16;"addisun";16;0;100
0;7672;"addisyn";7672;0;100
0;159;"addisynn";159;0;100
5;0;"addix";5;100;0
0;5;"addle";5;0;100
0;12;"addlee";12;0;100
0;129;"addley";129;0;100
0;6;"addlie";6;0;100
0;15;"addlyn";15;0;100
0;15;"addlynn";15;0;100
5;0;"addonis";5;100;0
0;5;"addriana";5;0;100
0;16;"addrianna";16;0;100
0;15;"addrienne";15;0;100
0;5;"addsion";5;0;100
22;1117;"addy";1139;1.9315188762072;98.0684811237928
0;10;"addylan";10;0;100
0;6;"addylen";6;0;100
0;68;"addylin";68;0;100
0;17;"addyline";17;0;100
0;35;"addylyn";35;0;100
0;53;"addylynn";53;0;100
0;47;"addysan";47;0;100
0;1005;"addysen";1005;0;100
0;112;"addysin";112;0;100
0;6;"addysn";6;0;100
33;14093;"addyson";14126;0.233611779697013;99.766388220303
0;13;"addysun";13;0;100
0;113;"addysyn";113;0;100
269;11;"ade";280;96.0714285714286;3.92857142857143
0;100;"adea";100;0;100
23;93;"adean";116;19.8275862068966;80.1724137931034
0;187;"adeana";187;0;100
0;5;"adeanna";5;0;100
118;0;"adebayo";118;100;0
0;10;"adebisi";10;0;100
10;40;"adebola";50;20;80
19;0;"adebowale";19;100;0
0;10;"adecyn";10;0;100
117;0;"adedamola";117;100;0
50;0;"adedayo";50;100;0
48;0;"adedeji";48;100;0
5;0;"adedotun";5;100;0
5;12;"adedoyin";17;29.4117647058824;70.5882352941177
0;6;"adee";6;0;100
229;0;"adeeb";229;100;0
0;21;"adeeba";21;0;100
300;0;"adeel";300;100;0
5;0;"adeem";5;100;0
5;0;"adeen";5;100;0
0;350;"adeena";350;0;100
7;0;"adefolarin";7;100;0
42;0;"adein";42;100;0
0;123;"adeja";123;0;100
0;30;"adejah";30;0;100
0;5;"adekemi";5;0;100
61;0;"adekunle";61;100;0
1193;1264;"adel";2457;48.5551485551486;51.4448514448514
0;11816;"adela";11816;0;100
0;47;"adelade";47;0;100
0;148;"adelae";148;0;100
0;5;"adelah";5;0;100
0;167;"adelai";167;0;100
0;5;"adelaid";5;0;100
0;2580;"adelaida";2580;0;100
0;22651;"adelaide";22651;0;100
221;0;"adelaido";221;100;0
0;11;"adelaina";11;0;100
0;342;"adelaine";342;0;100
0;16;"adelais";16;0;100
0;5;"adelane";5;0;100
438;0;"adelard";438;100;0
0;37;"adelay";37;0;100
0;10;"adelaya";10;0;100
0;25;"adelayda";25;0;100
0;51;"adelayde";51;0;100
0;6;"adelayne";6;0;100
2127;0;"adelbert";2127;100;0
11;37009;"adele";37020;0.0297136682874122;99.9702863317126
0;6;"adelea";6;0;100
0;5;"adelean";5;0;100
0;73;"adelee";73;0;100
0;5;"adeleen";5;0;100
0;93;"adelei";93;0;100
0;111;"adeleigh";111;0;100
0;237;"adeleine";237;0;100
5;0;"adeleke";5;100;0
0;7;"adelen";7;0;100
0;230;"adelena";230;0;100
0;1076;"adelene";1076;0;100
0;20;"adeley";20;0;100
0;345;"adelfa";345;0;100
0;6;"adelfina";6;0;100
63;0;"adelfo";63;100;0
0;102;"adelheid";102;0;100
0;57;"adeli";57;0;100
0;4240;"adelia";4240;0;100
0;14;"adeliah";14;0;100
0;5;"adelice";5;0;100
0;49;"adelicia";49;0;100
0;418;"adelie";418;0;100
0;5;"adelilah";5;0;100
0;380;"adelin";380;0;100
0;10022;"adelina";10022;0;100
0;11;"adelinah";11;0;100
0;41;"adelind";41;0;100
26;48629;"adeline";48655;0.0534374678861371;99.9465625321139
0;19;"adelinn";19;0;100
0;25;"adelinne";25;0;100
58;0;"adelino";58;100;0
0;67;"adelis";67;0;100
0;149;"adelisa";149;0;100
0;154;"adelise";154;0;100
0;1659;"adelita";1659;0;100
0;83;"adeliz";83;0;100
1049;5893;"adell";6942;15.1109190435033;84.8890809564967
0;4916;"adella";4916;0;100
0;4944;"adelle";4944;0;100
0;5;"adellia";5;0;100
0;8;"adelline";8;0;100
0;63;"adellyn";63;0;100
0;6;"adellynn";6;0;100
0;113;"adelma";113;0;100
0;26;"adelmira";26;0;100
13;0;"adelmo";13;100;0
5;0;"adelore";5;100;0
0;11;"adelphia";11;0;100
0;123;"adely";123;0;100
0;5;"adelya";5;0;100
6;12972;"adelyn";12978;0.0462320850670365;99.953767914933
0;86;"adelyna";86;0;100
0;649;"adelyne";649;0;100
0;7046;"adelynn";7046;0;100
0;506;"adelynne";506;0;100
0;5;"adelys";5;0;100
866;0;"adem";866;100;0
6;0;"ademar";6;100;0
40;5;"ademide";45;88.8888888888889;11.1111111111111
23;0;"ademir";23;100;0
131;0;"ademola";131;100;0
18329;548;"aden";18877;97.0969963447582;2.90300365524183
0;1658;"adena";1658;0;100
0;44;"adene";44;0;100
0;220;"adenike";220;0;100
20;0;"adeniyi";20;100;0
12;0;"adenn";12;100;0
31;345;"adeola";376;8.24468085106383;91.7553191489362
18;0;"adeolu";18;100;0
54;0;"adeoluwa";54;100;0
6;0;"adeon";6;100;0
0;193;"ader";193;0;100
0;10;"adera";10;0;100
6;0;"aderemi";6;100;0
0;30;"aderinsola";30;0;100
0;5;"adero";5;0;100
0;23;"aderonke";23;0;100
0;34;"aderyn";34;0;100
0;12;"adesewa";12;0;100
23;0;"adesh";23;100;0
0;5;"adesha";5;0;100
0;5;"adesina";5;0;100
0;5;"adesire";5;0;100
0;21;"adesola";21;0;100
0;349;"adessa";349;0;100
0;109;"adesuwa";109;0;100
12;0;"adetayo";12;100;0
90;5;"adetokunbo";95;94.7368421052632;5.26315789473684
5;0;"adetola";5;100;0
0;5;"adeva";5;0;100
150;0;"adewale";150;100;0
0;7;"adey";7;0;100
109;0;"adeyemi";109;100;0
5;5;"adeyinka";10;50;50
92;0;"adger";92;100;0
5;7;"adgie";12;41.6666666666667;58.3333333333333
693;0;"adham";693;100;0
0;34;"adhara";34;0;100
16;0;"adharsh";16;100;0
9;0;"adharv";9;100;0
35;0;"adhav";35;100;0
5;0;"adheesh";5;100;0
11;0;"adhem";11;100;0
36;0;"adhemar";36;100;0
0;89;"adhira";89;0;100
18;0;"adhiraj";18;100;0
0;37;"adhithi";37;0;100
6;0;"adhithya";6;100;0
12;0;"adhitya";12;100;0
0;7;"adhley";7;0;100
198;0;"adhrit";198;100;0
31;0;"adhrith";31;100;0
33;0;"adhvaith";33;100;0
190;0;"adhvik";190;100;0
0;29;"adhvika";29;0;100
0;269;"adhya";269;0;100
11;0;"adhyan";11;100;0
530;754;"adi";1284;41.2772585669782;58.7227414330218
0;2641;"adia";2641;0;100
0;125;"adiah";125;0;100
0;18;"adiam";18;0;100
1011;0;"adian";1011;100;0
0;292;"adiana";292;0;100
0;6;"adianey";6;0;100
0;58;"adianez";58;0;100
0;212;"adianna";212;0;100
206;0;"adib";206;100;0
0;124;"adiba";124;0;100
16;0;"adidas";16;100;0
16;156;"adie";172;9.30232558139535;90.6976744186046
1463;93;"adiel";1556;94.0231362467866;5.97686375321337
0;29;"adiela";29;0;100
0;43;"adiella";43;0;100
0;10;"adielle";10;0;100
388;0;"adien";388;100;0
0;6;"adijah";6;0;100
13;0;"adika";13;100;0
5;0;"adikus";5;100;0
1189;0;"adil";1189;100;0
0;46;"adila";46;0;100
0;24;"adilah";24;0;100
0;189;"adilee";189;0;100
0;31;"adileigh";31;0;100
0;61;"adilen";61;0;100
0;32;"adilena";32;0;100
7;5122;"adilene";5129;0.136478845778904;99.8635211542211
0;52;"adileni";52;0;100
0;158;"adilenne";158;0;100
0;60;"adileny";60;0;100
0;17;"adiley";17;0;100
0;20;"adilia";20;0;100
0;21;"adiline";21;0;100
56;0;"adilson";56;100;0
0;1625;"adilyn";1625;0;100
0;42;"adilyne";42;0;100
0;1731;"adilynn";1731;0;100
0;93;"adilynne";93;0;100
2675;86;"adin";2761;96.8851865266208;3.11481347337921
0;6005;"adina";6005;0;100
0;47;"adinah";47;0;100
0;270;"adine";270;0;100
171;0;"adir";171;100;0
0;481;"adira";481;0;100
0;5;"adirah";5;0;100
222;12;"adis";234;94.8717948717949;5.12820512820513
64;89;"adisa";153;41.8300653594771;58.1699346405229
0;179;"adisen";179;0;100
6;0;"adish";6;100;0
627;3021;"adison";3648;17.1875;82.8125
5;81;"adisson";86;5.81395348837209;94.1860465116279
0;1018;"adisyn";1018;0;100
0;73;"adisynn";73;0;100
0;50;"adisynne";50;0;100
264;0;"adit";264;100;0
103;0;"adith";103;100;0
0;330;"adithi";330;0;100
0;17;"adithri";17;0;100
515;0;"adithya";515;100;0
0;2930;"aditi";2930;0;100
0;139;"aditri";139;0;100
4520;5;"aditya";4525;99.8895027624309;0.110497237569061
20;0;"adiv";20;100;0
0;83;"adiva";83;0;100
0;153;"adiya";153;0;100
0;48;"adiyah";48;0;100
25;0;"adiyan";25;100;0
0;149;"adja";149;0;100
0;5;"adji";5;0;100
0;98;"adjoa";98;0;100
0;5;"adjua";5;0;100
457;56;"adlai";513;89.083820662768;10.916179337232
5;0;"adlan";5;100;0
5;0;"adlar";5;100;0
0;5;"adlea";5;0;100
0;138;"adlean";138;0;100
0;534;"adlee";534;0;100
0;7;"adlei";7;0;100
0;722;"adleigh";722;0;100
0;21;"adlemi";21;0;100
0;23;"adlen";23;0;100
0;42;"adlena";42;0;100
0;177;"adlene";177;0;100
1710;181;"adler";1891;90.4283447911158;9.57165520888419
331;1976;"adley";2307;14.3476376246207;85.6523623753793
11;0;"adlia";11;100;0
0;36;"adlie";36;0;100
0;20;"adlih";20;0;100
0;54;"adlin";54;0;100
0;5;"adlina";5;0;100
0;993;"adline";993;0;100
0;19;"adly";19;0;100
0;135;"adlyn";135;0;100
0;74;"adlynn";74;0;100
23;0;"adma";23;100;0
184;0;"admir";184;100;0
217;0;"admiral";217;100;0
5;58;"admire";63;7.93650793650794;92.0634920634921
0;5;"adn";5;0;100
12;390;"adna";402;2.98507462686567;97.0149253731343
49;0;"adnaan";49;100;0
2099;0;"adnan";2099;100;0
5;0;"adnel";5;100;0
12;0;"adner";12;100;0
10;0;"adniel";10;100;0
0;5;"adnrea";5;0;100
39;0;"adnrew";39;100;0
26;0;"ado";26;100;0
1326;0;"adolf";1326;100;0
15256;10;"adolfo";15266;99.9344949561116;0.0655050438883794
0;11;"adoline";11;0;100
16772;20;"adolph";16792;99.8808956646022;0.119104335397808
0;5;"adolpha";5;0;100
295;0;"adolphe";295;100;0
0;13;"adolphine";13;0;100
227;0;"adolpho";227;100;0
3729;0;"adolphus";3729;100;0
159;0;"adom";159;100;0
6;0;"adomas";6;100;0
691;0;"adon";691;100;0
0;35;"adona";35;0;100
600;162;"adonai";762;78.740157480315;21.259842519685
334;0;"adonay";334;100;0
0;5;"adoncia";5;0;100
5;0;"adones";5;100;0
85;0;"adoni";85;100;0
0;321;"adonia";321;0;100
35;20;"adoniah";55;63.6363636363636;36.3636363636364
137;0;"adonias";137;100;0
0;381;"adonica";381;0;100
358;26;"adonijah";384;93.2291666666667;6.77083333333333
31;0;"adoniram";31;100;0
8010;77;"adonis";8087;99.047854581427;0.952145418573018
6;0;"adoniyah";6;100;0
5;0;"adoniz";5;100;0
0;623;"adonna";623;0;100
374;0;"adonnis";374;100;0
7;0;"adontae";7;100;0
172;0;"adonte";172;100;0
70;0;"adonus";70;100;0
16;0;"adony";16;100;0
0;14;"adonya";14;0;100
133;0;"adonys";133;100;0
0;5;"ador";5;0;100
0;1623;"adora";1623;0;100
0;27;"adorabella";27;0;100
0;10;"adorable";10;0;100
0;5;"adorae";5;0;100
0;21;"adorah";21;0;100
6;0;"adoraim";6;100;0
19;214;"adore";233;8.15450643776824;91.8454935622318
0;33;"adoree";33;0;100
0;92;"adoria";92;0;100
85;0;"adorian";85;100;0
6;0;"adorion";6;100;0
0;5;"adorn";5;0;100
0;562;"adra";562;0;100
4143;569;"adrain";4712;87.9244482173175;12.0755517826825
5;218;"adraine";223;2.24215246636771;97.7578475336323
0;13;"adrainne";13;0;100
36;0;"adran";36;100;0
0;23;"adraya";23;0;100
6;0;"adre";6;100;0
0;720;"adrea";720;0;100
0;58;"adream";58;0;100
726;410;"adrean";1136;63.9084507042254;36.0915492957746
0;921;"adreana";921;0;100
0;7;"adreann";7;0;100
0;1525;"adreanna";1525;0;100
0;109;"adreanne";109;0;100
0;5;"adreauna";5;0;100
0;26;"adree";26;0;100
0;103;"adreena";103;0;100
21;0;"adreian";21;100;0
51;0;"adrein";51;100;0
0;11;"adreina";11;0;100
0;15;"adreinne";15;0;100
5;0;"adrell";5;100;0
348;0;"adren";348;100;0
0;498;"adrena";498;0;100
0;46;"adrene";46;0;100
35;0;"adreon";35;100;0
0;106;"adreona";106;0;100
0;176;"adreonna";176;0;100
31;0;"adrew";31;100;0
0;5;"adrey";5;0;100
97;0;"adreyan";97;100;0
0;5;"adreyona";5;0;100
20;172;"adri";192;10.4166666666667;89.5833333333333
7;5935;"adria";5942;0.117805452709525;99.8821945472905
77;0;"adriaan";77;100;0
0;47;"adriah";47;0;100
0;74;"adriahna";74;0;100
25;0;"adrial";25;100;0
0;8;"adrialis";8;0;100
0;16;"adrialys";16;0;100
5;0;"adriam";5;100;0
224595;15065;"adrian";239660;93.7140115163148;6.28598848368522
399;86445;"adriana";86844;0.459444521210446;99.5405554787895
0;232;"adrianah";232;0;100
274;6074;"adriane";6348;4.31632010081916;95.6836798991808
11;0;"adrianjames";11;100;0
104;933;"adriann";1037;10.0289296046287;89.9710703953713
18;43557;"adrianna";43575;0.0413080895008606;99.9586919104991
0;282;"adriannah";282;0;100
31;13031;"adrianne";13062;0.237329658551523;99.7626703414485
8;0;"adrianno";8;100;0
0;21;"adrianny";21;0;100
1982;0;"adriano";1982;100;0
7;0;"adrianpaul";7;100;0
0;248;"adriauna";248;0;100
0;53;"adriaunna";53;0;100
365;0;"adric";365;100;0
172;0;"adrick";172;100;0
0;210;"adrie";210;0;100
18;0;"adriean";18;100;0
0;121;"adrieana";121;0;100
0;363;"adrieanna";363;0;100
0;16;"adrieanne";16;0;100
10242;748;"adriel";10990;93.1938125568699;6.80618744313012
0;18;"adriela";18;0;100
58;0;"adriell";58;100;0
0;87;"adriella";87;0;100
0;747;"adrielle";747;0;100
7819;1359;"adrien";9178;85.1928524733057;14.8071475266943
0;135;"adriena";135;0;100
61;2360;"adriene";2421;2.51961999173895;97.4803800082611
7;27;"adrienn";34;20.5882352941176;79.4117647058823
0;788;"adrienna";788;0;100
382;66332;"adrienne";66714;0.572593458644363;99.4274065413556
0;5;"adriennie";5;0;100
0;5;"adrieonna";5;0;100
0;5;"adrihana";5;0;100
0;22;"adrihanna";22;0;100
0;35;"adrija";35;0;100
0;63;"adrijana";63;0;100
378;0;"adrik";378;100;0
0;25;"adrika";25;0;100
349;12;"adrin";361;96.6759002770083;3.32409972299169
0;1413;"adrina";1413;0;100
5;64;"adrine";69;7.2463768115942;92.7536231884058
0;34;"adrinna";34;0;100
0;66;"adrinne";66;0;100
694;0;"adrion";694;100;0
0;290;"adriona";290;0;100
0;861;"adrionna";861;0;100
10;0;"adris";10;100;0
0;49;"adrita";49;0;100
13;0;"adrith";13;100;0
0;5;"adriunna";5;0;100
19;0;"adrius";19;100;0
37;0;"adriyan";37;100;0
0;169;"adriyana";169;0;100
0;194;"adriyanna";194;0;100
22;0;"adriyel";22;100;0
1094;0;"adron";1094;100;0
0;5;"adry";5;0;100
1004;162;"adryan";1166;86.106346483705;13.893653516295
0;498;"adryana";498;0;100
0;5;"adryanah";5;0;100
0;5;"adryann";5;0;100
0;634;"adryanna";634;0;100
0;5;"adryauna";5;0;100
82;0;"adryel";82;100;0
84;0;"adryen";84;100;0
5;0;"adryian";5;100;0
26;6;"adryn";32;81.25;18.75
15;0;"adryon";15;100;0
0;5;"adryonna";5;0;100
5;0;"adulfo";5;100;0
0;38;"adut";38;0;100
374;0;"advait";374;100;0
0;34;"advaita";34;0;100
501;0;"advaith";501;100;0
330;0;"advay";330;100;0
574;0;"advik";574;100;0
0;373;"advika";373;0;100
46;0;"advit";46;100;0
0;36;"advita";36;0;100
71;0;"advith";71;100;0
0;23;"advitha";23;0;100
10;0;"adwaith";10;100;0
45;0;"adwin";45;100;0
5;0;"adwit";5;100;0
0;59;"adwita";59;0;100
0;5;"adwitiya";5;0;100
0;177;"adwoa";177;0;100
0;129;"ady";129;0;100
0;250;"adya";250;0;100
6;0;"adyaan";6;100;0
330;0;"adyan";330;100;0
0;11;"adyanna";11;0;100
21;0;"adyant";21;100;0
82;0;"adyen";82;100;0
0;28;"adylan";28;0;100
0;54;"adylee";54;0;100
0;6;"adyleigh";6;0;100
0;30;"adylen";30;0;100
0;276;"adylene";276;0;100
0;13;"adylenne";13;0;100
0;93;"adylin";93;0;100
0;5;"adylina";5;0;100
0;81;"adyline";81;0;100
0;11;"adylinn";11;0;100
0;23;"adylyn";23;0;100
0;47;"adylynn";47;0;100
5;0;"adym";5;100;0
1196;114;"adyn";1310;91.2977099236641;8.70229007633588
63;17;"adynn";80;78.75;21.25
0;7;"adysan";7;0;100
0;745;"adysen";745;0;100
0;40;"adysin";40;0;100
34;3792;"adyson";3826;0.888656560376372;99.1113434396236
0;69;"adysson";69;0;100
0;5;"adysun";5;0;100
0;32;"adysyn";32;0;100
3206;43;"aedan";3249;98.6765158510311;1.32348414896891
26;0;"aeddon";26;100;0
955;7;"aeden";962;99.2723492723493;0.727650727650728
177;0;"aedin";177;100;0
133;0;"aedon";133;100;0
21;0;"aedric";21;100;0
501;73;"aedyn";574;87.2822299651568;12.7177700348432
10;0;"aeiden";10;100;0
0;6;"aeiress";6;0;100
0;264;"aeisha";264;0;100
0;48;"aeja";48;0;100
0;232;"aela";232;0;100
0;6;"aelan";6;0;100
0;12;"aelani";12;0;100
0;15;"aeleen";15;0;100
0;5;"aelia";5;0;100
0;64;"aeliana";64;0;100
0;6;"aelicia";6;0;100
0;5;"aelin";5;0;100
0;5;"aelisa";5;0;100
0;5;"aelish";5;0;100
0;18;"aelita";18;0;100
0;89;"aella";89;0;100
28;0;"aelred";28;100;0
0;108;"aelyn";108;0;100
0;13;"aelynn";13;0;100
0;6;"aemelia";6;0;100
0;100;"aemilia";100;0;100
51;0;"aemon";51;100;0
0;12;"aenea";12;0;100
343;0;"aeneas";343;100;0
144;0;"aengus";144;100;0
84;65;"aeon";149;56.3758389261745;43.6241610738255
0;7;"aeona";7;0;100
0;22;"aeowyn";22;0;100
0;213;"aerabella";213;0;100
0;70;"aeralyn";70;0;100
0;31;"aeralynn";31;0;100
0;5;"aeri";5;0;100
6;1863;"aerial";1869;0.321027287319422;99.6789727126806
5;0;"aerian";5;100;0
0;386;"aeriana";386;0;100
0;356;"aerianna";356;0;100
108;0;"aeric";108;100;0
0;87;"aerica";87;0;100
49;0;"aerick";49;100;0
0;5;"aericka";5;0;100
0;91;"aerie";91;0;100
0;753;"aeriel";753;0;100
0;31;"aeriell";31;0;100
0;28;"aeriella";28;0;100
0;195;"aerielle";195;0;100
0;10;"aeries";10;0;100
75;0;"aerik";75;100;0
0;80;"aerika";80;0;100
0;202;"aerilyn";202;0;100
0;54;"aerilynn";54;0;100
16;726;"aerin";742;2.15633423180593;97.8436657681941
114;24;"aerion";138;82.6086956521739;17.3913043478261
0;46;"aeriona";46;0;100
0;123;"aerionna";123;0;100
6;1196;"aeris";1202;0.499168053244592;99.5008319467554
0;5;"aeriss";5;0;100
0;226;"aerith";226;0;100
7;0;"aerius";7;100;0
160;33;"aero";193;82.9015544041451;17.0984455958549
548;65;"aeron";613;89.3964110929853;10.6035889070147
0;11;"aerowyn";11;0;100
0;24;"aeryal";24;0;100
0;12;"aeryana";12;0;100
0;18;"aeryanna";18;0;100
53;0;"aeryk";53;100;0
24;940;"aeryn";964;2.4896265560166;97.5103734439834
0;5;"aeryona";5;0;100
0;10;"aesa";10;0;100
0;619;"aesha";619;0;100
0;7;"aeshia";7;0;100
303;0;"aeson";303;100;0
24;0;"aesop";24;100;0
44;0;"aethan";44;100;0
0;5;"aetna";5;0;100
0;413;"aeva";413;0;100
0;48;"aevah";48;0;100
22;0;"aevin";22;100;0
0;5;"aevry";5;0;100
0;5;"aevyn";5;0;100
13;0;"aeyden";13;100;0
0;11;"aeyla";11;0;100
5;0;"afa";5;100;0
0;36;"afaf";36;0;100
11;0;"afeef";11;100;0
0;31;"afeni";31;0;100
0;6;"aferdita";6;0;100
5;0;"affaan";5;100;0
276;0;"affan";276;100;0
0;44;"affie";44;0;100
0;5;"affinity";5;0;100
0;52;"afi";52;0;100
0;421;"afia";421;0;100
10;0;"afif";10;100;0
0;69;"afifa";69;0;100
0;15;"afifah";15;0;100
0;10;"afina";10;0;100
0;236;"afiya";236;0;100
0;24;"afiyah";24;0;100
88;372;"afnan";460;19.1304347826087;80.8695652173913
25;0;"afolabi";25;100;0
0;81;"afomia";81;0;100
5;0;"afonso";5;100;0
0;140;"afra";140;0;100
0;184;"afrah";184;0;100
42;0;"afraz";42;100;0
6;0;"afred";6;100;0
0;191;"afreen";191;0;100
0;960;"africa";960;0;100
0;5;"africia";5;0;100
0;239;"afrika";239;0;100
10;0;"afrim";10;100;0
0;30;"afrin";30;0;100
0;16;"afrodita";16;0;100
0;51;"afsa";51;0;100
0;103;"afsana";103;0;100
0;17;"afsaneh";17;0;100
0;41;"afshan";41;0;100
15;100;"afsheen";115;13.0434782608696;86.9565217391304
52;0;"afshin";52;100;0
20;0;"aftab";20;100;0
0;109;"aftan";109;0;100
0;102;"aften";102;0;100
0;61;"aftin";61;0;100
741;4598;"afton";5339;13.8790035587189;86.1209964412811
0;195;"aftyn";195;0;100
0;200;"afua";200;0;100
14;0;"afzal";14;100;0
170;90;"agam";260;65.3846153846154;34.6153846153846
40;0;"agamjot";40;100;0
12;0;"agamveer";12;100;0
15;57;"agape";72;20.8333333333333;79.1666666666667
0;299;"agapita";299;0;100
1508;0;"agapito";1508;100;0
6;0;"agassi";6;100;0
43;0;"agasthya";43;100;0
430;0;"agastya";430;100;0
0;321;"agata";321;0;100
0;7814;"agatha";7814;0;100
0;26;"agathe";26;0;100
0;21;"agda";21;0;100
38;0;"agee";38;100;0
5;0;"agel";5;100;0
0;6;"agela";6;0;100
0;11;"ageliki";11;0;100
0;15;"agena";15;0;100
5;0;"agent";5;100;0
0;5;"aggeliki";5;0;100
30;1293;"aggie";1323;2.26757369614512;97.7324263038549
11;0;"agha";11;100;0
0;21;"agigail";21;0;100
0;11;"agila";11;0;100
27;0;"agim";27;100;0
0;6;"aginah";6;0;100
0;7;"aglae";7;0;100
0;6;"aglaia";6;0;100
0;7;"agna";7;0;100
0;5;"agneda";5;0;100
0;13;"agnella";13;0;100
421;135893;"agnes";136314;0.308845753187494;99.6911542468125
0;5;"agnesa";5;0;100
0;16;"agnese";16;0;100
0;687;"agness";687;0;100
0;6;"agnessa";6;0;100
0;5;"agneta";5;0;100
35;0;"agnew";35;100;0
0;226;"agnieszka";226;0;100
0;30;"agnita";30;0;100
0;10;"agnus";10;0;100
0;17;"agostina";17;0;100
528;0;"agostino";528;100;0
24;0;"agrim";24;100;0
0;13;"agrima";13;0;100
0;184;"agripina";184;0;100
6;0;"agripino";6;100;0
133;0;"agron";133;100;0
0;232;"agueda";232;0;100
12;214;"agusta";226;5.30973451327434;94.6902654867257
14288;21;"agustin";14309;99.8532392200713;0.146760779928716
0;1513;"agustina";1513;0;100
504;0;"agustine";504;100;0
360;0;"agustus";360;100;0
7;0;"agustya";7;100;0
63;21;"ah";84;75;25
312;0;"ahaan";312;100;0
0;66;"ahaana";66;0;100
430;0;"ahad";430;100;0
41;0;"ahadu";41;100;0
0;6;"ahalya";6;0;100
35;0;"ahamad";35;100;0
63;0;"ahamed";63;100;0
171;0;"ahan";171;100;0
0;549;"ahana";549;0;100
5;0;"ahanna";5;100;0
11;0;"ahanu";11;100;0
1848;0;"aharon";1848;100;0
5;0;"aharshi";5;100;0
0;217;"ahava";217;0;100
0;15;"ahavah";15;0;100
5;0;"ahaziah";5;100;0
6;0;"ahbleza";6;100;0
0;10;"ahbree";10;0;100
0;14;"ahdia";14;0;100
0;5;"aheli";5;0;100
6;0;"ahian";6;100;0
72;0;"ahijah";72;100;0
25;0;"ahil";25;100;0
0;102;"ahilyn";102;0;100
0;9;"ahinara";9;0;100
5;0;"ahir";5;100;0
0;16;"ahisha";16;0;100
0;14;"ahitana";14;0;100
0;107;"ahja";107;0;100
0;49;"ahjah";49;0;100
0;5;"ahjahnae";5;0;100
0;136;"ahjanae";136;0;100
0;17;"ahjanay";17;0;100
13;0;"ahkai";13;100;0
5;0;"ahkari";5;100;0
6;0;"ahkeel";6;100;0
0;6;"ahkeelah";6;0;100
313;0;"ahkeem";313;100;0
5;0;"ahkil";5;100;0
22;0;"ahking";22;100;0
0;22;"ahlaam";22;0;100
0;12;"ahlai";12;0;100
0;718;"ahlam";718;0;100
0;175;"ahlana";175;0;100
0;127;"ahlani";127;0;100
0;10;"ahlanie";10;0;100
0;35;"ahlanna";35;0;100
0;131;"ahlaya";131;0;100
0;93;"ahlayah";93;0;100
0;16;"ahlayla";16;0;100
0;19;"ahlayna";19;0;100
0;10;"ahlaysia";10;0;100
0;32;"ahlea";32;0;100
0;100;"ahleah";100;0;100
0;28;"ahleena";28;0;100
0;5;"ahleeyah";5;0;100
0;12;"ahleigha";12;0;100
0;11;"ahlena";11;0;100
0;24;"ahlexis";24;0;100
0;13;"ahlexus";13;0;100
0;53;"ahley";53;0;100
0;141;"ahlia";141;0;100
0;22;"ahliana";22;0;100
32;0;"ahlias";32;100;0
46;0;"ahlijah";46;100;0
0;52;"ahlina";52;0;100
0;83;"ahlivia";83;0;100
0;70;"ahliya";70;0;100
0;234;"ahliyah";234;0;100
0;5;"ahlona";5;0;100
0;5;"ahlyana";5;0;100
0;37;"ahlyssa";37;0;100
0;5;"ahlyvia";5;0;100
366;0;"ahmaad";366;100;0
16423;18;"ahmad";16441;99.890517608418;0.109482391582021
102;0;"ahmadou";102;100;0
10;0;"ahmaj";10;100;0
203;0;"ahman";203;100;0
15;0;"ahmand";15;100;0
67;384;"ahmani";451;14.8558758314856;85.1441241685144
175;0;"ahmar";175;100;0
0;12;"ahmara";12;0;100
23;0;"ahmare";23;100;0
807;324;"ahmari";1131;71.3527851458886;28.6472148541114
0;33;"ahmaria";33;0;100
0;14;"ahmarie";14;0;100
75;0;"ahmarion";75;100;0
0;5;"ahmarria";5;0;100
194;0;"ahmaud";194;100;0
15;0;"ahmauri";15;100;0
0;174;"ahmaya";174;0;100
13256;0;"ahmed";13256;100;0
6;0;"ahmednur";6;100;0
56;0;"ahmeer";56;100;0
45;0;"ahmeir";45;100;0
43;0;"ahmer";43;100;0
158;0;"ahmere";158;100;0
517;0;"ahmet";517;100;0
38;5;"ahmi";43;88.3720930232558;11.6279069767442
0;116;"ahmia";116;0;100
0;28;"ahmiah";28;0;100
7;0;"ahmid";7;100;0
46;0;"ahmier";46;100;0
12;0;"ahmik";12;100;0
0;33;"ahmina";33;0;100
1831;5;"ahmir";1836;99.7276688453159;0.272331154684096
0;86;"ahmira";86;0;100
0;37;"ahmiracle";37;0;100
0;33;"ahmirah";33;0;100
29;0;"ahmire";29;100;0
0;168;"ahmiya";168;0;100
0;177;"ahmiyah";177;0;100
196;0;"ahmod";196;100;0
175;0;"ahmon";175;100;0
20;0;"ahmond";20;100;0
0;56;"ahmoni";56;0;100
0;5;"ahmonie";5;0;100
0;6;"ahmora";6;0;100
0;516;"ahmya";516;0;100
0;77;"ahmyah";77;0;100
0;12;"ahmyiah";12;0;100
0;22;"ahmyra";22;0;100
0;949;"ahna";949;0;100
243;0;"ahnaf";243;100;0
0;5;"ahnah";5;0;100
0;18;"ahnalee";18;0;100
0;10;"ahnaleigh";10;0;100
0;12;"ahnalia";12;0;100
0;12;"ahnalise";12;0;100
0;5;"ahnari";5;0;100
0;16;"ahnaya";16;0;100
0;71;"ahnesti";71;0;100
0;75;"ahnesty";75;0;100
0;86;"ahni";86;0;100
0;28;"ahnia";28;0;100
0;12;"ahniah";12;0;100
0;228;"ahnika";228;0;100
0;6;"ahnisty";6;0;100
0;308;"ahniya";308;0;100
0;261;"ahniyah";261;0;100
0;10;"ahniyla";10;0;100
0;7;"ahnjayla";7;0;100
0;206;"ahnna";206;0;100
0;155;"ahnya";155;0;100
0;56;"ahnyah";56;0;100
0;5;"ahnyia";5;0;100
0;72;"ahnyla";72;0;100
0;17;"ahnylah";17;0;100
0;5;"ahona";5;0;100
0;23;"ahonesti";23;0;100
0;61;"ahonesty";61;0;100
0;6;"ahrayah";6;0;100
0;5;"ahreanna";5;0;100
851;0;"ahren";851;100;0
0;139;"ahri";139;0;100
0;97;"ahria";97;0;100
0;12;"ahriah";12;0;100
9;0;"ahrian";9;100;0
0;164;"ahriana";164;0;100
0;182;"ahrianna";182;0;100
0;14;"ahriel";14;0;100
0;44;"ahriya";44;0;100
0;57;"ahriyah";57;0;100
823;0;"ahron";823;100;0
0;18;"ahrya";18;0;100
0;34;"ahsaki";34;0;100
520;0;"ahsan";520;100;0
6;0;"ahsen";6;100;0
0;118;"ahsha";118;0;100
0;5;"ahshanti";5;0;100
0;12;"ahsia";12;0;100
12;0;"ahsir";12;100;0
0;31;"ahslee";31;0;100
0;1189;"ahsley";1189;0;100
0;15;"ahsoka";15;0;100
13;0;"ahti";13;100;0
0;5;"ahtyana";5;0;100
0;1076;"ahtziri";1076;0;100
0;287;"ahtziry";287;0;100
0;1144;"ahuva";1144;0;100
0;19;"ahva";19;0;100
0;5;"ahviana";5;0;100
0;5;"ahvianna";5;0;100
5;0;"ahyaan";5;100;0
151;0;"ahyan";151;100;0
0;86;"ahyana";86;0;100
0;53;"ahyanna";53;0;100
0;13;"ahylin";13;0;100
0;5;"ahyonna";5;0;100
11;0;"ahzab";11;100;0
0;43;"ahzaria";43;0;100
0;9;"ahzariah";9;0;100
0;5;"ahzhane";5;0;100
26;0;"ahzir";26;100;0
0;12;"ahziyah";12;0;100
11;357;"ai";368;2.98913043478261;97.0108695652174
0;20;"aia";20;0;100
0;18;"aiah";18;0;100
5;0;"aian";5;100;0
0;148;"aiana";148;0;100
0;59;"aianna";59;0;100
6;0;"aibel";6;100;0
0;11;"aibhilin";11;0;100
0;111;"aibhlinn";111;0;100
0;6;"aibileen";6;0;100
5;0;"aicen";5;100;0
0;761;"aicha";761;0;100
0;28;"aichatou";28;0;100
0;47;"aicia";47;0;100
5;12018;"aida";12023;0.0415869583298678;99.9584130416701
0;100;"aidah";100;0;100
0;20;"aidaliz";20;0;100
0;72;"aidaly";72;0;100
0;18;"aidalyn";18;0;100
106525;2603;"aidan";109128;97.6147276592625;2.38527234073748
0;44;"aidana";44;0;100
6;0;"aidanjames";6;100;0
5;0;"aidanjohn";5;100;0
10;0;"aidann";10;100;0
5;0;"aidar";5;100;0
17;0;"aiddan";17;100;0
293;0;"aidden";293;100;0
0;1882;"aide";1882;0;100
23;0;"aidean";23;100;0
0;7;"aided";7;0;100
0;690;"aidee";690;0;100
39;108;"aideen";147;26.530612244898;73.469387755102
0;224;"aidel";224;0;100
0;12;"aidelis";12;0;100
0;114;"aideliz";114;0;100
0;32;"aidelyn";32;0;100
183703;1818;"aiden";185521;99.0200570285844;0.979942971415635
72;0;"aidenjames";72;100;0
5;0;"aidenjoseph";5;100;0
5;0;"aidenmatthew";5;100;0
6;0;"aidenmichael";6;100;0
173;0;"aidenn";173;100;0
0;5;"aidet";5;0;100
0;10;"aideth";10;0;100
14;0;"aideyn";14;100;0
0;39;"aidia";39;0;100
146;0;"aidian";146;100;0
5;0;"aidien";5;100;0
619;12;"aidin";631;98.0982567353407;1.90174326465927
452;0;"aidon";452;100;0
53;0;"aidrian";53;100;0
0;5;"aidrianna";5;0;100
369;0;"aidric";369;100;0
14;0;"aidrick";14;100;0
25;0;"aidrik";25;100;0
0;30;"aidsa";30;0;100
0;36;"aidy";36;0;100
5;0;"aidyen";5;100;0
3337;709;"aidyn";4046;82.4765200197726;17.5234799802274
74;64;"aidynn";138;53.6231884057971;46.3768115942029
5;0;"aiedan";5;100;0
12;0;"aieden";12;100;0
0;1253;"aiesha";1253;0;100
0;5;"aieshia";5;0;100
0;9;"aigne";9;0;100
0;242;"aigner";242;0;100
5;0;"aiham";5;100;0
45;0;"aiiden";45;100;0
0;368;"aija";368;0;100
0;322;"aijah";322;0;100
5;0;"aijahlon";5;100;0
102;95;"aijalon";197;51.7766497461929;48.2233502538071
0;5;"aijha";5;0;100
0;179;"aika";179;0;100
95;0;"aikeem";95;100;0
240;0;"aiken";240;100;0
6;0;"aiker";6;100;0
0;1300;"aiko";1300;0;100
0;1538;"aila";1538;0;100
0;126;"ailah";126;0;100
0;20;"ailaina";20;0;100
15;0;"ailan";15;100;0
0;125;"ailana";125;0;100
0;1755;"ailani";1755;0;100
0;50;"ailanie";50;0;100
0;13;"ailanny";13;0;100
0;393;"ailany";393;0;100
0;48;"aile";48;0;100
0;88;"ailea";88;0;100
0;51;"aileah";51;0;100
0;22;"ailean";22;0;100
0;48;"aileana";48;0;100
0;242;"ailed";242;0;100
0;507;"ailee";507;0;100
5;33559;"aileen";33564;0.0148969133595519;99.9851030866404
0;92;"aileena";92;0;100
0;370;"aileene";370;0;100
0;10;"aileigh";10;0;100
0;258;"ailen";258;0;100
0;20;"ailena";20;0;100
0;2108;"ailene";2108;0;100
0;10;"aileny";10;0;100
0;6;"ailet";6;0;100
0;36;"aileth";36;0;100
0;722;"ailey";722;0;100
0;1096;"aili";1096;0;100
0;50;"ailia";50;0;100
0;5;"ailiana";5;0;100
0;338;"ailie";338;0;100
5;904;"ailin";909;0.55005500550055;99.4499449944994
0;18;"ailina";18;0;100
0;87;"ailine";87;0;100
0;162;"ailis";162;0;100
0;12;"ailisa";12;0;100
0;6;"ailise";6;0;100
0;492;"ailish";492;0;100
0;10;"ailiyah";10;0;100
0;21;"ailleen";21;0;100
0;5;"aillene";5;0;100
0;484;"ailsa";484;0;100
62;0;"ailton";62;100;0
0;132;"aily";132;0;100
0;6;"ailyah";6;0;100
0;3011;"ailyn";3011;0;100
0;59;"ailyne";59;0;100
0;353;"ailynn";353;0;100
0;84;"aima";84;0;100
6;0;"aimal";6;100;0
283;93;"aiman";376;75.2659574468085;24.7340425531915
0;5;"aimani";5;0;100
138;122;"aimar";260;53.0769230769231;46.9230769230769
0;12;"aimara";12;0;100
474;1683;"aime";2157;21.9749652294854;78.0250347705146
78;52848;"aimee";52926;0.147375580999887;99.8526244190001
26;41;"aimen";67;38.8059701492537;61.1940298507463
0;132;"aimi";132;0;100
0;548;"aimie";548;0;100
0;26;"aimme";26;0;100
10;0;"aimo";10;100;0
46;0;"aimon";46;100;0
0;27;"aimsley";27;0;100
0;234;"aimy";234;0;100
0;23;"ain";23;0;100
0;439;"aina";439;0;100
0;296;"ainara";296;0;100
0;16;"aindrea";16;0;100
0;1262;"aine";1262;0;100
11;0;"ainesh";11;100;0
0;17;"ainhara";17;0;100
0;152;"ainhoa";152;0;100
0;5;"aini";5;0;100
0;6;"ainka";6;0;100
0;87;"aino";87;0;100
0;1059;"ainslee";1059;0;100
0;5;"ainslei";5;0;100
0;429;"ainsleigh";429;0;100
362;14265;"ainsley";14627;2.47487523073768;97.5251247692623
0;484;"ainslie";484;0;100
0;5;"ainsly";5;0;100
5;0;"ainsworth";5;100;0
0;28;"ainzlee";28;0;100
0;32;"ainzley";32;0;100
0;5;"aiona";5;0;100
0;12;"aionna";12;0;100
0;301;"aira";301;0;100
0;267;"airabella";267;0;100
0;11;"airabelle";11;0;100
0;24;"airah";24;0;100
0;36;"airalyn";36;0;100
0;37;"airalynn";37;0;100
115;713;"airam";828;13.8888888888889;86.1111111111111
5;0;"airan";5;100;0
0;64;"airanna";64;0;100
0;5;"aire";5;0;100
0;252;"aireal";252;0;100
0;205;"aireana";205;0;100
0;309;"aireanna";309;0;100
0;5;"aireka";5;0;100
0;272;"airel";272;0;100
0;233;"airelle";233;0;100
114;135;"airen";249;45.7831325301205;54.2168674698795
60;5;"aireon";65;92.3076923076923;7.69230769230769
0;212;"aireona";212;0;100
0;179;"aireonna";179;0;100
25;7;"aires";32;78.125;21.875
0;20;"airess";20;0;100
0;14;"aireyana";14;0;100
0;189;"airi";189;0;100
0;20;"airial";20;0;100
0;5;"airian";5;0;100
0;540;"airiana";540;0;100
0;509;"airianna";509;0;100
32;0;"airic";32;100;0
0;141;"airica";141;0;100
21;0;"airick";21;100;0
0;13;"airicka";13;0;100
0;145;"airiel";145;0;100
0;44;"airielle";44;0;100
64;0;"airik";64;100;0
0;173;"airika";173;0;100
5;31;"airin";36;13.8888888888889;86.1111111111111
18;0;"airion";18;100;0
0;5;"airiona";5;0;100
0;35;"airionna";35;0;100
11;105;"airis";116;9.48275862068965;90.5172413793103
5;0;"airius";5;100;0
0;5;"airlene";5;0;100
0;58;"airlie";58;0;100
183;5;"airon";188;97.3404255319149;2.65957446808511
78;0;"airrion";78;100;0
5;0;"airron";5;100;0
0;216;"airyana";216;0;100
0;248;"airyanna";248;0;100
5;99;"airyn";104;4.80769230769231;95.1923076923077
0;5;"airyona";5;0;100
0;61;"airyonna";61;0;100
0;5;"airys";5;0;100
5;487;"aisa";492;1.01626016260163;98.9837398373984
0;10;"aisah";10;0;100
19;0;"aisaiah";19;100;0
0;33;"aisatou";33;0;100
78;0;"aisea";78;100;0
46;0;"aisen";46;100;0
27;20703;"aisha";20730;0.130246020260492;99.8697539797395
0;1100;"aishah";1100;0;100
0;357;"aishani";357;0;100
0;48;"aishat";48;0;100
0;5;"aishatu";5;0;100
0;5;"aishe";5;0;100
0;60;"aishi";60;0;100
0;403;"aishia";403;0;100
0;10;"aishini";10;0;100
0;13;"aishleen";13;0;100
0;5;"aishlin";5;0;100
0;33;"aishling";33;0;100
0;5;"aishlyn";5;0;100
0;9;"aishvi";9;0;100
0;741;"aishwarya";741;0;100
0;83;"aisia";83;0;100
0;5;"aisja";5;0;100
0;20;"aisla";20;0;100
0;81;"aislee";81;0;100
0;41;"aisleen";41;0;100
0;19;"aisleigh";19;0;100
0;679;"aisley";679;0;100
0;993;"aislin";993;0;100
0;1207;"aisling";1207;0;100
0;3595;"aislinn";3595;0;100
0;1394;"aislyn";1394;0;100
0;1812;"aislynn";1812;0;100
0;36;"aislynne";36;0;100
87;0;"aison";87;100;0
0;37;"aisosa";37;0;100
0;606;"aissa";606;0;100
0;372;"aissata";372;0;100
0;633;"aissatou";633;0;100
0;5;"aisya";5;0;100
67;0;"aitan";67;100;0
0;1203;"aitana";1203;0;100
0;40;"aitanna";40;0;100
104;0;"aithan";104;100;0
0;30;"aithana";30;0;100
57;0;"aithen";57;100;0
0;27;"aitiana";27;0;100
0;9;"aitlin";9;0;100
29;0;"aitor";29;100;0
0;25;"aitza";25;0;100
0;576;"aiva";576;0;100
0;203;"aivah";203;0;100
71;5;"aivan";76;93.4210526315789;6.57894736842105
246;0;"aiven";246;100;0
0;5;"aivery";5;0;100
0;6;"aivley";6;0;100
0;40;"aivree";40;0;100
0;5;"aivry";5;0;100
0;163;"aivy";163;0;100
0;1006;"aixa";1006;0;100
0;339;"aiya";339;0;100
0;110;"aiyah";110;0;100
0;28;"aiyahna";28;0;100
11;0;"aiyan";11;100;0
0;7733;"aiyana";7733;0;100
0;305;"aiyanah";305;0;100
0;6;"aiyani";6;0;100
0;3651;"aiyanna";3651;0;100
0;138;"aiyannah";138;0;100
31;0;"aiydan";31;100;0
555;0;"aiyden";555;100;0
0;170;"aiyla";170;0;100
0;17;"aiylah";17;0;100
0;58;"aiyona";58;0;100
0;222;"aiyonna";222;0;100
0;148;"aiysha";148;0;100
0;929;"aiza";929;0;100
0;311;"aizah";311;0;100
11;0;"aizayah";11;100;0
11;0;"aizeah";11;100;0
5;0;"aizel";5;100;0
534;0;"aizen";534;100;0
0;7;"aizha";7;0;100
230;0;"aizik";230;100;0
0;38;"aizlee";38;0;100
0;5;"aizleigh";5;0;100
0;48;"aizley";48;0;100
0;154;"aizlyn";154;0;100
0;168;"aizlynn";168;0;100
0;60;"aizza";60;0;100
1783;31;"aj";1814;98.2910694597574;1.70893054024256
84;7680;"aja";7764;1.08191653786708;98.9180834621329
0;5;"ajacia";5;0;100
0;53;"ajada";53;0;100
6;0;"ajaden";6;100;0
11;30;"ajae";41;26.8292682926829;73.1707317073171
0;1318;"ajah";1318;0;100
6;0;"ajahn";6;100;0
0;111;"ajahnae";111;0;100
0;5;"ajahnay";5;0;100
72;0;"ajahni";72;100;0
182;169;"ajai";351;51.8518518518518;48.1481481481481
16;0;"ajak";16;100;0
0;22;"ajala";22;0;100
0;13;"ajalae";13;0;100
7;12;"ajalon";19;36.8421052631579;63.1578947368421
116;0;"ajamu";116;100;0
36;0;"ajan";36;100;0
0;41;"ajana";41;0;100
0;766;"ajanae";766;0;100
0;24;"ajanai";24;0;100
0;136;"ajanay";136;0;100
0;99;"ajane";99;0;100
0;12;"ajanea";12;0;100
0;116;"ajanee";116;0;100
5;0;"ajang";5;100;0
1628;177;"ajani";1805;90.1939058171745;9.80609418282548
0;28;"ajanique";28;0;100
0;10;"ajasia";10;0;100
12;0;"ajavian";12;100;0
20;0;"ajavion";20;100;0
186;0;"ajax";186;100;0
3840;5;"ajay";3845;99.8699609882965;0.130039011703511
0;142;"ajaya";142;0;100
0;5;"ajayah";5;0;100
8;0;"ajayceon";8;100;0
0;8;"ajaycia";8;0;100
10;0;"ajayden";10;100;0
5;0;"ajaye";5;100;0
0;205;"ajayla";205;0;100
0;25;"ajaylah";25;0;100
0;43;"ajaysia";43;0;100
279;0;"ajdin";279;100;0
0;6;"aje";6;0;100
0;12;"ajea";12;0;100
35;301;"ajee";336;10.4166666666667;89.5833333333333
0;79;"ajeenah";79;0;100
48;0;"ajeet";48;100;0
0;6;"ajena";6;0;100
0;8;"ajenae";8;0;100
89;59;"ajene";148;60.1351351351351;39.8648648648649
0;15;"ajeya";15;0;100
0;27;"ajha";27;0;100
0;5;"ajhane";5;0;100
5;0;"ajhani";5;100;0
0;7;"aji";7;0;100
0;605;"ajia";605;0;100
0;67;"ajiah";67;0;100
0;17;"ajiana";17;0;100
0;11;"ajianna";11;0;100
250;0;"ajit";250;100;0
0;11;"ajita";11;0;100
10;0;"ajitesh";10;100;0
34;0;"ajith";34;100;0
0;5;"ajiya";5;0;100
0;16;"ajiyah";16;0;100
0;567;"ajla";567;0;100
63;0;"ajmal";63;100;0
0;66;"ajna";66;0;100
39;0;"ajon";39;100;0
10;0;"ajoni";10;100;0
0;49;"ajooni";49;0;100
0;18;"ajournee";18;0;100
0;15;"ajsa";15;0;100
0;5;"ajsha";5;0;100
0;5;"ajua";5;0;100
0;16;"ajuni";16;0;100
0;75;"ajwa";75;0;100
0;5;"ajwan";5;0;100
123;0;"akaash";123;100;0
10;0;"akachi";10;100;0
10;0;"akachukwu";10;100;0
0;144;"akacia";144;0;100
6;0;"akaden";6;100;0
0;9;"akadia";9;0;100
5;0;"akadian";5;100;0
0;6;"akaela";6;0;100
366;39;"akai";405;90.3703703703704;9.62962962962963
0;39;"akaia";39;0;100
0;71;"akaila";71;0;100
0;25;"akailah";25;0;100
5;0;"akain";5;100;0
0;63;"akaisha";63;0;100
0;83;"akaiya";83;0;100
0;12;"akaiyah";12;0;100
0;5;"akaja";5;0;100
0;34;"akala";34;0;100
0;5;"akali";5;0;100
5;0;"akam";5;100;0
0;265;"akane";265;0;100
0;162;"akanksha";162;0;100
11;0;"akanni";11;100;0
0;55;"akansha";55;0;100
0;21;"akara";21;0;100
207;479;"akari";686;30.1749271137026;69.8250728862974
0;18;"akaria";18;0;100
35;0;"akarsh";35;100;0
2051;0;"akash";2051;100;0
0;1155;"akasha";1155;0;100
65;0;"akashdeep";65;100;0
0;19;"akashia";19;0;100
0;88;"akasia";88;0;100
0;106;"akaya";106;0;100
0;5;"akaycia";5;0;100
5;0;"akayden";5;100;0
0;1254;"akayla";1254;0;100
0;165;"akaylah";165;0;100
0;29;"akaylia";29;0;100
0;132;"akaysha";132;0;100
0;5;"akaysia";5;0;100
499;0;"akbar";499;100;0
0;43;"akea";43;0;100
5;0;"akeam";5;100;0
0;6;"akeara";6;0;100
0;26;"akeba";26;0;100
0;7;"akebia";7;0;100
0;7;"akeda";7;0;100
88;0;"akeel";88;100;0
0;172;"akeela";172;0;100
0;1299;"akeelah";1299;0;100
5662;0;"akeem";5662;100;0
0;113;"akeema";113;0;100
231;0;"akeen";231;100;0
0;29;"akeena";29;0;100
0;20;"akeera";20;0;100
0;11;"akeesha";11;0;100
0;7;"akeeyla";7;0;100
0;183;"akeia";183;0;100
0;60;"akeiba";60;0;100
30;0;"akeil";30;100;0
0;176;"akeila";176;0;100
0;29;"akeilah";29;0;100
50;0;"akeim";50;100;0
0;245;"akeira";245;0;100
0;257;"akeisha";257;0;100
0;5;"akeiya";5;0;100
5;551;"akela";556;0.899280575539568;99.1007194244604
0;54;"akelah";54;0;100
0;63;"akelia";63;0;100
5;0;"akem";5;100;0
5;706;"akemi";711;0.70323488045007;99.2967651195499
0;16;"akemy";16;0;100
10;0;"aken";10;100;0
0;10;"akena";10;0;100
0;5;"akendra";5;0;100
0;10;"akenya";10;0;100
0;6;"akenzie";6;0;100
5;0;"aker";5;100;0
5;252;"akera";257;1.94552529182879;98.0544747081712
0;29;"akerah";29;0;100
0;295;"akeria";295;0;100
0;5;"akeriah";5;0;100
0;7;"akerra";7;0;100
0;10;"akerria";10;0;100
0;133;"akesha";133;0;100
0;48;"akeshia";48;0;100
0;6;"aketzali";6;0;100
0;5;"aketzalli";5;0;100
0;15;"aketzaly";15;0;100
0;25;"akevia";25;0;100
0;212;"akeya";212;0;100
0;13;"akeyah";13;0;100
0;17;"akeyia";17;0;100
0;314;"akeyla";314;0;100
0;135;"akeylah";135;0;100
0;5;"akeyra";5;0;100
11;0;"akhari";11;100;0
44;0;"akheem";44;100;0
10;0;"akhenaton";10;100;0
12;0;"akhi";12;100;0
0;56;"akhia";56;0;100
1573;0;"akhil";1573;100;0
0;216;"akhila";216;0;100
132;0;"akhilesh";132;100;0
13;0;"akhilles";13;100;0
17;0;"akhilleus";17;100;0
16;0;"akhir";16;100;0
0;6;"akhira";6;0;100
0;10;"akhirah";10;0;100
0;5;"akhiya";5;0;100
268;212;"aki";480;55.8333333333333;44.1666666666667
94;1521;"akia";1615;5.82043343653251;94.1795665634675
0;133;"akiah";133;0;100
0;6;"akiana";6;0;100
5;87;"akiba";92;5.43478260869565;94.5652173913043
42;15;"akida";57;73.6842105263158;26.3157894736842
5;11;"akie";16;31.25;68.75
0;6;"akieba";6;0;100
79;0;"akiel";79;100;0
0;16;"akiela";16;0;100
76;0;"akiem";76;100;0
0;224;"akiera";224;0;100
0;8;"akierra";8;0;100
0;18;"akiesha";18;0;100
104;0;"akif";104;100;0
32;0;"akihiro";32;100;0
0;707;"akiko";707;0;100
1869;0;"akil";1869;100;0
0;606;"akila";606;0;100
0;2815;"akilah";2815;0;100
32;0;"akilan";32;100;0
44;0;"akiles";44;100;0
5;0;"akilesh";5;100;0
399;234;"akili";633;63.0331753554502;36.9668246445498
0;5;"akilia";5;0;100
44;0;"akilles";44;100;0
5;0;"akillian";5;100;0
579;0;"akim";579;100;0
0;73;"akima";73;0;100
0;10;"akimi";10;0;100
276;0;"akin";276;100;0
0;437;"akina";437;0;100
141;0;"aking";141;100;0
15;0;"akinola";15;100;0
27;0;"akintunde";27;100;0
359;0;"akio";359;100;0
58;0;"akir";58;100;0
1628;5756;"akira";7384;22.0476706392199;77.9523293607801
0;418;"akirah";418;0;100
0;70;"akire";70;0;100
0;39;"akiria";39;0;100
6;0;"akiro";6;100;0
0;71;"akirra";71;0;100
0;373;"akisha";373;0;100
0;6;"akishia";6;0;100
0;152;"akita";152;0;100
62;0;"akito";62;100;0
1790;119;"akiva";1909;93.7663698271346;6.23363017286537
0;476;"akiya";476;0;100
0;396;"akiyah";396;0;100
0;5;"akiylah";5;0;100
0;5;"akiyra";5;0;100
11;0;"akmal";11;100;0
22;5;"ako";27;81.4814814814815;18.5185185185185
6;0;"akol";6;100;0
61;16;"akon";77;79.2207792207792;20.7792207792208
120;0;"akoni";120;100;0
5;0;"akorede";5;100;0
5;0;"akos";5;100;0
0;5;"akosha";5;0;100
0;5;"akosita";5;0;100
0;302;"akosua";302;0;100
0;5;"akoya";5;0;100
862;0;"akram";862;100;0
0;5;"akria";5;0;100
6;0;"akrish";6;100;0
0;27;"akriti";27;0;100
0;16;"aksa";16;0;100
0;7;"aksana";7;0;100
1195;0;"aksel";1195;100;0
70;0;"aksh";70;100;0
0;13;"aksha";13;0;100
0;5;"akshada";5;0;100
0;29;"akshadha";29;0;100
491;0;"akshaj";491;100;0
5;0;"akshan";5;100;0
396;0;"akshar";396;100;0
0;1080;"akshara";1080;0;100
329;0;"akshat";329;100;0
0;23;"akshata";23;0;100
122;0;"akshath";122;100;0
1584;0;"akshay";1584;100;0
0;446;"akshaya";446;0;100
20;0;"akshit";20;100;0
0;268;"akshita";268;0;100
55;0;"akshith";55;100;0
0;81;"akshitha";81;0;100
12;0;"aksil";12;100;0
0;485;"akua";485;0;100
203;0;"akul";203;100;0
0;5;"akur";5;0;100
0;11;"akura";11;0;100
30;0;"akwasi";30;100;0
0;6;"akwete";6;0;100
25;0;"akxel";25;100;0
0;111;"akya";111;0;100
0;106;"akyah";106;0;100
0;81;"akyia";81;0;100
0;6;"akyiah";6;0;100
0;201;"akyla";201;0;100
0;153;"akylah";153;0;100
0;566;"akyra";566;0;100
0;44;"akyrah";44;0;100
0;6;"akyria";6;0;100
6;0;"akyrie";6;100;0
29;0;"akzel";29;100;0
16509;255;"al";16764;98.478883321403;1.52111667859699
142;640;"ala";782;18.1585677749361;81.8414322250639
398;1052;"alaa";1450;27.448275862069;72.551724137931
18;0;"alaan";18;100;0
0;10;"alaana";10;0;100
0;242;"alabama";242;0;100
10;0;"alac";10;100;0
0;474;"alacia";474;0;100
0;5;"alacyia";5;0;100
144;0;"aladdin";144;100;0
6;0;"aladin";6;100;0
31;0;"aladino";31;100;0
0;5;"aladrian";5;0;100
0;11;"alae";11;0;100
0;16;"alaejah";16;0;100
0;222;"alaena";222;0;100
0;28;"alaetra";28;0;100
0;5;"alaeya";5;0;100
0;33;"alaeyah";33;0;100
0;5;"alafia";5;0;100
6;0;"alagie";6;100;0
0;5;"alah";5;0;100
0;47;"alahia";47;0;100
0;840;"alahna";840;0;100
0;162;"alahni";162;0;100
0;20;"alahnna";20;0;100
6;12;"alai";18;33.3333333333333;66.6666666666667
0;1450;"alaia";1450;0;100
0;256;"alaiah";256;0;100
0;5;"alaida";5;0;100
0;5;"alaiha";5;0;100
0;20;"alaiia";20;0;100
0;5;"alaiiah";5;0;100
0;207;"alaija";207;0;100
5;585;"alaijah";590;0.847457627118644;99.1525423728814
0;39;"alaijha";39;0;100
0;347;"alaila";347;0;100
0;68;"alailah";68;0;100
3533;6;"alain";3539;99.8304605820853;0.169539417914665
6;37174;"alaina";37180;0.0161377084454008;99.9838622915546
0;391;"alainah";391;0;100
0;1335;"alaine";1335;0;100
0;16;"alainey";16;0;100
0;19;"alaini";19;0;100
0;13;"alainie";13;0;100
0;635;"alainna";635;0;100
0;26;"alainnah";26;0;100
0;10;"alair";10;0;100
0;139;"alaira";139;0;100
0;41;"alaire";41;0;100
0;96;"alaisa";96;0;100
0;520;"alaisha";520;0;100
0;44;"alaisia";44;0;100
0;609;"alaiya";609;0;100
0;747;"alaiyah";747;0;100
0;49;"alaiyna";49;0;100
0;173;"alaiza";173;0;100
0;21;"alaizah";21;0;100
0;5;"alaizha";5;0;100
0;165;"alaja";165;0;100
0;611;"alajah";611;0;100
7;0;"alajandro";7;100;0
0;29;"alajha";29;0;100
0;5;"alajhia";5;0;100
0;67;"alajia";67;0;100
0;86;"alajiah";86;0;100
13;0;"alajuwon";13;100;0
225;0;"alakai";225;100;0
13;0;"alakay";13;100;0
22;0;"alaki";22;100;0
0;15;"alala";15;0;100
0;5;"alalah";5;0;100
237;0;"alam";237;100;0
0;5;"alama";5;0;100
0;15;"alamae";15;0;100
0;16;"alamar";16;0;100
0;50;"alamea";50;0;100
0;31;"alameda";31;0;100
28;0;"alameen";28;100;0
124;0;"alamin";124;100;0
344030;1067;"alan";345097;99.6908115689212;0.309188431078798
31;53961;"alana";53992;0.057415913468662;99.9425840865313
0;3286;"alanah";3286;0;100
0;9;"alancia";9;0;100
83;0;"aland";83;100;0
0;730;"alanda";730;0;100
5;0;"alander";5;100;0
54;0;"alandis";54;100;0
232;0;"alando";232;100;0
0;897;"alandra";897;0;100
18;0;"alandre";18;100;0
0;47;"alandrea";47;0;100
0;453;"alandria";453;0;100
16;0;"alandus";16;100;0
0;1654;"alane";1654;0;100
0;108;"alanea";108;0;100
0;72;"alanee";72;0;100
0;74;"alaney";74;0;100
50;6268;"alani";6318;0.791389680278569;99.2086103197214
0;528;"alania";528;0;100
0;544;"alanie";544;0;100
0;65;"alanii";65;0;100
0;2506;"alanis";2506;0;100
0;44;"alaniz";44;0;100
221;0;"alanmichael";221;100;0
70;0;"alann";70;100;0
7;20807;"alanna";20814;0.0336312097626598;99.9663687902373
0;5501;"alannah";5501;0;100
0;287;"alanni";287;0;100
0;79;"alannie";79;0;100
0;197;"alannis";197;0;100
0;89;"alanny";89;0;100
0;22;"alannys";22;0;100
108;0;"alano";108;100;0
0;8;"alanood";8;0;100
0;21;"alanoud";21;0;100
185;0;"alanson";185;100;0
0;82;"alanta";82;0;100
10;0;"alantae";10;100;0
462;101;"alante";563;82.0603907637655;17.9396092362345
0;147;"alantis";147;0;100
0;64;"alantra";64;0;100
0;383;"alany";383;0;100
0;143;"alanya";143;0;100
0;266;"alanys";266;0;100
349;0;"alanzo";349;100;0
0;672;"alara";672;0;100
0;7;"alarah";7;0;100
0;71;"alaria";71;0;100
1884;0;"alaric";1884;100;0
0;16;"alarice";16;0;100
28;0;"alarick";28;100;0
0;13;"alarie";13;0;100
93;0;"alarik";93;100;0
0;12;"alaris";12;0;100
294;0;"alasdair";294;100;0
0;289;"alasha";289;0;100
0;246;"alashia";246;0;100
0;1443;"alasia";1443;0;100
0;26;"alasiah";26;0;100
0;561;"alaska";561;0;100
0;28;"alassandra";28;0;100
109;0;"alassane";109;100;0
863;0;"alastair";863;100;0
10;0;"alastar";10;100;0
57;0;"alaster";57;100;0
46;0;"alastor";46;100;0
0;42;"alathea";42;0;100
0;693;"alauna";693;0;100
0;10;"alaunah";10;0;100
0;10;"alaundra";10;0;100
0;33;"alauni";33;0;100
0;11;"alaunna";11;0;100
0;1397;"alaura";1397;0;100
0;5;"alaurah";5;0;100
0;74;"alawna";74;0;100
18;0;"alax";18;100;0
20;0;"alaxander";20;100;0
0;21;"alaxandra";21;0;100
0;10;"alaxandria";10;0;100
0;5;"alaxis";5;0;100
6;0;"alay";6;100;0
0;4321;"alaya";4321;0;100
0;4838;"alayah";4838;0;100
0;12;"alayana";12;0;100
0;107;"alayasia";107;0;100
0;181;"alaycia";181;0;100
0;5;"alayda";5;0;100
11;5;"alaye";16;68.75;31.25
0;155;"alayha";155;0;100
0;350;"alayia";350;0;100
0;377;"alayiah";377;0;100
0;319;"alayja";319;0;100
0;628;"alayjah";628;0;100
0;17;"alayjha";17;0;100
0;6;"alayjia";6;0;100
0;6;"alayjiah";6;0;100
0;1017;"alayla";1017;0;100
0;200;"alaylah";200;0;100
11;0;"alayn";11;100;0
5;24949;"alayna";24954;0.0200368678368197;99.9799631321632
0;733;"alaynah";733;0;100
0;1051;"alayne";1051;0;100
0;5;"alaynia";5;0;100
0;10;"alaynie";10;0;100
0;539;"alaynna";539;0;100
0;6;"alaynnah";6;0;100
0;48;"alaysa";48;0;100
0;1480;"alaysha";1480;0;100
0;592;"alayshia";592;0;100
0;4187;"alaysia";4187;0;100
0;83;"alaysiah";83;0;100
0;90;"alayssa";90;0;100
0;22;"alaythia";22;0;100
0;183;"alayza";183;0;100
0;10;"alayzah";10;0;100
0;68;"alayzha";68;0;100
0;7;"alayzhia";7;0;100
0;279;"alayzia";279;0;100
0;96;"alayziah";96;0;100
5;0;"alaz";5;100;0
0;21;"alaza";21;0;100
0;267;"alazae";267;0;100
0;7;"alazah";7;0;100
121;0;"alazar";121;100;0
0;262;"alazay";262;0;100
0;10;"alazaya";10;0;100
0;84;"alaze";84;0;100
0;15;"alazea";15;0;100
0;5;"alazhia";5;0;100
0;222;"alazia";222;0;100
0;29;"alaziah";29;0;100
0;81;"alazne";81;0;100
101;5784;"alba";5885;1.71622769753611;98.2837723024639
915;0;"alban";915;100;0
0;76;"albana";76;0;100
0;16;"albani";16;0;100
0;20;"albanie";20;0;100
5;0;"albano";5;100;0
5;606;"albany";611;0.818330605564648;99.1816693944354
13;0;"albara";13;100;0
66;0;"albaraa";66;100;0
667;0;"albaro";667;100;0
0;5;"albee";5;0;100
92;0;"albeiro";92;100;0
204;0;"alben";204;100;0
0;376;"albena";376;0;100
20;0;"alber";20;100;0
0;12;"alberdia";12;0;100
6;0;"alberico";6;100;0
458717;2409;"albert";461126;99.4775831334603;0.522416866539731
399;66961;"alberta";67360;0.592339667458432;99.4076603325416
0;56;"alberteen";56;0;100
57;0;"alberth";57;100;0
0;4953;"albertha";4953;0;100
0;204;"albertia";204;0;100
5;0;"albertico";5;100;0
0;10;"albertie";10;0;100
0;1471;"albertina";1471;0;100
0;1902;"albertine";1902;0;100
6;0;"albertis";6;100;0
5;0;"albertjames";5;100;0
59297;447;"alberto";59744;99.2518077129084;0.748192287091591
406;0;"albertus";406;100;0
0;15;"albesa";15;0;100
98;0;"albi";98;100;0
0;6;"albia";6;0;100
113;100;"albie";213;53.0516431924883;46.9483568075117
12;0;"albieri";12;100;0
5;0;"albieris";5;100;0
8;0;"albiery";8;100;0
4058;0;"albin";4058;100;0
0;4362;"albina";4362;0;100
1660;0;"albino";1660;100;0
607;0;"albion";607;100;0
0;10;"albiona";10;0;100
0;102;"albirda";102;0;100
0;16;"albirdia";16;0;100
0;177;"albirta";177;0;100
0;76;"albirtha";76;0;100
29;0;"albon";29;100;0
5;0;"alborz";5;100;0
0;43;"albree";43;0;100
0;13;"albrey";13;0;100
0;5;"albria";5;0;100
10;0;"alburn";10;100;0
8;0;"albus";8;100;0
33;15;"alby";48;68.75;31.25
0;6;"alcaria";6;0;100
99;0;"alcario";99;100;0
177;0;"alcee";177;100;0
0;15;"alchemy";15;0;100
0;23;"alcia";23;0;100
5;0;"alcibiades";5;100;0
884;0;"alcide";884;100;0
453;0;"alcides";453;100;0
10;296;"alcie";306;3.26797385620915;96.7320261437908
0;5;"alcina";5;0;100
33;0;"alcindor";33;100;0
0;5;"alcine";5;0;100
5;0;"alco";5;100;0
48;0;"alcuin";48;100;0
74;0;"alcus";74;100;0
0;5;"alcy";5;0;100
10;4518;"alda";4528;0.220848056537102;99.7791519434629
0;5;"aldah";5;0;100
226;0;"aldahir";226;100;0
1203;0;"aldair";1203;100;0
171;0;"aldan";171;100;0
0;33;"aldana";33;0;100
5;0;"aldayr";5;100;0
6;0;"aldayshein";6;100;0
0;231;"aldea";231;0;100
185;400;"aldean";585;31.6239316239316;68.3760683760684
0;61;"aldeen";61;0;100
5;0;"aldemar";5;100;0
14158;754;"alden";14912;94.943669527897;5.056330472103
0;288;"aldena";288;0;100
5;347;"aldene";352;1.42045454545455;98.5795454545455
428;31;"alder";459;93.2461873638344;6.75381263616558
17;0;"alderic";17;100;0
7;0;"aldhair";7;100;0
0;23;"aldia";23;0;100
21;11;"aldie";32;65.625;34.375
0;10;"aldijana";10;0;100
585;0;"aldin";585;100;0
0;255;"aldina";255;0;100
158;789;"aldine";947;16.6842661034847;83.3157338965153
24;0;"aldis";24;100;0
15354;15;"aldo";15369;99.902400936951;0.0975990630489947
18;0;"aldolfo";18;100;0
1477;0;"aldon";1477;100;0
0;925;"aldona";925;0;100
0;189;"aldonia";189;0;100
0;5;"aldonna";5;0;100
54;0;"aldor";54;100;0
0;499;"aldora";499;0;100
0;5;"aldoris";5;0;100
77;0;"aldous";77;100;0
64;0;"aldred";64;100;0
21;0;"aldren";21;100;0
0;10;"aldrena";10;0;100
408;0;"aldric";408;100;0
529;0;"aldrich";529;100;0
216;0;"aldrick";216;100;0
78;0;"aldridge";78;100;0
11;0;"aldrik";11;100;0
427;0;"aldrin";427;100;0
0;5;"aldrina";5;0;100
5;0;"alduin";5;100;0
50;0;"aldus";50;100;0
129;0;"aldwin";129;100;0
67;31;"aldyn";98;68.3673469387755;31.6326530612245
0;19;"aldyth";19;0;100
8;5;"ale";13;61.5384615384615;38.4615384615385
0;3549;"alea";3549;0;100
0;32;"aleacia";32;0;100
0;12384;"aleah";12384;0;100
0;741;"aleaha";741;0;100
0;21;"aleahya";21;0;100
0;1093;"alean";1093;0;100
0;731;"aleana";731;0;100
0;18;"aleanah";18;0;100
14;0;"aleander";14;100;0
0;5;"aleandra";5;0;100
0;92;"aleane";92;0;100
0;114;"aleanna";114;0;100
0;12;"aleara";12;0;100
0;23;"aleasa";23;0;100
0;1812;"alease";1812;0;100
0;968;"aleasha";968;0;100
0;25;"aleashia";25;0;100
0;38;"aleasia";38;0;100
0;17;"aleata";17;0;100
0;790;"aleatha";790;0;100
0;83;"aleathea";83;0;100
0;68;"aleathia";68;0;100
0;5;"aleatra";5;0;100
0;112;"aleaya";112;0;100
0;112;"aleayah";112;0;100
51394;337;"alec";51731;99.3485530919565;0.651446908043533
0;5;"aleca";5;0;100
5;0;"alecander";5;100;0
0;6;"aleccia";6;0;100
0;84;"alece";84;0;100
0;124;"alecea";124;0;100
0;5;"aleceia";5;0;100
0;11;"alecha";11;0;100
0;82;"alechia";82;0;100
0;11840;"alecia";11840;0;100
0;10;"aleciram";10;0;100
1088;0;"aleck";1088;100;0
0;11;"alecsa";11;0;100
240;0;"alecsander";240;100;0
0;16;"alecsandra";16;0;100
0;5;"alecsis";5;0;100
0;20;"alectra";20;0;100
0;18;"alecxa";18;0;100
143;0;"alecxander";143;100;0
0;5;"alecxia";5;0;100
75;0;"alecxis";75;100;0
1059;0;"aleczander";1059;100;0
0;12;"aleczandria";12;0;100
0;994;"aleda";994;0;100
0;5;"aledra";5;0;100
63;456;"alee";519;12.1387283236994;87.8612716763006
0;548;"aleea";548;0;100
0;1182;"aleeah";1182;0;100
0;5;"aleeana";5;0;100
0;616;"aleece";616;0;100
0;624;"aleecia";624;0;100
0;5;"aleecya";5;0;100
0;80;"aleeha";80;0;100
0;5;"aleeka";5;0;100
0;6;"aleela";6;0;100
443;0;"aleem";443;100;0
0;21;"aleema";21;0;100
0;25;"aleemah";25;0;100
0;2137;"aleen";2137;0;100
0;8253;"aleena";8253;0;100
0;252;"aleenah";252;0;100
0;790;"aleene";790;0;100
0;83;"aleera";83;0;100
0;675;"aleesa";675;0;100
0;240;"aleese";240;0;100
0;1868;"aleesha";1868;0;100
0;6;"aleeshia";6;0;100
0;379;"aleesia";379;0;100
0;89;"aleeta";89;0;100
0;1028;"aleeya";1028;0;100
0;1145;"aleeyah";1145;0;100
0;965;"aleeza";965;0;100
0;23;"aleezah";23;0;100
0;15;"aleezay";15;0;100
0;5;"alegacy";5;0;100
0;160;"alegandra";160;0;100
444;0;"alegandro";444;100;0
5;0;"alegend";5;100;0
0;41;"alegna";41;0;100
0;341;"alegra";341;0;100
0;187;"alegria";187;0;100
0;22;"aleha";22;0;100
0;5;"alei";5;0;100
0;1427;"aleia";1427;0;100
0;454;"aleiah";454;0;100
0;91;"aleicia";91;0;100
0;1543;"aleida";1543;0;100
0;28;"aleidy";28;0;100
0;575;"aleigh";575;0;100
0;3968;"aleigha";3968;0;100
0;12;"aleighana";12;0;100
0;5;"aleighanna";5;0;100
0;29;"aleighia";29;0;100
0;71;"aleighna";71;0;100
0;11;"aleighsha";11;0;100
0;60;"aleighya";60;0;100
0;5;"aleiha";5;0;100
0;59;"aleijah";59;0;100
0;68;"aleila";68;0;100
0;5;"aleily";5;0;100
0;524;"aleina";524;0;100
0;8;"aleinah";8;0;100
0;32;"aleine";32;0;100
0;49;"aleira";49;0;100
0;363;"aleisa";363;0;100
0;39;"aleise";39;0;100
0;2849;"aleisha";2849;0;100
0;10;"aleishia";10;0;100
227;0;"aleister";227;100;0
0;23;"aleita";23;0;100
0;6;"aleitha";6;0;100
17;0;"aleix";17;100;0
0;259;"aleiya";259;0;100
0;358;"aleiyah";358;0;100
0;33;"aleiza";33;0;100
0;152;"aleja";152;0;100
5;0;"alejadro";5;100;0
0;114;"alejah";114;0;100
30;0;"alejando";30;100;0
8;0;"alejandr";8;100;0
525;49016;"alejandra";49541;1.05972830584768;98.9402716941523
0;101;"alejandria";101;0;100
0;1272;"alejandrina";1272;0;100
129323;846;"alejandro";130169;99.3500756708586;0.649924329141347
785;0;"alejo";785;100;0
6;0;"alejondro";6;100;0
92;0;"alejos";92;100;0
3692;68;"alek";3760;98.1914893617021;1.80851063829787
0;211;"aleka";211;0;100
38;0;"alekai";38;100;0
5;0;"alekay";5;100;0
0;145;"alekhya";145;0;100
23;0;"aleki";23;100;0
5;0;"alekos";5;100;0
369;0;"aleks";369;100;0
57;521;"aleksa";578;9.86159169550173;90.1384083044983
0;5;"aleksah";5;0;100
1184;0;"aleksandar";1184;100;0
2937;0;"aleksander";2937;100;0
1242;0;"aleksandr";1242;100;0
0;2560;"aleksandra";2560;0;100
5;0;"aleksandre";5;100;0
0;29;"aleksandria";29;0;100
5;0;"aleksandrs";5;100;0
341;12;"aleksei";353;96.600566572238;3.39943342776204
423;10;"aleksey";433;97.6905311778291;2.3094688221709
67;28;"aleksi";95;70.5263157894737;29.4736842105263
0;206;"aleksia";206;0;100
5;68;"aleksis";73;6.84931506849315;93.1506849315068
48;0;"aleksy";48;100;0
0;20;"alektra";20;0;100
0;6;"alekxa";6;0;100
83;0;"alekxander";83;100;0
0;6;"alekya";6;0;100
0;17;"alekza";17;0;100
869;0;"alekzander";869;100;0
22;0;"alekzandr";22;100;0
0;5;"alekzandra";5;0;100
0;5;"alela";5;0;100
0;112;"aleli";112;0;100
0;11;"alelia";11;0;100
0;11;"alely";11;0;100
178;0;"alem";178;100;0
21;5;"alema";26;80.7692307692308;19.2307692307692
2009;0;"alen";2009;100;0
0;12431;"alena";12431;0;100
0;138;"alenah";138;0;100
0;106;"alencia";106;0;100
0;55;"alenda";55;0;100
5;8535;"alene";8540;0.0585480093676815;99.9414519906323
0;130;"aleni";130;0;100
0;37;"alenia";37;0;100
0;20;"alenis";20;0;100
0;16;"alenka";16;0;100
0;362;"alenna";362;0;100
0;6;"alennah";6;0;100
0;38;"aleny";38;0;100
0;5;"aleona";5;0;100
51;5;"aleph";56;91.0714285714286;8.92857142857143
5;0;"aleq";5;100;0
0;237;"alera";237;0;100
0;5;"alerah";5;0;100
0;173;"aleria";173;0;100
160;0;"aleric";160;100;0
0;5;"alero";5;0;100
10;0;"aleron";10;100;0
7;0;"ales";7;100;0
0;916;"alesa";916;0;100
0;186;"alesana";186;0;100
22;0;"alesander";22;100;0
0;802;"alesandra";802;0;100
310;0;"alesandro";310;100;0
0;51;"alescia";51;0;100
0;523;"alese";523;0;100
0;12;"alesea";12;0;100
6;7358;"alesha";7364;0.0814774579033134;99.9185225420967
0;45;"aleshanee";45;0;100
0;44;"aleshea";44;0;100
0;2825;"aleshia";2825;0;100
0;86;"aleshka";86;0;100
0;62;"alesi";62;0;100
0;7281;"alesia";7281;0;100
0;13;"alesiram";13;0;100
0;26;"aleska";26;0;100
0;1759;"alessa";1759;0;100
5;0;"alessand";5;100;0
71;0;"alessander";71;100;0
0;17086;"alessandra";17086;0;100
0;150;"alessandria";150;0;100
7555;0;"alessandro";7555;100;0
0;20;"alessi";20;0;100
0;3247;"alessia";3247;0;100
925;0;"alessio";925;100;0
29;0;"alesso";29;100;0
0;12;"alessondra";12;0;100
0;6;"alessya";6;0;100
0;48;"alesya";48;0;100
0;6319;"aleta";6319;0;100
0;6667;"aletha";6667;0;100
0;4393;"alethea";4393;0;100
0;441;"aletheia";441;0;100
0;2373;"alethia";2373;0;100
0;55;"aletia";55;0;100
0;11;"aletra";11;0;100
0;6;"aletris";6;0;100
0;33;"aletse";33;0;100
0;898;"aletta";898;0;100
0;60;"alette";60;0;100
0;12;"aletza";12;0;100
0;33;"alevia";33;0;100
264414;8580;"alex";272994;96.8570737818414;3.14292621815864
255;118868;"alexa";119123;0.214064454387482;99.7859355456125
25;0;"alexader";25;100;0
0;11;"alexadra";11;0;100
0;507;"alexah";507;0;100
0;34;"alexamarie";34;0;100
18;0;"alexan";18;100;0
0;23;"alexana";23;0;100
5;0;"alexand";5;100;0
0;22;"alexanda";22;0;100
647;0;"alexandar";647;100;0
314;0;"alexande";314;100;0
644442;4402;"alexander";648844;99.3215626560468;0.678437343953246
0;351;"alexandera";351;0;100
0;739;"alexanderia";739;0;100
83;0;"alexanderjames";83;100;0
0;17;"alexandia";17;0;100
0;5;"alexandira";5;0;100
16;0;"alexandor";16;100;0
415;301;"alexandr";716;57.9608938547486;42.0391061452514
859;228746;"alexandra";229605;0.374120772631258;99.6258792273687
0;6;"alexandrah";6;0;100
4606;145;"alexandre";4751;96.9480109450642;3.0519890549358
0;8369;"alexandrea";8369;0;100
0;5;"alexandreia";5;0;100
7;0;"alexandrer";7;100;0
49;0;"alexandrew";49;100;0
230;96187;"alexandria";96417;0.23854714417582;99.7614528558242
0;21;"alexandriah";21;0;100
0;246;"alexandrina";246;0;100
0;21;"alexandrine";21;0;100
6398;0;"alexandro";6398;100;0
1419;0;"alexandros";1419;100;0
495;0;"alexandru";495;100;0
0;354;"alexandrya";354;0;100
28;0;"alexaner";28;100;0
0;5;"alexann";5;0;100
0;27;"alexanna";27;0;100
0;7;"alexanndra";7;0;100
0;32;"alexanne";32;0;100
0;5;"alexanra";5;0;100
0;97;"alexarae";97;0;100
0;5;"alexaray";5;0;100
0;786;"alexas";786;0;100
0;10;"alexaundra";10;0;100
0;6;"alexaundrea";6;0;100
0;57;"alexaundria";57;0;100
0;5;"alexavia";5;0;100
1852;0;"alexavier";1852;100;0
7;0;"alexavior";7;100;0
0;1499;"alexcia";1499;0;100
11;215;"alexcis";226;4.86725663716814;95.1327433628319
0;8;"alexcya";8;0;100
0;15;"alexe";15;0;100
0;213;"alexea";213;0;100
0;87;"alexee";87;0;100
992;106;"alexei";1098;90.3460837887067;9.65391621129326
0;23;"alexeia";23;0;100
46;0;"alexender";46;100;0
0;13;"alexendra";13;0;100
0;15;"alexendria";15;0;100
139;700;"alexes";839;16.5673420738975;83.4326579261025
0;5;"alexeus";5;0;100
374;19;"alexey";393;95.1653944020356;4.83460559796438
0;7;"alexeya";7;0;100
1512;3879;"alexi";5391;28.0467445742905;71.9532554257095
44;42398;"alexia";42442;0.103670892040903;99.8963291079591
0;447;"alexiah";447;0;100
5;0;"alexian";5;100;0
0;375;"alexiana";375;0;100
0;251;"alexianna";251;0;100
0;154;"alexias";154;0;100
0;63;"alexica";63;0;100
0;22;"alexicia";22;0;100
266;1491;"alexie";1757;15.1394422310757;84.8605577689243
0;47;"alexiea";47;0;100
10;5;"alexiel";15;66.6666666666667;33.3333333333333
0;41;"alexies";41;0;100
0;256;"alexina";256;0;100
0;171;"alexine";171;0;100
180;0;"alexio";180;100;0
0;10;"alexiona";10;0;100
0;10;"alexionna";10;0;100
117;0;"alexios";117;100;0
0;41;"alexious";41;0;100
62098;334514;"alexis";396612;15.6571157705768;84.3428842294232
0;10;"alexisa";10;0;100
0;15;"alexisia";15;0;100
0;5;"alexisjade";5;0;100
0;75;"alexismarie";75;0;100
0;5;"alexisnicole";5;0;100
0;7;"alexisrose";7;0;100
20;528;"alexiss";548;3.64963503649635;96.3503649635037
123;1504;"alexius";1627;7.559926244622;92.440073755378
5;37;"alexix";42;11.9047619047619;88.0952380952381
0;108;"alexiya";108;0;100
0;37;"alexiyah";37;0;100
0;12;"alexiyana";12;0;100
249;265;"alexiz";514;48.443579766537;51.556420233463
49;0;"alexjandro";49;100;0
36;0;"alexnader";36;100;0
0;8;"alexnadra";8;0;100
0;54;"alexondra";54;0;100
0;24;"alexondria";24;0;100
0;5;"alexous";5;0;100
34;0;"alexs";34;100;0
0;595;"alexsa";595;0;100
1137;0;"alexsander";1137;100;0
0;2329;"alexsandra";2329;0;100
0;172;"alexsandria";172;0;100
275;0;"alexsandro";275;100;0
7;0;"alexsi";7;100;0
0;339;"alexsia";339;0;100
190;1258;"alexsis";1448;13.121546961326;86.878453038674
5;0;"alexson";5;100;0
0;5;"alexsondra";5;0;100
0;35;"alexssa";35;0;100
0;99;"alexsus";99;0;100
0;160;"alexsys";160;0;100
0;35;"alexuis";35;0;100
243;18380;"alexus";18623;1.3048381034205;98.6951618965795
0;5;"alexusia";5;0;100
0;10;"alexuss";10;0;100
361;204;"alexx";565;63.8938053097345;36.1061946902655
0;694;"alexxa";694;0;100
212;0;"alexxander";212;100;0
0;56;"alexxandra";56;0;100
0;15;"alexxandria";15;0;100
0;5;"alexxes";5;0;100
0;111;"alexxia";111;0;100
6;1155;"alexxis";1161;0.516795865633075;99.4832041343669
0;416;"alexxus";416;0;100
0;37;"alexxys";37;0;100
284;352;"alexy";636;44.6540880503145;55.3459119496855
0;467;"alexya";467;0;100
0;5;"alexyanna";5;0;100
0;63;"alexyia";63;0;100
363;4061;"alexys";4424;8.20524412296564;91.7947558770344
0;535;"alexyss";535;0;100
0;29;"alexyz";29;0;100
0;14;"alexz";14;0;100
0;215;"alexza";215;0;100
6;0;"alexzandar";6;100;0
5991;0;"alexzander";5991;100;0
0;1309;"alexzandra";1309;0;100
0;358;"alexzandrea";358;0;100
0;1642;"alexzandria";1642;0;100
0;8;"alexzandrya";8;0;100
5;0;"alexzandyr";5;100;0
62;0;"alexzavier";62;100;0
0;175;"alexzia";175;0;100
0;5;"alexzis";5;0;100
6;33;"aley";39;15.3846153846154;84.6153846153846
0;1450;"aleya";1450;0;100
0;1803;"aleyah";1803;0;100
0;43;"aleyana";43;0;100
0;33;"aleycia";33;0;100
0;1118;"aleyda";1118;0;100
0;49;"aleydis";49;0;100
0;11;"aleyha";11;0;100
0;58;"aleyia";58;0;100
0;45;"aleyiah";45;0;100
0;32;"aleyla";32;0;100
0;1417;"aleyna";1417;0;100
0;72;"aleynah";72;0;100
0;24;"aleynna";24;0;100
0;38;"aleysa";38;0;100
0;11;"aleyse";11;0;100
0;396;"aleysha";396;0;100
0;16;"aleyshka";16;0;100
0;121;"aleysia";121;0;100
0;33;"aleyssa";33;0;100
0;130;"aleyza";130;0;100
23;0;"alez";23;100;0
0;67;"aleza";67;0;100
0;13;"alezae";13;0;100
149;0;"alezander";149;100;0
0;114;"alezandra";114;0;100
0;5;"alezandria";5;0;100
11;0;"alezandro";11;100;0
0;37;"alezay";37;0;100
0;6;"alezia";6;0;100
968;0;"alf";968;100;0
5;218;"alfa";223;2.24215246636771;97.7578475336323
0;16;"alfair";16;0;100
0;5;"alfanette";5;0;100
5;0;"alfanso";5;100;0
86;0;"alfard";86;100;0
0;40;"alfaretta";40;0;100
947;0;"alferd";947;100;0
10;0;"alferdo";10;100;0
0;5;"alferetta";5;0;100
0;84;"alfhild";84;0;100
0;16;"alfia";16;0;100
581;123;"alfie";704;82.5284090909091;17.4715909090909
203;0;"alfio";203;100;0
0;5;"alfiya";5;0;100
18;0;"alfonce";18;100;0
441;0;"alfons";441;100;0
144;11;"alfonsa";155;92.9032258064516;7.09677419354839
1382;0;"alfonse";1382;100;0
0;48;"alfonsina";48;0;100
39129;109;"alfonso";39238;99.7222080636118;0.277791936388195
8;0;"alfonson";8;100;0
1714;0;"alfonza";1714;100;0
186;0;"alfonzia";186;100;0
11;0;"alfonzie";11;100;0
5557;0;"alfonzo";5557;100;0
4513;5;"alford";4518;99.8893315626383;0.110668437361664
20;0;"alfornia";20;100;0
26;0;"alfread";26;100;0
0;5;"alfreada";5;0;100
231166;1279;"alfred";232445;99.4497623093635;0.550237690636495
35;11187;"alfreda";11222;0.31188736410622;99.6881126358938
61;0;"alfreddie";61;100;0
0;1131;"alfredia";1131;0;100
53584;285;"alfredo";53869;99.4709387588409;0.529061241159108
6;0;"alfredrick";6;100;0
0;50;"alfreeda";50;0;100
0;492;"alfreida";492;0;100
0;283;"alfretta";283;0;100
0;46;"alfrida";46;0;100
0;755;"alfrieda";755;0;100
15;0;"alfy";15;100;0
5;127;"alga";132;3.78787878787879;96.2121212121212
0;5;"algean";5;0;100
28;59;"algene";87;32.183908045977;67.816091954023
65;0;"algenis";65;100;0
797;0;"alger";797;100;0
20;0;"algerd";20;100;0
0;32;"algeria";32;0;100
0;5;"algerine";5;0;100
980;0;"algernon";980;100;0
23;0;"algert";23;100;0
0;5;"algertha";5;0;100
58;46;"algia";104;55.7692307692308;44.2307692307692
1451;342;"algie";1793;80.9258226436141;19.0741773563859
33;0;"algin";33;100;0
52;0;"algird";52;100;0
22;0;"algirdas";22;100;0
104;0;"algis";104;100;0
43;0;"algot";43;100;0
10;0;"algy";10;100;0
178;0;"alhaji";178;100;0
5;0;"alhakim";5;100;0
0;5;"alham";5;0;100
10;0;"alhan";10;100;0
0;25;"alhana";25;0;100
0;10;"alhanouf";10;0;100
52;0;"alhasan";52;100;0
154;0;"alhassan";154;100;0
34;0;"alhassane";34;100;0
0;37;"alheli";37;0;100
0;6;"alhena";6;0;100
0;21;"alhia";21;0;100
24703;9653;"ali";34356;71.9030154849226;28.0969845150774
0;9438;"alia";9438;0;100
0;17;"aliaa";17;0;100
0;3936;"aliah";3936;0;100
0;29;"aliaha";29;0;100
0;83;"aliahna";83;0;100
48;0;"alian";48;100;0
0;5167;"aliana";5167;0;100
0;191;"alianah";191;0;100
0;34;"aliandra";34;0;100
0;101;"aliani";101;0;100
0;5;"alianie";5;0;100
0;43;"alianis";43;0;100
0;2794;"alianna";2794;0;100
0;422;"aliannah";422;0;100
0;6;"alianne";6;0;100
0;5;"aliannie";5;0;100
0;67;"alianny";67;0;100
0;5;"aliannys";5;0;100
0;105;"aliany";105;0;100
0;67;"alianys";67;0;100
552;0;"alias";552;100;0
0;5;"aliauna";5;0;100
0;30;"aliaya";30;0;100
0;216;"aliayah";216;0;100
5;0;"aliaz";5;100;0
212;0;"alic";212;100;0
0;1270;"alica";1270;0;100
0;20;"alicai";20;0;100
0;5;"aliccia";5;0;100
1780;514681;"alice";516461;0.344653323290626;99.6553466767094
0;1133;"alicea";1133;0;100
0;29;"aliceann";29;0;100
0;28;"aliceia";28;0;100
0;58;"alicemae";58;0;100
0;29;"alicemarie";29;0;100
0;1021;"alicen";1021;0;100
0;220;"aliceson";220;0;100
0;5;"aliceteen";5;0;100
0;8;"aliceyn";8;0;100
0;265;"alicha";265;0;100
0;151;"alichia";151;0;100
707;223733;"alicia";224440;0.315006237747282;99.6849937622527
0;21;"aliciah";21;0;100
0;12;"aliciamarie";12;0;100
0;12;"alician";12;0;100
0;324;"aliciana";324;0;100
0;159;"alicianna";159;0;100
0;20;"aliciya";20;0;100
0;305;"alicja";305;0;100
60;0;"alick";60;100;0
0;169;"alicya";169;0;100
0;665;"alicyn";665;0;100
0;3977;"alida";3977;0;100
0;24;"alidia";24;0;100
0;5;"alidiya";5;0;100
72;476;"alie";548;13.1386861313869;86.8613138686131
0;123;"aliea";123;0;100
0;65;"alieah";65;0;100
0;64;"aliece";64;0;100
0;39;"aliecia";39;0;100
0;5;"alieda";5;0;100
0;7;"aliee";7;0;100
0;5;"alieen";5;0;100
0;85;"aliegha";85;0;100
0;11;"alien";11;0;100
0;248;"aliena";248;0;100
0;727;"aliene";727;0;100
0;5;"alienna";5;0;100
0;32;"aliera";32;0;100
0;17;"aliesa";17;0;100
0;119;"aliese";119;0;100
0;852;"aliesha";852;0;100
0;5;"alieshia";5;0;100
0;5;"aliette";5;0;100
149;0;"alieu";149;100;0
0;30;"alieya";30;0;100
0;64;"alieyah";64;0;100
0;27;"alieza";27;0;100
0;6;"aliezah";6;0;100
131;0;"alif";131;100;0
0;7;"alifa";7;0;100
0;159;"aliha";159;0;100
36;6;"alii";42;85.7142857142857;14.2857142857143
0;11;"aliina";11;0;100
0;5;"aliisa";5;0;100
0;8;"aliiyah";8;0;100
67;44;"alija";111;60.3603603603604;39.6396396396396
8223;1108;"alijah";9331;88.1256028292787;11.8743971707213
0;29;"alijandra";29;0;100
10;0;"alijandro";10;100;0
43;11;"alijha";54;79.6296296296296;20.3703703703704
41;0;"alijiah";41;100;0
291;5;"alik";296;98.3108108108108;1.68918918918919
568;483;"alika";1051;54.0437678401522;45.9562321598478
0;11;"alikah";11;0;100
11;0;"alikai";11;100;0
0;11;"alike";11;0;100
10;0;"alikhan";10;100;0
0;16;"aliki";16;0;100
0;70;"alila";70;0;100
0;68;"alilah";68;0;100
0;21;"alilia";21;0;100
0;15;"aliliana";15;0;100
0;34;"alilyana";34;0;100
567;0;"alim";567;100;0
0;319;"alima";319;0;100
0;52;"alimah";52;0;100
0;13;"alimatou";13;0;100
127;393;"alin";520;24.4230769230769;75.5769230769231
0;27915;"alina";27915;0;100
0;413;"alinah";413;0;100
0;598;"alinda";598;0;100
5;13621;"aline";13626;0.036694554528108;99.9633054454719
0;11;"alinea";11;0;100
0;321;"alinna";321;0;100
0;48;"alinne";48;0;100
0;17;"alinson";17;0;100
0;50;"aliona";50;0;100
0;51;"alionna";51;0;100
107;0;"aliou";107;100;0
135;0;"alioune";135;100;0
5;5;"alique";10;50;50
0;84;"alira";84;0;100
0;5;"alirah";5;0;100
222;0;"alireza";222;100;0
5;315;"alis";320;1.5625;98.4375
22;32989;"alisa";33011;0.0666444518493835;99.9333555481506
0;350;"alisabeth";350;0;100
0;170;"alisah";170;0;100
0;81;"alisan";81;0;100
0;5;"alisana";5;0;100
0;36;"alisande";36;0;100
0;389;"alisandra";389;0;100
0;11;"alischa";11;0;100
0;269;"aliscia";269;0;100
0;3281;"alise";3281;0;100
0;87;"alisea";87;0;100
0;213;"alisen";213;0;100
0;5;"alish";5;0;100
131;54936;"alisha";55067;0.237892022445385;99.7621079775546
0;5;"alishaba";5;0;100
6;66;"alishah";72;8.33333333333333;91.6666666666667
25;0;"alishan";25;100;0
0;398;"alishba";398;0;100
0;183;"alishea";183;0;100
18;0;"alisher";18;100;0
0;2713;"alishia";2713;0;100
0;18;"alishya";18;0;100
0;68;"alisi";68;0;100
0;3797;"alisia";3797;0;100
0;5;"alisiah";5;0;100
0;18;"alisiana";18;0;100
0;5;"aliska";5;0;100
589;110481;"alison";111070;0.530296209597551;99.4697037904024
0;11;"aliss";11;0;100
31;37198;"alissa";37229;0.0832684197802788;99.9167315802197
0;10;"alissabeth";10;0;100
0;145;"alissah";145;0;100
0;355;"alissandra";355;0;100
0;174;"alisse";174;0;100
0;27;"alissha";27;0;100
0;769;"alissia";769;0;100
0;3679;"alisson";3679;0;100
0;5;"alissondra";5;0;100
0;33;"alissya";33;0;100
0;5;"alista";5;0;100
1931;0;"alistair";1931;100;0
5;0;"alistaire";5;100;0
63;0;"alistar";63;100;0
722;0;"alister";722;100;0
0;5;"alisun";5;0;100
0;52;"alisya";52;0;100
0;641;"alisyn";641;0;100
0;6;"alisynn";6;0;100
0;1711;"alita";1711;0;100
0;33;"alitha";33;0;100
0;75;"alithea";75;0;100
0;87;"alithia";87;0;100
0;5;"alitia";5;0;100
0;320;"alitza";320;0;100
0;31;"alitzah";31;0;100
0;303;"alitzel";303;0;100
43;0;"alius";43;100;0
0;19;"aliva";19;0;100
0;304;"alivea";304;0;100
0;78;"aliveah";78;0;100
0;5;"aliveya";5;0;100
10;25150;"alivia";25160;0.0397456279809221;99.9602543720191
0;745;"aliviah";745;0;100
0;70;"aliviana";70;0;100
0;25;"alivianna";25;0;100
0;128;"aliviya";128;0;100
0;95;"aliviyah";95;0;100
15;0;"alivn";15;100;0
0;254;"alivya";254;0;100
0;22;"alivyah";22;0;100
881;3339;"alix";4220;20.8767772511848;79.1232227488152
0;10;"alixa";10;0;100
249;0;"alixander";249;100;0
0;971;"alixandra";971;0;100
0;100;"alixandrea";100;0;100
0;562;"alixandria";562;0;100
0;5;"alixe";5;0;100
0;5;"alixia";5;0;100
0;74;"alixis";74;0;100
0;6;"alixon";6;0;100
0;7;"alixx";7;0;100
55;0;"alixzander";55;100;0
0;6;"alixzandria";6;0;100
0;8221;"aliya";8221;0;100
0;57;"aliyaah";57;0;100
8;0;"aliyaan";8;100;0
33;35421;"aliyah";35454;0.0930783550516162;99.9069216449484
0;23;"aliyaha";23;0;100
0;6;"aliyahmarie";6;0;100
0;22;"aliyahna";22;0;100
36;11;"aliyan";47;76.5957446808511;23.4042553191489
0;1496;"aliyana";1496;0;100
0;121;"aliyanah";121;0;100
0;5;"aliyani";5;0;100
0;483;"aliyanna";483;0;100
0;34;"aliyannah";34;0;100
42;0;"aliyas";42;100;0
0;16;"aliye";16;0;100
0;236;"aliyha";236;0;100
0;5;"aliyia";5;0;100
0;57;"aliyiah";57;0;100
0;20;"aliyna";20;0;100
0;24;"aliyonna";24;0;100
0;5;"aliysha";5;0;100
0;7;"aliyssa";7;0;100
0;7;"aliyya";7;0;100
0;218;"aliyyah";218;0;100
0;144;"aliz";144;0;100
5;8140;"aliza";8145;0.0613873542050338;99.938612645795
0;7;"alizabella";7;0;100
0;1588;"alizabeth";1588;0;100
5;866;"alizae";871;0.574052812858783;99.4259471871412
5;771;"alizah";776;0.644329896907216;99.3556701030928
0;5;"alizai";5;0;100
6;0;"alizander";6;100;0
0;64;"alizandra";64;0;100
5;722;"alizay";727;0.687757909215956;99.312242090784
0;101;"alizaya";101;0;100
0;30;"alizayah";30;0;100
0;15;"alizaye";15;0;100
322;4796;"alize";5118;6.29152012504885;93.7084798749512
0;270;"alizea";270;0;100
0;36;"alizeah";36;0;100
0;338;"alizee";338;0;100
0;135;"alizeh";135;0;100
0;5;"alizet";5;0;100
0;16;"alizette";16;0;100
0;115;"alizey";115;0;100
0;16;"alizeya";16;0;100
0;134;"alizia";134;0;100
0;5;"aliziah";5;0;100
0;323;"alizon";323;0;100
0;76;"alizza";76;0;100
0;61;"alizzon";61;0;100
45;0;"aljandro";45;100;0
6;0;"aljaquan";6;100;0
0;19;"aljawhara";19;0;100
5;0;"aljay";5;100;0
0;77;"aljean";77;0;100
0;12;"aljohara";12;0;100
0;10;"aljoharah";10;0;100
0;122;"alka";122;0;100
11;0;"alkeem";11;100;0
0;6;"alkeria";6;0;100
10;1042;"alla";1052;0.950570342205323;99.0494296577947
156;16;"allah";172;90.6976744186046;9.30232558139535
0;110;"allahna";110;0;100
0;211;"allaina";211;0;100
0;42;"allaire";42;0;100
5;0;"allam";5;100;0
93366;253;"allan";93619;99.7297557119815;0.270244288018458
0;2698;"allana";2698;0;100
0;798;"allanah";798;0;100
0;17;"allandra";17;0;100
0;79;"allani";79;0;100
0;5;"allanie";5;0;100
22;0;"allanmichael";22;100;0
0;239;"allanna";239;0;100
0;208;"allannah";208;0;100
460;131;"allante";591;77.834179357022;22.165820642978
244;0;"allard";244;100;0
0;5;"allasia";5;0;100
5;0;"allateef";5;100;0
0;31;"allaura";31;0;100
0;73;"allaya";73;0;100
0;286;"allayah";286;0;100
0;438;"allayna";438;0;100
0;5;"allaynah";5;0;100
0;10;"allayne";10;0;100
0;156;"alle";156;0;100
0;126;"allea";126;0;100
0;360;"alleah";360;0;100
0;1445;"allean";1445;0;100
0;12;"alleana";12;0;100
0;30;"alleane";30;0;100
13;0;"allec";13;100;0
0;175;"allecia";175;0;100
0;1093;"allee";1093;0;100
0;933;"alleen";933;0;100
0;42;"alleena";42;0;100
0;93;"alleene";93;0;100
0;4265;"allegra";4265;0;100
0;559;"alleigh";559;0;100
0;17;"alleigha";17;0;100
0;5;"alleine";5;0;100
0;5;"alleisha";5;0;100
0;7;"allejah";7;0;100
262173;1836;"allen";264009;99.3045691624149;0.695430837585082
0;1850;"allena";1850;0;100
0;5;"allenah";5;0;100
6;0;"allenby";6;100;0
5;8480;"allene";8485;0.0589275191514437;99.9410724808486
104;0;"allenmichael";104;100;0
0;5;"allenna";5;0;100
0;6;"allera";6;0;100
0;18;"alleria";18;0;100
0;161;"allesandra";161;0;100
0;5;"allese";5;0;100
0;119;"allesha";119;0;100
0;14;"alleshia";14;0;100
0;5;"allesia";5;0;100
0;27;"alleson";27;0;100
0;5;"allessa";5;0;100
0;230;"allessandra";230;0;100
0;105;"alleta";105;0;100
0;6;"alletha";6;0;100
0;68;"alletta";68;0;100
172;71;"allex";243;70.7818930041152;29.2181069958848
0;102;"allexa";102;0;100
12;0;"allexander";12;100;0
0;25;"allexandra";25;0;100
0;5;"allexandria";5;0;100
0;40;"allexia";40;0;100
0;402;"allexis";402;0;100
0;212;"allexus";212;0;100
0;10;"allexys";10;0;100
42;958;"alley";1000;4.2;95.8
0;62;"alleya";62;0;100
0;275;"alleyah";275;0;100
0;42;"alleyna";42;0;100
0;145;"alleyne";145;0;100
5;3502;"alli";3507;0.142571998859424;99.8574280011406
0;330;"allia";330;0;100
0;520;"alliah";520;0;100
0;557;"alliana";557;0;100
0;21;"allianah";21;0;100
0;338;"allianna";338;0;100
0;39;"alliannah";39;0;100
10;0;"allias";10;100;0
0;178;"allice";178;0;100
0;18;"allicen";18;0;100
0;689;"allicia";689;0;100
0;46;"allicyn";46;0;100
0;34;"allida";34;0;100
2634;42633;"allie";45267;5.81880840347273;94.1811915965273
0;7;"allieana";7;0;100
0;19;"allieanna";19;0;100
0;7;"alliee";7;0;100
0;23;"alliemae";23;0;100
0;73;"allien";73;0;100
0;283;"alliene";283;0;100
24;0;"allijah";24;100;0
0;5;"allimae";5;0;100
125;0;"allin";125;100;0
0;250;"allina";250;0;100
0;5;"allinah";5;0;100
0;1822;"alline";1822;0;100
0;34;"allinson";34;0;100
0;5;"alliona";5;0;100
0;5;"allionna";5;0;100
0;132;"allis";132;0;100
0;1340;"allisa";1340;0;100
0;34;"allisan";34;0;100
0;53;"allisandra";53;0;100
0;42;"allise";42;0;100
0;365;"allisen";365;0;100
0;865;"allisha";865;0;100
0;20;"allishia";20;0;100
0;44;"allisia";44;0;100
0;5;"allisin";5;0;100
3630;291001;"allison";294631;1.23204958066191;98.7679504193381
0;2034;"allissa";2034;0;100
0;37;"allissia";37;0;100
0;2296;"allisson";2296;0;100
33;0;"allistair";33;100;0
728;6;"allister";734;99.1825613079019;0.817438692098093
0;18;"allisun";18;0;100
0;935;"allisyn";935;0;100
0;5;"allita";5;0;100
0;53;"allivia";53;0;100
0;136;"allix";136;0;100
0;219;"alliya";219;0;100
0;2785;"alliyah";2785;0;100
0;16;"alliyana";16;0;100
0;5;"alliyiah";5;0;100
0;5;"allizae";5;0;100
0;5;"allize";5;0;100
0;212;"allizon";212;0;100
0;25;"allizzon";25;0;100
204;0;"allon";204;100;0
0;164;"allona";164;0;100
0;5;"allonah";5;0;100
0;40;"allondra";40;0;100
13;0;"allonte";13;100;0
5;0;"allonzo";5;100;0
0;337;"allora";337;0;100
0;37;"allorah";37;0;100
0;15;"allory";15;0;100
0;63;"allsion";63;0;100
0;5;"allson";5;0;100
11;0;"allston";11;100;0
0;615;"allura";615;0;100
0;315;"allure";315;0;100
22;0;"allwin";22;100;0
10;8884;"ally";8894;0.112435349673937;99.8875646503261
0;5;"allya";5;0;100
0;306;"allyah";306;0;100
0;339;"allyana";339;0;100
0;11;"allyanah";11;0;100
0;275;"allyanna";275;0;100
0;17;"allyannah";17;0;100
0;379;"allyce";379;0;100
0;348;"allycia";348;0;100
0;206;"allye";206;0;100
0;166;"allyiah";166;0;100
3187;1839;"allyn";5026;63.4102666136092;36.5897333863908
0;184;"allyna";184;0;100
0;499;"allyne";499;0;100
0;15;"allynn";15;0;100
0;5;"allyonna";5;0;100
0;7;"allyra";7;0;100
0;11;"allyria";11;0;100
0;2538;"allysa";2538;0;100
0;23;"allysah";23;0;100
0;18;"allysan";18;0;100
0;35;"allysandra";35;0;100
0;724;"allyse";724;0;100
0;553;"allysen";553;0;100
0;515;"allysha";515;0;100
0;41;"allyshia";41;0;100
0;609;"allysia";609;0;100
0;43;"allysin";43;0;100
21;50113;"allyson";50134;0.0418877408545099;99.9581122591455
0;6528;"allyssa";6528;0;100
0;11;"allyssah";11;0;100
0;5;"allysse";5;0;100
0;183;"allyssia";183;0;100
0;288;"allysson";288;0;100
0;29;"allysun";29;0;100
0;16;"allysyn";16;0;100
0;42;"allyx";42;0;100
0;5;"allyza";5;0;100
0;51;"allyzon";51;0;100
1960;142063;"alma";144023;1.36089374613777;98.6391062538622
0;267;"almadelia";267;0;100
0;10;"almae";10;0;100
92;0;"almalik";92;100;0
42;0;"alman";42;100;0
0;10;"almanda";10;0;100
93;0;"almando";93;100;0
17;0;"almanzo";17;100;0
0;5;"almar";5;0;100
0;12;"almaree";12;0;100
0;5;"almarene";5;0;100
0;333;"almarie";333;0;100
0;10;"almarine";10;0;100
13;0;"almarion";13;100;0
0;144;"almarosa";144;0;100
0;55;"almas";55;0;100
0;6;"almatine";6;0;100
0;5;"almaz";5;0;100
0;11;"almeada";11;0;100
0;16;"almeater";16;0;100
0;3847;"almeda";3847;0;100
0;471;"almedia";471;0;100
25;0;"almedin";25;100;0
0;33;"almedina";33;0;100
0;134;"almee";134;0;100
7;0;"almeer";7;100;0
0;223;"almena";223;0;100
0;139;"almendra";139;0;100
0;11;"almenia";11;0;100
523;312;"almer";835;62.6347305389222;37.3652694610778
0;5;"almera";5;0;100
0;5;"almeria";5;0;100
0;35;"almerinda";35;0;100
0;2200;"almeta";2200;0;100
0;176;"almeter";176;0;100
0;23;"almetia";23;0;100
0;5;"almetra";5;0;100
0;372;"almetta";372;0;100
0;5;"almetter";5;0;100
0;5;"almida";5;0;100
85;0;"almin";85;100;0
0;193;"almina";193;0;100
278;0;"almir";278;100;0
0;1453;"almira";1453;0;100
0;24;"almitra";24;0;100
58;15;"almo";73;79.4520547945205;20.5479452054795
1489;18;"almon";1507;98.8055739880557;1.19442601194426
591;0;"almond";591;100;0
5;0;"almondo";5;100;0
11;0;"almonte";11;100;0
5;0;"almonza";5;100;0
18;0;"almonzo";18;100;0
5;0;"almore";5;100;0
19;0;"almos";19;100;0
5;0;"almous";5;100;0
0;15;"almudena";15;0;100
138;0;"almus";138;100;0
0;183;"almyra";183;0;100
0;46;"alna";46;0;100
0;7;"alneisha";7;0;100
0;5;"alnesha";5;0;100
0;5;"alnetia";5;0;100
0;280;"alnisa";280;0;100
0;29;"alnisha";29;0;100
0;140;"alnita";140;0;100
0;23;"alnora";23;0;100
18;0;"alo";18;100;0
0;5;"aloa";5;0;100
0;5;"aloah";5;0;100
0;10;"alodie";10;0;100
0;10;"aloe";10;0;100
0;843;"aloha";843;0;100
0;16;"alohi";16;0;100
0;70;"alohilani";70;0;100
0;5;"alohna";5;0;100
2305;186;"alois";2491;92.5331192292252;7.46688077077479
28;100;"aloise";128;21.875;78.125
5;0;"aloisius";5;100;0
200;0;"alok";200;100;0
0;847;"aloma";847;0;100
962;24;"alon";986;97.5659229208925;2.4340770791075
0;2723;"alona";2723;0;100
0;270;"alonah";270;0;100
0;877;"alonda";877;0;100
43;0;"alondo";43;100;0
122;36821;"alondra";36943;0.330238475489267;99.6697615245107
28;0;"alondre";28;100;0
0;11;"alondrea";11;0;100
0;118;"alondria";118;0;100
0;360;"aloni";360;0;100
0;149;"alonia";149;0;100
0;57;"alonie";57;0;100
0;5;"alonii";5;0;100
0;2180;"alonna";2180;0;100
0;220;"alonnah";220;0;100
0;78;"alonni";78;0;100
0;82;"alonnie";82;0;100
9400;0;"alonso";9400;100;0
18;0;"alonta";18;100;0
180;0;"alontae";180;100;0
11;0;"alontay";11;100;0
411;6;"alonte";417;98.5611510791367;1.43884892086331
0;17;"alonya";17;0;100
3120;6;"alonza";3126;99.8080614203455;0.191938579654511
5;17;"alonzia";22;22.7272727272727;77.2727272727273
38589;154;"alonzo";38743;99.6025088403066;0.397491159693364
0;4101;"alora";4101;0;100
0;282;"alorah";282;0;100
0;5;"alori";5;0;100
0;79;"aloria";79;0;100
0;21;"alouise";21;0;100
0;133;"aloura";133;0;100
407;0;"aloys";407;100;0
0;5;"aloyse";5;0;100
0;12;"aloysia";12;0;100
98;0;"aloysious";98;100;0
5174;0;"aloysius";5174;100;0
114;0;"aloysuis";114;100;0
200;0;"alp";200;100;0
0;76;"alpa";76;0;100
56;0;"alper";56;100;0
6;0;"alperen";6;100;0
5;0;"alpesh";5;100;0
7;0;"alph";7;100;0
2158;6056;"alpha";8214;26.2722181641101;73.7277818358899
0;16;"alpharetta";16;0;100
11;0;"alphe";11;100;0
0;5;"alphea";5;0;100
11;0;"alphee";11;100;0
677;0;"alpheus";677;100;0
0;236;"alphia";236;0;100
17;0;"alphie";17;100;0
0;17;"alphild";17;0;100
0;5;"alphine";5;0;100
5;0;"alphon";5;100;0
10;0;"alphonce";10;100;0
5;0;"alphones";5;100;0
85;0;"alphons";85;100;0
260;0;"alphonsa";260;100;0
9770;0;"alphonse";9770;100;0
0;41;"alphonsine";41;0;100
14844;27;"alphonso";14871;99.8184385717168;0.181561428283236
356;0;"alphonsus";356;100;0
508;0;"alphonza";508;100;0
2006;0;"alphonzo";2006;100;0
121;0;"alphus";121;100;0
5;0;"alphy";5;100;0
0;7;"alpine";7;0;100
17;0;"alprentice";17;100;0
150;0;"alquan";150;100;0
5;0;"alquin";5;100;0
5;0;"alrahman";5;100;0
5;0;"alray";5;100;0
0;13;"alreem";13;0;100
198;0;"alric";198;100;0
127;0;"alrick";127;100;0
16;0;"alrik";16;100;0
0;5;"alrita";5;0;100
109;0;"alroy";109;100;0
0;6;"alsa";6;0;100
0;86;"alsace";86;0;100
0;17;"alsatia";17;0;100
5;0;"alsexander";5;100;0
0;106;"alsha";106;0;100
11;0;"alshawn";11;100;0
10;0;"alshon";10;100;0
0;139;"alsie";139;0;100
0;6;"alsiha";6;0;100
0;17;"alsion";17;0;100
480;0;"alson";480;100;0
2217;16;"alston";2233;99.2834751455441;0.716524854455889
93;24344;"alta";24437;0.380570446454147;99.6194295535459
8;0;"altaf";8;100;0
0;778;"altagracia";778;0;100
99;112;"altair";211;46.9194312796209;53.0805687203791
0;13;"altaira";13;0;100
0;36;"altamae";36;0;100
0;59;"altamease";59;0;100
0;287;"altamese";287;0;100
58;0;"altan";58;100;0
5;0;"altarik";5;100;0
211;0;"altariq";211;100;0
10;0;"altavious";10;100;0
25;0;"altay";25;100;0
0;11;"altee";11;0;100
10;0;"alten";10;100;0
321;18;"alter";339;94.6902654867257;5.30973451327434
12;0;"alterick";12;100;0
5;0;"alterik";5;100;0
0;5;"altermease";5;0;100
21;2917;"altha";2938;0.714771953710007;99.28522804629
5;16042;"althea";16047;0.0311584719885337;99.9688415280115
0;49;"altheda";49;0;100
0;72;"altheia";72;0;100
0;5;"althelia";5;0;100
0;17;"althena";17;0;100
0;5;"althera";5;0;100
0;61;"altheria";61;0;100
0;211;"althia";211;0;100
0;18;"altia";18;0;100
10;521;"altie";531;1.88323917137476;98.1167608286252
120;0;"altin";120;100;0
0;56;"altina";56;0;100
499;31;"alto";530;94.1509433962264;5.84905660377358
45940;376;"alton";46316;99.1881855082477;0.81181449175231
0;12;"altonette";12;0;100
7;5;"altonia";12;58.3333333333333;41.6666666666667
194;0;"altonio";194;100;0
0;5;"altonya";5;0;100
0;5;"altoria";5;0;100
0;17;"altouise";17;0;100
0;6;"altovese";6;0;100
0;144;"altovise";144;0;100
0;5;"altrice";5;0;100
0;5;"altrina";5;0;100
82;0;"altus";82;100;0
77;0;"alucard";77;100;0
0;57;"aluel";57;0;100
11;0;"alula";11;100;0
0;77;"aluna";77;0;100
0;23;"alundra";23;0;100
0;506;"alura";506;0;100
20;0;"alusine";20;100;0
9835;7974;"alva";17809;55.2248862934471;44.7751137065529
0;37;"alvada";37;0;100
1555;72;"alvah";1627;95.5746773202213;4.42532267977873
1095;0;"alvan";1095;100;0
0;6;"alvana";6;0;100
0;20;"alvania";20;0;100
92;0;"alvar";92;100;0
0;65;"alvaretta";65;0;100
48;0;"alvarez";48;100;0
14655;5;"alvaro";14660;99.9658935879945;0.034106412005457
24;0;"alve";24;100;0
0;163;"alveda";163;0;100
0;76;"alveena";76;0;100
12;0;"alveiro";12;100;0
462;0;"alven";462;100;0
0;1367;"alvena";1367;0;100
0;6;"alvene";6;0;100
0;420;"alvenia";420;0;100
114;5;"alver";119;95.7983193277311;4.20168067226891
0;2498;"alvera";2498;0;100
0;798;"alverda";798;0;100
0;30;"alveretta";30;0;100
0;106;"alveria";106;0;100
55;21;"alvern";76;72.3684210526316;27.6315789473684
0;968;"alverna";968;0;100
0;12;"alverne";12;0;100
0;5;"alvernia";5;0;100
13;0;"alvernon";13;100;0
5;0;"alvert";5;100;0
0;2277;"alverta";2277;0;100
0;10;"alvertia";10;0;100
17;0;"alvertis";17;100;0
141;0;"alverto";141;100;0
5;0;"alvery";5;100;0
5;0;"alves";5;100;0
0;36;"alvesta";36;0;100
490;0;"alvester";490;100;0
0;153;"alveta";153;0;100
0;86;"alvetta";86;0;100
173;0;"alvey";173;100;0
36;0;"alvi";36;100;0
420;381;"alvia";801;52.4344569288389;47.565543071161
0;29;"alvida";29;0;100
3833;558;"alvie";4391;87.2921885675245;12.7078114324755
5;0;"alvieri";5;100;0
13;0;"alviery";13;100;0
0;123;"alvilda";123;0;100
0;5;"alvilde";5;0;100
155124;1098;"alvin";156222;99.2971540500058;0.702845949994239
5;8802;"alvina";8807;0.0567730214602021;99.9432269785398
5;117;"alvine";122;4.0983606557377;95.9016393442623
0;22;"alvinia";22;0;100
1421;0;"alvino";1421;100;0
16;0;"alvion";16;100;0
0;903;"alvira";903;0;100
4970;326;"alvis";5296;93.8444108761329;6.15558912386707
0;275;"alvita";275;0;100
29;0;"alvoid";29;100;0
160;0;"alvon";160;100;0
0;5;"alvonia";5;0;100
5;0;"alvontae";5;100;0
33;0;"alvonte";33;100;0
17;0;"alvord";17;100;0
270;0;"alvy";270;100;0
28;0;"alvyn";28;100;0
50;0;"alwaleed";50;100;0
6;0;"alward";6;100;0
0;5;"alwayne";5;0;100
0;287;"alwilda";287;0;100
0;5;"alwillie";5;0;100
852;0;"alwin";852;100;0
11;0;"alwood";11;100;0
605;13;"alwyn";618;97.8964401294498;2.10355987055016
40;0;"alxander";40;100;0
5;0;"alxavier";5;100;0
0;16;"alxis";16;0;100
556;1027;"aly";1583;35.1231838281744;64.8768161718257
0;971;"alya";971;0;100
0;17;"alyaa";17;0;100
54;0;"alyaan";54;100;0
0;1051;"alyah";1051;0;100
62;0;"alyan";62;100;0
0;1367;"alyana";1367;0;100
0;110;"alyanah";110;0;100
0;1289;"alyanna";1289;0;100
0;83;"alyannah";83;0;100
165;0;"alyas";165;100;0
0;29;"alyasia";29;0;100
0;7;"alyca";7;0;100
0;16845;"alyce";16845;0;100
0;241;"alycea";241;0;100
0;5;"alycee";5;0;100
0;5;"alyceia";5;0;100
0;58;"alycen";58;0;100
0;9784;"alycia";9784;0;100
0;10;"alyciah";10;0;100
0;32;"alyciana";32;0;100
0;154;"alyda";154;0;100
0;461;"alydia";461;0;100
0;6;"alye";6;0;100
0;24;"alyea";24;0;100
0;37;"alyena";37;0;100
0;185;"alyene";185;0;100
0;27;"alyese";27;0;100
0;32;"alyeska";32;0;100
0;5;"alyessa";5;0;100
0;79;"alyha";79;0;100
0;473;"alyia";473;0;100
0;908;"alyiah";908;0;100
0;27;"alyiana";27;0;100
5;0;"alyias";5;100;0
0;5;"alyicia";5;0;100
25;0;"alyis";25;100;0
0;26;"alyisa";26;0;100
0;482;"alyissa";482;0;100
238;45;"alyjah";283;84.0989399293286;15.9010600706714
21;0;"alyk";21;100;0
0;6;"alyka";6;0;100
0;107;"alyla";107;0;100
0;69;"alylah";69;0;100
0;5;"alympia";5;0;100
5;0;"alymuhammad";5;100;0
303;405;"alyn";708;42.7966101694915;57.2033898305085
0;2016;"alyna";2016;0;100
0;189;"alynah";189;0;100
0;16;"alyncia";16;0;100
0;36;"alynda";36;0;100
0;839;"alyne";839;0;100
0;5;"alynia";5;0;100
0;360;"alynn";360;0;100
0;691;"alynna";691;0;100
0;10;"alynnah";10;0;100
0;29;"alynne";29;0;100
0;213;"alyona";213;0;100
0;40;"alyonna";40;0;100
6;0;"alyosha";6;100;0
0;186;"alyra";186;0;100
0;12;"alyrah";12;0;100
5;0;"alyre";5;100;0
0;124;"alyria";124;0;100
12;236;"alyric";248;4.83870967741935;95.1612903225807
0;63;"alyrica";63;0;100
0;1156;"alys";1156;0;100
0;6880;"alysa";6880;0;100
0;73;"alysabeth";73;0;100
0;163;"alysah";163;0;100
0;22;"alysan";22;0;100
0;222;"alysandra";222;0;100
0;167;"alyscia";167;0;100
0;7023;"alyse";7023;0;100
0;55;"alysea";55;0;100
0;434;"alysen";434;0;100
0;9218;"alysha";9218;0;100
0;33;"alyshea";33;0;100
0;1297;"alyshia";1297;0;100
0;9176;"alysia";9176;0;100
0;72;"alysiah";72;0;100
0;62;"alysiana";62;0;100
0;19;"alysianna";19;0;100
0;10;"alysin";10;0;100
10;27583;"alyson";27593;0.0362410756351249;99.9637589243649
0;331;"alyss";331;0;100
432;302300;"alyssa";302732;0.142700474346947;99.857299525653
0;23;"alyssaann";23;0;100
0;123;"alyssabeth";123;0;100
0;631;"alyssah";631;0;100
0;65;"alyssamae";65;0;100
0;314;"alyssamarie";314;0;100
0;698;"alyssandra";698;0;100
0;11;"alyssanicole";11;0;100
0;5;"alyssarae";5;0;100
0;5;"alyssarose";5;0;100
0;1391;"alysse";1391;0;100
0;6;"alyssea";6;0;100
0;75;"alyssha";75;0;100
0;4620;"alyssia";4620;0;100
0;1127;"alysson";1127;0;100
0;22;"alyssum";22;0;100
0;6;"alyssya";6;0;100
0;10;"alysta";10;0;100
24;0;"alyster";24;100;0
0;5;"alysun";5;0;100
0;39;"alythia";39;0;100
51;0;"alyus";51;100;0
0;22;"alyvea";22;0;100
0;4259;"alyvia";4259;0;100
0;191;"alyviah";191;0;100
5;0;"alywin";5;100;0
126;1116;"alyx";1242;10.1449275362319;89.8550724637681
0;32;"alyxa";32;0;100
135;0;"alyxander";135;100;0
0;718;"alyxandra";718;0;100
0;48;"alyxandrea";48;0;100
0;551;"alyxandria";551;0;100
0;25;"alyxia";25;0;100
0;274;"alyxis";274;0;100
0;5;"alyxus";5;0;100
10;0;"alyxzander";10;100;0
0;1235;"alyza";1235;0;100
0;187;"alyzabeth";187;0;100
0;106;"alyzae";106;0;100
0;218;"alyzah";218;0;100
0;133;"alyze";133;0;100
0;54;"alyzea";54;0;100
0;17;"alyzia";17;0;100
0;45;"alyzon";45;0;100
0;246;"alyzza";246;0;100
0;17;"alza";17;0;100
0;337;"alzada";337;0;100
0;18;"alzahra";18;0;100
0;5;"alzain";5;0;100
0;5;"alzata";5;0;100
0;70;"alzena";70;0;100
0;42;"alzenia";42;0;100
0;31;"alzie";31;0;100
0;137;"alzina";137;0;100
0;36;"alzira";36;0;100
0;6;"alzonia";6;0;100
0;78;"alzora";78;0;100
0;849;"ama";849;0;100
65;0;"amaad";65;100;0
0;98;"amaal";98;0;100
802;0;"amaan";802;100;0
0;39;"amaani";39;0;100
290;0;"amaar";290;100;0
10;0;"amaari";10;100;0
0;120;"amabel";120;0;100
0;39;"amabella";39;0;100
0;17;"amabelle";17;0;100
310;0;"amad";310;100;0
0;2111;"amada";2111;0;100
0;97;"amadea";97;0;100
1444;0;"amadeo";1444;100;0
909;0;"amadeus";909;100;0
129;161;"amadi";290;44.4827586206897;55.5172413793103
0;59;"amadis";59;0;100
0;22;"amadita";22;0;100
3707;0;"amado";3707;100;0
3177;0;"amador";3177;100;0
867;0;"amadou";867;100;0
87;0;"amadu";87;100;0
0;5;"amagine";5;0;100
82;0;"amahd";82;100;0
0;41;"amahia";41;0;100
0;30;"amahni";30;0;100
62;32;"amahri";94;65.9574468085106;34.0425531914894
0;16;"amahya";16;0;100
0;48;"amai";48;0;100
0;1549;"amaia";1549;0;100
0;431;"amaiah";431;0;100
0;5;"amaijah";5;0;100
81;0;"amair";81;100;0
0;287;"amaira";287;0;100
0;29;"amairah";29;0;100
0;1184;"amairani";1184;0;100
0;1035;"amairany";1035;0;100
6;0;"amaire";6;100;0
10;0;"amais";10;100;0
0;1460;"amaiya";1460;0;100
0;607;"amaiyah";607;0;100
15;0;"amaj";15;100;0
0;44;"amaja";44;0;100
5;0;"amajae";5;100;0
0;25;"amajah";25;0;100
23;0;"amaje";23;100;0
0;102;"amaka";102;0;100
280;2365;"amal";2645;10.586011342155;89.413988657845
0;167;"amala";167;0;100
0;74;"amalea";74;0;100
0;10;"amaleah";10;0;100
0;119;"amalee";119;0;100
0;128;"amali";128;0;100
0;11363;"amalia";11363;0;100
0;33;"amaliah";33;0;100
0;1062;"amalie";1062;0;100
0;6;"amalin";6;0;100
0;9;"amalina";9;0;100
142;0;"amalio";142;100;0
0;56;"amaliya";56;0;100
0;6;"amalthea";6;0;100
0;46;"amaly";46;0;100
0;245;"amalya";245;0;100
0;5;"amalyah";5;0;100
0;5;"amalyn";5;0;100
0;247;"amamda";247;0;100
1950;167;"aman";2117;92.1114785073217;7.88852149267832
0;296;"amana";296;0;100
0;369;"amanada";369;0;100
0;5;"amanah";5;0;100
0;27;"amanat";27;0;100
59;0;"amancio";59;100;0
0;181;"amand";181;0;100
2133;776741;"amanda";778874;0.273856875438133;99.7261431245619
0;44;"amandah";44;0;100
0;13;"amandajean";13;0;100
0;69;"amandajo";69;0;100
0;122;"amandalee";122;0;100
0;5;"amandaleigh";5;0;100
0;57;"amandalyn";57;0;100
0;81;"amandalynn";81;0;100
0;77;"amandamarie";77;0;100
0;12;"amandarae";12;0;100
0;15;"amandarose";15;0;100
0;19;"amande";19;0;100
237;183;"amandeep";420;56.4285714285714;43.5714285714286
0;43;"amandia";43;0;100
0;61;"amandine";61;0;100
6;0;"amandip";6;100;0
1180;134;"amando";1314;89.8021308980213;10.1978691019787
0;23;"amandra";23;0;100
26;0;"amandus";26;100;0
0;68;"amandy";68;0;100
0;50;"amane";50;0;100
0;163;"amanee";163;0;100
2045;9538;"amani";11583;17.655184321851;82.344815678149
0;5;"amania";5;0;100
5;165;"amanie";170;2.94117647058824;97.0588235294118
0;96;"amanii";96;0;100
0;5;"amanita";5;0;100
5;0;"amanjit";5;100;0
5;0;"amanjot";5;100;0
0;23;"amannda";23;0;100
0;36;"amanni";36;0;100
0;28;"amanoa";28;0;100
34;125;"amanpreet";159;21.3836477987421;78.6163522012579
173;0;"amante";173;100;0
0;158;"amantha";158;0;100
52;29;"amanti";81;64.1975308641975;35.8024691358025
431;0;"amanuel";431;100;0
0;180;"amany";180;0;100
3600;194;"amar";3794;94.8866631523458;5.11333684765419
190;10778;"amara";10968;1.73231218088986;98.2676878191101
0;459;"amarachi";459;0;100
0;69;"amarachukwu";69;0;100
0;33;"amarae";33;0;100
0;1113;"amarah";1113;0;100
0;121;"amaranta";121;0;100
23;0;"amarante";23;100;0
0;5;"amaranth";5;0;100
0;5;"amarantha";5;0;100
17;0;"amardeep";17;100;0
4917;293;"amare";5210;94.3761996161228;5.62380038387716
6;118;"amarea";124;4.83870967741935;95.1612903225807
0;11;"amareah";11;0;100
741;570;"amaree";1311;56.5217391304348;43.4782608695652
12;0;"amareion";12;100;0
0;5;"amareli";5;0;100
0;49;"amarelis";49;0;100
0;26;"amarely";26;0;100
0;11;"amarelys";11;0;100
91;0;"amareon";91;100;0
0;5;"amareona";5;0;100
20;5;"amarey";25;80;20
0;19;"amareya";19;0;100
5;0;"amareyon";5;100;0
0;5;"amarhi";5;0;100
15290;12848;"amari";28138;54.3393275996873;45.6606724003127
5;1908;"amaria";1913;0.261369576581286;99.7386304234187
5;0;"amariae";5;100;0
0;2379;"amariah";2379;0;100
322;0;"amarian";322;100;0
0;650;"amariana";650;0;100
0;5;"amariani";5;0;100
0;351;"amarianna";351;0;100
0;5;"amariauna";5;0;100
417;1739;"amarie";2156;19.3413729128015;80.6586270871985
0;20;"amariea";20;0;100
0;35;"amariee";35;0;100
0;39;"amarielle";39;0;100
97;0;"amarien";97;100;0
12;0;"amarieon";12;100;0
349;281;"amarii";630;55.3968253968254;44.6031746031746
0;673;"amarilis";673;0;100
0;10;"amarillis";10;0;100
0;5;"amarillys";5;0;100
0;6;"amarily";6;0;100
0;327;"amarilys";327;0;100
5;5;"amarin";10;50;50
0;5;"amarina";5;0;100
106;0;"amario";106;100;0
3263;44;"amarion";3307;98.6694889628062;1.33051103719383
0;220;"amariona";220;0;100
0;162;"amarionna";162;0;100
51;0;"amarious";51;100;0
218;6593;"amaris";6811;3.20070474232859;96.7992952576714
0;103;"amarisa";103;0;100
0;88;"amarise";88;0;100
0;66;"amariss";66;0;100
0;423;"amarissa";423;0;100
289;0;"amarius";289;100;0
0;434;"amariya";434;0;100
0;10;"amariyae";10;0;100
0;502;"amariyah";502;0;100
0;84;"amariyana";84;0;100
0;22;"amariyanna";22;0;100
64;0;"amariyon";64;100;0
0;114;"amariz";114;0;100
0;6;"amarley";6;0;100
90;0;"amaro";90;100;0
5;0;"amaron";5;100;0
0;5;"amarpreet";5;0;100
48;0;"amarr";48;100;0
0;235;"amarra";235;0;100
0;92;"amarrah";92;0;100
39;0;"amarre";39;100;0
289;252;"amarri";541;53.4195933456562;46.5804066543438
0;116;"amarria";116;0;100
0;34;"amarrie";34;0;100
119;0;"amarrion";119;100;0
30;0;"amartya";30;100;0
519;0;"amaru";519;100;0
5;40;"amary";45;11.1111111111111;88.8888888888889
0;95;"amarya";95;0;100
0;139;"amaryah";139;0;100
0;5;"amaryana";5;0;100
0;8;"amarye";8;0;100
0;17;"amaryia";17;0;100
0;135;"amarylis";135;0;100
0;1241;"amaryllis";1241;0;100
0;6;"amaryn";6;0;100
12;0;"amaryon";12;100;0
0;150;"amarys";150;0;100
0;10;"amaryss";10;0;100
27;0;"amasa";27;100;0
0;6;"amata";6;0;100
0;7;"amathyst";7;0;100
81;0;"amato";81;100;0
0;256;"amatullah";256;0;100
29;0;"amaud";29;100;0
0;97;"amaura";97;0;100
18;0;"amaure";18;100;0
1348;529;"amauri";1877;71.8167288225892;28.1832711774108
0;155;"amauria";155;0;100
0;14;"amauriah";14;0;100
85;68;"amaurie";153;55.5555555555556;44.4444444444444
51;0;"amaurion";51;100;0
63;0;"amauris";63;100;0
1184;5;"amaury";1189;99.5794785534062;0.420521446593776
10;0;"amaurys";10;100;0
125;0;"amay";125;100;0
17;26666;"amaya";26683;0.0637109770265712;99.9362890229734
0;2582;"amayah";2582;0;100
0;6;"amayha";6;0;100
0;184;"amayia";184;0;100
0;157;"amayiah";157;0;100
0;25;"amayla";25;0;100
0;5;"amaylee";5;0;100
0;79;"amayra";79;0;100
0;543;"amayrani";543;0;100
0;106;"amayrany";106;0;100
0;11;"amazen";11;0;100
267;84;"amaziah";351;76.0683760683761;23.9316239316239
0;70;"amazin";70;0;100
6;124;"amazing";130;4.61538461538462;95.3846153846154
0;34;"amazyn";34;0;100
0;10;"amba";10;0;100
5;2307;"ambar";2312;0.216262975778547;99.7837370242215
0;5;"ambee";5;0;100
0;48;"ambellina";48;0;100
981;368926;"amber";369907;0.265201793964429;99.7347982060356
0;46;"ambera";46;0;100
0;6;"amberann";6;0;100
0;23;"amberdawn";23;0;100
0;13;"ambere";13;0;100
0;74;"amberia";74;0;100
0;10;"amberjo";10;0;100
0;214;"amberle";214;0;100
0;127;"amberlea";127;0;100
0;1786;"amberlee";1786;0;100
0;447;"amberleigh";447;0;100
0;622;"amberley";622;0;100
0;84;"amberli";84;0;100
0;231;"amberlie";231;0;100
0;208;"amberlin";208;0;100
0;5679;"amberly";5679;0;100
0;1471;"amberlyn";1471;0;100
0;1186;"amberlynn";1186;0;100
0;10;"amberlynne";10;0;100
0;76;"ambermarie";76;0;100
0;23;"ambernicole";23;0;100
0;10;"ambernique";10;0;100
0;5;"amberrae";5;0;100
0;220;"amberrose";220;0;100
105;0;"ambers";105;100;0
0;145;"ambert";145;0;100
0;23;"ambi";23;0;100
0;340;"ambika";340;0;100
0;5;"ambir";5;0;100
0;23;"ambor";23;0;100
0;10;"ambr";10;0;100
0;892;"ambra";892;0;100
0;6;"ambrasia";6;0;100
0;645;"ambre";645;0;100
0;485;"ambrea";485;0;100
0;30;"ambreal";30;0;100
0;5;"ambreanna";5;0;100
0;414;"ambree";414;0;100
0;96;"ambreen";96;0;100
0;51;"ambreia";51;0;100
0;11;"ambresha";11;0;100
0;50;"ambrey";50;0;100
0;71;"ambri";71;0;100
0;1956;"ambria";1956;0;100
0;34;"ambriah";34;0;100
0;73;"ambriana";73;0;100
0;48;"ambrianna";48;0;100
0;140;"ambrie";140;0;100
0;17;"ambriehl";17;0;100
0;262;"ambriel";262;0;100
0;76;"ambriella";76;0;100
0;567;"ambrielle";567;0;100
53;0;"ambrocio";53;100;0
30;0;"ambros";30;100;0
7639;0;"ambrose";7639;100;0
0;10;"ambrosha";10;0;100
0;1600;"ambrosia";1600;0;100
915;0;"ambrosio";915;100;0
6;0;"ambrous";6;100;0
0;127;"ambry";127;0;100
0;495;"ambur";495;0;100
29;0;"ambus";29;100;0
0;28;"amby";28;0;100
0;283;"ambyr";283;0;100
0;18;"amdanda";18;0;100
0;16;"amdrea";16;0;100
104;0;"amdrew";104;100;0
0;352;"ame";352;0;100
0;137;"amea";137;0;100
0;87;"ameah";87;0;100
17;0;"ameal";17;100;0
61;0;"amear";61;100;0
0;16;"ameara";16;0;100
11;0;"amechi";11;100;0
0;27;"amecia";27;0;100
77;0;"amed";77;100;0
70;0;"amedee";70;100;0
612;0;"amedeo";612;100;0
63;0;"amedio";63;100;0
0;1673;"amee";1673;0;100
0;26;"ameelah";26;0;100
0;17;"ameelia";17;0;100
1281;0;"ameen";1281;100;0
0;1222;"ameena";1222;0;100
0;747;"ameenah";747;0;100
4249;0;"ameer";4249;100;0
0;1961;"ameera";1961;0;100
0;1696;"ameerah";1696;0;100
5;0;"ameere";5;100;0
0;6;"ameeria";6;0;100
0;10;"ameesha";10;0;100
65;0;"ameet";65;100;0
0;10;"ameeya";10;0;100
0;22;"ameeyah";22;0;100
0;12;"amei";12;0;100
0;149;"ameia";149;0;100
0;35;"ameiah";35;0;100
0;5;"ameika";5;0;100
5;0;"ameil";5;100;0
0;247;"ameila";247;0;100
0;189;"ameilia";189;0;100
0;50;"ameilya";50;0;100
0;20;"ameina";20;0;100
476;0;"ameir";476;100;0
0;152;"ameira";152;0;100
0;55;"ameirah";55;0;100
5;0;"ameire";5;100;0
0;72;"ameisha";72;0;100
0;5;"ameiya";5;0;100
0;5;"ameiyah";5;0;100
0;136;"ameka";136;0;100
0;6;"amekia";6;0;100
531;349;"amel";880;60.3409090909091;39.6590909090909
0;324;"amela";324;0;100
0;12;"amelah";12;0;100
0;198;"amelda";198;0;100
0;19;"amelea";19;0;100
0;5;"ameleah";5;0;100
0;5;"amelee";5;0;100
0;106;"ameli";106;0;100
199;160835;"amelia";161034;0.123576387595166;99.8764236124048
0;15;"ameliagrace";15;0;100
0;413;"ameliah";413;0;100
0;5;"ameliajane";5;0;100
0;6;"ameliamae";6;0;100
0;155;"ameliana";155;0;100
0;41;"amelianna";41;0;100
0;61;"ameliarose";61;0;100
0;6410;"amelie";6410;0;100
0;50;"amelina";50;0;100
0;40;"amelinda";40;0;100
0;6;"ameline";6;0;100
353;0;"amelio";353;100;0
0;66;"amelita";66;0;100
0;186;"ameliya";186;0;100
0;96;"ameliyah";96;0;100
0;6;"amella";6;0;100
0;23;"amelle";23;0;100
0;519;"amellia";519;0;100
0;259;"amely";259;0;100
0;488;"amelya";488;0;100
0;25;"amelyah";25;0;100
617;349;"amen";966;63.871635610766;36.128364389234
0;780;"amena";780;0;100
0;150;"amenah";150;0;100
0;5;"amenata";5;0;100
0;322;"amenda";322;0;100
0;45;"amenia";45;0;100
1210;12;"amer";1222;99.0180032733224;0.981996726677578
0;828;"amera";828;0;100
0;291;"amerah";291;0;100
712;139;"amere";851;83.6662749706228;16.3337250293772
6;123;"ameri";129;4.65116279069767;95.3488372093023
0;560;"ameria";560;0;100
0;202;"ameriah";202;0;100
0;5;"ameriana";5;0;100
16;12051;"america";12067;0.132593022292202;99.8674069777078
0;21;"americas";21;0;100
2846;0;"americo";2846;100;0
142;424;"americus";566;25.0883392226148;74.9116607773852
0;1909;"amerie";1909;0;100
353;0;"amerigo";353;100;0
0;300;"amerika";300;0;100
27;0;"amerion";27;100;0
0;252;"ameris";252;0;100
0;5;"amerissa";5;0;100
0;5;"amerius";5;0;100
0;21;"ameriya";21;0;100
0;51;"ameriyah";51;0;100
0;32;"amerra";32;0;100
5;5;"amerson";10;50;50
89;432;"amery";521;17.0825335892514;82.9174664107486
0;5;"ameryst";5;0;100
1131;5;"ames";1136;99.5598591549296;0.440140845070423
0;323;"amesha";323;0;100
0;150;"ameshia";150;0;100
0;2823;"amethyst";2823;0;100
0;16;"ametra";16;0;100
0;16;"ametria";16;0;100
27;828;"amey";855;3.15789473684211;96.8421052631579
183;560;"ameya";743;24.6298788694482;75.3701211305518
0;27;"ameyaa";27;0;100
0;164;"ameyah";164;0;100
0;5;"ameyali";5;0;100
0;43;"ameyalli";43;0;100
0;6;"ameyia";6;0;100
0;11;"amgela";11;0;100
5;0;"amhad";5;100;0
295;7220;"ami";7515;3.92548236859614;96.0745176314039
0;4193;"amia";4193;0;100
0;3394;"amiah";3394;0;100
0;5;"amiaha";5;0;100
403;0;"amias";403;100;0
0;215;"amiaya";215;0;100
0;56;"amiayah";56;0;100
0;89;"amica";89;0;100
46;0;"amichai";46;100;0
0;5;"amicia";5;0;100
10;0;"amid";10;100;0
0;6;"amida";6;0;100
0;7;"amidala";7;0;100
40;20978;"amie";21018;0.190313064991912;99.8096869350081
0;1675;"amiee";1675;0;100
971;57;"amiel";1028;94.4552529182879;5.54474708171206
0;34;"amiela";34;0;100
0;30;"amielia";30;0;100
0;10;"amielle";10;0;100
0;6;"amiena";6;0;100
458;0;"amier";458;100;0
0;133;"amiera";133;0;100
0;32;"amierah";32;0;100
89;7;"amiere";96;92.7083333333333;7.29166666666667
0;42;"amii";42;0;100
0;10;"amiia";10;0;100
12;0;"amiin";12;100;0
0;5;"amiina";5;0;100
84;0;"amiir";84;100;0
0;33;"amiira";33;0;100
0;29;"amija";29;0;100
0;98;"amijah";98;0;100
0;270;"amika";270;0;100
741;241;"amil";982;75.4582484725051;24.5417515274949
0;344;"amila";344;0;100
0;164;"amilah";164;0;100
787;0;"amilcar";787;100;0
6;0;"amilcare";6;100;0
0;11;"amilda";11;0;100
5;0;"amile";5;100;0
0;42;"amilea";42;0;100
0;39;"amileah";39;0;100
0;156;"amilee";156;0;100
11;0;"amileo";11;100;0
0;62;"amiley";62;0;100
0;1564;"amilia";1564;0;100
0;57;"amiliah";57;0;100
0;29;"amilian";29;0;100
0;152;"amiliana";152;0;100
36;0;"amiliano";36;100;0
0;5;"amilie";5;0;100
165;0;"amilio";165;100;0
0;45;"amiliya";45;0;100
0;20;"amiliyah";20;0;100
5;0;"amill";5;100;0
0;6;"amilla";6;0;100
0;10;"amilleon";10;0;100
0;32;"amilli";32;0;100
0;498;"amillia";498;0;100
0;5;"amilliah";5;0;100
0;31;"amillian";31;0;100
0;152;"amilliana";152;0;100
0;21;"amillianna";21;0;100
0;14;"amillie";14;0;100
36;0;"amillio";36;100;0
84;154;"amillion";238;35.2941176470588;64.7058823529412
0;10;"amilliona";10;0;100
0;5;"amilliyon";5;0;100
0;82;"amillya";82;0;100
0;223;"amily";223;0;100
0;598;"amilya";598;0;100
0;188;"amilyah";188;0;100
0;20;"amilyn";20;0;100
0;6;"amilynn";6;0;100
2610;0;"amin";2610;100;0
0;10152;"amina";10152;0;100
0;3399;"aminah";3399;0;100
0;80;"aminat";80;0;100
0;1637;"aminata";1637;0;100
0;22;"aminatou";22;0;100
0;39;"aminda";39;0;100
358;0;"amine";358;100;0
0;5;"aminna";5;0;100
0;5;"amino";5;0;100
0;279;"aminta";279;0;100
27357;390;"amir";27747;98.5944426424478;1.40555735755217
0;12017;"amira";12017;0;100
0;1087;"amiracle";1087;0;100
0;6003;"amirah";6003;0;100
25;0;"amirali";25;100;0
5;0;"amirbek";5;100;0
519;83;"amire";602;86.2126245847176;13.7873754152824
0;5;"amirea";5;0;100
0;74;"amiree";74;0;100
0;5;"amirh";5;0;100
546;127;"amiri";673;81.1292719167905;18.8707280832095
0;155;"amiria";155;0;100
0;23;"amiriah";23;0;100
0;5;"amirie";5;0;100
0;10;"amiriya";10;0;100
25;0;"amirjon";25;100;0
70;0;"amirr";70;100;0
0;336;"amirra";336;0;100
0;307;"amirrah";307;0;100
0;5;"amirya";5;0;100
0;11;"amiryah";11;0;100
0;29;"amirykal";29;0;100
5;0;"amis";5;100;0
0;16;"amisa";16;0;100
5;121;"amisadai";126;3.96825396825397;96.031746031746
0;5;"amisaday";5;0;100
294;0;"amish";294;100;0
0;772;"amisha";772;0;100
0;45;"amishi";45;0;100
0;21;"amissa";21;0;100
0;5;"amista";5;0;100
5;0;"amistad";5;100;0
2775;190;"amit";2965;93.5919055649241;6.40809443507589
0;456;"amita";456;0;100
12;0;"amitabh";12;100;0
121;0;"amitai";121;100;0
29;0;"amith";29;100;0
0;10;"amitha";10;0;100
0;38;"amitiel";38;0;100
0;6;"amitis";6;0;100
19;0;"amitoj";19;100;0
5;0;"amittai";5;100;0
0;1773;"amity";1773;0;100
15;0;"amius";15;100;0
0;6494;"amiya";6494;0;100
0;5;"amiyaah";5;0;100
0;10768;"amiyah";10768;0;100
0;53;"amiyha";53;0;100
0;5;"amiyiah";5;0;100
0;15;"amiyla";15;0;100
0;38;"amiylah";38;0;100
8;0;"amiyr";8;100;0
0;43;"amiyra";43;0;100
0;62;"amiyrah";62;0;100
418;0;"amjad";418;100;0
28;0;"amjed";28;100;0
0;457;"amma";457;0;100
184;0;"ammaar";184;100;0
0;10;"ammaarah";10;0;100
12;0;"ammad";12;100;0
87;0;"amman";87;100;0
0;106;"ammanda";106;0;100
48;0;"ammanuel";48;100;0
2050;0;"ammar";2050;100;0
0;94;"ammara";94;0;100
0;29;"ammarah";29;0;100
0;58;"ammarie";58;0;100
0;12;"ammber";12;0;100
0;49;"amme";49;0;100
5;5;"ammer";10;50;50
0;10;"ammerie";10;0;100
0;124;"ammi";124;0;100
32;2425;"ammie";2457;1.3024013024013;98.6975986975987
53;0;"ammiel";53;100;0
3759;0;"ammon";3759;100;0
0;1060;"ammy";1060;0;100
0;1283;"amna";1283;0;100
0;114;"amnah";114;0;100
0;6;"amneet";6;0;100
0;28;"amneh";28;0;100
38;0;"amner";38;100;0
0;35;"amneris";35;0;100
0;13;"amnesty";13;0;100
5;10;"amo";15;33.3333333333333;66.6666666666667
26;0;"amod";26;100;0
576;0;"amogh";576;100;0
0;13;"amoi";13;0;100
232;0;"amol";232;100;0
0;10;"amolika";10;0;100
2315;0;"amon";2315;100;0
63;0;"amond";63;100;0
0;72;"amonda";72;0;100
14;0;"amondo";14;100;0
23;0;"amondre";23;100;0
0;5;"amone";5;0;100
0;25;"amonee";25;0;100
152;990;"amoni";1142;13.3099824868651;86.6900175131348
0;290;"amonie";290;0;100
0;5;"amonii";5;0;100
0;19;"amonni";19;0;100
0;11;"amonnie";11;0;100
5;0;"amont";5;100;0
5;0;"amonta";5;100;0
171;0;"amontae";171;100;0
19;0;"amontay";19;100;0
591;0;"amonte";591;100;0
55;5;"amonti";60;91.6666666666667;8.33333333333333
277;1092;"amor";1369;20.2337472607743;79.7662527392257
0;1858;"amora";1858;0;100
0;10;"amorae";10;0;100
0;172;"amorah";172;0;100
152;678;"amore";830;18.3132530120482;81.6867469879518
0;91;"amoree";91;0;100
0;160;"amoreena";160;0;100
0;5;"amoret";5;0;100
0;486;"amorette";486;0;100
209;301;"amori";510;40.9803921568627;59.0196078431373
0;100;"amoria";100;0;100
0;54;"amoriah";54;0;100
10;0;"amorian";10;100;0
0;17;"amoriana";17;0;100
47;239;"amorie";286;16.4335664335664;83.5664335664336
0;68;"amorina";68;0;100
49;0;"amorion";49;100;0
0;73;"amorita";73;0;100
0;12;"amorra";12;0;100
0;5;"amorrah";5;0;100
440;434;"amory";874;50.3432494279176;49.6567505720824
30601;64;"amos";30665;99.7912930050546;0.208706994945377
6;0;"amose";6;100;0
42;261;"amour";303;13.8613861386139;86.1386138613861
0;177;"amoura";177;0;100
0;7;"amoure";7;0;100
14;11;"amouri";25;56;44
91;0;"amous";91;100;0
0;72;"amoy";72;0;100
0;32;"amoya";32;0;100
17;0;"amoz";17;100;0
17;3266;"amparo";3283;0.517819067925678;99.4821809320743
0;5;"ample";5;0;100
801;0;"amr";801;100;0
0;294;"amra";294;0;100
0;5;"amrah";5;0;100
49;0;"amram";49;100;0
41;187;"amran";228;17.9824561403509;82.0175438596491
0;59;"amree";59;0;100
0;196;"amreen";196;0;100
0;7;"amreet";7;0;100
10;0;"amren";10;100;0
8;298;"amri";306;2.61437908496732;97.3856209150327
0;117;"amrie";117;0;100
0;17;"amriel";17;0;100
6;0;"amrik";6;100;0
0;10;"amrin";10;0;100
498;362;"amrit";860;57.906976744186;42.093023255814
0;969;"amrita";969;0;100
5;0;"amrith";5;100;0
0;95;"amritha";95;0;100
85;0;"amritpal";85;100;0
180;0;"amro";180;100;0
224;0;"amrom";224;100;0
75;0;"amron";75;100;0
0;16;"amruta";16;0;100
5;0;"amruth";5;100;0
0;193;"amrutha";193;0;100
0;71;"amry";71;0;100
6;47;"amryn";53;11.3207547169811;88.6792452830189
0;5;"amsey";5;0;100
0;65;"amsi";65;0;100
28;0;"amuel";28;100;0
0;5;"amukta";5;0;100
8;0;"amulek";8;100;0
0;304;"amulya";304;0;100
51;0;"amun";51;100;0
0;32;"amunet";32;0;100
0;114;"amunique";114;0;100
5;0;"amuri";5;100;0
0;5;"amvi";5;0;100
1846;683333;"amy";685179;0.269418648265636;99.7305813517344
0;8938;"amya";8938;0;100
0;2543;"amyah";2543;0;100
0;12;"amyann";12;0;100
39;0;"amyas";39;100;0
0;116;"amybeth";116;0;100
0;651;"amye";651;0;100
0;10;"amyha";10;0;100
0;787;"amyia";787;0;100
0;773;"amyiah";773;0;100
0;486;"amyjo";486;0;100
0;235;"amyla";235;0;100
0;145;"amylah";145;0;100
0;5;"amylea";5;0;100
0;199;"amylee";199;0;100
0;239;"amylia";239;0;100
0;6;"amyliah";6;0;100
0;12;"amylyn";12;0;100
0;223;"amylynn";223;0;100
0;52;"amymarie";52;0;100
0;25;"amyna";25;0;100
138;0;"amyr";138;100;0
0;1081;"amyra";1081;0;100
0;39;"amyracle";39;0;100
0;428;"amyrah";428;0;100
12;98;"amyre";110;10.9090909090909;89.0909090909091
0;32;"amyree";32;0;100
0;156;"amyri";156;0;100
0;184;"amyria";184;0;100
0;97;"amyriah";97;0;100
0;10;"amyrical";10;0;100
0;134;"amyrie";134;0;100
0;5;"amyrikal";5;0;100
6;0;"amyrion";6;100;0
0;18;"amysue";18;0;100
0;24;"amythest";24;0;100
0;5;"amythyst";5;0;100
0;5;"amyya";5;0;100
0;11;"amzee";11;0;100
6;10;"amzi";16;37.5;62.5
45;104;"amzie";149;30.2013422818792;69.7986577181208
903;1085;"an";1988;45.4225352112676;54.5774647887324
591;98668;"ana";99259;0.595412002941799;99.4045879970582
0;5;"anaahat";5;0;100
0;201;"anaalicia";201;0;100
0;79;"anaaya";79;0;100
0;76;"anab";76;0;100
0;12;"anabeatriz";12;0;100
35;9110;"anabel";9145;0.382722799343904;99.6172772006561
0;466;"anabela";466;0;100
0;5;"anabele";5;0;100
0;73;"anabelen";73;0;100
0;7;"anabeli";7;0;100
0;6;"anabelia";6;0;100
0;1335;"anabell";1335;0;100
0;5460;"anabella";5460;0;100
0;7803;"anabelle";7803;0;100
0;5;"anabelli";5;0;100
0;5;"anaberta";5;0;100
0;167;"anabeth";167;0;100
0;204;"anabia";204;0;100
0;8;"anabiya";8;0;100
0;43;"anabrenda";43;0;100
0;30;"anacamila";30;0;100
0;33;"anacani";33;0;100
0;126;"anacaren";126;0;100
0;6;"anacarina";6;0;100
0;121;"anacarolina";121;0;100
0;57;"anacecilia";57;0;100
0;29;"anaceli";29;0;100
0;37;"anacelia";37;0;100
0;5;"anacelis";5;0;100
0;5;"anacely";5;0;100
0;45;"anachristina";45;0;100
0;5;"anacia";5;0;100
0;114;"anaclara";114;0;100
206;0;"anacleto";206;100;0
0;223;"anacristina";223;0;100
0;103;"anadalay";103;0;100
0;8;"anadela";8;0;100
0;96;"anadelia";96;0;100
0;74;"anadia";74;0;100
0;80;"anae";80;0;100
0;6;"anaee";6;0;100
0;5;"anaeja";5;0;100
0;11;"anaejah";11;0;100
22;91;"anael";113;19.4690265486726;80.5309734513274
0;163;"anaeli";163;0;100
0;12;"anaelisa";12;0;100
0;5;"anaelise";5;0;100
0;146;"anaelle";146;0;100
0;32;"anaely";32;0;100
0;6;"anagabriel";6;0;100
0;116;"anagabriela";116;0;100
11;0;"anagh";11;100;0
0;462;"anagha";462;0;100
0;32;"anagrace";32;0;100
0;384;"anah";384;0;100
0;5;"anahat";5;0;100
31;14550;"anahi";14581;0.212605445442699;99.7873945545573
0;8;"anahia";8;0;100
0;82;"anahid";82;0;100
0;11;"anahie";11;0;100
0;8;"anahii";8;0;100
0;187;"anahis";187;0;100
0;278;"anahit";278;0;100
0;342;"anahita";342;0;100
0;74;"anahla";74;0;100
0;56;"anahli";56;0;100
0;45;"anahlia";45;0;100
0;28;"anahly";28;0;100
0;1208;"anahy";1208;0;100
0;17;"anahya";17;0;100
0;2065;"anai";2065;0;100
0;377;"anaia";377;0;100
12;1865;"anaiah";1877;0.639318060735216;99.3606819392648
11;0;"anaias";11;100;0
0;5;"anaica";5;0;100
0;420;"anaid";420;0;100
0;15;"anaida";15;0;100
0;32;"anaie";32;0;100
0;64;"anaih";64;0;100
0;27;"anaiis";27;0;100
0;110;"anaija";110;0;100
0;158;"anaijah";158;0;100
0;103;"anaika";103;0;100
0;21;"anaila";21;0;100
0;20;"anailah";20;0;100
0;21;"anaili";21;0;100
0;78;"anaily";78;0;100
0;188;"anaira";188;0;100
0;124;"anairis";124;0;100
46;6449;"anais";6495;0.708237105465743;99.2917628945343
0;361;"anaisa";361;0;100
0;108;"anaisabel";108;0;100
0;10;"anaisabella";10;0;100
0;313;"anaise";313;0;100
0;276;"anaisha";276;0;100
0;5;"anaisia";5;0;100
0;93;"anaissa";93;0;100
0;1721;"anaiya";1721;0;100
0;1086;"anaiyah";1086;0;100
0;324;"anaiz";324;0;100
0;96;"anaiza";96;0;100
0;220;"anaja";220;0;100
0;6;"anajae";6;0;100
0;309;"anajah";309;0;100
6;0;"anajee";6;100;0
0;19;"anajia";19;0;100
0;124;"anajulia";124;0;100
0;270;"anaka";270;0;100
0;5;"anakah";5;0;100
0;999;"anakaren";999;0;100
0;34;"anakarina";34;0;100
2311;7;"anakin";2318;99.6980155306299;0.301984469370147
7;0;"anakyn";7;100;0
0;202;"anala";202;0;100
0;20;"analah";20;0;100
0;413;"analaura";413;0;100
0;90;"analaya";90;0;100
0;58;"analayah";58;0;100
0;233;"analea";233;0;100
0;838;"analeah";838;0;100
0;39;"analecia";39;0;100
0;1690;"analee";1690;0;100
0;7;"analeece";7;0;100
0;17;"analeesa";17;0;100
0;78;"analeese";78;0;100
0;90;"analei";90;0;100
0;41;"analeia";41;0;100
0;12;"analeiah";12;0;100
0;1243;"analeigh";1243;0;100
0;148;"analeigha";148;0;100
0;161;"analeise";161;0;100
0;136;"analena";136;0;100
0;172;"analese";172;0;100
0;6;"analeshia";6;0;100
0;5;"analexis";5;0;100
0;22;"analey";22;0;100
0;73;"analeya";73;0;100
0;35;"analeyah";35;0;100
0;1612;"anali";1612;0;100
0;3917;"analia";3917;0;100
0;522;"analiah";522;0;100
0;20;"analice";20;0;100
0;1808;"analicia";1808;0;100
0;5;"analidia";5;0;100
0;346;"analie";346;0;100
0;5;"analiegh";5;0;100
0;5;"analiesa";5;0;100
0;1468;"analiese";1468;0;100
0;5;"analiha";5;0;100
0;422;"analilia";422;0;100
0;5;"analily";5;0;100
0;16;"analin";16;0;100
0;147;"analina";147;0;100
0;476;"analis";476;0;100
0;3586;"analisa";3586;0;100
0;3662;"analise";3662;0;100
0;37;"analisha";37;0;100
0;184;"analisia";184;0;100
0;335;"analissa";335;0;100
0;245;"analisse";245;0;100
0;98;"analiya";98;0;100
0;714;"analiyah";714;0;100
0;571;"analiz";571;0;100
0;202;"analiza";202;0;100
0;34;"analize";34;0;100
0;137;"analleli";137;0;100
0;214;"anallely";214;0;100
0;7;"anally";7;0;100
10;0;"analu";10;100;0
0;454;"analucia";454;0;100
0;345;"analuisa";345;0;100
0;35;"analuiza";35;0;100
0;55;"analuz";55;0;100
0;1615;"analy";1615;0;100
0;146;"analya";146;0;100
0;68;"analyah";68;0;100
0;91;"analyce";91;0;100
0;130;"analycia";130;0;100
0;5;"analydia";5;0;100
0;350;"analyn";350;0;100
0;273;"analynn";273;0;100
0;69;"analys";69;0;100
0;308;"analysa";308;0;100
0;606;"analyse";606;0;100
0;229;"analysia";229;0;100
0;5;"analyss";5;0;100
0;491;"analyssa";491;0;100
0;104;"analysse";104;0;100
0;5;"analyssia";5;0;100
0;7;"analyz";7;0;100
0;542;"anam";542;0;100
0;72;"anamae";72;0;100
0;5;"anamar";5;0;100
0;85;"anamari";85;0;100
0;2849;"anamaria";2849;0;100
0;1235;"anamarie";1235;0;100
0;41;"anamaris";41;0;100
0;5;"anamary";5;0;100
0;6;"anamda";6;0;100
0;5;"anamia";5;0;100
0;155;"anamika";155;0;100
0;5;"anamile";5;0;100
0;22;"anamta";22;0;100
62;5;"anan";67;92.5373134328358;7.46268656716418
0;22;"anana";22;0;100
1676;0;"anand";1676;100;0
86;1563;"ananda";1649;5.21528198908429;94.7847180109157
0;84;"anandi";84;0;100
0;5;"anandita";5;0;100
0;203;"anani";203;0;100
16;0;"anania";16;100;0
0;132;"ananiah";132;0;100
592;0;"ananias";592;100;0
0;6;"anannya";6;0;100
0;22;"anansa";22;0;100
0;6;"ananshi";6;0;100
249;0;"anant";249;100;0
177;0;"ananth";177;100;0
0;3046;"ananya";3046;0;100
0;5;"ananyaa";5;0;100
0;130;"anapaola";130;0;100
0;46;"anapatricia";46;0;100
0;334;"anapaula";334;0;100
43;0;"anar";43;100;0
0;209;"anara";209;0;100
0;6;"anarae";6;0;100
0;20;"anarah";20;0;100
0;53;"anareli";53;0;100
0;97;"anarely";97;0;100
24;527;"anari";551;4.3557168784029;95.6442831215971
0;233;"anaria";233;0;100
0;46;"anariah";46;0;100
0;69;"anarie";69;0;100
0;5;"anariya";5;0;100
0;12;"anariyah";12;0;100
0;342;"anarosa";342;0;100
0;35;"anarose";35;0;100
0;6;"anaruth";6;0;100
1729;0;"anas";1729;100;0
0;13;"anasa";13;0;100
0;115;"anasha";115;0;100
0;5;"anashe";5;0;100
0;27;"anashia";27;0;100
0;842;"anasia";842;0;100
0;620;"anasofia";620;0;100
0;12;"anasol";12;0;100
0;216;"anasophia";216;0;100
30;0;"anass";30;100;0
0;8;"anassa";8;0;100
0;4489;"anastacia";4489;0;100
2212;0;"anastacio";2212;100;0
0;83;"anastaisa";83;0;100
0;11;"anastaisha";11;0;100
0;12;"anastaja";12;0;100
0;5;"anastajia";5;0;100
0;240;"anastasha";240;0;100
0;308;"anastashia";308;0;100
0;22;"anastasi";22;0;100
23;40345;"anastasia";40368;0.0569758224336108;99.9430241775664
0;127;"anastasija";127;0;100
174;0;"anastasio";174;100;0
908;0;"anastasios";908;100;0
0;409;"anastasiya";409;0;100
0;255;"anastassia";255;0;100
0;120;"anastasya";120;0;100
0;18;"anastatia";18;0;100
0;21;"anastaysia";21;0;100
0;705;"anastazia";705;0;100
0;82;"anastazja";82;0;100
0;20;"anastin";20;0;100
0;63;"anaston";63;0;100
0;184;"anastyn";184;0;100
0;50;"anat";50;0;100
0;45;"anatalia";45;0;100
0;123;"anatasia";123;0;100
0;24;"anathea";24;0;100
5;0;"anatol";5;100;0
188;0;"anatole";188;100;0
6;0;"anatoli";6;100;0
0;6;"anatolia";6;0;100
50;0;"anatoliy";50;100;0
22;0;"anatoly";22;100;0
0;29;"anaum";29;0;100
0;5;"anauri";5;0;100
0;27;"anautica";27;0;100
34;0;"anav";34;100;0
0;17;"anavae";17;0;100
0;11;"anavaeh";11;0;100
0;10;"anavay";10;0;100
0;31;"anaveah";31;0;100
0;35;"anavel";35;0;100
0;5;"anavela";5;0;100
0;70;"anavey";70;0;100
0;80;"anavi";80;0;100
0;5;"anaviah";5;0;100
0;209;"anavictoria";209;0;100
787;762;"anay";1549;50.8069722401549;49.1930277598451
0;10879;"anaya";10879;0;100
0;14;"anayaa";14;0;100
0;2053;"anayah";2053;0;100
0;7;"anayalee";7;0;100
0;20;"anayanci";20;0;100
0;27;"anayancy";27;0;100
0;63;"anayansi";63;0;100
0;1955;"anayeli";1955;0;100
0;5;"anayelis";5;0;100
0;60;"anayelli";60;0;100
0;6;"anayelly";6;0;100
0;240;"anayely";240;0;100
0;16;"anayha";16;0;100
0;92;"anayi";92;0;100
0;146;"anayia";146;0;100
0;176;"anayiah";176;0;100
0;5;"anayis";5;0;100
0;28;"anayjah";28;0;100
0;222;"anayla";222;0;100
0;14;"anaylah";14;0;100
0;16;"anayra";16;0;100
0;91;"anays";91;0;100
0;14;"anaysa";14;0;100
0;120;"anaysha";120;0;100
0;16;"anayshia";16;0;100
0;190;"anaysia";190;0;100
0;6;"anayssa";6;0;100
0;17;"anazia";17;0;100
0;56;"anber";56;0;100
0;200;"anberlin";200;0;100
0;59;"anberlyn";59;0;100
0;5;"anberlynn";5;0;100
0;10;"anbria";10;0;100
54;0;"ance";54;100;0
710;0;"ancel";710;100;0
51;0;"ancelmo";51;100;0
0;34;"anchal";34;0;100
0;6;"anchita";6;0;100
54;0;"anchor";54;100;0
0;5;"ancika";5;0;100
1080;0;"ancil";1080;100;0
38;0;"ancle";38;100;0
0;16;"ancy";16;0;100
0;194;"anda";194;0;100
0;5;"andaiye";5;0;100
0;22;"andalasia";22;0;100
0;11;"andalucia";11;0;100
0;90;"andalyn";90;0;100
0;18;"andalynn";18;0;100
15;0;"andamo";15;100;0
25;0;"andan";25;100;0
29;0;"andarius";29;100;0
64;0;"anddy";64;100;0
36;168;"ande";204;17.6470588235294;82.3529411764706
0;5;"andea";5;0;100
5;967;"andee";972;0.51440329218107;99.4855967078189
17;0;"andel";17;100;0
0;11;"andela";11;0;100
0;6;"andelin";6;0;100
0;6;"andella";6;0;100
0;150;"andelyn";150;0;100
0;14;"andelynn";14;0;100
608;0;"anden";608;100;0
1346;0;"ander";1346;100;0
18;735;"andera";753;2.39043824701195;97.609561752988
0;5;"anderea";5;0;100
10;0;"anderew";10;100;0
0;106;"anderia";106;0;100
5559;0;"anders";5559;100;0
671;185;"andersen";856;78.3878504672897;21.6121495327103
23755;722;"anderson";24477;97.0502921109613;2.94970788903869
67;0;"andersson";67;100;0
0;91;"andersyn";91;0;100
43;0;"anderw";43;100;0
16;0;"anderzon";16;100;0
12;0;"andes";12;100;0
13;0;"andew";13;100;0
21;0;"andhy";21;100;0
715;4011;"andi";4726;15.1290732120186;84.8709267879814
0;58;"andia";58;0;100
0;5;"andice";5;0;100
206;3294;"andie";3500;5.88571428571429;94.1142857142857
5;0;"andiel";5;100;0
0;79;"andilyn";79;0;100
0;50;"andilynn";50;0;100
53;5;"andin";58;91.3793103448276;8.62068965517241
7;0;"andino";7;100;0
5;0;"andis";5;100;0
0;45;"andjela";45;0;100
0;6;"andjoua";6;0;100
5;0;"andols";5;100;0
954;0;"andon";954;100;0
129;0;"andoni";129;100;0
0;5;"andonia";5;0;100
23;0;"andony";23;100;0
0;134;"andora";134;0;100
2572;5452;"andra";8024;32.0538384845464;67.9461615154536
5;0;"andrade";5;100;0
2007;41;"andrae";2048;97.998046875;2.001953125
0;36;"andraea";36;0;100
0;10;"andraia";10;0;100
0;40;"andralyn";40;0;100
0;11;"andranae";11;0;100
0;10;"andranette";10;0;100
156;0;"andranik";156;100;0
0;11;"andranique";11;0;100
195;0;"andras";195;100;0
230;0;"andray";230;100;0
0;956;"andraya";956;0;100
120252;2196;"andre";122448;98.2065856526852;1.79341434731478
5836;428648;"andrea";434484;1.34320251148489;98.6567974885151
0;416;"andreah";416;0;100
0;112;"andreal";112;0;100
0;15;"andreamarie";15;0;100
5;20;"andrean";25;20;80
0;1771;"andreana";1771;0;100
0;862;"andreanna";862;0;100
7128;49;"andreas";7177;99.3172634805629;0.682736519437091
18;0;"andreau";18;100;0
39;0;"andreaus";39;100;0
23;0;"andreaz";23;100;0
0;5;"andreca";5;0;100
15;0;"andreco";15;100;0
906;1928;"andree";2834;31.96894848271;68.0310515172901
0;273;"andreea";273;0;100
0;10;"andreena";10;0;100
2469;0;"andrei";2469;100;0
0;620;"andreia";620;0;100
0;40;"andreika";40;0;100
6;1199;"andreina";1205;0.497925311203319;99.5020746887967
34;0;"andreis";34;100;0
0;10;"andreita";10;0;100
282;0;"andrej";282;100;0
21;0;"andrejs";21;100;0
5;0;"andrek";5;100;0
0;144;"andreka";144;0;100
0;7;"andrekia";7;0;100
32;5;"andrel";37;86.4864864864865;13.5135135135135
311;134;"andrell";445;69.8876404494382;30.1123595505618
0;35;"andrella";35;0;100
0;11;"andrelle";11;0;100
74;0;"andren";74;100;0
0;700;"andrena";700;0;100
0;5;"andrenae";5;0;100
0;25;"andrene";25;0;100
0;10;"andrenette";10;0;100
0;11;"andrenika";11;0;100
0;14;"andreniki";14;0;100
0;12;"andrenique";12;0;100
19;0;"andreo";19;100;0
0;8;"andreona";8;0;100
0;6;"andreonna";6;0;100
10;0;"andreous";10;100;0
12;0;"andreq";12;100;0
80195;444;"andres";80639;99.4493979340022;0.550602065997842
0;27;"andresha";27;0;100
10;0;"andress";10;100;0
0;41;"andressa";41;0;100
0;289;"andretta";289;0;100
33;0;"andretti";33;100;0
207;0;"andreu";207;100;0
408;0;"andreus";408;100;0
1263813;4854;"andrew";1268667;99.617393689597;0.382606310402966
12;0;"andrewjacob";12;100;0
129;0;"andrewjames";129;100;0
42;0;"andrewjohn";42;100;0
32;0;"andrewjoseph";32;100;0
10;0;"andrewmichael";10;100;0
499;0;"andrews";499;100;0
2186;100;"andrey";2286;95.6255468066492;4.37445319335083
0;1036;"andreya";1036;0;100
0;69;"andreyah";69;0;100
0;13;"andreyna";13;0;100
992;0;"andrez";992;100;0
111;5;"andri";116;95.6896551724138;4.31034482758621
32;8769;"andria";8801;0.363595046017498;99.6364049539825
0;15;"andriah";15;0;100
548;96;"andrian";644;85.0931677018634;14.9068322981366
0;1664;"andriana";1664;0;100
0;929;"andrianna";929;0;100
0;33;"andrianne";33;0;100
114;0;"andric";114;100;0
0;33;"andrica";33;0;100
453;0;"andrick";453;100;0
0;5;"andricka";5;0;100
13;0;"andrico";13;100;0
39;0;"andrie";39;100;0
0;95;"andriea";95;0;100
0;7;"andrieka";7;0;100
72;31;"andriel";103;69.9029126213592;30.0970873786408
0;51;"andrielle";51;0;100
0;6;"andriena";6;0;100
0;5;"andrienna";5;0;100
0;308;"andrienne";308;0;100
0;5;"andrietta";5;0;100
0;20;"andriette";20;0;100
0;6;"andrijana";6;0;100
630;0;"andrik";630;100;0
0;75;"andrika";75;0;100
0;649;"andrina";649;0;100
0;5;"andrine";5;0;100
210;0;"andris";210;100;0
114;0;"andrius";114;100;0
147;0;"andriy";147;100;0
42;0;"andro";42;100;0
0;790;"andromeda";790;0;100
65;0;"andron";65;100;0
0;5;"androniki";5;0;100
6;0;"andropolis";6;100;0
87;0;"andros";87;100;0
5;0;"androw";5;100;0
1123;0;"andru";1123;100;0
584;0;"andrue";584;100;0
123;0;"andrus";123;100;0
504;0;"andruw";504;100;0
51;0;"andrw";51;100;0
213;5;"andry";218;97.7064220183486;2.29357798165138
0;117;"andrya";117;0;100
335;0;"andrzej";335;100;0
9;0;"anduin";9;100;0
29;0;"andwele";29;100;0
86545;1008;"andy";87553;98.8486973604559;1.15130263954405
115;0;"andyn";115;100;0
0;277;"ane";277;0;100
0;62;"anea";62;0;100
0;17;"aneah";17;0;100
16;0;"aneas";16;100;0
0;6;"anease";6;0;100
0;41;"aneatra";41;0;100
0;630;"anecia";630;0;100
0;13;"aneda";13;0;100
0;105;"anedra";105;0;100
0;10;"anee";10;0;100
0;12;"aneea";12;0;100
0;10;"aneecia";10;0;100
13;0;"aneek";13;100;0
0;75;"aneeka";75;0;100
0;5;"aneeksha";5;0;100
20;0;"aneel";20;100;0
0;24;"aneela";24;0;100
20;0;"aneeq";20;100;0
0;6;"aneeqa";6;0;100
57;0;"anees";57;100;0
0;1402;"aneesa";1402;0;100
0;680;"aneesah";680;0;100
827;0;"aneesh";827;100;0
0;577;"aneesha";577;0;100
0;39;"aneesia";39;0;100
0;5;"aneeya";5;0;100
0;14;"aneeza";14;0;100
0;35;"anegla";35;0;100
0;16;"aneia";16;0;100
0;5;"aneicia";5;0;100
0;10;"aneida";10;0;100
0;10;"aneika";10;0;100
35;0;"aneil";35;100;0
0;24;"aneila";24;0;100
0;64;"aneira";64;0;100
0;121;"aneisa";121;0;100
0;589;"aneisha";589;0;100
0;31;"aneissa";31;0;100
0;221;"aneita";221;0;100
0;9;"aneitra";9;0;100
0;6;"aneiya";6;0;100
0;5;"aneiyah";5;0;100
0;311;"aneka";311;0;100
254;1765;"anel";2019;12.5804853888063;87.4195146111937
0;1379;"anela";1379;0;100
0;6;"anelah";6;0;100
0;43;"anele";43;0;100
0;5;"aneley";5;0;100
0;190;"aneli";190;0;100
0;150;"anelia";150;0;100
0;27;"anelie";27;0;100
0;139;"aneliese";139;0;100
0;137;"anelis";137;0;100
0;52;"anelisa";52;0;100
0;439;"anelise";439;0;100
0;97;"anelisse";97;0;100
0;200;"aneliz";200;0;100
0;47;"anell";47;0;100
0;275;"anella";275;0;100
0;125;"anelle";125;0;100
5;0;"anello";5;100;0
0;73;"anelly";73;0;100
0;284;"anely";284;0;100
0;39;"anelys";39;0;100
0;19;"anelyse";19;0;100
0;6;"anemone";6;0;100
10;7;"aner";17;58.8235294117647;41.1764705882353
0;50;"aneres";50;0;100
0;159;"aneri";159;0;100
0;5;"aneria";5;0;100
0;7;"aneris";7;0;100
108;0;"anes";108;100;0
0;442;"anesa";442;0;100
0;795;"anesha";795;0;100
0;377;"aneshia";377;0;100
0;456;"anesia";456;0;100
0;2528;"anessa";2528;0;100
0;11;"anessah";11;0;100
0;149;"anessia";149;0;100
5;5;"anesti";10;50;50
0;10;"anesty";10;0;100
0;95;"anet";95;0;100
0;838;"aneta";838;0;100
0;223;"aneth";223;0;100
0;99;"anetha";99;0;100
0;16;"anetia";16;0;100
0;423;"anetra";423;0;100
0;61;"anetria";61;0;100
0;144;"anett";144;0;100
0;564;"anetta";564;0;100
0;2552;"anette";2552;0;100
16;0;"aneudi";16;100;0
99;0;"aneudy";99;100;0
0;16;"aneva";16;0;100
0;41;"anevaeh";41;0;100
0;317;"anevay";317;0;100
0;199;"aneya";199;0;100
0;71;"aneyah";71;0;100
0;5;"aneyda";5;0;100
0;5;"aneysa";5;0;100
0;5;"aneysha";5;0;100
0;50;"anezka";50;0;100
0;40;"anfal";40;0;100
5;0;"anferne";5;100;0
1193;0;"anfernee";1193;100;0
5;0;"anferney";5;100;0
18;0;"anferny";18;100;0
0;11;"anfisa";11;0;100
23;0;"anfrenee";23;100;0
6;0;"ang";6;100;0
0;15;"anga";15;0;100
482;0;"angad";482;100;0
0;213;"angala";213;0;100
0;46;"angalee";46;0;100
0;75;"angalena";75;0;100
0;181;"angalina";181;0;100
0;19;"anganette";19;0;100
10;341;"ange";351;2.84900284900285;97.1509971509972
5;0;"angeal";5;100;0
0;159;"angee";159;0;100
221383;93883;"angel";315266;70.2210197103398;29.7789802896602
2136;661417;"angela";663553;0.321903450063522;99.6780965499365
0;5;"angelah";5;0;100
0;11;"angelamae";11;0;100
0;5;"angelamaria";5;0;100
0;148;"angelamarie";148;0;100
0;11;"angelann";11;0;100
0;10;"angelar";10;0;100
31;0;"angeldaniel";31;100;0
11;0;"angeldavid";11;100;0
95;0;"angeldejesus";95;100;0
0;1501;"angele";1501;0;100
0;1001;"angelea";1001;0;100
0;461;"angeleah";461;0;100
0;35;"angelean";35;0;100
0;18;"angeleana";18;0;100
0;5;"angeleca";5;0;100
0;1238;"angelee";1238;0;100
0;251;"angeleen";251;0;100
0;282;"angeleena";282;0;100
0;7;"angeleia";7;0;100
0;58;"angeleigh";58;0;100
0;3103;"angelena";3103;0;100
0;1890;"angelene";1890;0;100
0;6;"angelenia";6;0;100
0;46;"angeleque";46;0;100
65;3044;"angeles";3109;2.0907044065616;97.9092955934384
0;25;"angelese";25;0;100
0;13;"angeleta";13;0;100
0;22;"angelete";22;0;100
0;88;"angeletta";88;0;100
0;388;"angelette";388;0;100
261;0;"angelgabriel";261;100;0
0;1246;"angeli";1246;0;100
22;22122;"angelia";22144;0.0993497109826589;99.9006502890173
0;134;"angeliah";134;0;100
0;6;"angelian";6;0;100
0;6;"angeliana";6;0;100
0;3719;"angelic";3719;0;100
321;88672;"angelica";88993;0.360702527165058;99.6392974728349
0;7;"angelicamae";7;0;100
0;24;"angelicamaria";24;0;100
0;29;"angelicamarie";29;0;100
0;180;"angelice";180;0;100
0;443;"angelicia";443;0;100
0;5;"angelick";5;0;100
0;11;"angelicque";11;0;100
0;1825;"angelie";1825;0;100
0;12;"angeliese";12;0;100
0;131;"angeligue";131;0;100
0;198;"angelik";198;0;100
0;2661;"angelika";2661;0;100
0;5;"angelike";5;0;100
0;304;"angeliki";304;0;100
0;530;"angelin";530;0;100
111;115155;"angelina";115266;0.0962989953672375;99.9037010046328
0;31;"angelinah";31;0;100
0;16;"angelinamarie";16;0;100
10;34054;"angeline";34064;0.029356505401597;99.9706434945984
0;58;"angelinna";58;0;100
0;57;"angelinne";57;0;100
269;0;"angelino";269;100;0
0;11;"angeliq";11;0;100
0;5;"angeliqu";5;0;100
0;32;"angeliqua";32;0;100
6;27795;"angelique";27801;0.0215819574835438;99.9784180425165
35;443;"angelis";478;7.32217573221757;92.6778242677824
0;743;"angelisa";743;0;100
0;682;"angelise";682;0;100
0;6;"angelisha";6;0;100
0;70;"angelissa";70;0;100
0;177;"angelisse";177;0;100
37;11387;"angelita";11424;0.323879551820728;99.6761204481793
0;5;"angelite";5;0;100
0;5;"angelith";5;0;100
404;0;"angelito";404;100;0
0;5;"angeliya";5;0;100
0;146;"angeliyah";146;0;100
0;377;"angeliz";377;0;100
0;11;"angeliza";11;0;100
0;76;"angelize";76;0;100
41;0;"angeljesus";41;100;0
136;465;"angell";601;22.6289517470882;77.3710482529118
0;3494;"angella";3494;0;100
0;1863;"angelle";1863;0;100
0;29;"angellea";29;0;100
0;11;"angelleah";11;0;100
0;104;"angellee";104;0;100
0;5;"angelleigh";5;0;100
0;25;"angellena";25;0;100
0;334;"angelli";334;0;100
0;14;"angellia";14;0;100
0;396;"angellica";396;0;100
0;13;"angellie";13;0;100
0;325;"angellina";325;0;100
0;9;"angelline";9;0;100
0;6;"angellique";6;0;100
487;0;"angello";487;100;0
22;0;"angelluis";22;100;0
0;429;"angelly";429;0;100
0;17;"angellyn";17;0;100
0;5;"angellyna";5;0;100
0;65;"angellynn";65;0;100
10;0;"angelmanuel";10;100;0
0;222;"angelmarie";222;0;100
12;0;"angelmiguel";12;100;0
76109;850;"angelo";76959;98.8955157941242;1.10448420587586
230;0;"angelos";230;100;0
5;0;"angelou";5;100;0
14;0;"angelous";14;100;0
0;14;"angelque";14;0;100
6;0;"angelray";6;100;0
0;16;"angelrose";16;0;100
5;0;"angeluis";5;100;0
309;25;"angelus";334;92.5149700598802;7.48502994011976
0;1953;"angely";1953;0;100
0;26;"angelyca";26;0;100
0;7;"angelyce";7;0;100
0;17;"angelyka";17;0;100
0;2510;"angelyn";2510;0;100
0;554;"angelyna";554;0;100
0;214;"angelyne";214;0;100
0;607;"angelynn";607;0;100
0;7;"angelynna";7;0;100
0;26;"angelynne";26;0;100
0;168;"angelys";168;0;100
0;103;"angelyse";103;0;100
0;17;"angelyssa";17;0;100
0;12;"angelysse";12;0;100
0;34;"angenetta";34;0;100
0;388;"angenette";388;0;100
0;84;"angeni";84;0;100
0;5;"angenie";5;0;100
0;6;"angenique";6;0;100
0;10;"angenita";10;0;100
0;34;"anges";34;0;100
0;22;"anggie";22;0;100
0;5;"angharad";5;0;100
6;0;"anghel";6;100;0
0;538;"angi";538;0;100
0;22;"angia";22;0;100
131;60902;"angie";61033;0.214637982730654;99.7853620172693
0;23;"angiela";23;0;100
0;30;"angielina";30;0;100
0;5;"angil";5;0;100
0;613;"angila";613;0;100
0;44;"angilee";44;0;100
0;5;"angilina";5;0;100
0;18;"angilique";18;0;100
0;83;"anginette";83;0;100
0;6;"angiolina";6;0;100
0;511;"angla";511;0;100
125;1149;"angle";1274;9.8116169544741;90.1883830455259
0;1489;"anglea";1489;0;100
0;5;"anglee";5;0;100
0;17;"angleica";17;0;100
0;5;"anglene";5;0;100
11;0;"angleo";11;100;0
5;0;"angler";5;100;0
0;65;"angles";65;0;100
0;639;"anglia";639;0;100
0;40;"anglica";40;0;100
0;45;"anglie";45;0;100
0;46;"anglina";46;0;100
0;81;"angline";81;0;100
0;43;"anglique";43;0;100
15;0;"anglo";15;100;0
192;0;"anguel";192;100;0
0;53;"angula";53;0;100
5765;0;"angus";5765;100;0
0;382;"angy";382;0;100
0;6;"angye";6;0;100
0;10;"angyl";10;0;100
625;1399;"anh";2024;30.8794466403162;69.1205533596838
47;0;"anhad";47;100;0
0;48;"anhar";48;0;100
0;71;"anhelica";71;0;100
0;135;"anhthu";135;0;100
16;0;"anhtony";16;100;0
5;0;"anhtuan";5;100;0
12;0;"anhuar";12;100;0
5;2525;"ani";2530;0.197628458498024;99.802371541502
0;2651;"ania";2651;0;100
0;2674;"aniah";2674;0;100
0;5;"aniaha";5;0;100
176;24;"anias";200;88;12
0;313;"aniaya";313;0;100
0;150;"aniayah";150;0;100
3595;22;"anibal";3617;99.3917611280066;0.608238871993365
0;6;"anibella";6;0;100
0;7;"anibelle";7;0;100
0;1003;"anica";1003;0;100
0;928;"anice";928;0;100
0;6;"aniceta";6;0;100
481;0;"aniceto";481;100;0
0;578;"anicia";578;0;100
0;82;"anicka";82;0;100
0;92;"anida";92;0;100
0;198;"anie";198;0;100
0;34;"aniece";34;0;100
0;32;"aniecia";32;0;100
320;0;"aniel";320;100;0
0;805;"aniela";805;0;100
0;21;"anielka";21;0;100
0;133;"aniella";133;0;100
0;55;"anielle";55;0;100
550;0;"aniello";550;100;0
0;85;"aniesa";85;0;100
0;121;"aniesha";121;0;100
0;50;"aniessa";50;0;100
0;6;"anieta";6;0;100
0;5;"anietra";5;0;100
0;78;"anieya";78;0;100
0;23;"anieyah";23;0;100
0;5;"aniha";5;0;100
0;89;"anihya";89;0;100
0;22;"aniiya";22;0;100
0;33;"aniiyah";33;0;100
0;5;"anij";5;0;100
0;324;"anija";324;0;100
0;5;"anijae";5;0;100
0;1227;"anijah";1227;0;100
0;54;"anijha";54;0;100
0;5;"anijia";5;0;100
243;17;"anik";260;93.4615384615385;6.53846153846154
0;13567;"anika";13567;0;100
0;134;"anikah";134;0;100
19;0;"anikait";19;100;0
10;0;"anikan";10;100;0
0;20;"anike";20;0;100
85;0;"aniken";85;100;0
287;0;"aniket";287;100;0
201;0;"aniketh";201;100;0
10;0;"aniki";10;100;0
0;5;"anikia";5;0;100
77;0;"anikin";77;100;0
0;244;"anikka";244;0;100
0;93;"aniko";93;0;100
8;0;"anikyn";8;100;0
1133;0;"anil";1133;100;0
0;416;"anila";416;0;100
0;317;"anilah";317;0;100
0;38;"anilu";38;0;100
0;16;"anilya";16;0;100
0;16;"anilyah";16;0;100
0;5;"anilyn";5;0;100
0;5;"anime";5;0;100
17;0;"animesh";17;100;0
0;497;"anina";497;0;100
0;8;"anindita";8;0;100
6;0;"aniq";6;100;0
0;89;"aniqa";89;0;100
0;102;"aniqua";102;0;100
0;299;"anique";299;0;100
27;0;"anir";27;100;0
0;84;"anira";84;0;100
0;26;"anirah";26;0;100
5;0;"anirud";5;100;0
61;0;"aniruddh";61;100;0
26;0;"aniruddha";26;100;0
1263;0;"anirudh";1263;100;0
21;0;"anirvin";21;100;0
264;65;"anis";329;80.2431610942249;19.7568389057751
0;4802;"anisa";4802;0;100
0;723;"anisah";723;0;100
0;1171;"anise";1171;0;100
27;0;"aniseto";27;100;0
0;5;"anisette";5;0;100
2792;0;"anish";2792;100;0
0;4175;"anisha";4175;0;100
0;38;"anishia";38;0;100
0;255;"anishka";255;0;100
0;212;"anisia";212;0;100
6;0;"anisjon";6;100;0
0;5;"anisley";5;0;100
5;11765;"anissa";11770;0.0424808836023789;99.9575191163976
0;29;"anissah";29;0;100
0;5;"anisse";5;0;100
0;281;"anissia";281;0;100
0;30;"anistasia";30;0;100
0;109;"anisten";109;0;100
0;7;"anistin";7;0;100
19;1801;"aniston";1820;1.04395604395604;98.956043956044
0;42;"anisty";42;0;100
0;697;"anistyn";697;0;100
0;23;"anistynn";23;0;100
684;212092;"anita";212776;0.321464826860172;99.6785351731398
0;10;"anite";10;0;100
0;123;"anitha";123;0;100
0;6;"anitia";6;0;100
0;4379;"anitra";4379;0;100
0;5;"anitrea";5;0;100
0;112;"anitria";112;0;100
0;11;"anitrice";11;0;100
0;90;"anitta";90;0;100
0;31;"anitza";31;0;100
16;0;"aniv";16;100;0
0;6;"aniva";6;0;100
278;0;"anival";278;100;0
0;63;"anivea";63;0;100
0;10;"anivia";10;0;100
0;15432;"aniya";15432;0;100
5;22788;"aniyah";22793;0.0219365594700127;99.97806344053
0;10;"aniyaha";10;0;100
0;5;"aniyahlee";5;0;100
0;17;"aniyan";17;0;100
0;5;"aniye";5;0;100
0;222;"aniyha";222;0;100
0;82;"aniyia";82;0;100
0;65;"aniyiah";65;0;100
0;11;"aniyja";11;0;100
0;24;"aniyjah";24;0;100
0;444;"aniyla";444;0;100
0;469;"aniylah";469;0;100
0;5;"aniysa";5;0;100
0;18;"aniyyah";18;0;100
0;128;"aniza";128;0;100
0;2340;"anja";2340;0;100
0;6;"anjae";6;0;100
0;51;"anjail";51;0;100
0;154;"anjalee";154;0;100
0;6;"anjalena";6;0;100
0;5060;"anjali";5060;0;100
0;39;"anjalie";39;0;100
0;5;"anjalika";5;0;100
0;59;"anjalina";59;0;100
0;5;"anjaliyah";5;0;100
0;7;"anjaly";7;0;100
24;0;"anjan";24;100;0
0;480;"anjana";480;0;100
0;125;"anjanae";125;0;100
0;9;"anjanet";9;0;100
0;5;"anjanett";5;0;100
0;36;"anjanetta";36;0;100
0;2556;"anjanette";2556;0;100
0;186;"anjani";186;0;100
0;6;"anjanie";6;0;100
0;13;"anjanique";13;0;100
0;72;"anjannette";72;0;100
41;0;"anjay";41;100;0
0;389;"anjeanette";389;0;100
1038;381;"anjel";1419;73.1501057082452;26.8498942917548
0;550;"anjela";550;0;100
0;23;"anjelah";23;0;100
0;78;"anjeli";78;0;100
0;19;"anjelia";19;0;100
0;4232;"anjelica";4232;0;100
0;24;"anjelicia";24;0;100
0;7;"anjeliett";7;0;100
0;345;"anjelika";345;0;100
0;591;"anjelina";591;0;100
0;242;"anjelique";242;0;100
0;66;"anjelita";66;0;100
0;44;"anjellica";44;0;100
132;0;"anjelo";132;100;0
0;15;"anjely";15;0;100
0;5;"anjelyka";5;0;100
0;5;"anjelyn";5;0;100
0;6;"anjelyna";6;0;100
0;82;"anjenette";82;0;100
0;5;"anjennette";5;0;100
0;57;"anji";57;0;100
0;36;"anjie";36;0;100
0;11;"anjli";11;0;100
0;12;"anjola";12;0;100
11;179;"anjolaoluwa";190;5.78947368421053;94.2105263157895
0;12;"anjolee";12;0;100
0;5;"anjolena";5;0;100
0;141;"anjoli";141;0;100
0;394;"anjolie";394;0;100
0;156;"anjolina";156;0;100
0;5;"anjolique";5;0;100
0;18;"anjonette";18;0;100
5;0;"anjrue";5;100;0
0;186;"anju";186;0;100
33;0;"anjuan";33;100;0
0;534;"anjuli";534;0;100
0;53;"anjulie";53;0;100
0;28;"anjum";28;0;100
0;7;"anka";7;0;100
0;5;"anke";5;0;100
23;0;"anker";23;100;0
779;0;"ankit";779;100;0
0;498;"ankita";498;0;100
89;0;"ankith";89;100;0
0;59;"ankitha";59;0;100
6;0;"ankoma";6;100;0
5;0;"ankoor";5;100;0
662;0;"ankur";662;100;0
158;0;"ankush";158;100;0
0;6;"anleigh";6;0;100
0;5;"anley";5;0;100
0;5;"anlin";5;0;100
0;5;"anllely";5;0;100
0;10;"anlly";10;0;100
0;5;"anly";5;0;100
14;0;"anmar";14;100;0
0;385;"anmarie";385;0;100
7;0;"anmay";7;100;0
386;288;"anmol";674;57.2700296735905;42.7299703264095
1365;461302;"ann";462667;0.295028605887172;99.7049713941128
2371;790462;"anna";792833;0.299054151378664;99.7009458486213
0;25;"annaalicia";25;0;100
0;12935;"annabel";12935;0;100
0;11;"annabela";11;0;100
0;12;"annabele";12;0;100
0;6198;"annabell";6198;0;100
0;12011;"annabella";12011;0;100
0;5;"annabellah";5;0;100
10;54350;"annabelle";54360;0.0183958793230316;99.981604120677
0;45;"annabellee";45;0;100
0;10;"annabellelee";10;0;100
0;1715;"annabeth";1715;0;100
0;15;"annacarolina";15;0;100
0;18;"annacatherine";18;0;100
0;6;"annachristina";6;0;100
0;344;"annaclaire";344;0;100
0;56;"annaclara";56;0;100
0;12;"annadell";12;0;100
0;20;"annaelise";20;0;100
0;26;"annaelizabeth";26;0;100
0;58;"annaelle";58;0;100
0;30;"annagail";30;0;100
0;5;"annagene";5;0;100
0;589;"annagrace";589;0;100
0;1727;"annah";1727;0;100
0;5;"annahbella";5;0;100
0;290;"annahi";290;0;100
0;24;"annahy";24;0;100
0;166;"annai";166;0;100
0;6;"annaie";6;0;100
0;5;"annaira";5;0;100
0;297;"annais";297;0;100
0;11;"annaise";11;0;100
0;41;"annajane";41;0;100
0;27;"annajean";27;0;100
0;29;"annajo";29;0;100
0;5;"annajoy";5;0;100
0;60;"annajulia";60;0;100
0;546;"annaka";546;0;100
0;45;"annakaren";45;0;100
0;245;"annakate";245;0;100
0;49;"annakatherine";49;0;100
0;5;"annakathryn";5;0;100
0;29;"annakay";29;0;100
0;5;"annakiya";5;0;100
0;76;"annalaura";76;0;100
0;49;"annalaya";49;0;100
0;14;"annalayah";14;0;100
0;543;"annalea";543;0;100
0;666;"annaleah";666;0;100
0;10;"annalease";10;0;100
0;22;"annalecia";22;0;100
0;5877;"annalee";5877;0;100
0;21;"annaleece";21;0;100
0;111;"annaleese";111;0;100
0;79;"annalei";79;0;100
0;37;"annaleia";37;0;100
0;1743;"annaleigh";1743;0;100
0;100;"annaleigha";100;0;100
0;5;"annaleisa";5;0;100
0;378;"annaleise";378;0;100
0;212;"annalena";212;0;100
0;17;"annalene";17;0;100
0;335;"annalese";335;0;100
0;15;"annalesia";15;0;100
0;42;"annaley";42;0;100
0;10;"annaleya";10;0;100
0;358;"annali";358;0;100
0;690;"annalia";690;0;100
0;84;"annaliah";84;0;100
0;15;"annalice";15;0;100
0;688;"annalicia";688;0;100
0;727;"annalie";727;0;100
0;10;"annaliece";10;0;100
0;87;"annaliesa";87;0;100
0;3938;"annaliese";3938;0;100
0;13;"annaliesse";13;0;100
0;5;"annaliisa";5;0;100
0;20;"annalin";20;0;100
0;183;"annalina";183;0;100
0;5;"annaline";5;0;100
0;164;"annalis";164;0;100
0;5262;"annalisa";5262;0;100
0;10487;"annalise";10487;0;100
0;20;"annalisha";20;0;100
0;133;"annalisia";133;0;100
0;215;"annalissa";215;0;100
0;192;"annalisse";192;0;100
0;5;"annaliya";5;0;100
0;173;"annaliyah";173;0;100
0;121;"annaliz";121;0;100
0;220;"annaliza";220;0;100
0;41;"annalize";41;0;100
0;53;"annalou";53;0;100
0;22;"annalouise";22;0;100
0;96;"annalucia";96;0;100
0;5;"annaluisa";5;0;100
0;16;"annaluiza";16;0;100
0;410;"annaly";410;0;100
0;25;"annalya";25;0;100
0;136;"annalyce";136;0;100
0;86;"annalycia";86;0;100
0;929;"annalyn";929;0;100
0;5;"annalyne";5;0;100
0;977;"annalynn";977;0;100
0;135;"annalynne";135;0;100
0;18;"annalys";18;0;100
0;186;"annalysa";186;0;100
0;1333;"annalyse";1333;0;100
0;149;"annalysia";149;0;100
0;5;"annalyss";5;0;100
0;270;"annalyssa";270;0;100
0;83;"annalysse";83;0;100
0;5;"annalyssia";5;0;100
0;21;"annam";21;0;100
0;3443;"annamae";3443;0;100
0;6;"annamari";6;0;100
0;3524;"annamaria";3524;0;100
0;11334;"annamarie";11334;0;100
0;293;"annamary";293;0;100
0;723;"annamay";723;0;100
0;5;"annamolly";5;0;100
26;0;"annan";26;100;0
0;25;"annanicole";25;0;100
0;5;"annanya";5;0;100
0;6;"annapaula";6;0;100
0;11;"annapurna";11;0;100
0;59;"annarae";59;0;100
0;23;"annarosa";23;0;100
0;564;"annarose";564;0;100
0;10;"annaruth";10;0;100
34;22;"annas";56;60.7142857142857;39.2857142857143
0;5;"annasha";5;0;100
0;18;"annasia";18;0;100
0;121;"annasofia";121;0;100
0;421;"annasophia";421;0;100
0;456;"annastacia";456;0;100
0;10;"annastashia";10;0;100
0;1639;"annastasia";1639;0;100
0;5;"annastassia";5;0;100
0;55;"annastazia";55;0;100
0;26;"annastin";26;0;100
0;141;"annaston";141;0;100
0;151;"annastyn";151;0;100
0;30;"annavictoria";30;0;100
0;57;"annay";57;0;100
0;255;"annaya";255;0;100
0;62;"annayah";62;0;100
0;11;"annayeli";11;0;100
0;20;"annazette";20;0;100
0;97;"anndee";97;0;100
0;6;"anndi";6;0;100
0;623;"anndrea";623;0;100
0;35;"anndria";35;0;100
22;0;"anndy";22;100;0
829;314230;"anne";315059;0.263125319384623;99.7368746806154
0;5;"annea";5;0;100
0;5;"annease";5;0;100
0;142;"annebelle";142;0;100
0;26;"annecia";26;0;100
0;17;"annecy";17;0;100
0;16;"annee";16;0;100
0;10;"anneelise";10;0;100
0;15;"anneelizabeth";15;0;100
0;6;"anneice";6;0;100
0;20;"anneisha";20;0;100
0;819;"anneka";819;0;100
0;906;"anneke";906;0;100
0;522;"annel";522;0;100
0;7;"annelee";7;0;100
0;40;"anneleise";40;0;100
0;322;"anneli";322;0;100
0;178;"annelie";178;0;100
0;162;"annelies";162;0;100
0;11;"anneliesa";11;0;100
0;4746;"anneliese";4746;0;100
0;14;"anneliesse";14;0;100
0;25;"annelis";25;0;100
0;218;"annelisa";218;0;100
0;4957;"annelise";4957;0;100
0;31;"annelisse";31;0;100
0;20;"anneliz";20;0;100
0;15;"annelizabeth";15;0;100
0;653;"annell";653;0;100
0;476;"annella";476;0;100
0;1022;"annelle";1022;0;100
0;10;"annelouise";10;0;100
0;53;"annely";53;0;100
0;5;"annelyn";5;0;100
0;5;"annelys";5;0;100
0;302;"annelyse";302;0;100
0;5;"annemargaret";5;0;100
0;14;"annemari";14;0;100
0;11764;"annemarie";11764;0;100
0;5;"annemary";5;0;100
12;864;"anner";876;1.36986301369863;98.6301369863014
0;39;"annesa";39;0;100
0;5;"annese";5;0;100
0;72;"annesha";72;0;100
0;5;"anneshia";5;0;100
0;21;"annesia";21;0;100
0;29;"annesley";29;0;100
0;40;"annesophie";40;0;100
0;624;"annessa";624;0;100
0;11;"annessia";11;0;100
0;230;"annet";230;0;100
0;60;"anneta";60;0;100
0;96;"annete";96;0;100
0;159;"anneth";159;0;100
0;5;"annetha";5;0;100
0;33;"annetra";33;0;100
0;1112;"annett";1112;0;100
0;8396;"annetta";8396;0;100
499;166477;"annette";166976;0.298845343043312;99.7011546569567
0;42;"annettee";42;0;100
0;6;"annettia";6;0;100
0;21;"annettie";21;0;100
0;9;"annexie";9;0;100
0;27;"anney";27;0;100
0;51;"anngela";51;0;100
0;11;"anngelica";11;0;100
0;6;"anngelina";6;0;100
0;6;"anngie";6;0;100
0;493;"anni";493;0;100
0;521;"annia";521;0;100
0;202;"anniah";202;0;100
12;0;"annias";12;100;0
5;0;"annibale";5;100;0
0;12;"annibella";12;0;100
0;79;"annibelle";79;0;100
0;591;"annica";591;0;100
0;1727;"annice";1727;0;100
0;6;"annicia";6;0;100
0;168;"annick";168;0;100
0;46;"annicka";46;0;100
1754;308103;"annie";309857;0.566067573106304;99.4339324268937
0;155;"anniebell";155;0;100
0;73;"anniebelle";73;0;100
0;69;"anniece";69;0;100
0;11;"annielaurie";11;0;100
0;71;"annielee";71;0;100
0;5;"annielou";5;0;100
0;278;"anniemae";278;0;100
0;11;"anniemarie";11;0;100
0;10;"annieruth";10;0;100
0;5;"annies";5;0;100
0;7;"anniesha";7;0;100
0;16651;"annika";16651;0;100
0;101;"annikah";101;0;100
0;40;"annikka";40;0;100
0;7;"annil";7;0;100
0;31;"annilee";31;0;100
0;7;"annily";7;0;100
0;6;"annilyn";6;0;100
0;121;"annina";121;0;100
0;5;"anniqua";5;0;100
0;40;"annique";40;0;100
7;2621;"annis";2628;0.266362252663623;99.7336377473364
0;646;"annisa";646;0;100
0;231;"annise";231;0;100
0;169;"annisha";169;0;100
0;56;"annison";56;0;100
0;1150;"annissa";1150;0;100
0;27;"annissia";27;0;100
0;67;"annisten";67;0;100
0;6;"annistin";6;0;100
0;2042;"anniston";2042;0;100
0;565;"annistyn";565;0;100
0;1374;"annita";1374;0;100
0;49;"annitra";49;0;100
0;81;"annitta";81;0;100
0;6;"annitte";6;0;100
0;212;"anniya";212;0;100
0;637;"anniyah";637;0;100
0;5;"annjane";5;0;100
0;148;"annjanette";148;0;100
0;91;"annjeanette";91;0;100
0;5;"annjelica";5;0;100
0;80;"annlee";80;0;100
0;52;"annleigh";52;0;100
0;11;"annley";11;0;100
0;62;"annlouise";62;0;100
0;9;"annlynn";9;0;100
0;189;"annmargaret";189;0;100
0;5;"annmari";5;0;100
0;11;"annmaria";11;0;100
0;18343;"annmarie";18343;0;100
0;12;"annmary";12;0;100
5;0;"annon";5;100;0
0;343;"annora";343;0;100
0;33;"annorah";33;0;100
0;336;"annslee";336;0;100
0;104;"annsleigh";104;0;100
0;659;"annsley";659;0;100
0;5;"annslie";5;0;100
0;93;"anntionette";93;0;100
0;376;"anntoinette";376;0;100
0;92;"anntonette";92;0;100
0;21;"annum";21;0;100
0;5;"annunciata";5;0;100
0;25;"annunziata";25;0;100
5;0;"annunzio";5;100;0
0;1093;"anny";1093;0;100
0;168;"annya";168;0;100
0;24;"annyah";24;0;100
0;98;"annye";98;0;100
0;28;"annyka";28;0;100
0;10;"annysa";10;0;100
0;54;"annyssa";54;0;100
0;20;"annyston";20;0;100
0;13;"annzlee";13;0;100
0;5;"annzley";5;0;100
0;67;"anokhi";67;0;100
5;0;"anoki";5;100;0
0;191;"anola";191;0;100
5;0;"anon";5;100;0
0;497;"anona";497;0;100
0;45;"anonda";45;0;100
5;0;"anooj";5;100;0
200;30;"anoop";230;86.9565217391304;13.0434782608696
0;30;"anoosha";30;0;100
0;435;"anora";435;0;100
0;97;"anorah";97;0;100
0;10;"anorea";10;0;100
0;8;"anori";8;0;100
0;16;"anosha";16;0;100
36;0;"anothny";36;100;0
344;0;"anothony";344;100;0
180;0;"anothy";180;100;0
0;284;"anouk";284;0;100
0;21;"anoush";21;0;100
0;20;"anousha";20;0;100
0;565;"anoushka";565;0;100
5;0;"anousone";5;100;0
0;10;"anova";10;0;100
0;7;"anqi";7;0;100
238;0;"anquan";238;100;0
0;90;"anquanette";90;0;100
5;0;"anquavious";5;100;0
0;26;"anquenette";26;0;100
0;5;"anquetta";5;0;100
0;43;"anquette";43;0;100
0;5;"anquinetta";5;0;100
0;165;"anquinette";165;0;100
0;23;"anqunette";23;0;100
5;0;"anre";5;100;0
0;12;"anrea";12;0;100
21;0;"anrew";21;100;0
5;0;"anri";5;100;0
0;21;"ansa";21;0;100
0;5;"ansal";5;0;100
71;0;"ansar";71;100;0
5;0;"ansara";5;100;0
3296;10;"ansel";3306;99.697519661222;0.302480338777979
6;0;"ansell";6;100;0
232;0;"anselm";232;100;0
0;189;"anselma";189;0;100
5;0;"anselmi";5;100;0
2624;0;"anselmo";2624;100;0
181;0;"ansen";181;100;0
1408;0;"ansh";1408;100;0
0;10;"ansha";10;0;100
10;0;"anshel";10;100;0
0;109;"anshi";109;0;100
0;265;"anshika";265;0;100
0;11;"anshita";11;0;100
10;112;"anshu";122;8.19672131147541;91.8032786885246
369;0;"anshul";369;100;0
49;0;"anshuman";49;100;0
5;0;"anshveer";5;100;0
25;0;"ansil";25;100;0
0;25;"anslea";25;0;100
0;1000;"anslee";1000;0;100
0;34;"anslei";34;0;100
0;1143;"ansleigh";1143;0;100
10;0;"anslem";10;100;0
290;9575;"ansley";9865;2.93968575772935;97.0603142422706
0;5;"ansli";5;0;100
0;220;"anslie";220;0;100
6174;5;"anson";6179;99.9190807574041;0.0809192425958893
0;14;"ansonia";14;0;100
5;0;"ansony";5;100;0
10;0;"ansu";10;100;0
10;0;"ansumana";10;100;0
0;49;"anta";49;0;100
70;0;"antaeus";70;100;0
0;10;"antaja";10;0;100
5;0;"antajuan";5;100;0
8;0;"antal";8;100;0
0;16;"antalya";16;0;100
0;36;"antanae";36;0;100
0;74;"antanasia";74;0;100
0;17;"antanay";17;0;100
0;5;"antanea";5;0;100
0;15;"antaneisha";15;0;100
0;45;"antanesha";45;0;100
0;69;"antanette";69;0;100
0;343;"antania";343;0;100
0;6;"antanika";6;0;100
0;36;"antanique";36;0;100
0;102;"antanisha";102;0;100
0;77;"antaniya";77;0;100
0;35;"antaniyah";35;0;100
208;0;"antar";208;100;0
0;169;"antara";169;0;100
12;0;"antares";12;100;0
161;0;"antario";161;100;0
10;0;"antarious";10;100;0
28;0;"antarius";28;100;0
0;6;"antashia";6;0;100
0;382;"antasia";382;0;100
15;0;"antaun";15;100;0
0;182;"antavia";182;0;100
132;0;"antavion";132;100;0
516;0;"antavious";516;100;0
15;0;"antavis";15;100;0
227;0;"antavius";227;100;0
198;0;"antawan";198;100;0
592;0;"antawn";592;100;0
28;0;"antawon";28;100;0
0;5;"antaysia";5;0;100
210;0;"ante";210;100;0
0;5;"antea";5;0;100
8;0;"anteaus";8;100;0
50;0;"antelmo";50;100;0
0;6;"antenette";6;0;100
5;0;"anteo";5;100;0
0;54;"anteria";54;0;100
86;0;"anterio";86;100;0
6;0;"anterion";6;100;0
7;0;"anterious";7;100;0
11;0;"anterius";11;100;0
66;0;"antero";66;100;0
0;10;"anterria";10;0;100
111;0;"anterrio";111;100;0
15;0;"anterrion";15;100;0
6;0;"anterrius";6;100;0
0;5;"antesha";5;0;100
0;310;"antha";310;0;100
5;0;"anthani";5;100;0
536;0;"anthany";536;100;0
0;731;"anthea";731;0;100
0;5;"antheia";5;0;100
46;6;"anthem";52;88.4615384615385;11.5384615384615
5;0;"antheny";5;100;0
0;36;"anthia";36;0;100
6;0;"anthnoy";6;100;0
13;0;"anthny";13;100;0
5;0;"anthoine";5;100;0
395;0;"anthon";395;100;0
130;0;"anthone";130;100;0
208;0;"anthonee";208;100;0
0;69;"anthonella";69;0;100
0;304;"anthonette";304;0;100
2738;0;"anthoney";2738;100;0
858;0;"anthoni";858;100;0
0;180;"anthonia";180;0;100
728;0;"anthonie";728;100;0
426;0;"anthonio";426;100;0
0;16;"anthonique";16;0;100
85;0;"anthonny";85;100;0
1419761;7050;"anthony";1426811;99.5058911096144;0.494108890385622
144;0;"anthonyjames";144;100;0
36;0;"anthonyjohn";36;100;0
44;0;"anthonyjoseph";44;100;0
14;0;"anthonyjr";14;100;0
79;0;"anthonymichael";79;100;0
5;0;"anthory";5;100;0
0;10;"anthoula";10;0;100
31;0;"anthoy";31;100;0
22;0;"anthuan";22;100;0
0;179;"antia";179;0;100
0;38;"antiana";38;0;100
0;5;"antianna";5;0;100
0;327;"antigone";327;0;100
16;0;"antimo";16;100;0
0;32;"antina";32;0;100
0;75;"antinette";75;0;100
82;0;"antinio";82;100;0
0;32;"antinique";32;0;100
0;5;"antinisha";5;0;100
126;0;"antino";126;100;0
190;0;"antion";190;100;0
18;5;"antiona";23;78.2608695652174;21.7391304347826
4675;49;"antione";4724;98.9627434377646;1.03725656223539
0;16;"antionett";16;0;100
0;88;"antionetta";88;0;100
0;9081;"antionette";9081;0;100
381;0;"antionio";381;100;0
0;10;"antionna";10;0;100
222;0;"antionne";222;100;0
339;0;"antiono";339;100;0
0;29;"antiqua";29;0;100
0;46;"antisha";46;0;100
58;0;"antiwan";58;100;0
0;16;"antje";16;0;100
819;0;"antjuan";819;100;0
55;0;"antoan";55;100;0
29;0;"antohny";29;100;0
532;0;"antoin";532;100;0
0;6;"antoinae";6;0;100
25967;364;"antoine";26331;98.617599027762;1.38240097223805
0;5;"antoinese";5;0;100
0;5;"antoinesha";5;0;100
0;8;"antoinet";8;0;100
0;173;"antoinett";173;0;100
0;711;"antoinetta";711;0;100
68;76826;"antoinette";76894;0.0884334278357219;99.9115665721643
0;6;"antoiniece";6;0;100
37;0;"antoinio";37;100;0
0;25;"antoinique";25;0;100
384;0;"antoinne";384;100;0
0;22;"antoinnette";22;0;100
505;0;"antoino";505;100;0
5;0;"antojuan";5;100;0
129;0;"antolin";129;100;0
0;5;"antolina";5;0;100
21253;21;"anton";21274;99.9012879571308;0.09871204286923
0;5;"antona";5;0;100
0;89;"antonae";89;0;100
0;17;"antonasia";17;0;100
0;10;"antonay";10;0;100
5654;10;"antone";5664;99.8234463276836;0.176553672316384
0;71;"antonea";71;0;100
0;6;"antoneisha";6;0;100
0;82;"antonela";82;0;100
0;3532;"antonella";3532;0;100
15;0;"antonello";15;100;0
64;0;"antoneo";64;100;0
0;5;"antonese";5;0;100
0;52;"antonesha";52;0;100
0;6;"antoneshia";6;0;100
0;16;"antonett";16;0;100
0;1413;"antonetta";1413;0;100
0;7597;"antonette";7597;0;100
63;0;"antoney";63;100;0
5;0;"antoneyo";5;100;0
1869;5;"antoni";1874;99.7331910352188;0.266808964781217
2617;31546;"antonia";34163;7.66033427977637;92.3396657202236
0;10;"antoniah";10;0;100
5;0;"antonial";5;100;0
0;5;"antonica";5;0;100
748;16;"antonie";764;97.9057591623037;2.09424083769634
10;0;"antonieo";10;100;0
0;166;"antonieta";166;0;100
0;1215;"antonietta";1215;0;100
0;797;"antoniette";797;0;100
71;0;"antonin";71;100;0
0;2565;"antonina";2565;0;100
53;0;"antonine";53;100;0
0;60;"antoninette";60;0;100
1877;0;"antonino";1877;100;0
242346;1965;"antonio";244311;99.1956972874737;0.804302712526247
55;0;"antoniodejesus";55;100;0
6;0;"antonion";6;100;0
767;0;"antonios";767;100;0
281;0;"antonious";281;100;0
0;359;"antonique";359;0;100
78;0;"antonis";78;100;0
0;26;"antonise";26;0;100
0;268;"antonisha";268;0;100
0;22;"antonita";22;0;100
0;16;"antonitte";16;0;100
549;0;"antonius";549;100;0
0;52;"antoniya";52;0;100
0;13;"antoniyah";13;0;100
5;0;"antoniyo";5;100;0
11;0;"antonne";11;100;0
0;18;"antonnette";18;0;100
0;5;"antonnia";5;0;100
42;0;"antonnio";42;100;0
5;0;"antonny";5;100;0
9846;0;"antony";9846;100;0
0;209;"antonya";209;0;100
11;0;"antonyio";11;100;0
645;0;"antonyo";645;100;0
0;196;"antoria";196;0;100
24;0;"antorio";24;100;0
6;0;"antorion";6;100;0
0;5;"antorria";5;0;100
5;0;"antowain";5;100;0
119;0;"antowan";119;100;0
10;0;"antowine";10;100;0
11;0;"antown";11;100;0
5;0;"antowne";5;100;0
0;35;"antoya";35;0;100
0;38;"antranette";38;0;100
5;0;"antravion";5;100;0
45;0;"antravious";45;100;0
5;0;"antre";5;100;0
0;5;"antrea";5;0;100
10;0;"antrel";10;100;0
349;0;"antrell";349;100;0
0;6;"antrese";6;0;100
5;0;"antrez";5;100;0
0;8;"antria";8;0;100
0;55;"antrice";55;0;100
0;10;"antrina";10;0;100
5;0;"antrione";5;100;0
12;0;"antroine";12;100;0
1216;0;"antron";1216;100;0
165;0;"antrone";165;100;0
0;25;"antronette";25;0;100
5;0;"antroy";5;100;0
5;0;"anttwan";5;100;0
1265;0;"antuan";1265;100;0
131;0;"antuane";131;100;0
5;0;"antuwan";5;100;0
7;0;"antvan";7;100;0
30;0;"antwaan";30;100;0
2272;0;"antwain";2272;100;0
328;0;"antwaine";328;100;0
11837;113;"antwan";11950;99.0543933054393;0.945606694560669
7;5;"antwana";12;58.3333333333333;41.6666666666667
0;10;"antwanae";10;0;100
24;0;"antwand";24;100;0
861;0;"antwane";861;100;0
0;10;"antwanesha";10;0;100
0;5;"antwanett";5;0;100
0;601;"antwanette";601;0;100
0;45;"antwanique";45;0;100
0;17;"antwanisha";17;0;100
563;0;"antwann";563;100;0
12;0;"antwanne";12;100;0
1403;5;"antwaun";1408;99.6448863636364;0.355113636363636
6;0;"antwaune";6;100;0
11;0;"antwayne";11;100;0
70;0;"antwian";70;100;0
5;0;"antwin";5;100;0
494;0;"antwine";494;100;0
0;13;"antwinette";13;0;100
130;0;"antwion";130;100;0
128;0;"antwione";128;100;0
312;0;"antwoin";312;100;0
1022;0;"antwoine";1022;100;0
0;11;"antwoinette";11;0;100
6044;5;"antwon";6049;99.9173417093735;0.0826582906265498
2000;0;"antwone";2000;100;0
0;114;"antwonette";114;0;100
5;0;"antwonn";5;100;0
37;0;"antwonne";37;100;0
763;0;"antwuan";763;100;0
40;0;"antwun";40;100;0
64;0;"antwyne";64;100;0
11;0;"antyon";11;100;0
5;0;"antyone";5;100;0
10;218;"anu";228;4.3859649122807;95.6140350877193
217;0;"anuar";217;100;0
10;0;"anubhav";10;100;0
72;0;"anubis";72;100;0
5;0;"anudeep";5;100;0
19;0;"anuel";19;100;0
0;346;"anuhea";346;0;100
0;35;"anuhya";35;0;100
877;0;"anuj";877;100;0
0;121;"anuja";121;0;100
0;22;"anujin";22;0;100
0;534;"anum";534;0;100
5;17;"anuoluwa";22;22.7272727272727;77.2727272727273
0;50;"anuoluwapo";50;0;100
197;0;"anup";197;100;0
16;0;"anupam";16;100;0
0;176;"anupama";176;0;100
0;5;"anupriya";5;0;100
57;0;"anuraag";57;100;0
0;127;"anuradha";127;0;100
234;0;"anurag";234;100;0
0;41;"anureet";41;0;100
73;0;"anush";73;100;0
0;1052;"anusha";1052;0;100
0;1506;"anushka";1506;0;100
0;108;"anushree";108;0;100
0;82;"anushri";82;0;100
0;18;"anuska";18;0;100
0;5;"anusri";5;0;100
0;39;"anuva";39;0;100
84;0;"anvay";84;100;0
0;17;"anvesha";17;0;100
0;681;"anvi";681;0;100
5;0;"anvik";5;100;0
0;228;"anvika";228;0;100
27;0;"anvit";27;100;0
0;370;"anvita";370;0;100
87;0;"anvith";87;100;0
0;369;"anvitha";369;0;100
0;5;"anwaar";5;0;100
5;0;"anwan";5;100;0
2422;96;"anwar";2518;96.1874503574265;3.81254964257347
0;146;"anwen";146;0;100
0;41;"anwesha";41;0;100
0;234;"anwita";234;0;100
0;82;"anwitha";82;0;100
5;0;"anwon";5;100;0
0;90;"anwyn";90;0;100
0;621;"any";621;0;100
0;15217;"anya";15217;0;100
0;210;"anyae";210;0;100
0;1419;"anyah";1419;0;100
0;16;"anyanka";16;0;100
0;22;"anyce";22;0;100
0;34;"anycia";34;0;100
0;119;"anye";119;0;100
0;57;"anyea";57;0;100
0;71;"anyela";71;0;100
0;284;"anyeli";284;0;100
0;195;"anyelin";195;0;100
0;122;"anyelina";122;0;100
0;13;"anyeline";13;0;100
0;6;"anyelis";6;0;100
72;0;"anyelo";72;100;0
0;60;"anyely";60;0;100
0;21;"anyha";21;0;100
0;10;"anyhia";10;0;100
0;94;"anyi";94;0;100
0;810;"anyia";810;0;100
0;590;"anyiah";590;0;100
0;6;"anyieth";6;0;100
0;5;"anyila";5;0;100
0;18;"anyja";18;0;100
0;89;"anyjah";89;0;100
0;5;"anyjha";5;0;100
0;26;"anyka";26;0;100
0;1445;"anyla";1445;0;100
0;870;"anylah";870;0;100
0;28;"anylia";28;0;100
0;7;"anyliah";7;0;100
0;60;"anyra";60;0;100
0;5;"anyree";5;0;100
0;17;"anyri";17;0;100
0;11;"anyria";11;0;100
0;5;"anyriah";5;0;100
0;5;"anyrie";5;0;100
0;207;"anysa";207;0;100
0;97;"anysha";97;0;100
0;11;"anyshia";11;0;100
0;307;"anysia";307;0;100
0;1963;"anyssa";1963;0;100
0;37;"anyssia";37;0;100
0;24;"anyston";24;0;100
0;6;"anyya";6;0;100
0;10;"anza";10;0;100
0;102;"anzal";102;0;100
21;0;"anzar";21;100;0
18;0;"anze";18;100;0
55;5;"anzel";60;91.6666666666667;8.33333333333333
0;12;"anzie";12;0;100
29;0;"anzio";29;100;0
0;82;"anzlee";82;0;100
0;73;"anzleigh";73;0;100
0;120;"anzley";120;0;100
0;12;"anzlie";12;0;100
233;0;"aodhan";233;100;0
23;169;"aoi";192;11.9791666666667;88.0208333333333
0;11;"aoibheann";11;0;100
0;1266;"aoife";1266;0;100
0;113;"aoki";113;0;100
0;722;"aolani";722;0;100
0;220;"aolanis";220;0;100
0;16;"aolany";16;0;100
0;5;"aonesti";5;0;100
0;36;"aonesty";36;0;100
0;5;"aonna";5;0;100
18;0;"aous";18;100;0
0;48;"aowyn";48;0;100
16;10;"apache";26;61.5384615384615;38.4615384615385
0;6;"aparajita";6;0;100
0;507;"aparna";507;0;100
0;5;"apasra";5;0;100
0;564;"aphrodite";564;0;100
0;5;"aphton";5;0;100
0;24;"apiffany";24;0;100
0;22;"apiphany";22;0;100
0;52;"apirl";52;0;100
1268;5;"apolinar";1273;99.6072270227808;0.392772977219167
0;35;"apolline";35;0;100
2834;0;"apollo";2834;100;0
0;519;"apollonia";519;0;100
79;0;"apollos";79;100;0
118;0;"apolo";118;100;0
0;946;"apolonia";946;0;100
1455;0;"apolonio";1455;100;0
0;23;"aponi";23;0;100
0;151;"apoorva";151;0;100
5;0;"apostolis";5;100;0
221;0;"apostolos";221;100;0
0;95;"apphia";95;0;100
0;18;"appie";18;0;100
0;378;"apple";378;0;100
0;6;"apples";6;0;100
0;7;"applonia";7;0;100
0;55;"appollonia";55;0;100
0;83;"appolonia";83;0;100
0;5;"aprecious";5;0;100
0;70;"aprel";70;0;100
0;19;"aprell";19;0;100
0;16;"apria";16;0;100
0;5;"apriel";5;0;100
667;237361;"april";238028;0.280219133883409;99.7197808661166
0;15;"aprilann";15;0;100
0;481;"aprile";481;0;100
0;5;"apriljoy";5;0;100
0;406;"aprill";406;0;100
0;518;"aprille";518;0;100
0;12;"aprillynn";12;0;100
0;33;"aprilmarie";33;0;100
0;2986;"apryl";2986;0;100
0;131;"apryle";131;0;100
0;71;"apryll";71;0;100
0;29;"apsara";29;0;100
28;101;"apurva";129;21.7054263565891;78.2945736434108
163;0;"aqeel";163;100;0
162;0;"aqib";162;100;0
55;0;"aqil";55;100;0
0;12;"aqila";12;0;100
0;5;"aqilah";5;0;100
0;334;"aqsa";334;0;100
0;122;"aqua";122;0;100
0;5;"aquaisha";5;0;100
0;5;"aquala";5;0;100
137;0;"aquan";137;100;0
0;207;"aquanetta";207;0;100
0;22;"aquanette";22;0;100
5;0;"aquanis";5;100;0
0;11;"aquaria";11;0;100
149;235;"aquarius";384;38.8020833333333;61.1979166666667
0;5;"aquasha";5;0;100
0;31;"aquasia";31;0;100
0;5;"aquavia";5;0;100
5;0;"aquavion";5;100;0
16;0;"aquavious";16;100;0
0;5;"aqueela";5;0;100
0;321;"aqueelah";321;0;100
0;5;"aquera";5;0;100
0;24;"aquetzalli";24;0;100
0;25;"aquia";25;0;100
0;5;"aquiel";5;0;100
463;0;"aquil";463;100;0
67;686;"aquila";753;8.89774236387782;91.1022576361222
0;32;"aquilah";32;0;100
5;0;"aquileo";5;100;0
400;0;"aquiles";400;100;0
0;5;"aquilina";5;0;100
19;0;"aquilino";19;100;0
7;0;"aquill";7;100;0
116;970;"aquilla";1086;10.6813996316759;89.3186003683241
17;0;"aquille";17;100;0
0;6;"aquina";6;0;100
5;0;"aquinas";5;100;0
0;97;"aquinnah";97;0;100
13;0;"aquino";13;100;0
0;44;"aquira";44;0;100
0;38;"aquisha";38;0;100
0;67;"aquita";67;0;100
5;0;"ar";5;100;0
1162;2691;"ara";3853;30.1583181936154;69.8416818063846
0;10;"araba";10;0;100
0;113;"arabel";113;0;100
0;108;"arabela";108;0;100
0;96;"arabell";96;0;100
0;14130;"arabella";14130;0;100
0;27;"arabellah";27;0;100
0;6;"arabellarose";6;0;100
0;1324;"arabelle";1324;0;100
0;305;"arabia";305;0;100
0;6;"arabian";6;0;100
0;5;"aracel";5;0;100
0;6;"aracele";6;0;100
138;17650;"araceli";17788;0.775803912750169;99.2241960872498
0;431;"aracelia";431;0;100
0;119;"aracelie";119;0;100
5;0;"aracelio";5;100;0
0;1050;"aracelis";1050;0;100
0;5;"araceliz";5;0;100
0;292;"aracelli";292;0;100
0;5;"aracellie";5;0;100
0;122;"aracelly";122;0;100
11;8670;"aracely";8681;0.126713512268172;99.8732864877318
0;82;"aracelys";82;0;100
93;0;"arad";93;100;0
0;87;"aradhana";87;0;100
5;154;"aradhya";159;3.14465408805031;96.8553459119497
0;105;"aradia";105;0;100
68;0;"arael";68;100;0
0;5;"araelynn";5;0;100
0;62;"araeya";62;0;100
92;0;"araf";92;100;0
100;0;"arafat";100;100;0
62;0;"aragon";62;100;0
48;0;"aragorn";48;100;0
0;503;"arah";503;0;100
0;10;"arahbella";10;0;100
0;10;"arahi";10;0;100
0;46;"arai";46;0;100
0;43;"araia";43;0;100
0;40;"araiah";40;0;100
0;406;"araina";406;0;100
0;10;"arainna";10;0;100
0;158;"araiya";158;0;100
0;69;"araiyah";69;0;100
0;15;"araiza";15;0;100
0;15;"aralee";15;0;100
0;61;"arali";61;0;100
0;13;"aralia";13;0;100
0;5;"aralin";5;0;100
0;5;"aralis";5;0;100
0;92;"araly";92;0;100
0;669;"aralyn";669;0;100
0;557;"aralynn";557;0;100
0;17;"aralynne";17;0;100
2537;38;"aram";2575;98.5242718446602;1.47572815533981
0;15;"arame";15;0;100
0;23;"arami";23;0;100
0;5;"aramie";5;0;100
0;235;"araminta";235;0;100
1828;176;"aramis";2004;91.2175648702595;8.78243512974052
6;0;"aramus";6;100;0
5;0;"aramys";5;100;0
702;27;"aran";729;96.2962962962963;3.7037037037037
0;142;"aranda";142;0;100
0;18;"aransa";18;0;100
0;420;"arantxa";420;0;100
0;680;"arantza";680;0;100
0;16;"aranxa";16;0;100
0;17;"aranya";17;0;100
0;1714;"aranza";1714;0;100
0;17;"aranzazu";17;0;100
0;5;"araoluwa";5;0;100
178;0;"aras";178;100;0
0;7;"arasele";7;0;100
0;1190;"araseli";1190;0;100
0;244;"arasely";244;0;100
833;0;"arash";833;100;0
10;0;"arashdeep";10;100;0
0;6;"arashel";6;0;100
35;0;"arata";35;100;0
923;0;"arath";923;100;0
0;10;"arathi";10;0;100
0;16;"arati";16;0;100
723;0;"arav";723;100;0
0;7;"aravella";7;0;100
160;0;"aravind";160;100;0
0;33;"aravis";33;0;100
0;20;"arawyn";20;0;100
0;13;"arax";13;0;100
0;10;"araxi";10;0;100
5;2175;"araya";2180;0.229357798165138;99.7706422018349
0;719;"arayah";719;0;100
0;6;"arayana";6;0;100
0;5;"arayeli";5;0;100
0;54;"arayia";54;0;100
0;23;"arayiah";23;0;100
0;67;"arayla";67;0;100
0;10;"araylia";10;0;100
0;134;"arayna";134;0;100
11;0;"araz";11;100;0
0;5;"arazeli";5;0;100
39;16;"arba";55;70.9090909090909;29.0909090909091
15;0;"arbaaz";15;100;0
0;66;"arbadella";66;0;100
0;10;"arbay";10;0;100
25;0;"arbaz";25;100;0
0;20;"arbedella";20;0;100
0;5;"arbelia";5;0;100
0;61;"arbell";61;0;100
0;44;"arbella";44;0;100
0;10;"arbelle";10;0;100
259;0;"arben";259;100;0
263;0;"arber";263;100;0
18;0;"arbi";18;100;0
513;124;"arbie";637;80.5337519623234;19.4662480376766
24;0;"arbin";24;100;0
7;0;"arbon";7;100;0
39;143;"arbor";182;21.4285714285714;78.5714285714286
0;18;"arbra";18;0;100
0;5;"arbri";5;0;100
0;5;"arbrianna";5;0;100
0;11;"arbrielle";11;0;100
0;17;"arbutis";17;0;100
0;1075;"arbutus";1075;0;100
230;0;"arby";230;100;0
0;458;"arcadia";458;0;100
5;0;"arcadian";5;100;0
1059;0;"arcadio";1059;100;0
5;0;"arcadius";5;100;0
141;0;"arcangel";141;100;0
0;11;"arcangela";11;0;100
31;0;"arcangelo";31;100;0
12;0;"arcel";12;100;0
0;25;"arceli";25;0;100
0;1737;"arcelia";1737;0;100
0;11;"arcella";11;0;100
0;22;"arcely";22;0;100
0;116;"arcenia";116;0;100
176;0;"arcenio";176;100;0
1771;0;"arch";1771;100;0
5;0;"archa";5;100;0
12;0;"archan";12;100;0
0;395;"archana";395;0;100
0;6;"archelle";6;0;100
8791;144;"archer";8935;98.388360380526;1.61163961947398
0;5;"archi";5;0;100
2446;0;"archibald";2446;100;0
46200;1200;"archie";47400;97.4683544303797;2.53164556962025
10;0;"archiebald";10;100;0
6;0;"archille";6;100;0
65;0;"archimedes";65;100;0
0;23;"archisha";23;0;100
184;0;"archit";184;100;0
0;59;"archita";59;0;100
13;0;"archith";13;100;0
0;6;"architha";6;0;100
33;0;"archivaldo";33;100;0
17;53;"arcie";70;24.2857142857143;75.7142857142857
0;27;"arcilia";27;0;100
5;0;"arco";5;100;0
0;324;"arcola";324;0;100
6;0;"arcus";6;100;0
392;327;"arda";719;54.5201668984701;45.4798331015299
0;12;"ardala";12;0;100
0;40;"ardalia";40;0;100
33;0;"ardan";33;100;0
34;0;"ardarius";34;100;0
22;1321;"ardath";1343;1.63812360387193;98.3618763961281
148;252;"ardean";400;37;63
0;51;"ardeen";51;0;100
31;97;"ardel";128;24.21875;75.78125
0;44;"ardele";44;0;100
0;1251;"ardelia";1251;0;100
2411;2578;"ardell";4989;48.3263178993786;51.6736821006214
0;3276;"ardella";3276;0;100
0;1494;"ardelle";1494;0;100
6962;5289;"arden";12251;56.8280140396702;43.1719859603298
0;550;"ardena";550;0;100
0;386;"ardene";386;0;100
0;122;"ardenia";122;0;100
0;49;"ardes";49;0;100
0;1033;"ardeth";1033;0;100
57;0;"ardi";57;100;0
0;5;"ardia";5;0;100
127;0;"ardian";127;100;0
0;12;"ardiana";12;0;100
0;68;"ardice";68;0;100
517;558;"ardie";1075;48.093023255814;51.9069767441861
0;5;"ardilia";5;0;100
25;0;"ardin";25;100;0
0;17;"ardina";17;0;100
5;125;"ardine";130;3.84615384615385;96.1538461538462
1025;6355;"ardis";7380;13.8888888888889;86.1111111111111
102;0;"ardit";102;100;0
0;29;"ardita";29;0;100
131;5581;"ardith";5712;2.29341736694678;97.7065826330532
72;0;"ardon";72;100;0
0;5;"ardonia";5;0;100
0;6;"ardoth";6;0;100
0;106;"ardra";106;0;100
0;6;"ardriana";6;0;100
0;6;"ardus";6;0;100
5;0;"ardwin";5;100;0
0;5;"ardy";5;0;100
0;1263;"ardyce";1263;0;100
0;234;"ardyn";234;0;100
0;11;"ardynn";11;0;100
5;954;"ardys";959;0.521376433785193;99.4786235662148
0;802;"ardyth";802;0;100
0;425;"ardythe";425;0;100
0;6;"areah";6;0;100
0;124;"areal";124;0;100
5;0;"arean";5;100;0
0;428;"areana";428;0;100
0;625;"areanna";625;0;100
0;382;"areatha";382;0;100
0;21;"areather";21;0;100
6;0;"arec";6;100;0
10;0;"ared";10;100;0
5;36;"aree";41;12.1951219512195;87.8048780487805
338;0;"areeb";338;100;0
0;299;"areeba";299;0;100
0;108;"areebah";108;0;100
0;5;"areecia";5;0;100
0;11;"areeg";11;0;100
0;384;"areej";384;0;100
5;133;"areen";138;3.6231884057971;96.3768115942029
0;16;"areena";16;0;100
0;141;"areesha";141;0;100
0;21;"areeya";21;0;100
13;0;"aref";13;100;0
59;0;"areg";59;100;0
0;39;"areia";39;0;100
0;46;"areial";46;0;100
0;27;"areiana";27;0;100
0;19;"areianna";19;0;100
0;5;"areigha";5;0;100
0;299;"areil";299;0;100
0;12;"areille";12;0;100
5;31;"areion";36;13.8888888888889;86.1111111111111
0;11;"areiona";11;0;100
0;5;"areionna";5;0;100
0;21;"areisy";21;0;100
302;0;"arek";302;100;0
200;6;"arel";206;97.0873786407767;2.9126213592233
0;6;"arela";6;0;100
0;165;"arelene";165;0;100
72;5441;"areli";5513;1.30600399056775;98.6939960094323
0;231;"arelia";231;0;100
0;102;"arelie";102;0;100
0;6;"arelin";6;0;100
0;892;"arelis";892;0;100
0;67;"areliz";67;0;100
0;327;"arella";327;0;100
0;12;"arelle";12;0;100
0;33;"arelli";33;0;100
0;265;"arelly";265;0;100
0;19;"arellys";19;0;100
0;8866;"arely";8866;0;100
0;56;"arelyn";56;0;100
0;350;"arelys";350;0;100
0;41;"aremi";41;0;100
0;22;"aremy";22;0;100
1644;331;"aren";1975;83.2405063291139;16.7594936708861
0;369;"arena";369;0;100
138;0;"arend";138;100;0
0;31;"arenda";31;0;100
0;15;"arene";15;0;100
0;14;"areni";14;0;100
82;45;"areon";127;64.5669291338583;35.4330708661417
0;184;"areona";184;0;100
0;11;"areonia";11;0;100
0;211;"areonna";211;0;100
2148;59;"ares";2207;97.3266878115088;2.67331218849116
8;0;"aresenio";8;100;0
0;32;"aresha";32;0;100
0;290;"areta";290;0;100
0;5626;"aretha";5626;0;100
0;28;"arethea";28;0;100
0;6;"arether";6;0;100
0;28;"arethia";28;0;100
0;30;"areti";30;0;100
0;34;"aretina";34;0;100
0;1142;"aretta";1142;0;100
0;11;"aretzi";11;0;100
0;45;"aretzy";45;0;100
0;7;"arey";7;0;100
0;205;"areya";205;0;100
0;25;"areyah";25;0;100
0;155;"areyana";155;0;100
0;134;"areyanna";134;0;100
15;33;"areyon";48;31.25;68.75
0;21;"areyona";21;0;100
0;33;"areyonna";33;0;100
0;11;"arezo";11;0;100
0;91;"arfa";91;0;100
5;0;"arfaan";5;100;0
43;0;"arfan";43;100;0
0;5;"argatha";5;0;100
127;0;"argel";127;100;0
0;824;"argelia";824;0;100
101;0;"argelio";101;100;0
36;5;"argelis";41;87.8048780487805;12.1951219512195
16;0;"argene";16;100;0
893;0;"argenis";893;100;0
10;0;"argeniz";10;100;0
0;5;"argent";5;0;100
0;437;"argentina";437;0;100
0;5;"argentine";5;0;100
10;0;"argenys";10;100;0
146;958;"argie";1104;13.2246376811594;86.7753623188406
62;0;"argil";62;100;0
0;5;"argiro";5;0;100
51;0;"argle";51;100;0
22;0;"argo";22;100;0
5;0;"argonne";5;100;0
172;0;"argus";172;100;0
26;69;"argusta";95;27.3684210526316;72.6315789473684
11;10;"arguster";21;52.3809523809524;47.6190476190476
10;0;"argyl";10;100;0
118;24;"argyle";142;83.0985915492958;16.9014084507042
0;5;"argyro";5;0;100
5;0;"arha";5;100;0
12;0;"arhaam";12;100;0
250;0;"arhaan";250;100;0
737;0;"arham";737;100;0
198;0;"arhan";198;100;0
10;0;"arhant";10;100;0
0;6;"arhea";6;0;100
0;43;"arhiana";43;0;100
0;197;"arhianna";197;0;100
0;28;"arhonda";28;0;100
15;0;"arhtur";15;100;0
130;0;"arhum";130;100;0
12668;2681;"ari";15349;82.5330640432602;17.4669359567399
510;36769;"aria";37279;1.36806244802704;98.631937551973
0;6;"ariaa";6;0;100
5;0;"ariaan";5;100;0
0;89;"ariabella";89;0;100
0;2434;"ariadna";2434;0;100
0;2794;"ariadne";2794;0;100
0;6;"ariadnna";6;0;100
0;22;"ariadnne";22;0;100
0;11;"ariadny";11;0;100
0;17;"ariagna";17;0;100
36;5089;"ariah";5125;0.702439024390244;99.2975609756098
0;6;"ariaha";6;0;100
0;6;"ariahana";6;0;100
0;347;"ariahna";347;0;100
0;30;"ariahnna";30;0;100
0;5;"ariajade";5;0;100
0;1122;"arial";1122;0;100
0;5;"ariale";5;0;100
0;5;"arialle";5;0;100
0;8;"arialynn";8;0;100
17;242;"ariam";259;6.56370656370656;93.4362934362934
0;5;"ariamarie";5;0;100
4363;1388;"arian";5751;75.8650669448792;24.1349330551209
180;92374;"ariana";92554;0.194481059705685;99.8055189402943
0;798;"arianah";798;0;100
0;5;"arianamarie";5;0;100
0;22;"arianda";22;0;100
5;3512;"ariane";3517;0.142166619277794;99.8578333807222
0;355;"ariani";355;0;100
0;57;"arianie";57;0;100
0;47;"arianis";47;0;100
6;419;"ariann";425;1.41176470588235;98.5882352941176
72;84867;"arianna";84939;0.0847667149366016;99.9152332850634
0;794;"ariannah";794;0;100
0;3718;"arianne";3718;0;100
0;288;"arianni";288;0;100
0;98;"ariannie";98;0;100
0;1208;"arianny";1208;0;100
29;0;"ariano";29;100;0
0;303;"ariany";303;0;100
0;18;"arianys";18;0;100
0;26;"ariarose";26;0;100
188;41;"arias";229;82.0960698689956;17.9039301310044
5;0;"ariat";5;100;0
0;133;"ariatna";133;0;100
0;367;"ariauna";367;0;100
0;120;"ariaunna";120;0;100
0;6;"ariaya";6;0;100
0;10;"ariayah";10;0;100
49;0;"arib";49;100;0
0;93;"ariba";93;0;100
0;29;"aribah";29;0;100
0;24;"aribel";24;0;100
0;579;"aribella";579;0;100
0;71;"aribelle";71;0;100
0;10;"aribeth";10;0;100
7290;5;"aric";7295;99.9314599040439;0.0685400959561343
0;2324;"arica";2324;0;100
0;11;"aricca";11;0;100
0;10;"aricel";10;0;100
0;92;"aricela";92;0;100
0;34;"ariceli";34;0;100
0;18;"aricella";18;0;100
0;6;"aricely";6;0;100
0;38;"aricia";38;0;100
48;0;"aricin";48;100;0
875;0;"arick";875;100;0
0;478;"aricka";478;0;100
0;23;"aridai";23;0;100
0;115;"ariday";115;0;100
1936;2778;"arie";4714;41.0691557064064;58.9308442935936
0;91;"ariea";91;0;100
0;17;"arieah";17;0;100
0;412;"arieal";412;0;100
0;739;"arieana";739;0;100
0;1135;"arieanna";1135;0;100
0;28;"ariebella";28;0;100
0;10;"ariee";10;0;100
71;0;"arieh";71;100;0
17146;65850;"ariel";82996;20.6588269314184;79.3411730685816
0;2316;"ariela";2316;0;100
0;6;"arielah";6;0;100
0;560;"ariele";560;0;100
0;18;"arieli";18;0;100
0;226;"arielis";226;0;100
0;60;"arieliz";60;0;100
5;798;"ariell";803;0.62266500622665;99.3773349937733
0;8576;"ariella";8576;0;100
0;49;"ariellah";49;0;100
40;23316;"arielle";23356;0.171262202431923;99.8287377975681
0;38;"arielly";38;0;100
0;7;"arielmarie";7;0;100
0;172;"ariely";172;0;100
0;5;"arielyn";5;0;100
0;201;"arielys";201;0;100
0;17;"arielyz";17;0;100
499;401;"arien";900;55.4444444444444;44.5555555555556
0;28;"ariena";28;0;100
0;44;"ariene";44;0;100
0;5;"arienette";5;0;100
0;111;"arienna";111;0;100
0;409;"arienne";409;0;100
101;66;"arieon";167;60.4790419161677;39.5209580838323
0;195;"arieona";195;0;100
0;320;"arieonna";320;0;100
2209;1490;"aries";3699;59.7188429305218;40.2811570694782
0;10;"arieta";10;0;100
0;531;"arietta";531;0;100
5;0;"arieus";5;100;0
0;10;"arieya";10;0;100
0;53;"arieyana";53;0;100
0;45;"arieyanna";45;0;100
0;7;"arieyonna";7;0;100
81;5;"ariez";86;94.1860465116279;5.81395348837209
609;0;"arif";609;100;0
0;20;"arifa";20;0;100
0;10;"ariha";10;0;100
58;0;"arihaan";58;100;0
23;0;"arihan";23;100;0
0;144;"arihana";144;0;100
0;589;"arihanna";589;0;100
93;0;"arihant";93;100;0
0;16;"arii";16;0;100
0;5;"ariiana";5;0;100
0;39;"arij";39;0;100
0;18;"arijah";18;0;100
0;124;"arijana";124;0;100
5;0;"arijit";5;100;0
2239;0;"arik";2239;100;0
0;2222;"arika";2222;0;100
0;5;"arikah";5;0;100
0;10;"arikka";10;0;100
0;10;"aril";10;0;100
0;27;"arilene";27;0;100
0;164;"arilla";164;0;100
0;5;"arillia";5;0;100
0;301;"arilyn";301;0;100
0;156;"arilynn";156;0;100
0;5;"arim";5;0;100
0;5;"arimentha";5;0;100
1602;2342;"arin";3944;40.6186612576065;59.3813387423935
0;608;"arina";608;0;100
0;10;"arinda";10;0;100
0;85;"arine";85;0;100
10;0;"arinjay";10;100;0
0;30;"arinn";30;0;100
0;17;"arinna";17;0;100
0;5;"arinola";5;0;100
125;0;"arinze";125;100;0
29;0;"arinzechukwu";29;100;0
80;0;"ario";80;100;0
1646;589;"arion";2235;73.6465324384788;26.3534675615213
0;885;"ariona";885;0;100
0;22;"arionah";22;0;100
0;6;"arione";6;0;100
0;2180;"arionna";2180;0;100
0;180;"arionne";180;0;100
95;0;"ariq";95;100;0
1863;1242;"aris";3105;60;40
0;652;"arisa";652;0;100
0;17;"arisai";17;0;100
0;80;"arisbel";80;0;100
0;53;"arisbet";53;0;100
0;563;"arisbeth";563;0;100
0;7;"arisdelsy";7;0;100
0;15;"arisela";15;0;100
122;0;"arish";122;100;0
0;579;"arisha";579;0;100
0;5;"arishka";5;0;100
0;5;"arisleidy";5;0;100
0;5;"arismel";5;0;100
5;0;"arismendy";5;100;0
41;0;"arison";41;100;0
0;20;"ariss";20;0;100
0;2194;"arissa";2194;0;100
0;501;"arista";501;0;100
0;45;"aristea";45;0;100
22;0;"aristede";22;100;0
5;0;"aristedes";5;100;0
767;0;"aristeo";767;100;0
81;0;"aristide";81;100;0
636;0;"aristides";636;100;0
63;0;"aristidis";63;100;0
263;0;"ariston";263;100;0
40;0;"aristotelis";40;100;0
812;0;"aristotle";812;100;0
0;11;"arit";11;0;100
0;219;"arita";219;0;100
0;100;"aritha";100;0;100
5;0;"aritra";5;100;0
0;152;"aritza";152;0;100
0;59;"aritzel";59;0;100
0;12;"aritzi";12;0;100
0;57;"aritzy";57;0;100
0;5;"ariunna";5;0;100
612;42;"arius";654;93.5779816513761;6.42201834862385
90;0;"ariv";90;100;0
30;2577;"ariya";2607;1.15074798619102;98.849252013809
0;3287;"ariyah";3287;0;100
0;50;"ariyahna";50;0;100
0;6;"ariyal";6;0;100
235;295;"ariyan";530;44.3396226415094;55.6603773584906
0;2832;"ariyana";2832;0;100
0;215;"ariyanah";215;0;100
0;18;"ariyani";18;0;100
0;2278;"ariyanna";2278;0;100
0;79;"ariyannah";79;0;100
0;5;"ariyauna";5;0;100
6;0;"ariyeh";6;100;0
0;84;"ariyel";84;0;100
0;5;"ariyella";5;0;100
0;41;"ariyelle";41;0;100
0;5;"ariyha";5;0;100
0;10;"ariyiah";10;0;100
89;167;"ariyon";256;34.765625;65.234375
0;165;"ariyona";165;0;100
0;441;"ariyonna";441;0;100
0;6;"ariyunna";6;0;100
82;0;"ariz";82;100;0
0;447;"ariza";447;0;100
0;417;"arizbeth";417;0;100
0;7;"arizel";7;0;100
113;2210;"arizona";2323;4.8643994834266;95.1356005165734
0;5;"arizonia";5;0;100
5;0;"arjae";5;100;0
425;0;"arjan";425;100;0
0;29;"arjanae";29;0;100
17;0;"arjav";17;100;0
224;0;"arjay";224;100;0
0;5;"arjean";5;0;100
221;0;"arjen";221;100;0
25;0;"arjenis";25;100;0
0;5;"arjeta";5;0;100
18;0;"arjit";18;100;0
7380;0;"arjun";7380;100;0
249;0;"arjuna";249;100;0
61;0;"ark";61;100;0
22;0;"arka";22;100;0
0;7;"arkadia";7;0;100
5;0;"arkadian";5;100;0
5;0;"arkadiusz";5;100;0
11;0;"arkady";11;100;0
40;0;"arkan";40;100;0
16;0;"arkangel";16;100;0
0;6;"arkayla";6;0;100
0;5;"arkeba";5;0;100
5;0;"arkee";5;100;0
203;0;"arkeem";203;100;0
15;0;"arkeen";15;100;0
0;26;"arkeisha";26;0;100
14;0;"arkeith";14;100;0
64;0;"arkel";64;100;0
31;0;"arkell";31;100;0
0;12;"arkeria";12;0;100
0;26;"arkesha";26;0;100
0;11;"arkeshia";11;0;100
30;0;"arkham";30;100;0
0;16;"arkia";16;0;100
37;142;"arkie";179;20.6703910614525;79.3296089385475
7;0;"arkim";7;100;0
95;0;"arkin";95;100;0
0;50;"arkisha";50;0;100
0;5;"arkita";5;0;100
5;0;"arkley";5;100;0
5;0;"arko";5;100;0
7;0;"arkyn";7;100;0
54;0;"arl";54;100;0
17;2553;"arla";2570;0.66147859922179;99.3385214007782
0;10;"arlaina";10;0;100
0;42;"arlaine";42;0;100
3058;0;"arlan";3058;100;0
0;537;"arlana";537;0;100
1744;5;"arland";1749;99.7141223556318;0.28587764436821
25;67;"arlanda";92;27.1739130434783;72.8260869565217
125;0;"arlander";125;100;0
12;0;"arlandis";12;100;0
537;0;"arlando";537;100;0
0;17;"arlandria";17;0;100
10;0;"arlandus";10;100;0
0;5;"arlane";5;0;100
0;74;"arlayne";74;0;100
0;5;"arlea";5;0;100
0;1655;"arlean";1655;0;100
0;40;"arleane";40;0;100
0;5;"arleaner";5;0;100
0;5;"arlease";5;0;100
0;157;"arleatha";157;0;100
0;53;"arlecia";53;0;100
0;22;"arleda";22;0;100
419;945;"arlee";1364;30.7184750733138;69.2815249266862
6;12252;"arleen";12258;0.0489476260401371;99.9510523739599
0;6;"arleena";6;0;100
0;388;"arleene";388;0;100
0;11;"arleeta";11;0;100
0;6;"arleht";6;0;100
496;428;"arleigh";924;53.6796536796537;46.3203463203463
0;15;"arlein";15;0;100
0;5;"arleine";5;0;100
6609;629;"arlen";7238;91.3097540757115;8.69024592428848
0;2636;"arlena";2636;0;100
362;141642;"arlene";142004;0.25492239655221;99.7450776034478
0;6;"arlener";6;0;100
0;29;"arleni";29;0;100
0;65;"arlenis";65;0;100
0;147;"arlenne";147;0;100
0;197;"arleny";197;0;100
0;33;"arlenys";33;0;100
0;5;"arleon";5;0;100
195;6;"arles";201;97.0149253731343;2.98507462686567
0;10;"arlesa";10;0;100
0;51;"arlesha";51;0;100
0;86;"arlesia";86;0;100
65;5;"arless";70;92.8571428571429;7.14285714285714
188;0;"arlester";188;100;0
5;963;"arlet";968;0.516528925619835;99.4834710743802
0;1025;"arleta";1025;0;100
0;5;"arlete";5;0;100
0;2836;"arleth";2836;0;100
0;1640;"arletha";1640;0;100
0;22;"arlethe";22;0;100
0;11;"arlethea";11;0;100
0;6;"arlether";6;0;100
0;243;"arlethia";243;0;100
0;587;"arlett";587;0;100
0;2285;"arletta";2285;0;100
0;4949;"arlette";4949;0;100
0;15;"arlevia";15;0;100
5;0;"arlex";5;100;0
2919;579;"arley";3498;83.4476843910806;16.5523156089194
0;74;"arli";74;0;100
0;5;"arliana";5;0;100
26;15;"arlice";41;63.4146341463415;36.5853658536585
0;205;"arlicia";205;0;100
6290;1929;"arlie";8219;76.5299914831488;23.4700085168512
0;10;"arlien";10;0;100
0;176;"arliene";176;0;100
0;14;"arlillian";14;0;100
3737;694;"arlin";4431;84.3376213044459;15.6623786955541
0;152;"arlina";152;0;100
166;0;"arlind";166;100;0
0;1493;"arlinda";1493;0;100
36;17243;"arline";17279;0.208345390358238;99.7916546096418
78;0;"arling";78;100;0
1363;39;"arlington";1402;97.2182596291013;2.78174037089872
1829;797;"arlis";2626;69.6496572734196;30.3503427265803
0;431;"arlisa";431;0;100
0;276;"arlisha";276;0;100
570;801;"arliss";1371;41.5754923413567;58.4245076586433
0;68;"arlissa";68;0;100
0;215;"arlita";215;0;100
0;13;"arliz";13;0;100
7393;172;"arlo";7565;97.7263714474554;2.27362855254461
0;300;"arloa";300;0;100
0;17;"arloene";17;0;100
0;47;"arloine";47;0;100
1388;0;"arlon";1388;100;0
0;7;"arlonda";7;0;100
10;0;"arlondo";10;100;0
0;86;"arlone";86;0;100
37;0;"arlos";37;100;0
129;13;"arlow";142;90.8450704225352;9.15492957746479
0;5;"arlowe";5;0;100
0;10;"arloween";10;0;100
0;5;"arlowene";5;0;100
10;0;"arlton";10;100;0
11;0;"arlus";11;100;0
51;731;"arly";782;6.52173913043478;93.4782608695652
0;359;"arlyce";359;0;100
0;44;"arlyle";44;0;100
2064;1975;"arlyn";4039;51.1017578608566;48.8982421391433
0;10;"arlynda";10;0;100
0;1450;"arlyne";1450;0;100
0;5;"arlynes";5;0;100
61;437;"arlynn";498;12.2489959839357;87.7510040160643
0;51;"arlynne";51;0;100
0;1103;"arlys";1103;0;100
0;158;"arlyss";158;0;100
0;10;"arlyssa";10;0;100
0;606;"arma";606;0;100
5;0;"armaad";5;100;0
2414;0;"armaan";2414;100;0
33;0;"armad";33;100;0
34;0;"armahn";34;100;0
16;48;"armahni";64;25;75
3524;0;"arman";3524;100;0
0;5;"armana";5;0;100
14887;6;"armand";14893;99.9597126166656;0.0402873833344524
0;1281;"armanda";1281;0;100
0;22;"armande";22;0;100
0;769;"armandina";769;0;100
71510;367;"armando";71877;99.4894055121944;0.510594487805557
0;28;"armanee";28;0;100
8738;6865;"armani";15603;56.0020508876498;43.9979491123502
61;144;"armanie";205;29.7560975609756;70.2439024390244
88;180;"armanii";268;32.8358208955224;67.1641791044776
5;0;"armann";5;100;0
54;18;"armanni";72;75;25
15;0;"armante";15;100;0
10;0;"armanti";10;100;0
168;0;"armany";168;100;0
6;0;"armar";6;100;0
18;0;"armard";18;100;0
89;39;"armari";128;69.53125;30.46875
108;0;"armarion";108;100;0
72;0;"armas";72;100;0
0;44;"armatha";44;0;100
10;0;"armaun";10;100;0
0;278;"armeda";278;0;100
47;5;"armeen";52;90.3846153846154;9.61538461538462
191;0;"armel";191;100;0
0;18;"armelda";18;0;100
0;418;"armelia";418;0;100
0;17;"armelinda";17;0;100
0;741;"armella";741;0;100
0;14;"armelle";14;0;100
1851;5;"armen";1856;99.7306034482759;0.269396551724138
0;10;"armena";10;0;100
58;0;"armend";58;100;0
0;37;"armenda";37;0;100
0;153;"armenia";153;0;100
0;197;"armenta";197;0;100
0;189;"armentha";189;0;100
6;16;"armer";22;27.2727272727273;72.7272727272727
0;16;"armesha";16;0;100
0;51;"armeta";51;0;100
0;34;"armetha";34;0;100
0;5;"armetrice";5;0;100
0;164;"armetta";164;0;100
0;10;"armiah";10;0;100
0;3019;"armida";3019;0;100
0;72;"armie";72;0;100
0;224;"armilda";224;0;100
0;31;"armilla";31;0;100
2688;0;"armin";2688;100;0
0;217;"armina";217;0;100
0;1221;"arminda";1221;0;100
0;150;"armine";150;0;100
0;593;"arminta";593;0;100
0;5;"armintha";5;0;100
6;0;"armir";6;100;0
0;16;"armisha";16;0;100
62;0;"armistead";62;100;0
11;10;"armistice";21;52.3809523809524;47.6190476190476
0;57;"armita";57;0;100
0;5;"armittie";5;0;100
0;41;"armiya";41;0;100
0;88;"armiyah";88;0;100
10;0;"armod";10;100;0
3036;0;"armon";3036;100;0
4152;0;"armond";4152;100;0
1404;0;"armondo";1404;100;0
53;10;"armone";63;84.1269841269841;15.8730158730159
6;74;"armonee";80;7.5;92.5
0;5;"armoney";5;0;100
816;1334;"armoni";2150;37.953488372093;62.046511627907
179;521;"armonie";700;25.5714285714286;74.4285714285714
0;59;"armonii";59;0;100
0;25;"armonni";25;0;100
0;5;"armonnie";5;0;100
5;0;"armonta";5;100;0
16;0;"armontae";16;100;0
191;0;"armonte";191;100;0
0;29;"armony";29;0;100
22;0;"armor";22;100;0
184;0;"armour";184;100;0
383;0;"armstead";383;100;0
30;0;"armster";30;100;0
67;0;"armstrong";67;100;0
0;6;"army";6;0;100
0;76;"armya";76;0;100
60;0;"arn";60;100;0
0;441;"arna";441;0;100
32;0;"arnab";32;100;0
0;5;"arnae";5;0;100
15;0;"arnald";15;100;0
1985;0;"arnaldo";1985;100;0
5;0;"arnardo";5;100;0
0;54;"arnasia";54;0;100
15;0;"arnaud";15;100;0
3095;0;"arnav";3095;100;0
0;13;"arnavi";13;0;100
7;0;"arnay";7;100;0
21;0;"arnaz";21;100;0
2790;0;"arne";2790;100;0
0;77;"arnecia";77;0;100
0;108;"arneda";108;0;100
0;5;"arnedra";5;0;100
0;6;"arnee";6;0;100
0;5;"arneice";5;0;100
0;124;"arneisha";124;0;100
0;6;"arneita";6;0;100
793;22;"arnel";815;97.3006134969325;2.69938650306748
0;43;"arnela";43;0;100
0;10;"arnelda";10;0;100
0;11;"arnelia";11;0;100
1243;797;"arnell";2040;60.9313725490196;39.0686274509804
0;166;"arnella";166;0;100
0;161;"arnelle";161;0;100
5;0;"arner";5;100;0
27;0;"arnes";27;100;0
27;0;"arnesh";27;100;0
0;304;"arnesha";304;0;100
0;123;"arneshia";123;0;100
0;67;"arnesia";67;0;100
11;0;"arness";11;100;0
0;32;"arnessa";32;0;100
5;0;"arnesto";5;100;0
96;0;"arnet";96;100;0
0;152;"arneta";152;0;100
0;463;"arnetha";463;0;100
0;76;"arnetia";76;0;100
0;63;"arnetra";63;0;100
0;13;"arnetria";13;0;100
1276;75;"arnett";1351;94.4485566247224;5.55144337527757
0;3232;"arnetta";3232;0;100
33;1055;"arnette";1088;3.03308823529412;96.9669117647059
0;10;"arnettie";10;0;100
67;0;"arney";67;100;0
480;5;"arnez";485;98.9690721649485;1.03092783505155
0;12;"arni";12;0;100
0;5;"arnica";5;0;100
0;109;"arnice";109;0;100
2001;230;"arnie";2231;89.6907216494845;10.3092783505155
0;5;"arniece";5;0;100
0;5;"arniesha";5;0;100
0;57;"arnika";57;0;100
7;0;"arnim";7;100;0
17;0;"arnis";17;100;0
0;5;"arnise";5;0;100
0;303;"arnisha";303;0;100
0;36;"arnissa";36;0;100
6;0;"arnit";6;100;0
0;2047;"arnita";2047;0;100
0;5;"arnitha";5;0;100
0;97;"arnitra";97;0;100
0;12;"arniya";12;0;100
0;18;"arniyah";18;0;100
1515;0;"arno";1515;100;0
5;0;"arnob";5;100;0
102;0;"arnol";102;100;0
0;70;"arnola";70;0;100
101587;550;"arnold";102137;99.4615075829523;0.538492417047691
4492;0;"arnoldo";4492;100;0
5;0;"arnolfo";5;100;0
5;0;"arnon";5;100;0
11;0;"arnt";11;100;0
6097;0;"arnulfo";6097;100;0
5;0;"arny";5;100;0
19;0;"aro";19;100;0
0;13;"aroara";13;0;100
0;12;"aroha";12;0;100
7;0;"arohan";7;100;0
0;111;"arohi";111;0;100
30;0;"arol";30;100;0
5;0;"arold";5;100;0
110;0;"aroldo";110;100;0
0;7;"arolyn";7;0;100
17966;355;"aron";18321;98.0623328420938;1.93766715790623
6;15;"arona";21;28.5714285714286;71.4285714285714
0;108;"aronda";108;0;100
37;0;"aronde";37;100;0
0;32;"arooj";32;0;100
10;0;"aroon";10;100;0
0;6;"aroosa";6;0;100
5;29;"aroosh";34;14.7058823529412;85.2941176470588
0;185;"arora";185;0;100
0;70;"aroura";70;0;100
0;116;"aroush";116;0;100
0;12;"arowyn";12;0;100
0;5;"aroya";5;0;100
7;0;"aroyal";7;100;0
0;5;"arpa";5;0;100
44;0;"arpad";44;100;0
209;5;"arpan";214;97.6635514018692;2.33644859813084
0;81;"arpi";81;0;100
0;5;"arpie";5;0;100
0;55;"arpil";55;0;100
0;10;"arpine";10;0;100
40;0;"arpit";40;100;0
0;96;"arpita";96;0;100
5;0;"arquan";5;100;0
0;17;"arquilla";17;0;100
5;0;"arquimedes";5;100;0
18;0;"arquimides";18;100;0
0;10;"arquita";10;0;100
0;99;"arra";99;0;100
0;128;"arrabella";128;0;100
0;5;"arrabelle";5;0;100
0;20;"arrah";20;0;100
233;0;"arran";233;100;0
0;84;"arraya";84;0;100
0;135;"arrayah";135;0;100
0;6;"arreana";6;0;100
0;21;"arreanna";21;0;100
286;21;"arren";307;93.1596091205212;6.84039087947883
0;11;"arrena";11;0;100
16;24;"arreon";40;40;60
0;10;"arreona";10;0;100
0;11;"arreonna";11;0;100
0;240;"arretta";240;0;100
20;23;"arri";43;46.5116279069767;53.4883720930233
0;228;"arria";228;0;100
0;96;"arriah";96;0;100
81;21;"arrian";102;79.4117647058823;20.5882352941176
0;1461;"arriana";1461;0;100
0;5;"arriane";5;0;100
0;1358;"arrianna";1358;0;100
0;5;"arriannah";5;0;100
0;34;"arrianne";34;0;100
15;0;"arric";15;100;0
0;54;"arrica";54;0;100
212;0;"arrick";212;100;0
312;1399;"arrie";1711;18.2349503214494;81.7650496785506
0;12;"arrieanna";12;0;100
0;318;"arriel";318;0;100
0;6;"arriell";6;0;100
0;36;"arriella";36;0;100
0;293;"arrielle";293;0;100
0;16;"arrietta";16;0;100
0;52;"arrietty";52;0;100
0;20;"arrihanna";20;0;100
5;0;"arrik";5;100;0
0;19;"arrika";19;0;100
0;23;"arrilla";23;0;100
95;68;"arrin";163;58.2822085889571;41.7177914110429
449;188;"arrington";637;70.4866562009419;29.5133437990581
257;79;"arrion";336;76.4880952380952;23.5119047619048
0;111;"arriona";111;0;100
0;154;"arrionna";154;0;100
47;0;"arris";47;100;0
0;20;"arrissa";20;0;100
10;0;"arrius";10;100;0
0;26;"arriya";26;0;100
0;90;"arriyah";90;0;100
0;64;"arriyana";64;0;100
0;6;"arriyanah";6;0;100
0;62;"arriyanna";62;0;100
6;0;"arro";6;100;0
7864;173;"arron";8037;97.8474555182282;2.15254448177181
534;217;"arrow";751;71.1051930758988;28.8948069241012
7;0;"arry";7;100;0
0;5;"arrya";5;0;100
0;140;"arryana";140;0;100
0;158;"arryanna";158;0;100
11;69;"arryn";80;13.75;86.25
0;5;"arryon";5;0;100
0;11;"arryonna";11;0;100
99;0;"arsal";99;100;0
6;0;"arsalaan";6;100;0
318;0;"arsalan";318;100;0
5;0;"arsam";5;100;0
0;383;"arsema";383;0;100
372;0;"arsen";372;100;0
41;0;"arsene";41;100;0
0;121;"arsenia";121;0;100
6;0;"arsenial";6;100;0
2035;0;"arsenio";2035;100;0
62;0;"arseniy";62;100;0
5;0;"arseno";5;100;0
16;0;"arseny";16;100;0
457;0;"arsh";457;100;0
10;33;"arsha";43;23.2558139534884;76.7441860465116
44;0;"arshaan";44;100;0
218;0;"arshad";218;100;0
5;0;"arshag";5;100;0
193;0;"arshan";193;100;0
0;5;"arshanti";5;0;100
35;0;"arshaun";35;100;0
98;0;"arshawn";98;100;0
133;21;"arshdeep";154;86.3636363636364;13.6363636363636
0;91;"arshi";91;0;100
112;319;"arshia";431;25.9860788863109;74.0139211136891
0;18;"arshika";18;0;100
0;141;"arshiya";141;0;100
5;0;"arshon";5;100;0
10;0;"arshveer";10;100;0
0;25;"arsie";25;0;100
192;0;"arslan";192;100;0
36;0;"arson";36;100;0
0;25;"arsula";25;0;100
7;0;"arsyn";7;100;0
5682;5;"art";5687;99.9120801828732;0.0879198171267804
7;560;"arta";567;1.23456790123457;98.7654320987654
5;0;"artadius";5;100;0
55;0;"artan";55;100;0
0;199;"artasia";199;0;100
0;443;"artavia";443;0;100
7;0;"artavian";7;100;0
46;0;"artavion";46;100;0
440;0;"artavious";440;100;0
72;0;"artavis";72;100;0
374;0;"artavius";374;100;0
26;10;"artee";36;72.2222222222222;27.7777777777778
23;0;"arteen";23;100;0
0;577;"artelia";577;0;100
7;5;"artell";12;58.3333333333333;41.6666666666667
0;5;"artella";5;0;100
562;0;"artem";562;100;0
55;0;"artemas";55;100;0
0;5;"artemia";5;0;100
2206;0;"artemio";2206;100;0
156;1028;"artemis";1184;13.1756756756757;86.8243243243243
0;217;"artemisa";217;0;100
0;58;"artemisia";58;0;100
11;0;"artemiy";11;100;0
555;0;"artemus";555;100;0
5;0;"artemy";5;100;0
0;5;"artena";5;0;100
0;5;"artensia";5;0;100
5;0;"arter";5;100;0
0;38;"arteria";38;0;100
0;153;"artesha";153;0;100
0;226;"artesia";226;0;100
568;0;"artez";568;100;0
73;0;"arth";73;100;0
117;536;"artha";653;17.9173047473201;82.0826952526799
0;5;"arthalia";5;0;100
21;0;"arthar";21;100;0
16;0;"arthas";16;100;0
0;81;"arthea";81;0;100
21;0;"arthel";21;100;0
0;82;"arthelia";82;0;100
23;0;"arthell";23;100;0
0;169;"arthella";169;0;100
0;17;"arthemise";17;0;100
0;29;"arthena";29;0;100
0;35;"arthenia";35;0;100
4638;47;"arther";4685;98.9967982924226;1.00320170757737
0;16;"artherine";16;0;100
0;5;"arthetta";5;0;100
0;85;"arthi";85;0;100
582;0;"arthor";582;100;0
493234;3045;"arthur";496279;99.3864338406421;0.613566159357942
0;21;"arthuree";21;0;100
0;18;"arthurene";18;0;100
0;296;"arthurine";296;0;100
338;0;"arthuro";338;100;0
5;0;"arthus";5;100;0
8;251;"arti";259;3.08880308880309;96.9111969111969
0;73;"artia";73;0;100
0;6;"artiana";6;0;100
152;64;"artice";216;70.3703703703704;29.6296296296296
0;20;"articia";20;0;100
4104;5290;"artie";9394;43.6874600809027;56.3125399190973
0;10;"artimese";10;0;100
44;0;"artimus";44;100;0
350;0;"artin";350;100;0
0;291;"artina";291;0;100
5200;946;"artis";6146;84.6078750406769;15.3921249593231
0;478;"artisha";478;0;100
0;10;"artishia";10;0;100
191;5;"artist";196;97.4489795918367;2.55102040816327
10;0;"arto";10;100;0
6;0;"arton";6;100;0
36;0;"artorius";36;100;0
0;5;"artra";5;0;100
163;0;"artrell";163;100;0
0;5;"artresha";5;0;100
0;93;"artrice";93;0;100
0;11;"artricia";11;0;100
0;11;"artrina";11;0;100
655;0;"artur";655;100;0
0;6;"artura";6;0;100
52864;209;"arturo";53073;99.6062027773067;0.393797222693272
148;0;"arty";148;100;0
155;0;"artyom";155;100;0
0;6;"aruba";6;0;100
89;0;"arul";89;100;0
1286;0;"arun";1286;100;0
0;140;"aruna";140;0;100
17;0;"arunas";17;100;0
0;5;"arundhati";5;0;100
0;16;"arunima";16;0;100
345;0;"arush";345;100;0
0;10;"arusha";10;0;100
0;569;"arushi";569;0;100
33;0;"aruther";33;100;0
17;0;"aruthur";17;100;0
0;535;"arva";535;0;100
0;107;"arvada";107;0;100
85;0;"arval";85;100;0
5;0;"arvard";5;100;0
10;0;"arve";10;100;0
0;12;"arveda";12;0;100
0;5;"arveen";5;0;100
2182;0;"arvel";2182;100;0
392;0;"arvell";392;100;0
0;1388;"arvella";1388;0;100
5;0;"arvelle";5;100;0
15;0;"arven";15;100;0
0;20;"arvena";20;0;100
5;0;"arvene";5;100;0
22;0;"arvester";22;100;0
0;20;"arveta";20;0;100
0;182;"arvetta";182;0;100
41;0;"arvey";41;100;0
10;5;"arvi";15;66.6666666666667;33.3333333333333
0;5;"arvia";5;0;100
2952;0;"arvid";2952;100;0
479;260;"arvie";739;64.8173207036536;35.1826792963464
2570;0;"arvil";2570;100;0
10;0;"arvile";10;100;0
22;0;"arvill";22;100;0
0;2677;"arvilla";2677;0;100
758;11;"arville";769;98.5695708712614;1.43042912873862
0;5;"arvillia";5;0;100
4650;0;"arvin";4650;100;0
0;6;"arvina";6;0;100
552;0;"arvind";552;100;0
99;0;"arvine";99;100;0
5;0;"arvion";5;100;0
643;189;"arvis";832;77.2836538461538;22.7163461538462
137;0;"arvle";137;100;0
304;0;"arvo";304;100;0
12;0;"arvol";12;100;0
74;0;"arvon";74;100;0
16;0;"arvy";16;100;0
5;0;"arvydas";5;100;0
0;732;"arwa";732;0;100
0;1971;"arwen";1971;0;100
0;113;"arwilda";113;0;100
0;13;"arwilla";13;0;100
155;0;"arwin";155;100;0
15;0;"arwood";15;100;0
0;374;"arwyn";374;0;100
0;11;"arwynn";11;0;100
292;318;"ary";610;47.8688524590164;52.1311475409836
1867;8953;"arya";10820;17.2550831792976;82.7449168207024
0;75;"aryaa";75;0;100
123;0;"aryaan";123;100;0
0;5;"aryadne";5;0;100
0;915;"aryah";915;0;100
0;76;"aryahi";76;0;100
0;74;"aryahna";74;0;100
0;38;"aryal";38;0;100
15;248;"aryam";263;5.70342205323194;94.2965779467681
228;0;"aryaman";228;100;0
5305;587;"aryan";5892;90.0373387644264;9.96266123557366
0;6022;"aryana";6022;0;100
0;287;"aryanah";287;0;100
0;10;"aryane";10;0;100
0;55;"aryani";55;0;100
0;51;"aryann";51;0;100
0;7937;"aryanna";7937;0;100
0;283;"aryannah";283;0;100
0;59;"aryanne";59;0;100
0;6;"aryanni";6;0;100
33;0;"aryash";33;100;0
0;32;"aryauna";32;0;100
124;0;"aryav";124;100;0
19;0;"aryaveer";19;100;0
0;29;"arybella";29;0;100
296;0;"arye";296;100;0
2319;5;"aryeh";2324;99.7848537005164;0.215146299483649
25;475;"aryel";500;5;95
0;10;"aryela";10;0;100
0;17;"aryell";17;0;100
0;134;"aryella";134;0;100
0;423;"aryelle";423;0;100
30;0;"aryen";30;100;0
11;0;"aryes";11;100;0
0;21;"aryhanna";21;0;100
0;323;"aryia";323;0;100
0;329;"aryiah";329;0;100
26;40;"aryian";66;39.3939393939394;60.6060606060606
0;178;"aryiana";178;0;100
0;191;"aryianna";191;0;100
0;18;"aryiel";18;0;100
12;0;"aryion";12;100;0
35;0;"aryk";35;100;0
0;167;"aryka";167;0;100
0;31;"arykah";31;0;100
357;2481;"aryn";2838;12.5792811839323;87.4207188160676
0;401;"arynn";401;0;100
0;35;"arynne";35;0;100
10;0;"aryo";10;100;0
115;32;"aryon";147;78.2312925170068;21.7687074829932
0;161;"aryona";161;0;100
0;599;"aryonna";599;0;100
13;5;"arys";18;72.2222222222222;27.7777777777778
0;17;"arysa";17;0;100
0;20;"aryss";20;0;100
0;602;"aryssa";602;0;100
0;5;"arysta";5;0;100
5;0;"aryton";5;100;0
12;0;"aryus";12;100;0
33;0;"arza";33;100;0
10;0;"arzel";10;100;0
0;52;"arzelia";52;0;100
81;8;"arzell";89;91.0112359550562;8.98876404494382
0;376;"arzella";376;0;100
0;35;"arzetta";35;0;100
53;0;"arzie";53;100;0
0;5;"arzilla";5;0;100
13;0;"arzjon";13;100;0
39;0;"arzo";39;100;0
0;11;"arzola";11;0;100
0;5;"arzona";5;0;100
0;5;"arzoo";5;0;100
0;93;"arzu";93;0;100
14754;1171;"asa";15925;92.6467817896389;7.35321821036107
375;0;"asaad";375;100;0
5;0;"asaan";5;100;0
0;5;"asacia";5;0;100
1306;0;"asad";1306;100;0
0;5;"asada";5;0;100
27;0;"asadbek";27;100;0
19;0;"asadullah";19;100;0
0;10;"asae";10;0;100
1169;0;"asael";1169;100;0
266;0;"asaf";266;100;0
90;0;"asah";90;100;0
190;0;"asahel";190;100;0
22;0;"asahi";22;100;0
20;0;"asai";20;100;0
458;72;"asaiah";530;86.4150943396226;13.5849056603774
0;5;"asaiya";5;0;100
0;225;"asako";225;0;100
0;35;"asal";35;0;100
0;5;"asala";5;0;100
0;17;"asalah";17;0;100
0;119;"asalee";119;0;100
0;31;"asalia";31;0;100
0;57;"asami";57;0;100
26;0;"asan";26;100;0
0;31;"asana";31;0;100
108;332;"asani";440;24.5454545454545;75.4545454545455
11;0;"asantae";11;100;0
918;223;"asante";1141;80.45574057844;19.54425942156
48;213;"asanti";261;18.3908045977011;81.6091954022989
6;0;"asao";6;100;0
204;0;"asaph";204;100;0
63;0;"asar";63;100;0
0;5;"asaria";5;0;100
0;5;"asasha";5;0;100
0;32;"asata";32;0;100
23;0;"asaun";23;100;0
0;6;"asauni";6;0;100
13;0;"asaya";13;100;0
0;33;"asayo";33;0;100
19;0;"asbel";19;100;0
270;0;"asberry";270;100;0
21;0;"asbery";21;100;0
9;0;"asbiel";9;100;0
474;0;"asbury";474;100;0
540;98;"ascencion";638;84.6394984326019;15.3605015673981
92;52;"ascension";144;63.8888888888889;36.1111111111111
286;0;"ascher";286;100;0
0;29;"aschley";29;0;100
5;0;"aschton";5;100;0
5;0;"asdrubal";5;100;0
6;8;"ase";14;42.8571428571429;57.1428571428571
51;0;"asean";51;100;0
5;0;"aseante";5;100;0
15;5;"aseda";20;75;25
82;642;"aseel";724;11.3259668508287;88.6740331491713
0;19;"aseelah";19;0;100
83;0;"aseem";83;100;0
0;41;"asees";41;0;100
0;5;"asela";5;0;100
0;5;"aselin";5;0;100
5;0;"asem";5;100;0
0;15;"asena";15;0;100
0;25;"asenat";25;0;100
0;382;"asenath";382;0;100
380;110;"asencion";490;77.5510204081633;22.4489795918367
0;15;"asenet";15;0;100
0;47;"aseneth";47;0;100
0;5;"asenith";5;0;100
5;0;"asension";5;100;0
72;0;"aser";72;100;0
0;58;"aseret";58;0;100
0;21;"aset";21;0;100
0;12;"asfia";12;0;100
0;11;"asfiya";11;0;100
978;35;"ash";1013;96.5449160908193;3.45508390918065
32;7485;"asha";7517;0.425701742716509;99.5742982572835
67;0;"ashaad";67;100;0
15;0;"ashaan";15;100;0
170;0;"ashad";170;100;0
0;5;"ashadieeyah";5;0;100
0;36;"ashae";36;0;100
21;15;"ashai";36;58.3333333333333;41.6666666666667
0;10;"ashaiya";10;0;100
0;252;"ashaki";252;0;100
0;27;"ashala";27;0;100
0;23;"ashalee";23;0;100
0;49;"ashaley";49;0;100
0;5;"ashalina";5;0;100
0;10;"ashalyn";10;0;100
135;0;"ashan";135;100;0
0;214;"ashana";214;0;100
0;25;"ashanae";25;0;100
0;23;"ashanda";23;0;100
0;5;"ashane";5;0;100
0;5;"ashanee";5;0;100
0;251;"ashani";251;0;100
0;17;"ashanique";17;0;100
0;94;"ashanna";94;0;100
0;6;"ashanni";6;0;100
6;597;"ashanta";603;0.995024875621891;99.0049751243781
0;104;"ashantae";104;0;100
0;10;"ashantai";10;0;100
0;35;"ashantay";35;0;100
172;1450;"ashante";1622;10.6041923551171;89.3958076448829
0;128;"ashantee";128;0;100
0;5;"ashantey";5;0;100
761;11456;"ashanti";12217;6.22902512891872;93.7709748710813
0;71;"ashantia";71;0;100
0;5;"ashantiana";5;0;100
0;6;"ashantianna";6;0;100
0;52;"ashantie";52;0;100
0;21;"ashantii";21;0;100
0;16;"ashantis";16;0;100
0;540;"ashanty";540;0;100
264;0;"ashar";264;100;0
0;184;"ashara";184;0;100
0;24;"asharee";24;0;100
0;554;"ashari";554;0;100
0;198;"asharia";198;0;100
0;11;"ashariah";11;0;100
0;42;"asharie";42;0;100
0;6;"asharra";6;0;100
0;5;"asharri";5;0;100
5;0;"ashaud";5;100;0
132;0;"ashaun";132;100;0
0;83;"ashauna";83;0;100
0;5;"ashaunie";5;0;100
0;5;"ashaunta";5;0;100
0;5;"ashauntae";5;0;100
0;91;"ashaunte";91;0;100
0;11;"ashauntee";11;0;100
0;366;"ashaunti";366;0;100
0;51;"ashaureah";51;0;100
0;10;"ashauria";10;0;100
193;0;"ashawn";193;100;0
0;106;"ashawna";106;0;100
0;5;"ashawni";5;0;100
0;132;"ashawnti";132;0;100
23;27;"ashay";50;46;54
0;93;"ashaya";93;0;100
0;330;"ashayla";330;0;100
114;0;"ashaz";114;100;0
5;0;"ashburn";5;100;0
1450;645;"ashby";2095;69.2124105011933;30.7875894988067
254;16;"ashden";270;94.0740740740741;5.92592592592593
201;0;"ashdon";201;100;0
31;6;"ashdyn";37;83.7837837837838;16.2162162162162
170;64;"ashe";234;72.6495726495726;27.3504273504274
0;69;"ashea";69;0;100
0;5;"ashee";5;0;100
0;29;"asheena";29;0;100
0;38;"ashelee";38;0;100
0;786;"asheley";786;0;100
0;34;"asheli";34;0;100
0;6;"ashelle";6;0;100
0;32;"ashelly";32;0;100
70;6436;"ashely";6506;1.07592991085152;98.9240700891485
0;285;"ashelyn";285;0;100
0;74;"ashelynn";74;0;100
43033;696;"asher";43729;98.4083788790048;1.59162112099522
0;5;"ashera";5;0;100
0;52;"asherah";52;0;100
99;78;"asheton";177;55.9322033898305;44.0677966101695
0;113;"ashey";113;0;100
416;0;"ashford";416;100;0
0;5;"ashgan";5;0;100
0;23;"ashi";23;0;100
0;2354;"ashia";2354;0;100
0;73;"ashiah";73;0;100
0;54;"ashiana";54;0;100
0;5;"ashianna";5;0;100
0;227;"ashika";227;0;100
0;5;"ashilee";5;0;100
0;11;"ashiley";11;0;100
6;0;"ashim";6;100;0
0;71;"ashima";71;0;100
0;5;"ashini";5;0;100
81;0;"ashir";81;100;0
0;444;"ashira";444;0;100
0;16;"ashirah";16;0;100
877;0;"ashish";877;100;0
0;26;"ashita";26;0;100
0;420;"ashiya";420;0;100
0;166;"ashiyah";166;0;100
0;6;"ashja";6;0;100
0;32;"ashka";32;0;100
199;0;"ashkan";199;100;0
17;0;"ashkii";17;100;0
58;0;"ashkon";58;100;0
0;55;"ashla";55;0;100
0;5;"ashlae";5;0;100
40;995;"ashlan";1035;3.86473429951691;96.1352657004831
126;619;"ashland";745;16.9127516778523;83.0872483221477
0;57;"ashlay";57;0;100
0;546;"ashle";546;0;100
0;3151;"ashlea";3151;0;100
0;178;"ashleah";178;0;100
258;43101;"ashlee";43359;0.595032173251228;99.4049678267488
0;5;"ashleeann";5;0;100
0;512;"ashleen";512;0;100
0;18;"ashleey";18;0;100
0;11;"ashleh";11;0;100
0;2044;"ashlei";2044;0;100
83;31521;"ashleigh";31604;0.262624984179218;99.7373750158208
0;5;"ashlely";5;0;100
13;1004;"ashlen";1017;1.27826941986234;98.7217305801377
15413;841259;"ashley";856672;1.79917167830862;98.2008283216914
0;315;"ashleyann";315;0;100
0;67;"ashleyanne";67;0;100
0;8;"ashleyelizabeth";8;0;100
0;5;"ashleykate";5;0;100
0;34;"ashleylynn";34;0;100
0;28;"ashleymae";28;0;100
0;356;"ashleymarie";356;0;100
0;48;"ashleyn";48;0;100
0;239;"ashleynicole";239;0;100
0;5;"ashleyrae";5;0;100
0;32;"ashleyrose";32;0;100
0;5658;"ashli";5658;0;100
5;9976;"ashlie";9981;0.0500951808436028;99.9499048191564
0;418;"ashliegh";418;0;100
0;6;"ashlii";6;0;100
155;2391;"ashlin";2546;6.08798114689709;93.9120188531029
0;292;"ashling";292;0;100
0;303;"ashlinn";303;0;100
0;5;"ashliy";5;0;100
0;104;"ashlley";104;0;100
0;11;"ashlly";11;0;100
5;68;"ashlon";73;6.84931506849315;93.1506849315068
122;10976;"ashly";11098;1.09929717066138;98.9007028293386
0;391;"ashlye";391;0;100
54;44133;"ashlyn";44187;0.12220788919818;99.8777921108018
0;241;"ashlynd";241;0;100
0;418;"ashlyne";418;0;100
12;22191;"ashlynn";22203;0.0540467504391298;99.9459532495609
0;1520;"ashlynne";1520;0;100
0;6;"ashmeet";6;0;100
0;63;"ashmi";63;0;100
44;0;"ashmit";44;100;0
0;34;"ashmita";34;0;100
0;601;"ashna";601;0;100
11;0;"ashneel";11;100;0
0;5;"ashney";5;0;100
0;67;"ashni";67;0;100
251;0;"ashok";251;100;0
5;0;"ashoka";5;100;0
287;0;"ashon";287;100;0
0;36;"ashonda";36;0;100
0;17;"ashonna";17;0;100
0;24;"ashonta";24;0;100
0;108;"ashonte";108;0;100
0;217;"ashonti";217;0;100
12;0;"ashor";12;100;0
43;0;"ashot";43;100;0
763;0;"ashraf";763;100;0
6;0;"ashrit";6;100;0
0;71;"ashrita";71;0;100
130;0;"ashrith";130;100;0
0;72;"ashritha";72;0;100
0;5;"ashriya";5;0;100
20;0;"ashston";20;100;0
114;119;"ashtan";233;48.9270386266094;51.0729613733906
1074;1102;"ashten";2176;49.3566176470588;50.6433823529412
65;0;"ashtian";65;100;0
1296;1186;"ashtin";2482;52.2159548751007;47.7840451248993
6;0;"ashtion";6;100;0
65067;18417;"ashton";83484;77.939485410378;22.060514589622
37;0;"ashtun";37;100;0
1247;5296;"ashtyn";6543;19.0585358398288;80.9414641601712
8;246;"ashtynn";254;3.1496062992126;96.8503937007874
0;5;"ashuna";5;0;100
0;10;"ashunta";10;0;100
0;39;"ashunte";39;0;100
0;301;"ashunti";301;0;100
446;0;"ashur";446;100;0
0;5;"ashura";5;0;100
61;0;"ashutosh";61;100;0
52;0;"ashvath";52;100;0
0;10;"ashvi";10;0;100
129;0;"ashvik";129;100;0
0;39;"ashvika";39;0;100
165;0;"ashvin";165;100;0
0;30;"ashwaq";30;0;100
139;0;"ashwath";139;100;0
0;103;"ashwika";103;0;100
1826;0;"ashwin";1826;100;0
0;144;"ashwini";144;0;100
0;402;"ashya";402;0;100
0;87;"ashyah";87;0;100
0;134;"ashyia";134;0;100
0;5;"ashyiah";5;0;100
0;88;"ashyla";88;0;100
80;0;"ashyr";80;100;0
0;102;"ashyra";102;0;100
0;5;"ashyria";5;0;100
196;31086;"asia";31282;0.626558404194105;99.3734415958059
189;1548;"asiah";1737;10.880829015544;89.1191709844559
0;31;"asialyn";31;0;100
0;28;"asialynn";28;0;100
0;6;"asiamarie";6;0;100
11;16;"asian";27;40.7407407407407;59.2592592592593
0;386;"asiana";386;0;100
0;82;"asianae";82;0;100
0;5;"asianah";5;0;100
0;5;"asianay";5;0;100
0;5;"asiane";5;0;100
0;381;"asianna";381;0;100
0;5;"asiaonna";5;0;100
40;36;"asie";76;52.6315789473684;47.3684210526316
405;6;"asiel";411;98.5401459854015;1.45985401459854
25;0;"asier";25;100;0
529;0;"asif";529;100;0
0;15;"asiha";15;0;100
0;34;"asija";34;0;100
0;55;"asijah";55;0;100
10;11;"asil";21;47.6190476190476;52.3809523809524
0;44;"asilee";44;0;100
901;0;"asim";901;100;0
0;11;"asimina";11;0;100
90;0;"asir";90;100;0
0;7;"asira";7;0;100
6;0;"asire";6;100;0
5;0;"asis";5;100;0
0;6;"asisha";6;0;100
0;1270;"asiya";1270;0;100
31;966;"asiyah";997;3.10932798395186;96.8906720160481
0;331;"asja";331;0;100
0;200;"asjah";200;0;100
0;28;"asjha";28;0;100
0;73;"asjia";73;0;100
160;0;"askari";160;100;0
329;0;"askia";329;100;0
13;0;"aslam";13;100;0
556;63;"aslan";619;89.8222940226171;10.1777059773829
0;23;"aslean";23;0;100
0;190;"aslee";190;0;100
0;12;"asleigh";12;0;100
0;605;"asley";605;0;100
0;6;"aslhey";6;0;100
0;255;"asli";255;0;100
0;142;"aslin";142;0;100
0;59;"asly";59;0;100
0;324;"aslyn";324;0;100
0;256;"aslynn";256;0;100
0;1846;"asma";1846;0;100
0;757;"asmaa";757;0;100
0;15;"asmahan";15;0;100
170;0;"asmar";170;100;0
0;83;"asmara";83;0;100
0;100;"asmi";100;0;100
31;0;"asmir";31;100;0
0;47;"asmita";47;0;100
0;6;"asmitha";6;0;100
0;64;"asna";64;0;100
287;6;"ason";293;97.9522184300341;2.04778156996587
0;6;"asoni";6;0;100
10;6;"asonte";16;62.5;37.5
0;6;"aspacia";6;0;100
0;261;"aspasia";261;0;100
1263;13069;"aspen";14332;8.81244766955066;91.1875523304493
0;6;"aspenn";6;0;100
0;81;"aspin";81;0;100
10;1462;"aspyn";1472;0.679347826086957;99.320652173913
0;128;"aspynn";128;0;100
0;164;"asra";164;0;100
0;5;"asrar";5;0;100
51;12;"asriel";63;80.9523809523809;19.047619047619
0;24;"assa";24;0;100
150;0;"assad";150;100;0
37;0;"assael";37;100;0
6;0;"assaf";6;100;0
10;0;"assan";10;100;0
0;5;"assandra";5;0;100
19;0;"assane";19;100;0
33;0;"assante";33;100;0
0;545;"assata";545;0;100
51;0;"asser";51;100;0
0;11;"assetou";11;0;100
0;55;"assia";55;0;100
0;7;"assiatou";7;0;100
0;12;"assie";12;0;100
0;10;"assitan";10;0;100
0;5;"assma";5;0;100
0;1335;"assunta";1335;0;100
0;117;"assyria";117;0;100
0;157;"asta";157;0;100
0;46;"astacia";46;0;100
0;26;"astara";26;0;100
0;55;"astaria";55;0;100
0;50;"astasia";50;0;100
0;60;"astella";60;0;100
30;8;"asten";38;78.9473684210526;21.0526315789474
129;290;"aster";419;30.7875894988067;69.2124105011933
0;19;"asteria";19;0;100
0;97;"astha";97;0;100
11;0;"asthon";11;100;0
0;67;"asti";67;0;100
375;157;"astin";532;70.4887218045113;29.5112781954887
5;0;"astley";5;100;0
1923;139;"aston";2062;93.258971871969;6.74102812803104
305;0;"astor";305;100;0
0;236;"astoria";236;0;100
0;77;"astou";77;0;100
0;375;"astra";375;0;100
0;83;"astraea";83;0;100
10;0;"astraeus";10;100;0
0;10;"astraya";10;0;100
0;34;"astrea";34;0;100
0;6;"astreia";6;0;100
0;41;"astri";41;0;100
0;63;"astria";63;0;100
0;8052;"astrid";8052;0;100
0;6;"astride";6;0;100
0;8;"astrin";8;0;100
6;0;"astro";6;100;0
0;15;"astry";15;0;100
0;69;"astryd";69;0;100
24;31;"astyn";55;43.6363636363636;56.3636363636364
0;442;"asucena";442;0;100
0;92;"asuka";92;0;100
0;5;"asul";5;0;100
0;40;"asuna";40;0;100
76;122;"asuncion";198;38.3838383838384;61.6161616161616
0;15;"asunta";15;0;100
0;685;"asusena";685;0;100
0;85;"asuzena";85;0;100
129;0;"aswad";129;100;0
5;0;"aswath";5;100;0
5;0;"aswell";5;100;0
5;0;"aswin";5;100;0
0;1875;"asya";1875;0;100
0;189;"asyah";189;0;100
0;5;"asyana";5;0;100
0;74;"asyia";74;0;100
0;21;"asyiah";21;0;100
0;6;"asyra";6;0;100
0;70;"asyria";70;0;100
0;17;"aszia";17;0;100
0;5;"aszure";5;0;100
207;0;"ata";207;100;0
10;0;"atahan";10;100;0
6;0;"atai";6;100;0
0;6;"ataja";6;0;100
7;0;"atakan";7;100;0
5;0;"atal";5;100;0
0;5;"atalanta";5;0;100
0;160;"atalaya";160;0;100
0;37;"atalee";37;0;100
0;504;"atalia";504;0;100
0;11;"ataliah";11;0;100
0;596;"atalie";596;0;100
0;5;"ataly";5;0;100
0;132;"atalya";132;0;100
353;0;"atanacio";353;100;0
0;6;"atanya";6;0;100
0;820;"atara";820;0;100
0;272;"atarah";272;0;100
79;48;"atari";127;62.2047244094488;37.7952755905512
0;215;"atasha";215;0;100
0;22;"atasia";22;0;100
0;219;"atavia";219;0;100
21;0;"atavion";21;100;0
0;88;"ataya";88;0;100
7;0;"ateeb";7;100;0
11;0;"atef";11;100;0
15;0;"atem";15;100;0
11;0;"aten";11;100;0
0;5;"atena";5;0;100
0;24;"atenas";24;0;100
0;6;"atenea";6;0;100
5;0;"ater";5;100;0
0;5;"atesha";5;0;100
94;1302;"atha";1396;6.73352435530086;93.2664756446991
0;5;"athala";5;0;100
0;102;"athalee";102;0;100
0;21;"athaleen";21;0;100
0;108;"athalene";108;0;100
0;481;"athalia";481;0;100
0;108;"athaliah";108;0;100
0;219;"athalie";219;0;100
1591;0;"athan";1591;100;0
0;469;"athanasia";469;0;100
1111;0;"athanasios";1111;100;0
101;0;"athanasius";101;100;0
23;0;"athaniel";23;100;0
703;0;"atharv";703;100;0
549;0;"atharva";549;100;0
0;186;"athea";186;0;100
0;17;"atheana";17;0;100
0;180;"atheena";180;0;100
0;5;"atheer";5;0;100
298;36;"athel";334;89.2215568862275;10.7784431137725
0;110;"athelene";110;0;100
0;16;"athelia";16;0;100
0;7;"atheline";7;0;100
509;0;"athen";509;100;0
0;28797;"athena";28797;0;100
0;5;"athenamarie";5;0;100
0;12;"athenarose";12;0;100
0;135;"athene";135;0;100
0;47;"athenea";47;0;100
0;110;"athenia";110;0;100
0;22;"athenna";22;0;100
67;13;"athens";80;83.75;16.25
22;17;"ather";39;56.4102564102564;43.5897435897436
0;42;"atherine";42;0;100
6;0;"atherton";6;100;0
0;5;"athie";5;0;100
0;758;"athina";758;0;100
0;40;"athira";40;0;100
0;5;"athlee";5;0;100
0;141;"athleen";141;0;100
0;25;"athlene";25;0;100
0;5;"athlyn";5;0;100
136;0;"athol";136;100;0
11;0;"athon";11;100;0
516;0;"athony";516;100;0
14;0;"athos";14;100;0
0;10;"athryn";10;0;100
0;5;"athulya";5;0;100
0;5;"athylene";5;0;100
0;38;"athyna";38;0;100
0;463;"athziri";463;0;100
0;334;"athziry";334;0;100
0;374;"atia";374;0;100
0;508;"atiana";508;0;100
0;189;"atianna";189;0;100
367;5;"atiba";372;98.6559139784946;1.34408602150538
0;5;"atie";5;0;100
420;0;"atif";420;100;0
0;5;"atifa";5;0;100
19;0;"atiim";19;100;0
0;59;"atika";59;0;100
45;0;"atiksh";45;100;0
167;0;"atilano";167;100;0
5;0;"atilio";5;100;0
78;0;"atilla";78;100;0
0;207;"atina";207;0;100
0;5;"atinuke";5;0;100
0;287;"atira";287;0;100
0;124;"atisha";124;0;100
6;0;"atit";6;100;0
0;7;"ativa";7;0;100
0;1314;"atiya";1314;0;100
0;196;"atiyah";196;0;100
0;67;"atiyana";67;0;100
0;6;"atiyanna";6;0;100
0;9;"atiyya";9;0;100
0;10;"atiyyah";10;0;100
42;0;"atlai";42;100;0
0;632;"atlanta";632;0;100
17;421;"atlantis";438;3.88127853881279;96.1187214611872
3362;185;"atlas";3547;94.7843247815055;5.2156752184945
0;55;"atlean";55;0;100
1072;239;"atlee";1311;81.769641495042;18.230358504958
0;144;"atleigh";144;0;100
398;388;"atley";786;50.6361323155216;49.3638676844784
0;5;"atline";5;0;100
5;0;"atlis";5;100;0
10;0;"atnhony";10;100;0
56;0;"ato";56;100;0
0;5;"atoli";5;0;100
622;0;"atom";622;100;0
0;10;"atong";10;0;100
0;18;"atonia";18;0;100
13;0;"atonio";13;100;0
0;83;"atonya";83;0;100
0;15;"atoria";15;0;100
0;17;"atosha";17;0;100
0;153;"atoya";153;0;100
5;0;"atravion";5;100;0
27;0;"atrayu";27;100;0
16;0;"atreal";16;100;0
5;0;"atreau";5;100;0
6;0;"atreju";6;100;0
6;0;"atrell";6;100;0
5;0;"atreo";5;100;0
5;0;"atreu";5;100;0
16;0;"atreus";16;100;0
27;6;"atreya";33;81.8181818181818;18.1818181818182
1605;0;"atreyu";1605;100;0
0;5;"atrice";5;0;100
0;5;"atricia";5;0;100
13;0;"atrick";13;100;0
0;13;"atrina";13;0;100
0;16;"atsuko";16;0;100
86;0;"atsushi";86;100;0
12;5;"atta";17;70.5882352941177;29.4117647058824
0;6;"attache";6;0;100
0;18;"attalia";18;0;100
0;32;"attalie";32;0;100
0;55;"attallah";55;0;100
194;0;"atthew";194;100;0
0;7;"attia";7;0;100
0;13;"attiana";13;0;100
0;17;"attica";17;0;100
7892;39;"atticus";7931;99.5082587315597;0.491741268440298
0;222;"attie";222;0;100
104;0;"attikus";104;100;0
557;0;"attila";557;100;0
1022;0;"attilio";1022;100;0
16;0;"attis";16;100;0
0;39;"attison";39;0;100
0;10;"attiya";10;0;100
0;11;"attiyya";11;0;100
6;0;"attley";6;100;0
0;19;"attoria";19;0;100
212;0;"atul";212;100;0
5;0;"atward";5;100;0
128;0;"atwell";128;100;0
334;0;"atwood";334;100;0
0;37;"atyana";37;0;100
0;13;"atyanna";13;0;100
0;15;"atyia";15;0;100
153;0;"atzel";153;100;0
0;27;"atzhiri";27;0;100
0;11;"atzhiry";11;0;100
0;48;"atzi";48;0;100
0;10;"atzimba";10;0;100
105;22;"atzin";127;82.6771653543307;17.3228346456693
0;481;"atziri";481;0;100
0;408;"atziry";408;0;100
6;0;"auberon";6;100;0
85;0;"aubert";85;100;0
503;82;"aubery";585;85.982905982906;14.017094017094
24;5;"aubie";29;82.7586206896552;17.2413793103448
44;11;"aubin";55;80;20
304;37;"aubra";341;89.149560117302;10.8504398826979
0;18;"aubray";18;0;100
15;714;"aubre";729;2.05761316872428;97.9423868312757
0;400;"aubrea";400;0;100
0;5;"aubreah";5;0;100
0;202;"aubreana";202;0;100
0;385;"aubreanna";385;0;100
0;5;"aubreauna";5;0;100
41;33948;"aubree";33989;0.120627261761158;99.8793727382388
0;24;"aubreeana";24;0;100
0;14;"aubreeann";14;0;100
0;33;"aubreeanna";33;0;100
0;12;"aubreella";12;0;100
0;36;"aubreelynn";36;0;100
0;6;"aubreerose";6;0;100
0;470;"aubrei";470;0;100
0;974;"aubreigh";974;0;100
0;11;"aubrelle";11;0;100
11;25;"aubren";36;30.5555555555556;69.4444444444444
0;5;"aubreona";5;0;100
0;21;"aubreonna";21;0;100
29360;100324;"aubrey";129684;22.6396471422843;77.3603528577157
0;261;"aubreyana";261;0;100
0;39;"aubreyann";39;0;100
0;305;"aubreyanna";305;0;100
0;36;"aubreyella";36;0;100
0;5;"aubreyelle";5;0;100
0;5;"aubreyjo";5;0;100
0;22;"aubreylynn";22;0;100
0;17;"aubreyona";17;0;100
0;17;"aubreyonna";17;0;100
0;18;"aubreyrose";18;0;100
0;3692;"aubri";3692;0;100
0;149;"aubria";149;0;100
0;7;"aubriahna";7;0;100
0;2727;"aubriana";2727;0;100
0;36;"aubrianah";36;0;100
0;10;"aubriann";10;0;100
0;3716;"aubrianna";3716;0;100
0;16;"aubriannah";16;0;100
0;146;"aubrianne";146;0;100
0;65;"aubriauna";65;0;100
0;5;"aubriaunna";5;0;100
0;12041;"aubrie";12041;0;100
0;11;"aubrieana";11;0;100
0;26;"aubrieanna";26;0;100
0;196;"aubriee";196;0;100
0;61;"aubriegh";61;0;100
0;246;"aubriel";246;0;100
0;12;"aubriela";12;0;100
0;1658;"aubriella";1658;0;100
0;2525;"aubrielle";2525;0;100
0;188;"aubrii";188;0;100
0;5;"aubrilyn";5;0;100
0;16;"aubrin";16;0;100
0;92;"aubrina";92;0;100
0;33;"aubriona";33;0;100
0;117;"aubrionna";117;0;100
0;10;"aubriyana";10;0;100
1585;2775;"aubry";4360;36.3532110091743;63.6467889908257
0;274;"aubryana";274;0;100
0;253;"aubryanna";253;0;100
0;41;"aubrye";41;0;100
0;16;"aubryella";16;0;100
0;11;"aubryelle";11;0;100
0;328;"aubryn";328;0;100
0;114;"aubrynn";114;0;100
686;1038;"auburn";1724;39.7911832946636;60.2088167053364
0;37;"aubyn";37;0;100
14;0;"aud";14;100;0
0;209;"auda";209;0;100
7;0;"auddie";7;100;0
0;5;"aude";5;0;100
0;26;"audean";26;0;100
0;10;"audee";10;0;100
205;0;"audel";205;100;0
0;712;"audelia";712;0;100
5;0;"audelio";5;100;0
6;0;"audeliz";6;100;0
0;28;"audell";28;0;100
0;5;"audella";5;0;100
994;417;"auden";1411;70.446491849752;29.5535081502481
0;45;"audene";45;0;100
0;495;"audery";495;0;100
0;7;"audette";7;0;100
12;0;"audey";12;100;0
85;134;"audi";219;38.8127853881278;61.1872146118721
0;49;"audia";49;0;100
0;37;"audiana";37;0;100
0;69;"audianna";69;0;100
3980;2028;"audie";6008;66.2450066577896;33.7549933422104
67;0;"audiel";67;100;0
15;0;"audin";15;100;0
0;213;"audine";213;0;100
6;0;"audio";6;100;0
16;0;"audis";16;100;0
672;5;"audley";677;99.261447562777;0.738552437223043
0;11;"audna";11;0;100
68;0;"audon";68;100;0
193;24221;"audra";24414;0.790530023756861;99.2094699762431
0;39;"audrae";39;0;100
0;5;"audranna";5;0;100
0;79;"audray";79;0;100
0;8;"audraya";8;0;100
40;820;"audre";860;4.65116279069767;95.3488372093023
0;2083;"audrea";2083;0;100
0;267;"audreana";267;0;100
0;524;"audreanna";524;0;100
0;7;"audreauna";7;0;100
0;2978;"audree";2978;0;100
0;71;"audreena";71;0;100
0;24;"audrei";24;0;100
0;22;"audreigh";22;0;100
0;108;"audrena";108;0;100
0;41;"audrene";41;0;100
0;5;"audreona";5;0;100
0;18;"audresha";18;0;100
2858;270805;"audrey";273663;1.04435016790724;98.9556498320927
0;12;"audreya";12;0;100
0;205;"audreyana";205;0;100
0;14;"audreyann";14;0;100
0;392;"audreyanna";392;0;100
0;5;"audreyna";5;0;100
0;5;"audreyonna";5;0;100
0;11;"audreyrose";11;0;100
0;1056;"audri";1056;0;100
0;1227;"audria";1227;0;100
0;4151;"audriana";4151;0;100
0;4142;"audrianna";4142;0;100
0;27;"audrianne";27;0;100
0;47;"audriauna";47;0;100
0;5;"audriaunna";5;0;100
384;0;"audric";384;100;0
50;0;"audrick";50;100;0
5;3629;"audrie";3634;0.137589433131536;99.8624105668685
0;5;"audrieana";5;0;100
0;55;"audrieanna";55;0;100
0;6;"audriel";6;0;100
0;70;"audriella";70;0;100
0;152;"audrielle";152;0;100
0;24;"audriena";24;0;100
0;19;"audrienna";19;0;100
0;26;"audrienne";26;0;100
0;5;"audrii";5;0;100
0;7197;"audrina";7197;0;100
0;17;"audrinah";17;0;100
0;176;"audrinna";176;0;100
0;14;"audriona";14;0;100
0;94;"audrionna";94;0;100
0;102;"audris";102;0;100
0;5;"audrone";5;0;100
496;3899;"audry";4395;11.2855517633675;88.7144482366325
0;99;"audryana";99;0;100
0;126;"audryanna";126;0;100
0;157;"audryna";157;0;100
0;11;"audrynna";11;0;100
5;0;"audvik";5;100;0
351;0;"audwin";351;100;0
274;12;"audy";286;95.8041958041958;4.1958041958042
5;59;"audyn";64;7.8125;92.1875
29;0;"auggie";29;100;0
573;5;"augie";578;99.1349480968858;0.865051903114187
15;0;"augus";15;100;0
37353;3561;"august";40914;91.2963777680012;8.70362223199883
1610;11369;"augusta";12979;12.4046536713152;87.5953463286848
19;0;"augustas";19;100;0
281;13;"auguste";294;95.578231292517;4.42176870748299
94;0;"augusten";94;100;0
29;0;"auguster";29;100;0
3515;0;"augustin";3515;100;0
0;2053;"augustina";2053;0;100
12232;3425;"augustine";15657;78.1248004087629;21.8751995912371
400;0;"augustino";400;100;0
5;0;"augustis";5;100;0
1464;0;"augusto";1464;100;0
14517;10;"augustus";14527;99.9311626626282;0.0688373373717905
5;0;"augustyn";5;100;0
0;42;"auja";42;0;100
0;10;"aujah";10;0;100
0;188;"aujanae";188;0;100
0;5;"aujanai";5;0;100
0;11;"aujane";11;0;100
53;0;"aukai";53;100;0
5;0;"aukeem";5;100;0
0;10;"aukievah";10;0;100
46;0;"aul";46;100;0
0;5;"aula";5;0;100
0;462;"aulani";462;0;100
0;13;"aulbrey";13;0;100
0;5;"aulda";5;0;100
73;0;"aulden";73;100;0
0;18;"aulelei";18;0;100
0;11;"aulene";11;0;100
0;21;"aulii";21;0;100
0;38;"auline";38;0;100
0;6;"aulona";6;0;100
0;38;"aulora";38;0;100
106;0;"aulton";106;100;0
168;0;"aum";168;100;0
5;0;"aumi";5;100;0
0;5;"aumya";5;0;100
17;0;"aun";17;100;0
0;436;"auna";436;0;100
0;13;"aunah";13;0;100
0;40;"aunalee";40;0;100
0;10;"aunaleigh";10;0;100
838;431;"aundra";1269;66.0362490149724;33.9637509850276
26;0;"aundrae";26;100;0
211;0;"aundray";211;100;0
0;94;"aundraya";94;0;100
1213;0;"aundre";1213;100;0
181;4631;"aundrea";4812;3.76142975893599;96.238570241064
0;6;"aundreah";6;0;100
0;5;"aundreia";5;0;100
316;5;"aundrey";321;98.4423676012461;1.55763239875389
0;132;"aundreya";132;0;100
0;783;"aundria";783;0;100
0;312;"aune";312;0;100
19;0;"auner";19;100;0
0;110;"aunesti";110;0;100
0;205;"aunesty";205;0;100
44;0;"aung";44;100;0
0;24;"aungelique";24;0;100
0;10;"auni";10;0;100
0;108;"aunica";108;0;100
0;325;"aunika";325;0;100
0;17;"aunisti";17;0;100
0;78;"aunisty";78;0;100
0;10;"auniya";10;0;100
0;5;"aunjel";5;0;100
0;377;"aunna";377;0;100
0;5;"aunnika";5;0;100
0;115;"aunya";115;0;100
0;38;"aunyae";38;0;100
0;27;"aunye";27;0;100
0;2864;"aura";2864;0;100
0;7;"aurabella";7;0;100
0;12;"auralee";12;0;100
0;23;"auralia";23;0;100
13;0;"aurash";13;100;0
0;5;"auraya";5;0;100
0;24;"aurbree";24;0;100
0;1060;"aurea";1060;0;100
0;10;"aureana";10;0;100
0;10;"aureanna";10;0;100
0;18;"auree";18;0;100
177;33;"aurel";210;84.2857142857143;15.7142857142857
49;0;"aurele";49;100;0
0;5;"aureli";5;0;100
0;11790;"aurelia";11790;0;100
0;25;"aureliana";25;0;100
567;0;"aureliano";567;100;0
0;394;"aurelie";394;0;100
6667;6;"aurelio";6673;99.9100854188521;0.0899145811479095
717;0;"aurelius";717;100;0
0;31;"aurella";31;0;100
0;13;"aurellia";13;0;100
0;6;"aurelya";6;0;100
63;40;"auren";103;61.1650485436893;38.8349514563107
5;0;"aureo";5;100;0
0;10;"aureon";10;0;100
0;5;"auretta";5;0;100
5;0;"aureus";5;100;0
0;10;"aurey";10;0;100
20;326;"auri";346;5.78034682080925;94.2196531791908
0;763;"auria";763;0;100
0;46;"auriah";46;0;100
6;11;"aurian";17;35.2941176470588;64.7058823529412
0;600;"auriana";600;0;100
0;614;"aurianna";614;0;100
11;0;"auric";11;100;0
25;0;"aurick";25;100;0
0;297;"aurie";297;0;100
42;725;"auriel";767;5.47588005215124;94.5241199478488
0;171;"auriella";171;0;100
0;649;"aurielle";649;0;100
0;10;"aurieona";10;0;100
16;0;"aurik";16;100;0
0;5;"auril";5;0;100
0;127;"aurilla";127;0;100
5;0;"aurin";5;100;0
24;30;"aurion";54;44.4444444444444;55.5555555555556
0;5;"auriona";5;0;100
0;13;"aurionna";13;0;100
0;14;"auriya";14;0;100
0;12;"auriyah";12;0;100
0;14;"auriyana";14;0;100
0;13;"auroara";13;0;100
16;0;"aurohom";16;100;0
417;0;"auron";417;100;0
48;47409;"aurora";47457;0.101144193691131;99.8988558063089
0;114;"aurorah";114;0;100
0;5;"auroralee";5;0;100
0;5;"auroralynn";5;0;100
0;546;"aurore";546;0;100
0;5;"auroura";5;0;100
0;5;"aurra";5;0;100
284;0;"aurther";284;100;0
17;0;"aurthor";17;100;0
403;0;"aurthur";403;100;0
5;102;"aury";107;4.67289719626168;95.3271028037383
0;11;"auryana";11;0;100
0;12;"auryanna";12;0;100
44;11;"auryn";55;80;20
119;0;"ausar";119;100;0
10;0;"ausbon";10;100;0
10;0;"ausby";10;100;0
78;0;"ausencio";78;100;0
0;116;"auset";116;0;100
0;238;"ausha";238;0;100
0;5;"ausia";5;0;100
5;0;"ausie";5;100;0
30;0;"ausitn";30;100;0
0;15;"austa";15;0;100
191;0;"austan";191;100;0
0;7;"austeja";7;0;100
7428;763;"austen";8191;90.6848980588451;9.31510194115492
0;20;"austi";20;0;100
401375;4413;"austin";405788;98.9124863229075;1.08751367709247
0;105;"austina";105;0;100
153;168;"austine";321;47.6635514018692;52.3364485981308
37;0;"austinjames";37;100;0
11;0;"austinjohn";11;100;0
15;0;"austinlee";15;100;0
33;0;"austinmichael";33;100;0
28;0;"austinn";28;100;0
11;0;"austintyler";11;100;0
3326;0;"auston";3326;100;0
11;332;"australia";343;3.2069970845481;96.7930029154519
16;0;"austreberto";16;100;0
0;17;"austria";17;0;100
49;0;"austun";49;100;0
4515;2836;"austyn";7351;61.4202149367433;38.5797850632567
0;228;"austynn";228;0;100
0;5;"autavia";5;0;100
17;0;"authar";17;100;0
2245;17;"auther";2262;99.2484526967286;0.751547303271441
0;51;"autherine";51;0;100
2084;0;"author";2084;100;0
2128;0;"authur";2128;100;0
0;48;"autiana";48;0;100
0;8;"autianna";8;0;100
11;62;"autie";73;15.0684931506849;84.9315068493151
11;0;"autin";11;100;0
5;0;"autis";5;100;0
0;11;"autmn";11;0;100
0;10;"autom";10;0;100
0;6;"automn";6;0;100
0;5;"autra";5;0;100
213;21;"autrey";234;91.025641025641;8.97435897435897
1131;197;"autry";1328;85.1656626506024;14.8343373493976
0;5;"auttum";5;0;100
0;5;"auttumn";5;0;100
0;3175;"autum";3175;0;100
0;11;"autume";11;0;100
0;125;"autumm";125;0;100
270;116635;"autumn";116905;0.2309567597622;99.7690432402378
0;62;"autumne";62;0;100
0;12;"autumnn";12;0;100
0;90;"autumnrose";90;0;100
0;13;"autunm";13;0;100
17;0;"auturo";17;100;0
0;59;"autym";59;0;100
0;222;"autymn";222;0;100
8;0;"autzen";8;100;0
0;17;"auviana";17;0;100
0;5;"auvianna";5;0;100
0;22;"auzhane";22;0;100
10;0;"auzie";10;100;0
5;0;"av";5;100;0
279;233991;"ava";234270;0.119093353822512;99.8809066461775
0;20;"avaa";20;0;100
0;6;"avaah";6;0;100
13;0;"avaan";13;100;0
0;6;"avaani";6;0;100
0;82;"avabella";82;0;100
0;34;"avabelle";34;0;100
0;41;"avaclaire";41;0;100
0;108;"avacyn";108;0;100
0;6;"avadna";6;0;100
0;5;"avae";5;0;100
0;10;"avaeah";10;0;100
0;64;"avaeh";64;0;100
0;15;"avaelizabeth";15;0;100
0;82;"avagail";82;0;100
0;314;"avagrace";314;0;100
0;3744;"avah";3744;0;100
0;5;"avahlyn";5;0;100
0;21;"avahlynn";21;0;100
0;16;"avaia";16;0;100
0;82;"avaiah";82;0;100
0;34;"avaiya";34;0;100
0;42;"avaiyah";42;0;100
0;6;"avajames";6;0;100
0;6;"avajane";6;0;100
0;5;"avajo";5;0;100
0;5;"avajoy";5;0;100
0;16;"avakate";16;0;100
0;5;"avala";5;0;100
0;8;"avalanna";8;0;100
0;42;"avalea";42;0;100
0;824;"avalee";824;0;100
0;77;"avaleen";77;0;100
0;6;"avaleena";6;0;100
0;42;"avalei";42;0;100
0;498;"avaleigh";498;0;100
0;51;"avalena";51;0;100
0;149;"avalene";149;0;100
0;51;"avaley";51;0;100
0;5;"avali";5;0;100
0;15;"avalia";15;0;100
0;70;"avalie";70;0;100
0;5;"avaliese";5;0;100
0;73;"avalin";73;0;100
0;261;"avalina";261;0;100
0;177;"avaline";177;0;100
0;32;"avalise";32;0;100
30;3051;"avalon";3081;0.973709834469328;99.0262901655307
0;1951;"avalyn";1951;0;100
0;5;"avalyna";5;0;100
0;19;"avalyne";19;0;100
0;1825;"avalynn";1825;0;100
0;146;"avalynne";146;0;100
0;23;"avalyse";23;0;100
0;79;"avamae";79;0;100
0;21;"avamaria";21;0;100
0;767;"avamarie";767;0;100
0;5;"avamay";5;0;100
0;5;"avamonroe";5;0;100
647;48;"avan";695;93.0935251798561;6.90647482014388
0;201;"avana";201;0;100
0;5;"avanah";5;0;100
6;0;"avander";6;100;0
196;0;"avaneesh";196;100;0
0;11;"avanel";11;0;100
0;642;"avanell";642;0;100
0;502;"avanelle";502;0;100
0;5;"avangaline";5;0;100
0;5;"avangelene";5;0;100
0;6;"avangelia";6;0;100
0;89;"avangelina";89;0;100
0;264;"avangeline";264;0;100
17;2244;"avani";2261;0.75187969924812;99.2481203007519
0;6;"avanicole";6;0;100
59;0;"avanish";59;100;0
0;186;"avanna";186;0;100
0;59;"avannah";59;0;100
0;77;"avanni";77;0;100
547;0;"avant";547;100;0
12;0;"avanta";12;100;0
132;0;"avantae";132;100;0
17;0;"avantay";17;100;0
713;38;"avante";751;94.9400798934754;5.05992010652463
0;5;"avanthi";5;0;100
0;51;"avanthika";51;0;100
52;296;"avanti";348;14.9425287356322;85.0574712643678
0;281;"avantika";281;0;100
0;12;"avanya";12;0;100
0;88;"avarae";88;0;100
20;0;"avard";20;100;0
0;354;"avaree";354;0;100
0;6;"avareigh";6;0;100
0;130;"avarey";130;0;100
87;660;"avari";747;11.6465863453815;88.3534136546185
0;1211;"avarie";1211;0;100
0;24;"avariella";24;0;100
0;15;"avarielle";15;0;100
0;242;"avarose";242;0;100
92;1325;"avary";1417;6.49258997882851;93.5074100211715
6;0;"avash";6;100;0
0;18;"avasophia";18;0;100
11;0;"avaughn";11;100;0
0;718;"avaya";718;0;100
0;442;"avayah";442;0;100
0;5;"avayiah";5;0;100
0;24;"avayla";24;0;100
0;796;"ave";796;0;100
0;131;"avea";131;0;100
0;285;"aveah";285;0;100
0;5;"aveaha";5;0;100
0;5;"aveana";5;0;100
0;30;"aveanna";30;0;100
0;5;"aveda";5;0;100
68;0;"avedis";68;100;0
0;22;"avee";22;0;100
0;51;"aveen";51;0;100
0;75;"aveena";75;0;100
98;0;"aveer";98;100;0
0;5;"aveigha";5;0;100
140;0;"aveion";140;100;0
370;0;"avel";370;100;0
278;0;"avelardo";278;100;0
0;62;"aveleen";62;0;100
0;5;"avelene";5;0;100
0;16;"avelia";16;0;100
0;5;"avelie";5;0;100
0;31;"avelin";31;0;100
0;1369;"avelina";1369;0;100
0;603;"aveline";603;0;100
0;5;"avelinn";5;0;100
972;0;"avelino";972;100;0
0;32;"avella";32;0;100
0;6;"avellana";6;0;100
0;5;"avelle";5;0;100
0;5;"avellina";5;0;100
0;654;"avelyn";654;0;100
0;190;"avelynn";190;0;100
0;10;"avemaria";10;0;100
1674;1131;"aven";2805;59.6791443850267;40.3208556149733
0;30;"avena";30;0;100
0;137;"avenell";137;0;100
0;17;"avenelle";17;0;100
212;0;"avenir";212;100;0
0;15;"avenlea";15;0;100
0;5;"avenlee";5;0;100
0;30;"avenleigh";30;0;100
0;26;"avenley";26;0;100
0;66;"avenly";66;0;100
5;0;"avenn";5;100;0
367;20;"aveon";387;94.8320413436692;5.16795865633075
0;21;"aveona";21;0;100
0;21;"aveonna";21;0;100
0;15;"aver";15;0;100
0;11;"avera";11;0;100
30;763;"averee";793;3.78310214375788;96.2168978562421
0;51;"avereigh";51;0;100
22;0;"averell";22;100;0
20;0;"averett";20;100;0
168;368;"averey";536;31.3432835820896;68.6567164179104
226;5219;"averi";5445;4.1505968778696;95.8494031221304
0;169;"averiana";169;0;100
0;155;"averianna";155;0;100
10;0;"averick";10;100;0
162;7884;"averie";8046;2.01342281879195;97.9865771812081
0;11;"averiee";11;0;100
0;5;"averiella";5;0;100
0;8;"averielle";8;0;100
0;35;"averii";35;0;100
44;386;"averil";430;10.2325581395349;89.7674418604651
228;110;"averill";338;67.4556213017752;32.5443786982249
11;0;"averion";11;100;0
0;10;"averionna";10;0;100
0;46;"averlee";46;0;100
0;45;"averleigh";45;0;100
0;38;"averley";38;0;100
0;5;"averlie";5;0;100
0;189;"averly";189;0;100
51020;109543;"avery";160563;31.7756892932992;68.2243107067008
0;139;"averyana";139;0;100
0;136;"averyanna";136;0;100
0;21;"averyl";21;0;100
0;28;"averylynn";28;0;100
0;5;"averymarie";5;0;100
5;0;"averyn";5;100;0
7;0;"averyon";7;100;0
0;7;"averyona";7;0;100
0;24;"averyonna";24;0;100
0;19;"averyrose";19;0;100
0;7;"aves";7;0;100
5;0;"avet";5;100;0
42;0;"avetis";42;100;0
286;12;"avett";298;95.9731543624161;4.02684563758389
0;115;"avey";115;0;100
0;153;"aveya";153;0;100
0;163;"aveyah";163;0;100
52;0;"aveyon";52;100;0
3583;467;"avi";4050;88.4691358024691;11.5308641975309
0;1177;"avia";1177;0;100
12;0;"aviad";12;100;0
0;245;"aviah";245;0;100
0;6;"aviahna";6;0;100
1117;277;"avian";1394;80.12912482066;19.87087517934
0;4175;"aviana";4175;0;100
0;133;"avianah";133;0;100
0;28;"avianca";28;0;100
0;461;"aviance";461;0;100
0;3584;"avianna";3584;0;100
0;123;"aviannah";123;0;100
0;21;"avianne";21;0;100
0;5;"aviara";5;0;100
0;10;"aviary";10;0;100
0;184;"avice";184;0;100
5;0;"avichai";5;100;0
227;0;"avid";227;100;0
50;0;"avidan";50;100;0
11;1124;"avie";1135;0.969162995594714;99.0308370044053
650;19;"aviel";669;97.1599402092676;2.84005979073244
0;100;"aviela";100;0;100
0;142;"aviella";142;0;100
6;234;"avielle";240;2.5;97.5
163;0;"avien";163;100;0
0;14;"avienda";14;0;100
0;131;"aviendha";131;0;100
0;7;"avienne";7;0;100
11;0;"avieon";11;100;0
75;0;"avier";75;100;0
0;1470;"avigail";1470;0;100
0;457;"avigayil";457;0;100
344;0;"avigdor";344;100;0
10;0;"avighna";10;100;0
209;0;"avik";209;100;0
0;267;"avika";267;0;100
0;255;"avila";255;0;100
0;11;"avilee";11;0;100
0;110;"avilene";110;0;100
0;65;"avilyn";65;0;100
0;39;"avilynn";39;0;100
35;0;"avimael";35;100;0
734;58;"avin";792;92.6767676767677;7.32323232323232
0;162;"avina";162;0;100
902;0;"avinash";902;100;0
0;21;"avinell";21;0;100
5;0;"avinoam";5;100;0
1703;290;"avion";1993;85.4490717511289;14.550928248871
0;275;"aviona";275;0;100
0;17;"avionce";17;0;100
0;5;"avione";5;0;100
0;558;"avionna";558;0;100
0;19;"avionne";19;0;100
34;0;"avir";34;100;0
0;31;"avira";31;0;100
5;0;"aviraaj";5;100;0
72;0;"aviraj";72;100;0
5;0;"aviral";5;100;0
5;0;"aviram";5;100;0
0;11;"aviree";11;0;100
788;16550;"avis";17338;4.54493021109701;95.455069788903
65;0;"avish";65;100;0
0;32;"avisha";32;0;100
157;0;"avishai";157;100;0
5;0;"avishek";5;100;0
0;31;"avishi";31;0;100
0;13;"avishka";13;0;100
0;55;"avita";55;0;100
18;0;"avitaj";18;100;0
0;761;"avital";761;0;100
5;0;"avitaz";5;100;0
465;115;"aviv";580;80.1724137931034;19.8275862068966
0;2661;"aviva";2661;0;100
0;5;"avivah";5;0;100
0;249;"aviya";249;0;100
0;130;"aviyah";130;0;100
0;110;"aviyana";110;0;100
0;80;"aviyanna";80;0;100
93;6;"aviyon";99;93.9393939393939;6.06060606060606
0;11;"aviyonna";11;0;100
0;158;"avleen";158;0;100
0;29;"avlyn";29;0;100
0;53;"avlynn";53;0;100
36;0;"avneesh";36;100;0
5;379;"avneet";384;1.30208333333333;98.6979166666667
234;0;"avner";234;100;0
0;933;"avni";933;0;100
15;0;"avnish";15;100;0
0;44;"avnoor";44;0;100
5;162;"avo";167;2.9940119760479;97.0059880239521
0;5;"avola";5;0;100
1483;700;"avon";2183;67.9340357306459;32.0659642693541
0;35;"avona";35;0;100
0;94;"avonda";94;0;100
112;0;"avondre";112;100;0
0;5;"avonel";5;0;100
0;186;"avonell";186;0;100
0;284;"avonelle";284;0;100
0;820;"avonlea";820;0;100
0;12;"avonlee";12;0;100
0;256;"avonna";256;0;100
0;182;"avonne";182;0;100
0;6;"avonni";6;0;100
19;0;"avont";19;100;0
31;0;"avonta";31;100;0
199;0;"avontae";199;100;0
25;0;"avontay";25;100;0
410;0;"avonte";410;100;0
0;5;"avor";5;0;100
0;9;"avoree";9;0;100
0;15;"avori";15;0;100
0;45;"avorie";45;0;100
284;380;"avory";664;42.7710843373494;57.2289156626506
0;36;"avra";36;0;100
3276;0;"avraham";3276;100;0
50;0;"avrahom";50;100;0
32;0;"avraj";32;100;0
750;0;"avram";750;100;0
11;433;"avree";444;2.47747747747748;97.5225225225225
0;17;"avreet";17;0;100
0;10;"avreigh";10;0;100
8;0;"avren";8;100;0
263;332;"avrey";595;44.2016806722689;55.7983193277311
23;378;"avri";401;5.7356608478803;94.2643391521197
60;0;"avrian";60;100;0
0;168;"avriana";168;0;100
0;202;"avrianna";202;0;100
10;862;"avrie";872;1.14678899082569;98.8532110091743
16;121;"avriel";137;11.6788321167883;88.3211678832117
0;18;"avriella";18;0;100
0;152;"avrielle";152;0;100
5;0;"avrik";5;100;0
5;2474;"avril";2479;0.201694231544978;99.798305768455
0;5;"avrill";5;0;100
0;5;"avrilynn";5;0;100
5;0;"avrion";5;100;0
23;0;"avroham";23;100;0
2606;0;"avrohom";2606;100;0
64;0;"avrom";64;100;0
33;0;"avron";33;100;0
0;10;"avrora";10;0;100
384;0;"avrum";384;100;0
35;0;"avrumi";35;100;0
18;0;"avrumy";18;100;0
413;454;"avry";867;47.6355247981546;52.3644752018454
0;81;"avryl";81;0;100
0;7;"avryn";7;0;100
5;0;"avshalom";5;100;0
0;17;"avva";17;0;100
16;286;"avy";302;5.29801324503311;94.7019867549669
0;60;"avya";60;0;100
157;0;"avyaan";157;100;0
257;0;"avyan";257;100;0
0;190;"avyana";190;0;100
0;5;"avyanah";5;0;100
0;387;"avyanna";387;0;100
5;0;"avyansh";5;100;0
109;0;"avyay";109;100;0
5;0;"avyion";5;100;0
163;207;"avyn";370;44.0540540540541;55.9459459459459
0;6;"avynlee";6;0;100
0;58;"avynn";58;0;100
89;0;"avyon";89;100;0
0;7;"avyona";7;0;100
0;75;"avyonna";75;0;100
148;0;"avyukt";148;100;0
150;0;"avyukth";150;100;0
0;608;"awa";608;0;100
141;0;"awab";141;100;0
114;0;"awad";114;100;0
107;0;"awais";107;100;0
29;0;"awan";29;100;0
0;90;"awanda";90;0;100
0;22;"awbree";22;0;100
0;12;"awbrey";12;0;100
10;0;"aweis";10;100;0
46;0;"awesome";46;100;0
9;0;"awet";9;100;0
10;0;"aweys";10;100;0
0;5;"awi";5;0;100
0;1725;"awilda";1725;0;100
0;5;"awn";5;0;100
0;5;"awna";5;0;100
0;7;"awo";7;0;100
76;0;"aws";76;100;0
11;0;"awwab";11;100;0
5;0;"awwal";5;100;0
0;17;"axa";17;0;100
11;0;"axal";11;100;0
125;0;"axavier";125;100;0
272;0;"axcel";272;100;0
5;0;"axcell";5;100;0
8;0;"axe";8;100;0
10;0;"axeel";10;100;0
33218;111;"axel";33329;99.6669567043716;0.333043295628432
353;0;"axell";353;100;0
0;106;"axelle";106;0;100
22;0;"axeton";22;100;0
0;11;"axia";11;0;100
0;119;"axie";119;0;100
56;0;"axiel";56;100;0
47;0;"axil";47;100;0
5;0;"axiom";5;100;0
0;5;"axiry";5;0;100
15;0;"axis";15;100;0
1815;0;"axl";1815;100;0
677;0;"axle";677;100;0
5;0;"axon";5;100;0
52;0;"axsel";52;100;0
55;0;"axten";55;100;0
40;0;"axtin";40;100;0
2053;0;"axton";2053;100;0
80;0;"axtyn";80;100;0
5;0;"axwell";5;100;0
97;0;"axxel";97;100;0
185;0;"axyl";185;100;0
58;0;"axzel";58;100;0
0;4452;"aya";4452;0;100
0;23;"ayaa";23;0;100
3734;138;"ayaan";3872;96.4359504132231;3.56404958677686
0;116;"ayaana";116;0;100
148;0;"ayaansh";148;100;0
0;123;"ayaat";123;0;100
65;0;"ayad";65;100;0
0;2676;"ayah";2676;0;100
0;91;"ayahna";91;0;100
0;5;"ayaina";5;0;100
0;33;"ayak";33;0;100
0;407;"ayaka";407;0;100
0;537;"ayako";537;0;100
31;0;"ayal";31;100;0
0;671;"ayala";671;0;100
0;7;"ayalah";7;0;100
0;236;"ayame";236;0;100
0;11;"ayami";11;0;100
1791;609;"ayan";2400;74.625;25.375
5;10102;"ayana";10107;0.0494706638963095;99.9505293361037
0;414;"ayanah";414;0;100
0;5;"ayanami";5;0;100
0;6;"ayanda";6;0;100
0;242;"ayane";242;0;100
0;276;"ayani";276;0;100
0;52;"ayania";52;0;100
0;5;"ayaniah";5;0;100
16;0;"ayanle";16;100;0
0;14488;"ayanna";14488;0;100
0;605;"ayannah";605;0;100
0;5;"ayanne";5;0;100
0;128;"ayanni";128;0;100
0;10;"ayannia";10;0;100
0;125;"ayano";125;0;100
216;0;"ayansh";216;100;0
0;5;"ayante";5;0;100
0;11;"ayantu";11;0;100
0;303;"ayari";303;0;100
0;268;"ayasha";268;0;100
0;685;"ayat";685;0;100
0;6;"ayati";6;0;100
6;0;"ayatollah";6;100;0
0;6;"ayatt";6;0;100
0;67;"ayauna";67;0;100
89;0;"ayaz";89;100;0
33;0;"aybel";33;100;0
0;77;"aybree";77;0;100
0;7;"aybri";7;0;100
0;19;"aybrie";19;0;100
161;0;"ayce";161;100;0
103;0;"aycen";103;100;0
0;758;"ayda";758;0;100
0;36;"aydah";36;0;100
9;0;"aydain";9;100;0
0;5;"aydali";5;0;100
4915;436;"aydan";5351;91.8519902821902;8.14800971780975
17;0;"aydann";17;100;0
113;0;"aydden";113;100;0
0;283;"ayde";283;0;100
0;171;"aydee";171;0;100
61;0;"aydeen";61;100;0
0;5;"aydelis";5;0;100
0;6;"aydeliz";6;0;100
65213;2118;"ayden";67331;96.8543464377478;3.14565356225216
601;13;"aydenn";614;97.8827361563518;2.11726384364821
0;5;"aydenne";5;0;100
0;81;"aydia";81;0;100
107;0;"aydian";107;100;0
117;0;"aydien";117;100;0
4505;191;"aydin";4696;95.9327086882453;4.06729131175468
146;0;"aydn";146;100;0
585;0;"aydon";585;100;0
0;16;"aydree";16;0;100
26;0;"aydren";26;100;0
231;47;"aydrian";278;83.0935251798561;16.9064748201439
0;37;"aydriana";37;0;100
0;27;"aydrianna";27;0;100
33;0;"aydric";33;100;0
0;5;"aydrie";5;0;100
134;0;"aydrien";134;100;0
5;0;"aydrik";5;100;0
6;0;"aydun";6;100;0
310;11;"aydyn";321;96.5732087227414;3.42679127725857
0;25;"aye";25;0;100
0;5;"ayea";5;0;100
0;5;"ayeasha";5;0;100
11;0;"ayedan";11;100;0
107;0;"ayeden";107;100;0
37;0;"ayedin";37;100;0
0;29;"ayeesha";29;0;100
0;10;"ayeh";10;0;100
0;137;"ayeisha";137;0;100
0;16;"ayela";16;0;100
5;5;"ayele";10;50;50
0;10;"ayeleen";10;0;100
0;572;"ayelen";572;0;100
0;38;"ayelene";38;0;100
0;689;"ayelet";689;0;100
0;36;"ayelin";36;0;100
0;50;"ayen";50;0;100
0;82;"ayerim";82;0;100
0;5290;"ayesha";5290;0;100
0;12;"ayeshah";12;0;100
0;114;"ayeshia";114;0;100
0;36;"ayeza";36;0;100
235;0;"ayham";235;100;0
14;0;"ayhan";14;100;0
34;0;"ayhem";34;100;0
0;16;"ayia";16;0;100
0;614;"ayiana";614;0;100
0;263;"ayianna";263;0;100
75;0;"ayiden";75;100;0
0;5;"ayin";5;0;100
415;0;"ayinde";415;100;0
0;34;"ayira";34;0;100
0;880;"ayisha";880;0;100
0;11;"ayishah";11;0;100
0;16;"ayja";16;0;100
0;83;"ayjah";83;0;100
0;16973;"ayla";16973;0;100
0;930;"aylah";930;0;100
0;5;"aylamae";5;0;100
196;0;"aylan";196;100;0
0;151;"aylana";151;0;100
0;264;"aylani";264;0;100
0;37;"aylanie";37;0;100
0;5;"aylanna";5;0;100
0;5;"aylanni";5;0;100
0;58;"ayleah";58;0;100
0;11;"ayled";11;0;100
0;260;"aylee";260;0;100
0;4536;"ayleen";4536;0;100
0;5;"ayleena";5;0;100
0;27;"ayleene";27;0;100
0;37;"ayleigh";37;0;100
54;582;"aylen";636;8.49056603773585;91.5094339622642
0;10;"aylena";10;0;100
0;407;"aylene";407;0;100
0;5;"aylenne";5;0;100
0;9;"aylet";9;0;100
0;34;"ayleth";34;0;100
0;35;"ayli";35;0;100
0;28;"aylia";28;0;100
0;52;"ayliah";52;0;100
0;44;"ayliana";44;0;100
0;5;"aylianna";5;0;100
0;18;"aylie";18;0;100
18;10109;"aylin";10127;0.17774266811494;99.8222573318851
0;19;"aylina";19;0;100
0;336;"ayline";336;0;100
0;142;"aylinn";142;0;100
0;22;"aylinne";22;0;100
0;6;"aylisha";6;0;100
0;286;"aylissa";286;0;100
0;56;"aylla";56;0;100
5;0;"aylon";5;100;0
0;276;"aylssa";276;0;100
0;101;"aylyn";101;0;100
0;7;"aylynn";7;0;100
26;0;"aymaan";26;100;0
1629;28;"ayman";1657;98.3101991550996;1.68980084490042
0;238;"aymar";238;0;100
0;84;"aymara";84;0;100
0;317;"ayme";317;0;100
0;418;"aymee";418;0;100
325;17;"aymen";342;95.0292397660819;4.97076023391813
6;0;"aymeric";6;100;0
0;5;"aymie";5;0;100
0;140;"ayn";140;0;100
0;39;"ayna";39;0;100
0;15;"aynara";15;0;100
0;18;"ayneka";18;0;100
0;5;"ayni";5;0;100
0;11;"aynia";11;0;100
0;30;"ayniah";30;0;100
0;193;"aynslee";193;0;100
0;18;"aynsleigh";18;0;100
0;389;"aynsley";389;0;100
0;39;"aynslie";39;0;100
0;6;"aynur";6;0;100
99;68;"ayo";167;59.2814371257485;40.7185628742515
16;0;"ayobami";16;100;0
216;0;"ayodeji";216;100;0
236;98;"ayodele";334;70.6586826347305;29.3413173652695
0;14;"ayofemi";14;0;100
0;46;"ayoka";46;0;100
0;5;"ayoki";5;0;100
0;5;"ayomi";5;0;100
425;296;"ayomide";721;58.9459084604716;41.0540915395284
70;26;"ayomikun";96;72.9166666666667;27.0833333333333
13;12;"ayomiposi";25;52;48
34;0;"ayon";34;100;0
0;283;"ayona";283;0;100
0;6;"ayonah";6;0;100
0;5;"ayondela";5;0;100
0;1064;"ayonna";1064;0;100
13;0;"ayoob";13;100;0
5;5;"ayoola";10;50;50
5;10;"ayooluwa";15;33.3333333333333;66.6666666666667
6;0;"ayotomi";6;100;0
38;0;"ayotunde";38;100;0
591;0;"ayoub";591;100;0
0;472;"ayra";472;0;100
0;156;"ayrabella";156;0;100
0;24;"ayrah";24;0;100
0;32;"ayram";32;0;100
0;6;"ayreana";6;0;100
0;17;"ayreanna";17;0;100
59;5;"ayren";64;92.1875;7.8125
0;17;"ayreona";17;0;100
0;18;"ayreonna";18;0;100
5;0;"ayres";5;100;0
0;10;"ayria";10;0;100
0;10;"ayriah";10;0;100
0;5;"ayrial";5;0;100
12;28;"ayrian";40;30;70
0;321;"ayriana";321;0;100
0;324;"ayrianna";324;0;100
0;5;"ayriauna";5;0;100
5;0;"ayric";5;100;0
0;38;"ayrica";38;0;100
0;8;"ayrie";8;0;100
0;152;"ayriel";152;0;100
0;5;"ayrihanna";5;0;100
0;47;"ayrika";47;0;100
0;25;"ayrin";25;0;100
6;6;"ayrion";12;50;50
0;25;"ayrionna";25;0;100
0;83;"ayris";83;0;100
274;5;"ayron";279;98.2078853046595;1.7921146953405
609;0;"ayrton";609;100;0
10;234;"aysa";244;4.0983606557377;95.9016393442623
0;444;"ayse";444;0;100
0;127;"aysel";127;0;100
79;0;"aysen";79;100;0
0;5;"aysenur";5;0;100
0;2557;"aysha";2557;0;100
0;29;"ayshah";29;0;100
0;334;"ayshia";334;0;100
0;2002;"aysia";2002;0;100
0;190;"aysiah";190;0;100
0;8;"ayslee";8;0;100
0;88;"ayslin";88;0;100
0;12;"ayslinn";12;0;100
0;5;"ayslyn";5;0;100
301;0;"ayson";301;100;0
0;161;"ayssa";161;0;100
0;5;"aysu";5;0;100
0;27;"aytana";27;0;100
0;10;"ayten";10;0;100
59;0;"aythan";59;100;0
15;0;"aythen";15;100;0
967;0;"ayub";967;100;0
0;450;"ayumi";450;0;100
6;0;"ayumu";6;100;0
0;7;"ayuna";7;0;100
0;10;"ayunna";10;0;100
1693;0;"ayush";1693;100;0
0;26;"ayusha";26;0;100
0;331;"ayushi";331;0;100
7;0;"ayushmaan";7;100;0
32;0;"ayushman";32;100;0
124;0;"ayuub";124;100;0
0;2291;"ayva";2291;0;100
0;908;"ayvah";908;0;100
17;0;"ayvan";17;100;0
0;5;"ayvani";5;0;100
0;5;"ayvee";5;0;100
261;31;"ayven";292;89.3835616438356;10.6164383561644
6;0;"ayveon";6;100;0
0;14;"ayveri";14;0;100
0;19;"ayverie";19;0;100
0;5;"ayvia";5;0;100
0;10;"ayviana";10;0;100
63;0;"ayvin";63;100;0
60;0;"ayvion";60;100;0
0;58;"ayvree";58;0;100
0;5;"ayvri";5;0;100
0;11;"ayvrie";11;0;100
123;0;"ayyan";123;100;0
13;0;"ayyoub";13;100;0
191;0;"ayyub";191;100;0
0;91;"ayza";91;0;100
0;13;"ayzah";13;0;100
0;5;"ayzaria";5;0;100
0;14;"ayzel";14;0;100
18;0;"ayzen";18;100;0
0;34;"ayzha";34;0;100
0;140;"ayzia";140;0;100
0;38;"ayzlee";38;0;100
0;5;"ayzlin";5;0;100
0;5;"ayzlyn";5;0;100
39;318;"aza";357;10.9243697478992;89.0756302521009
5;0;"azaad";5;100;0
633;0;"azaan";633;100;0
195;0;"azad";195;100;0
0;146;"azadeh";146;0;100
1602;0;"azael";1602;100;0
0;44;"azaela";44;0;100
0;35;"azaelia";35;0;100
0;11;"azah";11;0;100
65;0;"azahel";65;100;0
0;46;"azahria";46;0;100
133;0;"azai";133;100;0
0;20;"azaia";20;0;100
472;61;"azaiah";533;88.5553470919325;11.4446529080675
0;20;"azaila";20;0;100
0;18;"azailya";18;0;100
0;54;"azaira";54;0;100
0;6;"azairah";6;0;100
0;5;"azaireyah";5;0;100
0;6;"azaiyah";6;0;100
0;15;"azalaya";15;0;100
0;5010;"azalea";5010;0;100
0;330;"azaleah";330;0;100
0;1347;"azalee";1347;0;100
0;25;"azaleia";25;0;100
0;18;"azaleigh";18;0;100
0;5;"azaleigha";5;0;100
0;10;"azalene";10;0;100
0;5;"azaley";5;0;100
0;21;"azaleya";21;0;100
0;5;"azaleyah";5;0;100
0;1718;"azalia";1718;0;100
0;243;"azaliah";243;0;100
0;128;"azalie";128;0;100
0;26;"azaline";26;0;100
0;12;"azaliya";12;0;100
0;68;"azaliyah";68;0;100
0;70;"azalya";70;0;100
0;79;"azalyn";79;0;100
0;77;"azalynn";77;0;100
142;0;"azam";142;100;0
273;0;"azan";273;100;0
0;141;"azana";141;0;100
0;5;"azanae";5;0;100
0;7;"azaneth";7;0;100
0;52;"azani";52;0;100
0;44;"azania";44;0;100
5;10;"azaniah";15;33.3333333333333;66.6666666666667
5;0;"azante";5;100;0
56;5;"azar";61;91.8032786885246;8.19672131147541
0;196;"azara";196;0;100
0;10;"azarae";10;0;100
5;0;"azarael";5;100;0
0;75;"azarah";75;0;100
0;5;"azaraya";5;0;100
0;31;"azarea";31;0;100
0;5;"azareah";5;0;100
0;16;"azaree";16;0;100
13;0;"azareel";13;100;0
0;5;"azareeyah";5;0;100
76;0;"azarel";76;100;0
0;5;"azareth";5;0;100
0;39;"azareya";39;0;100
0;6;"azareyah";6;0;100
205;463;"azari";668;30.688622754491;69.311377245509
115;4799;"azaria";4914;2.34025234025234;97.6597476597477
2581;3768;"azariah";6349;40.6520711923137;59.3479288076862
99;0;"azarian";99;100;0
0;6;"azariana";6;0;100
191;0;"azarias";191;100;0
5;97;"azarie";102;4.90196078431373;95.0980392156863
0;10;"azariea";10;0;100
77;0;"azariel";77;100;0
155;0;"azarion";155;100;0
11;0;"azarious";11;100;0
100;0;"azarius";100;100;0
0;234;"azariya";234;0;100
18;542;"azariyah";560;3.21428571428571;96.7857142857143
0;106;"azarria";106;0;100
0;53;"azarriah";53;0;100
15;61;"azarya";76;19.7368421052632;80.2631578947368
55;128;"azaryah";183;30.0546448087432;69.9453551912568
0;5;"azaryia";5;0;100
10;0;"azavian";10;100;0
137;0;"azavier";137;100;0
126;0;"azavion";126;100;0
0;95;"azaya";95;0;100
24;41;"azayah";65;36.9230769230769;63.0769230769231
0;207;"azayla";207;0;100
0;41;"azaylah";41;0;100
0;69;"azaylea";69;0;100
0;5;"azayleah";5;0;100
0;28;"azaylee";28;0;100
0;123;"azaylia";123;0;100
0;16;"azayliah";16;0;100
19;0;"azayvion";19;100;0
126;0;"azazel";126;100;0
11;0;"azden";11;100;0
0;33;"azealia";33;0;100
439;0;"azeem";439;100;0
0;7;"azeemah";7;0;100
0;6;"azeen";6;0;100
73;0;"azeez";73;100;0
0;11;"azeeza";11;0;100
37;0;"azekiel";37;100;0
231;50;"azel";281;82.2064056939502;17.7935943060498
0;50;"azelea";50;0;100
0;6;"azelene";6;0;100
0;297;"azelia";297;0;100
0;72;"azelie";72;0;100
0;41;"azelin";41;0;100
200;48;"azell";248;80.6451612903226;19.3548387096774
0;35;"azella";35;0;100
0;42;"azelle";42;0;100
0;11;"azelya";11;0;100
0;67;"azelyn";67;0;100
0;36;"azelynn";36;0;100
0;5;"azema";5;0;100
0;5;"azena";5;0;100
27;0;"azende";27;100;0
0;14;"azenet";14;0;100
0;703;"azeneth";703;0;100
5;0;"azer";5;100;0
0;36;"azera";36;0;100
0;59;"azeria";59;0;100
10;49;"azeriah";59;16.9491525423729;83.0508474576271
5;0;"azerion";5;100;0
5;0;"azfar";5;100;0
0;75;"azha";75;0;100
10;0;"azhaan";10;100;0
5;0;"azhan";5;100;0
0;5;"azhanae";5;0;100
0;155;"azhane";155;0;100
0;6;"azhani";6;0;100
185;87;"azhar";272;68.0147058823529;31.9852941176471
0;6;"azhari";6;0;100
0;65;"azharia";65;0;100
0;88;"azhia";88;0;100
28;0;"azi";28;100;0
0;1280;"azia";1280;0;100
360;587;"aziah";947;38.0147835269271;61.9852164730729
0;42;"aziana";42;0;100
0;5;"azianna";5;0;100
0;82;"azie";82;0;100
676;10;"aziel";686;98.5422740524781;1.45772594752187
8;0;"azier";8;100;0
18;0;"azikiwe";18;100;0
0;19;"azilda";19;0;100
0;91;"azile";91;0;100
0;403;"azilee";403;0;100
0;10;"azilyn";10;0;100
0;5;"azilynn";5;0;100
404;0;"azim";404;100;0
6;0;"azimjon";6;100;0
161;21;"azion";182;88.4615384615385;11.5384615384615
140;0;"azir";140;100;0
0;10;"azira";10;0;100
0;35;"azirah";35;0;100
0;5;"aziria";5;0;100
0;5;"aziriah";5;0;100
0;25;"azita";25;0;100
0;326;"aziya";326;0;100
32;951;"aziyah";983;3.25534079348932;96.7446592065107
1242;0;"aziz";1242;100;0
0;1456;"aziza";1456;0;100
0;127;"azizah";127;0;100
15;71;"azizi";86;17.4418604651163;82.5581395348837
6;0;"azizjon";6;100;0
0;35;"azja";35;0;100
0;74;"azjah";74;0;100
5;0;"azjon";5;100;0
0;46;"azka";46;0;100
55;0;"azlaan";55;100;0
315;8;"azlan";323;97.5232198142415;2.47678018575851
0;139;"azlee";139;0;100
0;11;"azleigh";11;0;100
0;88;"azlin";88;0;100
0;645;"azlyn";645;0;100
0;775;"azlynn";775;0;100
0;5;"azlynne";5;0;100
0;25;"azmariah";25;0;100
10;0;"azmeer";10;100;0
12;0;"azmi";12;100;0
0;23;"azmina";23;0;100
20;0;"azmir";20;100;0
24;0;"azon";24;100;0
0;35;"azora";35;0;100
0;29;"azori";29;0;100
0;96;"azoria";96;0;100
0;6;"azoriah";6;0;100
17;750;"azra";767;2.21642764015645;97.7835723598435
626;135;"azrael";761;82.2601839684626;17.7398160315375
0;13;"azrah";13;0;100
96;0;"azreal";96;100;0
0;12;"azria";12;0;100
11;17;"azriah";28;39.2857142857143;60.7142857142857
1380;442;"azriel";1822;75.7409440175631;24.2590559824369
0;34;"azriela";34;0;100
0;87;"azriella";87;0;100
0;148;"azrielle";148;0;100
5;0;"azrien";5;100;0
5;0;"azryel";5;100;0
0;5;"azsa";5;0;100
0;5;"azsha";5;0;100
0;5;"azteca";5;0;100
81;0;"aztlan";81;100;0
0;3420;"azucena";3420;0;100
67;3229;"azul";3296;2.03276699029126;97.9672330097087
0;57;"azula";57;0;100
0;50;"azumi";50;0;100
0;13;"azur";13;0;100
0;386;"azura";386;0;100
0;5;"azurae";5;0;100
0;5;"azurah";5;0;100
0;12;"azurdee";12;0;100
216;1467;"azure";1683;12.8342245989305;87.1657754010695
0;22;"azuredee";22;0;100
0;105;"azuree";105;0;100
0;241;"azuri";241;0;100
50;0;"azuriah";50;100;0
0;5;"azurie";5;0;100
0;5;"azury";5;0;100
0;32;"azusa";32;0;100
0;426;"azusena";426;0;100
0;5;"azuzena";5;0;100
0;168;"azya";168;0;100
0;116;"azyah";116;0;100
6;0;"azyan";6;100;0
0;38;"azyia";38;0;100
0;114;"azyiah";114;0;100
0;26;"azyla";26;0;100
0;12;"azylah";12;0;100
10;0;"azyon";10;100;0
0;18;"azyra";18;0;100
0;10;"azyrah";10;0;100
0;116;"azyria";116;0;100
0;83;"azyriah";83;0;100
0;42;"azza";42;0;100
0;5;"azzahra";5;0;100
91;0;"azzam";91;100;0
64;0;"azzan";64;100;0
0;32;"azzareya";32;0;100
0;40;"azzaria";40;0;100
0;6;"azziah";6;0;100
22;873;"azzie";895;2.45810055865922;97.5418994413408
5;75;"azzure";80;6.25;93.75
0;65;"baani";65;0;100
5;0;"baasil";5;100;0
23;0;"baba";23;100;0
157;0;"babacar";157;100;0
44;0;"babajide";44;100;0
287;0;"babak";287;100;0
0;431;"babara";431;0;100
344;0;"babatunde";344;100;0
0;5;"babbett";5;0;100
0;126;"babbette";126;0;100
0;12;"babbi";12;0;100
0;88;"babbie";88;0;100
0;34;"babby";34;0;100
314;363;"babe";677;46.3810930576071;53.6189069423929
6;0;"baber";6;100;0
0;98;"babetta";98;0;100
5;3261;"babette";3266;0.153092467850582;99.8469075321494
0;15;"babie";15;0;100
0;11;"babita";11;0;100
31;0;"baboucarr";31;100;0
0;285;"babs";285;0;100
6056;5837;"baby";11893;50.9207096611452;49.0792903388548
1981;0;"babyboy";1981;100;0
6;1760;"babygirl";1766;0.339750849377123;99.6602491506229
28;0;"bacari";28;100;0
5;0;"bacarri";5;100;0
58;0;"bach";58;100;0
22;0;"bachir";22;100;0
11;0;"bacil";11;100;0
0;16;"bacilia";16;0;100
183;0;"bacilio";183;100;0
7;0;"badal";7;100;0
355;0;"baden";355;100;0
282;0;"bader";282;100;0
7;0;"badhir";7;100;0
5;0;"badi";5;100;0
0;40;"badia";40;0;100
172;0;"badr";172;100;0
5;23;"bae";28;17.8571428571429;82.1428571428571
5;0;"baeden";5;100;0
0;5;"baela";5;0;100
0;31;"baelee";31;0;100
0;104;"baeleigh";104;0;100
0;23;"baeley";23;0;100
5;0;"baelfire";5;100;0
0;50;"baeli";50;0;100
0;11;"baelie";11;0;100
23;0;"baelin";23;100;0
5;0;"baelor";5;100;0
11;80;"baelyn";91;12.0879120879121;87.9120879120879
0;66;"baelynn";66;0;100
97;0;"baer";97;100;0
12;0;"baggio";12;100;0
0;5;"bah";5;0;100
11;0;"baha";11;100;0
15;0;"bahaa";15;100;0
0;387;"bahar";387;0;100
0;28;"bahareh";28;0;100
0;16;"bahati";16;0;100
32;0;"bahe";32;100;0
0;11;"baheejah";11;0;100
0;5;"baheerah";5;0;100
0;17;"bahia";17;0;100
0;15;"bahiya";15;0;100
0;6;"bahiyah";6;0;100
0;6;"bahiyyah";6;0;100
0;111;"bahja";111;0;100
5;5;"bai";10;50;50
0;5;"baiba";5;0;100
51;0;"baiden";51;100;0
0;2160;"baila";2160;0;100
0;6;"bailasan";6;0;100
0;13;"baile";13;0;100
0;227;"bailea";227;0;100
221;13057;"bailee";13278;1.66440729025456;98.3355927097454
0;170;"bailei";170;0;100
0;2003;"baileigh";2003;0;100
84;0;"bailen";84;100;0
20371;94370;"bailey";114741;17.7538979092042;82.2461020907958
0;41;"baileyann";41;0;100
0;7;"baileyrae";7;0;100
0;333;"baili";333;0;100
0;1571;"bailie";1571;0;100
0;5;"bailiegh";5;0;100
0;5;"baille";5;0;100
0;13;"baillee";13;0;100
0;71;"bailley";71;0;100
0;409;"baillie";409;0;100
0;20;"bailly";20;0;100
18;10;"bailor";28;64.2857142857143;35.7142857142857
417;1303;"baily";1720;24.2441860465116;75.7558139534884
0;5;"bailye";5;0;100
15;201;"bailyn";216;6.94444444444444;93.0555555555556
0;114;"bailynn";114;0;100
252;0;"bain";252;100;0
176;0;"baine";176;100;0
6;0;"bair";6;100;0
419;0;"baird";419;100;0
11;0;"bairo";11;100;0
245;0;"bairon";245;100;0
0;12;"baisha";12;0;100
0;15;"baisley";15;0;100
0;13;"baiya";13;0;100
12;0;"baize";12;100;0
0;5;"baja";5;0;100
6;0;"bakar";6;100;0
1155;0;"bakari";1155;100;0
100;0;"bakary";100;100;0
1629;70;"baker";1699;95.8799293702178;4.12007062978222
0;5;"bakhita";5;0;100
5;0;"bakir";5;100;0
13;0;"bakr";13;100;0
5;0;"balaji";5;100;0
17;0;"balal";17;100;0
28;0;"balam";28;100;0
0;309;"balbina";309;0;100
5;0;"baldassare";5;100;0
2166;0;"baldemar";2166;100;0
77;0;"baldo";77;100;0
1039;0;"baldomero";1039;100;0
569;0;"baldwin";569;100;0
5;0;"bale";5;100;0
0;24;"balee";24;0;100
0;1646;"baleigh";1646;0;100
96;0;"balen";96;100;0
24;0;"balentin";24;100;0
6;0;"baler";6;100;0
0;415;"baleria";415;0;100
0;10;"balery";10;0;100
103;327;"baley";430;23.953488372093;76.046511627907
10;0;"balfour";10;100;0
0;54;"bali";54;0;100
248;0;"balian";248;100;0
0;55;"balie";55;0;100
0;12;"baliegh";12;0;100
13;0;"balil";13;100;0
397;0;"balin";397;100;0
0;647;"balinda";647;0;100
7;0;"balint";7;100;0
21;0;"balke";21;100;0
1069;0;"ballard";1069;100;0
0;5;"ballarie";5;0;100
10;0;"balmore";10;100;0
0;5;"balon";5;0;100
0;6;"balqis";6;0;100
56;0;"balraj";56;100;0
56;0;"baltasar";56;100;0
2435;0;"baltazar";2435;100;0
114;0;"balthazar";114;100;0
0;20;"balvina";20;0;100
0;5;"balynda";5;0;100
46;0;"bam";46;100;0
0;363;"bama";363;0;100
0;5179;"bambi";5179;0;100
0;227;"bambie";227;0;100
0;16;"bambina";16;0;100
0;5;"bamby";5;0;100
21;0;"bamidele";21;100;0
0;38;"bamma";38;0;100
0;127;"bana";127;0;100
5;0;"banan";5;100;0
13;0;"bandar";13;100;0
0;52;"bandi";52;0;100
61;0;"bandon";61;100;0
62;30;"bandy";92;67.3913043478261;32.6086956521739
612;0;"bane";612;100;0
0;108;"baneen";108;0;100
0;26;"banelly";26;0;100
0;514;"banesa";514;0;100
0;390;"banessa";390;0;100
0;77;"baneza";77;0;100
5;0;"bang";5;100;0
5;0;"bangaly";5;100;0
0;135;"bani";135;0;100
0;32;"bania";32;0;100
0;5;"banisha";5;0;100
0;96;"banita";96;0;100
297;0;"banjamin";297;100;0
1298;0;"banks";1298;100;0
33;0;"bankston";33;100;0
0;10;"banna";10;0;100
296;17;"banner";313;94.5686900958466;5.43130990415335
0;74;"bannie";74;0;100
45;0;"banning";45;100;0
138;0;"bannon";138;100;0
0;17;"bansari";17;0;100
0;6;"bansi";6;0;100
0;5;"bansri";5;0;100
38;0;"banx";38;100;0
254;0;"banyan";254;100;0
5;0;"banyon";5;100;0
762;579;"bao";1341;56.8232662192394;43.1767337807606
0;16;"baotran";16;0;100
66;0;"baptiste";66;100;0
6;0;"baqir";6;100;0
17;23;"bar";40;42.5;57.5
12;0;"bara";12;100;0
116;24;"baraa";140;82.8571428571429;17.1428571428571
0;20;"baraah";20;0;100
0;181;"barabara";181;0;100
0;54;"barabra";54;0;100
234;0;"barack";234;100;0
812;0;"barak";812;100;0
228;18;"baraka";246;92.6829268292683;7.31707317073171
0;5;"barakah";5;0;100
0;5;"barakat";5;0;100
142;38;"baran";180;78.8888888888889;21.1111111111111
0;16;"baranda";16;0;100
0;23;"barara";23;0;100
0;3853;"barb";3853;0;100
0;208;"barba";208;0;100
0;14;"barbaa";14;0;100
0;316;"barbar";316;0;100
4138;1429124;"barbara";1433262;0.288712042878413;99.7112879571216
0;5;"barbaraa";5;0;100
0;670;"barbaraann";670;0;100
0;5;"barbaraanne";5;0;100
0;231;"barbarajean";231;0;100
0;53;"barbarajo";53;0;100
0;15;"barbaralee";15;0;100
0;294;"barbarann";294;0;100
0;16;"barbaranne";16;0;100
0;11;"barbarba";11;0;100
0;5;"barbare";5;0;100
0;25;"barbarella";25;0;100
0;16;"barbarette";16;0;100
0;157;"barbarita";157;0;100
15;0;"barbaro";15;100;0
0;36;"barbe";36;0;100
0;113;"barbee";113;0;100
18;5;"barber";23;78.2608695652174;21.7391304347826
0;164;"barbera";164;0;100
0;5;"barbett";5;0;100
0;27;"barbetta";27;0;100
0;335;"barbette";335;0;100
0;585;"barbi";585;0;100
0;3903;"barbie";3903;0;100
0;5;"barbora";5;0;100
0;7747;"barbra";7747;0;100
0;18;"barbro";18;0;100
0;155;"barby";155;0;100
943;24;"barclay";967;97.5180972078594;2.48190279214064
212;0;"bard";212;100;0
0;11;"bardara";11;0;100
65;0;"bardia";65;100;0
39;0;"bardo";39;100;0
0;6;"bareera";6;0;100
0;15;"bareerah";15;0;100
5;0;"barek";5;100;0
5;0;"baren";5;100;0
127;0;"barett";127;100;0
52;20;"baretta";72;72.2222222222222;27.7777777777778
140;1779;"bari";1919;7.29546638874414;92.7045336112559
0;13;"bariah";13;0;100
0;9;"barika";9;0;100
11;0;"barin";11;100;0
23;0;"baris";23;100;0
0;5;"barisha";5;0;100
16;0;"barker";16;100;0
7;0;"barkim";7;100;0
306;5;"barkley";311;98.3922829581994;1.60771704180064
13;0;"barkon";13;100;0
10;11;"barkot";21;47.6190476190476;52.3809523809524
5;0;"barksdale";5;100;0
82;0;"barlow";82;100;0
430;0;"barnabas";430;100;0
320;0;"barnaby";320;100;0
890;0;"barnard";890;100;0
26;0;"barndon";26;100;0
97;6;"barnell";103;94.1747572815534;5.8252427184466
136;0;"barnes";136;100;0
221;0;"barnet";221;100;0
1238;6;"barnett";1244;99.5176848874598;0.482315112540193
0;52;"barnetta";52;0;100
0;25;"barnette";25;0;100
14953;91;"barney";15044;99.3951076841266;0.604892315873438
603;5;"barnie";608;99.1776315789474;0.822368421052632
5;0;"barnwell";5;100;0
5;0;"barny";5;100;0
5;0;"barok";5;100;0
5965;0;"baron";5965;100;0
16;0;"barr";16;100;0
75;0;"barre";75;100;0
45;0;"barren";45;100;0
1134;5;"barret";1139;99.5610184372256;0.438981562774364
16445;711;"barrett";17156;95.8556773140592;4.14432268594078
6;0;"barrette";6;100;0
47;504;"barri";551;8.52994555353902;91.470054446461
37;0;"barrick";37;100;0
1332;1708;"barrie";3040;43.8157894736842;56.1842105263158
1186;0;"barrington";1186;100;0
5;0;"barrion";5;100;0
5;0;"barris";5;100;0
4216;0;"barron";4216;100;0
180010;766;"barry";180776;99.5762711864407;0.423728813559322
0;11;"barsha";11;0;100
16172;5;"bart";16177;99.969091920628;0.0309080793719478
0;6;"barta";6;0;100
59;0;"bartek";59;100;0
5;0;"bartel";5;100;0
470;0;"barth";470;100;0
0;5;"bartha";5;0;100
23;0;"bartholome";23;100;0
3817;0;"bartholomew";3817;100;0
0;5;"bartie";5;0;100
641;0;"bartlett";641;100;0
1894;0;"bartley";1894;100;0
81;0;"bartlomiej";81;100;0
5;0;"bartly";5;100;0
33;0;"barto";33;100;0
0;18;"bartola";18;0;100
857;0;"bartolo";857;100;0
38;0;"bartolome";38;100;0
37;0;"bartolomeo";37;100;0
9150;0;"barton";9150;100;0
226;0;"bartosz";226;100;0
114;0;"bartow";114;100;0
115;0;"bartt";115;100;0
5;0;"bartu";5;100;0
5;0;"barty";5;100;0
65;0;"baruc";65;100;0
1428;0;"baruch";1428;100;0
6;0;"baruti";6;100;0
300;0;"bary";300;100;0
5;0;"baryn";5;100;0
0;5;"bas";5;0;100
649;0;"bascom";649;100;0
5;0;"bascomb";5;100;0
19;0;"bascum";19;100;0
0;28;"baseemah";28;0;100
445;0;"basel";445;100;0
106;0;"basem";106;100;0
13;0;"bash";13;100;0
0;161;"basha";161;0;100
16;0;"bashan";16;100;0
308;0;"bashar";308;100;0
44;0;"bashawn";44;100;0
0;24;"basheba";24;0;100
194;0;"basheer";194;100;0
790;0;"bashir";790;100;0
0;6;"bashira";6;0;100
0;13;"bashirah";13;0;100
5;0;"bashiri";5;100;0
0;6;"bashy";6;0;100
0;349;"basia";349;0;100
12156;145;"basil";12301;98.8212340460125;1.17876595398748
27;0;"basile";27;100;0
0;271;"basilia";271;0;100
0;7;"basiliki";7;0;100
1710;0;"basilio";1710;100;0
5;0;"basilios";5;100;0
0;32;"basilisa";32;0;100
241;0;"basim";241;100;0
0;5;"basimah";5;0;100
139;0;"basir";139;100;0
48;0;"basit";48;100;0
0;288;"basma";288;0;100
0;33;"basmah";33;0;100
16;0;"bass";16;100;0
393;0;"bassam";393;100;0
224;0;"bassel";224;100;0
49;0;"bassem";49;100;0
10;0;"bassey";10;100;0
0;91;"bassheva";91;0;100
52;0;"bassil";52;100;0
10;0;"bassirou";10;100;0
0;50;"bassy";50;0;100
998;0;"bastian";998;100;0
140;0;"bastien";140;100;0
88;0;"bastion";88;100;0
0;723;"basya";723;0;100
0;5;"batel";5;0;100
99;0;"bates";99;100;0
0;341;"bathsheba";341;0;100
0;139;"batina";139;0;100
0;290;"batool";290;0;100
0;314;"batoul";314;0;100
0;6;"batrice";6;0;100
0;5;"batrina";5;0;100
0;1440;"batsheva";1440;0;100
37;0;"battal";37;100;0
42;0;"battista";42;100;0
10;0;"battle";10;100;0
76;0;"batu";76;100;0
41;0;"batuhan";41;100;0
0;81;"batul";81;0;100
0;10;"batula";10;0;100
0;527;"batya";527;0;100
11;0;"baudel";11;100;0
0;88;"baudelia";88;0;100
351;0;"baudelio";351;100;0
16;0;"baudilio";16;100;0
409;0;"bauer";409;100;0
48;0;"bautista";48;100;0
0;5;"bavan";5;0;100
18;0;"bavly";18;100;0
133;27;"bawi";160;83.125;16.875
0;5;"baxlee";5;0;100
20;27;"baxley";47;42.5531914893617;57.4468085106383
3469;0;"baxter";3469;100;0
41;0;"baxton";41;100;0
174;402;"bay";576;30.2083333333333;69.7916666666667
0;311;"baya";311;0;100
0;49;"bayah";49;0;100
92;612;"bayan";704;13.0681818181818;86.9318181818182
58;0;"bayani";58;100;0
884;0;"bayard";884;100;0
27;0;"bayardo";27;100;0
289;6;"bayden";295;97.9661016949153;2.03389830508475
0;56;"baye";56;0;100
5;0;"bayete";5;100;0
0;723;"bayla";723;0;100
0;5;"baylaa";5;0;100
31;0;"baylan";31;100;0
28;221;"bayle";249;11.2449799196787;88.7550200803213
0;444;"baylea";444;0;100
618;18318;"baylee";18936;3.26362484157161;96.7363751584284
0;5;"bayleen";5;0;100
0;364;"baylei";364;0;100
0;3911;"bayleigh";3911;0;100
894;124;"baylen";1018;87.8192534381139;12.1807465618861
191;70;"bayler";261;73.1800766283525;26.8199233716475
10;0;"bayless";10;100;0
435;1860;"bayley";2295;18.9542483660131;81.0457516339869
0;994;"bayli";994;0;100
7;0;"baylian";7;100;0
26;3204;"baylie";3230;0.804953560371517;99.1950464396285
0;12;"bayliegh";12;0;100
215;156;"baylin";371;57.9514824797844;42.0485175202156
238;0;"baylon";238;100;0
3104;1141;"baylor";4245;73.1213191990577;26.8786808009423
11;51;"bayly";62;17.741935483871;82.258064516129
0;73;"baylyn";73;0;100
0;114;"baylynn";114;0;100
10;0;"baynard";10;100;0
433;0;"bayne";433;100;0
0;5;"bayoleth";5;0;100
26;0;"bayro";26;100;0
1117;0;"bayron";1117;100;0
5;0;"bayshawn";5;100;0
0;73;"bayyinah";73;0;100
6;0;"bayze";6;100;0
55;0;"baze";55;100;0
17;0;"bazel";17;100;0
136;0;"bazil";136;100;0
39;0;"bb";39;100;0
5;0;"be";5;100;0
0;1735;"bea";1735;0;100
5;0;"beach";5;100;0
76;0;"beacher";76;100;0
0;386;"beadie";386;0;100
0;6;"beah";6;0;100
16;0;"beal";16;100;0
6;0;"beale";6;100;0
5;0;"beaman";5;100;0
32;0;"beamon";32;100;0
5;0;"bean";5;100;0
0;61;"beanca";61;0;100
5;0;"beandon";5;100;0
0;5;"beaney";5;0;100
0;29;"beanna";29;0;100
0;5;"beaonca";5;0;100
942;0;"bear";942;100;0
71;0;"bearett";71;100;0
183;0;"bearl";183;100;0
0;10;"bearnice";10;0;100
0;6;"beasia";6;0;100
11;0;"beasley";11;100;0
0;913;"beata";913;0;100
0;10;"beate";10;0;100
0;5;"beatha";5;0;100
0;5;"beather";5;0;100
0;5;"beathrice";5;0;100
0;109;"beatric";109;0;100
0;5;"beatrica";5;0;100
717;180602;"beatrice";181319;0.395435668628219;99.6045643313718
0;1178;"beatris";1178;0;100
0;2263;"beatrix";2263;0;100
53;17267;"beatriz";17320;0.306004618937644;99.6939953810624
0;32;"beatrize";32;0;100
0;123;"beatryce";123;0;100
0;18;"beatta";18;0;100
5;0;"beattie";5;100;0
10;0;"beatty";10;100;0
32427;523;"beau";32950;98.412746585736;1.58725341426404
96;0;"beauden";96;100;0
6;0;"beauen";6;100;0
1011;10;"beauford";1021;99.0205680705191;0.979431929480901
36;0;"beaufort";36;100;0
0;16;"beaula";16;0;100
0;2061;"beaulah";2061;0;100
114;0;"beaumont";114;100;0
317;0;"beauregard";317;100;0
0;740;"beautiful";740;0;100
0;172;"beautifull";172;0;100
0;38;"beauton";38;0;100
0;5;"beautrice";5;0;100
0;575;"beauty";575;0;100
0;11;"beautyful";11;0;100
904;93;"beaux";997;90.6720160481444;9.32798395185557
19;0;"beaver";19;100;0
0;1543;"bebe";1543;0;100
0;11;"beca";11;0;100
0;2885;"becca";2885;0;100
0;122;"becci";122;0;100
2272;0;"beck";2272;100;0
0;332;"becka";332;0;100
0;5;"beckah";5;0;100
572;0;"beckam";572;100;0
133;0;"beckem";133;100;0
300;0;"becker";300;100;0
319;0;"becket";319;100;0
11740;440;"beckett";12180;96.3875205254516;3.61247947454844
5;5;"beckette";10;50;50
0;552;"beckey";552;0;100
5323;49;"beckham";5372;99.0878629932986;0.912137006701415
53;0;"beckhem";53;100;0
0;2510;"becki";2510;0;100
0;2781;"beckie";2781;0;100
5;18;"beckley";23;21.7391304347826;78.2608695652174
0;5;"becklyn";5;0;100
5;0;"beckman";5;100;0
38;0;"beckum";38;100;0
144;86447;"becky";86591;0.166299038006259;99.8337009619937
0;213;"beda";213;0;100
0;5;"bedar";5;0;100
0;17;"beddie";17;0;100
0;81;"bedelia";81;0;100
0;5;"bedell";5;0;100
1152;0;"bedford";1152;100;0
0;77;"bedie";77;0;100
891;554;"bee";1445;61.6608996539792;38.3391003460208
5;31;"beebe";36;13.8888888888889;86.1111111111111
981;0;"beecher";981;100;0
0;34;"beedie";34;0;100
0;90;"beena";90;0;100
0;5;"beenish";5;0;100
0;6;"beesan";6;0;100
0;26;"beeta";26;0;100
0;5;"begum";5;0;100
0;22;"behati";22;0;100
29;0;"behnam";29;100;0
132;0;"behr";132;100;0
9;0;"behrang";9;100;0
12;0;"behrett";12;100;0
25;0;"behruz";25;100;0
0;7;"behtzy";7;0;100
0;7;"beige";7;0;100
0;11;"beighley";11;0;100
0;40;"beija";40;0;100
0;85;"beila";85;0;100
0;22;"beily";22;0;100
0;6;"beira";6;0;100
442;0;"bejamin";442;100;0
28;0;"bejan";28;100;0
5;0;"bek";5;100;0
29;0;"beka";29;100;0
0;172;"bekah";172;0;100
15;0;"bekam";15;100;0
5;0;"bekett";5;100;0
13;0;"bekham";13;100;0
0;35;"beki";35;0;100
150;0;"bekim";150;100;0
0;100;"bekka";100;0;100
0;164;"bekki";164;0;100
466;577;"bela";1043;44.6788111217641;55.3211888782359
0;10;"belah";10;0;100
578;0;"belal";578;100;0
0;6;"belana";6;0;100
0;97;"belanna";97;0;100
0;5;"belany";5;0;100
12;0;"belarmino";12;100;0
35;0;"belden";35;100;0
93;0;"beldon";93;100;0
0;289;"belem";289;0;100
63;9127;"belen";9190;0.685527747551687;99.3144722524483
0;120;"belenda";120;0;100
0;7;"beleta";7;0;100
229;0;"belford";229;100;0
0;12;"belgica";12;0;100
0;2011;"belia";2011;0;100
0;566;"belicia";566;0;100
0;14;"believe";14;0;100
0;95;"belina";95;0;100
150;71680;"belinda";71830;0.208826395656411;99.7911736043436
0;64;"belisa";64;0;100
7;0;"belisario";7;100;0
0;63;"belissa";63;0;100
0;384;"belita";384;0;100
0;5;"beliz";5;0;100
0;30;"belize";30;0;100
0;391;"belkis";391;0;100
0;25;"belky";25;0;100
0;112;"belkys";112;0;100
130;1502;"bell";1632;7.9656862745098;92.0343137254902
34;52068;"bella";52102;0.0652566120302484;99.9347433879697
0;31;"bellaann";31;0;100
0;257;"belladonna";257;0;100
0;95;"bellagrace";95;0;100
0;333;"bellah";333;0;100
0;17;"bellaluna";17;0;100
0;5;"bellalynn";5;0;100
0;26;"bellamae";26;0;100
0;154;"bellamarie";154;0;100
0;5;"bellamay";5;0;100
0;5;"bellamee";5;0;100
0;38;"bellami";38;0;100
0;79;"bellamia";79;0;100
0;81;"bellamie";81;0;100
85;851;"bellamy";936;9.08119658119658;90.9188034188034
0;11;"bellani";11;0;100
0;45;"bellanie";45;0;100
0;6;"bellanira";6;0;100
0;63;"bellany";63;0;100
0;47;"bellarae";47;0;100
0;460;"bellarose";460;0;100
0;6;"bellasophia";6;0;100
0;95;"bellatrix";95;0;100
0;11576;"belle";11576;0;100
0;8;"bellemy";8;0;100
0;5;"bellicia";5;0;100
0;93;"bellina";93;0;100
0;5;"bellinda";5;0;100
0;14;"bellissa";14;0;100
0;625;"belma";625;0;100
0;11;"belmaris";11;0;100
0;6;"belmeda";6;0;100
56;0;"belmin";56;100;0
0;75;"belmira";75;0;100
171;0;"belmont";171;100;0
0;15;"belon";15;0;100
0;23;"beloved";23;0;100
0;6;"belsy";6;0;100
1140;0;"belton";1140;100;0
0;5;"belua";5;0;100
0;7376;"belva";7376;0;100
0;5;"belverly";5;0;100
0;626;"belvia";626;0;100
0;116;"belvie";116;0;100
415;7;"belvin";422;98.3412322274881;1.65876777251185
0;766;"belynda";766;0;100
0;23;"belzora";23;0;100
5;0;"bemjamin";5;100;0
29;45;"bemnet";74;39.1891891891892;60.8108108108108
75776;448;"ben";76224;99.4122586062133;0.587741393786734
0;521;"bena";521;0;100
0;10;"benae";10;0;100
1114;0;"benaiah";1114;100;0
16;0;"benajamin";16;100;0
31;0;"benajmin";31;100;0
0;5;"benancia";5;0;100
284;0;"benancio";284;100;0
7;0;"benaniah";7;100;0
1622;0;"benard";1622;100;0
5;0;"benardo";5;100;0
10;0;"benas";10;100;0
0;209;"benay";209;0;100
124;0;"bence";124;100;0
0;5;"benda";5;0;100
0;24;"bendetta";24;0;100
5;0;"bendrick";5;100;0
0;10;"bene";10;0;100
0;25;"benecia";25;0;100
64;0;"benecio";64;100;0
5;0;"benedek";5;100;0
0;374;"benedetta";374;0;100
786;0;"benedetto";786;100;0
8345;0;"benedict";8345;100;0
0;105;"benedicta";105;0;100
0;5;"benedicte";5;0;100
188;0;"benedicto";188;100;0
25;0;"benedikt";25;100;0
0;6;"benee";6;0;100
0;62;"benelli";62;0;100
66;0;"benen";66;100;0
0;6;"benesha";6;0;100
0;5;"benessa";5;0;100
37;20;"benet";57;64.9122807017544;35.0877192982456
0;36;"beneta";36;0;100
226;0;"benett";226;100;0
0;438;"benetta";438;0;100
0;17;"benette";17;0;100
0;38;"beneva";38;0;100
366;0;"benford";366;100;0
46;0;"bengamin";46;100;0
7;0;"bengi";7;100;0
155;0;"bengie";155;100;0
6;0;"bengt";6;100;0
52;0;"bengy";52;100;0
8;0;"benham";8;100;0
18;0;"benhamin";18;100;0
21;0;"benhard";21;100;0
13;0;"benhart";13;100;0
8;0;"benhur";8;100;0
66;32;"beni";98;67.3469387755102;32.6530612244898
92;0;"beniah";92;100;0
33;0;"beniamin";33;100;0
0;6;"benica";6;0;100
0;119;"benicia";119;0;100
1966;0;"benicio";1966;100;0
35;0;"benie";35;100;0
0;95;"benigna";95;0;100
1554;0;"benigno";1554;100;0
0;19;"benika";19;0;100
0;5;"benilda";5;0;100
0;22;"benilde";22;0;100
0;39;"benina";39;0;100
85;0;"benino";85;100;0
0;91;"benisha";91;0;100
0;13504;"benita";13504;0;100
10;0;"benitez";10;100;0
13354;31;"benito";13385;99.7683974598431;0.231602540156892
15;0;"benjahmin";15;100;0
10;0;"benjain";10;100;0
1827;0;"benjaman";1827;100;0
3556;0;"benjamen";3556;100;0
27;0;"benjamim";27;100;0
711215;2384;"benjamin";713599;99.6659188143481;0.334081185651886
1617;0;"benjamine";1617;100;0
5;0;"benjaminjoseph";5;100;0
5;0;"benjammin";5;100;0
14;0;"benjamon";14;100;0
284;0;"benjamyn";284;100;0
5;0;"benje";5;100;0
5;0;"benjeman";5;100;0
13;0;"benjemin";13;100;0
122;0;"benjerman";122;100;0
5;0;"benjermen";5;100;0
165;0;"benjermin";165;100;0
1395;47;"benji";1442;96.7406380027739;3.25936199722607
5;0;"benjiam";5;100;0
906;31;"benjie";937;96.6915688367129;3.30843116328709
3664;0;"benjiman";3664;100;0
276;0;"benjimen";276;100;0
250;0;"benjimin";250;100;0
11;0;"benjmain";11;100;0
47;0;"benjman";47;100;0
334;0;"benjy";334;100;0
5;0;"benley";5;100;0
370;0;"benn";370;100;0
0;186;"benna";186;0;100
29;0;"bennard";29;100;0
0;5;"benne";5;0;100
5;0;"benner";5;100;0
1458;36;"bennet";1494;97.5903614457831;2.40963855421687
34755;977;"bennett";35732;97.2657561849323;2.73424381506773
0;239;"bennetta";239;0;100
30;61;"bennette";91;32.967032967033;67.032967032967
108;0;"benney";108;100;0
0;12;"benni";12;0;100
50890;9338;"bennie";60228;84.4955834495583;15.5044165504417
7;0;"benning";7;100;0
5;0;"bennington";5;100;0
5;0;"bennit";5;100;0
0;47;"bennita";47;0;100
10;0;"bennjamin";10;100;0
258;0;"benno";258;100;0
46519;569;"benny";47088;98.7916241930003;1.20837580699966
0;161;"bennye";161;0;100
16;0;"beno";16;100;0
360;0;"benoit";360;100;0
193;0;"bensen";193;100;0
7;0;"bensley";7;100;0
8626;5;"benson";8631;99.942069285135;0.0579307148650214
86;0;"bensyn";86;100;0
0;10;"bente";10;0;100
6;0;"bentely";6;100;0
18;0;"benten";18;100;0
0;8;"bentlea";8;0;100
2440;609;"bentlee";3049;80.026238110856;19.973761889144
26;22;"bentlei";48;54.1666666666667;45.8333333333333
53;356;"bentleigh";409;12.958435207824;87.041564792176
37055;2290;"bentley";39345;94.1796924640996;5.82030753590037
48;112;"bentli";160;30;70
70;123;"bentlie";193;36.2694300518135;63.7305699481865
2005;68;"bently";2073;96.7197298601061;3.28027013989387
12;0;"bento";12;100;0
8690;0;"benton";8690;100;0
43;5;"bentura";48;89.5833333333333;10.4166666666667
28;0;"bentyn";28;100;0
5;0;"bentz";5;100;0
324;0;"bentzion";324;100;0
698;0;"benuel";698;100;0
0;5;"benvinda";5;0;100
38;0;"beny";38;100;0
25;0;"benyam";25;100;0
466;0;"benyamin";466;100;0
63;0;"benz";63;100;0
5;0;"benzel";5;100;0
8;0;"benzino";8;100;0
823;0;"benzion";823;100;0
0;104;"beola";104;0;100
0;151;"beonca";151;0;100
0;9;"beonce";9;0;100
0;12;"beonica";12;0;100
0;119;"beonka";119;0;100
16;0;"beorn";16;100;0
27;0;"beowulf";27;100;0
10;0;"ber";10;100;0
12;163;"bera";175;6.85714285714286;93.1428571428571
0;10;"beranda";10;0;100
0;62;"berania";62;0;100
28;0;"berat";28;100;0
0;16;"berchie";16;0;100
5;0;"berchman";5;100;0
0;137;"berda";137;0;100
0;57;"berdean";57;0;100
0;5;"berdeen";5;0;100
92;149;"berdell";241;38.1742738589212;61.8257261410788
0;185;"berdella";185;0;100
0;383;"berdena";383;0;100
0;93;"berdene";93;0;100
0;155;"berdia";155;0;100
0;952;"berdie";952;0;100
0;340;"berdina";340;0;100
0;433;"berdine";433;0;100
0;7;"berdyne";7;0;100
0;63;"berea";63;0;100
5;0;"berek";5;100;0
115;0;"bereket";115;100;0
107;0;"berel";107;100;0
145;34;"beren";179;81.0055865921788;18.9944134078212
11;0;"berend";11;100;0
0;41;"berenda";41;0;100
10;0;"berenger";10;100;0
11;8717;"berenice";8728;0.126031164069661;99.8739688359303
0;161;"berenis";161;0;100
0;645;"berenise";645;0;100
0;21;"berenisse";21;0;100
0;56;"bereniz";56;0;100
0;99;"berenize";99;0;100
5;0;"beresford";5;100;0
0;15;"beret";15;0;100
0;111;"beretta";111;0;100
6;0;"berg";6;100;0
0;53;"bergan";53;0;100
22;0;"berge";22;100;0
334;436;"bergen";770;43.3766233766234;56.6233766233766
54;0;"berger";54;100;0
0;5;"bergetta";5;0;100
0;5;"bergin";5;0;100
0;17;"beri";17;0;100
19;0;"beric";19;100;0
5;0;"beril";5;100;0
0;25;"berina";25;0;100
0;5;"berinda";5;0;100
170;0;"berish";170;100;0
0;579;"berit";579;0;100
0;5;"berita";5;0;100
5;0;"berj";5;100;0
221;0;"berk";221;100;0
49;0;"berkay";49;100;0
34;0;"berke";34;100;0
785;1243;"berkeley";2028;38.7080867850099;61.2919132149901
11;553;"berklee";564;1.95035460992908;98.0496453900709
0;239;"berkleigh";239;0;100
1849;2794;"berkley";4643;39.8233900495369;60.1766099504631
0;29;"berkli";29;0;100
0;128;"berklie";128;0;100
0;5;"berkly";5;0;100
929;5;"berl";934;99.4646680942184;0.535331905781585
0;46;"berla";46;0;100
331;11;"berle";342;96.7836257309941;3.21637426900585
0;10;"berlena";10;0;100
0;178;"berlene";178;0;100
131;0;"berley";131;100;0
189;103;"berlie";292;64.7260273972603;35.2739726027397
1435;1306;"berlin";2741;52.3531557825611;47.6468442174389
0;5;"berlina";5;0;100
0;960;"berlinda";960;0;100
0;313;"berline";313;0;100
37;0;"berlon";37;100;0
82;735;"berlyn";817;10.0367197062423;89.9632802937576
0;383;"berlynn";383;0;100
0;266;"berma";266;0;100
249;0;"berman";249;100;0
86;0;"bern";86;100;0
0;1461;"berna";1461;0;100
1690;0;"bernabe";1690;100;0
0;15;"bernace";15;0;100
0;521;"bernadean";521;0;100
0;29;"bernadeen";29;0;100
0;482;"bernadene";482;0;100
0;9;"bernadet";9;0;100
0;181;"bernadett";181;0;100
0;199;"bernadetta";199;0;100
60;52865;"bernadette";52925;0.113367973547473;99.8866320264525
0;54;"bernadina";54;0;100
0;21652;"bernadine";21652;0;100
17;0;"bernadino";17;100;0
15;0;"bernado";15;100;0
0;16;"bernadyne";16;0;100
190;0;"bernal";190;100;0
31;0;"bernaldo";31;100;0
0;5;"bernalee";5;0;100
6;0;"bernando";6;100;0
194826;979;"bernard";195805;99.5000127678047;0.499987232195296
0;360;"bernarda";360;0;100
0;232;"bernardette";232;0;100
0;166;"bernardina";166;0;100
0;3049;"bernardine";3049;0;100
1598;0;"bernardino";1598;100;0
0;13;"bernardita";13;0;100
9917;0;"bernardo";9917;100;0
80;0;"bernarr";80;100;0
0;5;"bernasia";5;0;100
18;0;"bernave";18;100;0
0;13;"bernay";13;0;100
96;0;"bernd";96;100;0
0;5;"bernda";5;0;100
48;0;"berne";48;100;0
0;405;"bernece";405;0;100
0;569;"berneda";569;0;100
0;173;"bernedette";173;0;100
0;3154;"berneice";3154;0;100
0;11;"berneil";11;0;100
0;92;"berneita";92;0;100
28;0;"bernel";28;100;0
0;22;"bernelda";22;0;100
1552;750;"bernell";2302;67.4196350999131;32.5803649000869
0;10;"bernella";10;0;100
0;43;"bernelle";43;0;100
527;0;"bernerd";527;100;0
0;138;"bernese";138;0;100
0;5;"bernesha";5;0;100
0;5;"bernessa";5;0;100
0;6;"bernessia";6;0;100
25;0;"bernest";25;100;0
0;367;"bernestine";367;0;100
5;0;"bernet";5;100;0
0;473;"berneta";473;0;100
0;376;"bernetha";376;0;100
26;51;"bernett";77;33.7662337662338;66.2337662337662
0;2757;"bernetta";2757;0;100
0;787;"bernette";787;0;100
52;0;"berney";52;100;0
1547;0;"bernhard";1547;100;0
423;0;"bernhardt";423;100;0
19;0;"bernhart";19;100;0
0;6;"berni";6;0;100
0;5;"bernia";5;0;100
3305;176549;"bernice";179854;1.83760161019494;98.1623983898051
0;7;"bernicia";7;0;100
0;23;"bernida";23;0;100
8945;1509;"bernie";10454;85.5653338435049;14.4346661564951
0;9714;"berniece";9714;0;100
0;40;"bernina";40;0;100
428;107;"bernis";535;80;20
0;100;"bernise";100;0;100
0;88;"bernisha";88;0;100
0;10;"bernistine";10;0;100
0;4629;"bernita";4629;0;100
0;15;"bernitha";15;0;100
0;20;"bernitta";20;0;100
0;5;"berniya";5;0;100
0;17;"bernnadette";17;0;100
68;0;"bernon";68;100;0
20;0;"bernt";20;100;0
56;0;"berny";56;100;0
0;460;"bernyce";460;0;100
0;1011;"beronica";1011;0;100
0;26;"berra";26;0;100
12;0;"berrett";12;100;0
0;6;"berri";6;0;100
0;5;"berrie";5;0;100
6;0;"berrin";6;100;0
5249;347;"berry";5596;93.7991422444603;6.20085775553967
11;0;"berryman";11;100;0
7;0;"bersain";7;100;0
29012;577;"bert";29589;98.0499509953023;1.95004900469769
0;6569;"berta";6569;0;100
0;5;"berte";5;0;100
0;5;"berteal";5;0;100
115;0;"bertel";115;100;0
16;0;"bertell";16;100;0
0;5;"bertella";5;0;100
0;5;"bertelle";5;0;100
11;0;"berten";11;100;0
0;6;"bertena";6;0;100
0;6;"berth";6;0;100
749;164193;"bertha";164942;0.454099016624025;99.545900983376
17;6;"berthal";23;73.9130434782609;26.0869565217391
0;5;"berthalee";5;0;100
0;26;"berthamae";26;0;100
0;173;"berthe";173;0;100
63;30;"berthel";93;67.741935483871;32.258064516129
0;11;"berthella";11;0;100
0;54;"berthena";54;0;100
0;52;"berthenia";52;0;100
0;7;"berther";7;0;100
0;10;"berthia";10;0;100
0;5;"berthina";5;0;100
0;22;"berthine";22;0;100
10;0;"berthol";10;100;0
267;0;"berthold";267;100;0
0;22;"bertia";22;0;100
44;175;"bertice";219;20.0913242009132;79.9086757990868
664;10819;"bertie";11483;5.78246102934773;94.2175389706523
482;0;"bertil";482;100;0
0;5;"bertile";5;0;100
0;38;"bertilla";38;0;100
0;31;"bertille";31;0;100
298;0;"bertin";298;100;0
0;1209;"bertina";1209;0;100
0;110;"bertine";110;0;100
455;19;"bertis";474;95.9915611814346;4.0084388185654
6;0;"berto";6;100;0
1783;0;"berton";1783;100;0
7559;0;"bertram";7559;100;0
132;0;"bertran";132;100;0
3840;0;"bertrand";3840;100;0
0;64;"bertrice";64;0;100
246;0;"bertrum";246;100;0
31;0;"bertus";31;100;0
32;0;"bervin";32;100;0
5;0;"berwick";5;100;0
16;0;"berwin";16;100;0
249;0;"berwyn";249;100;0
2312;9516;"beryl";11828;19.5468380114981;80.4531619885019
94;550;"beryle";644;14.5962732919255;85.4037267080745
0;11;"besa";11;0;100
0;61;"besan";61;0;100
10;0;"besart";10;100;0
9;0;"beshoy";9;100;0
0;5;"besiana";5;0;100
32;0;"besim";32;100;0
0;10;"besma";10;0;100
96;0;"besnik";96;100;0
0;4515;"bess";4515;0;100
0;246;"besse";246;0;100
605;130224;"bessie";130829;0.462435698507212;99.5375643014928
0;6;"bessiemae";6;0;100
0;275;"bessy";275;0;100
0;105;"bessye";105;0;100
0;53;"besty";53;0;100
0;11;"beta";11;0;100
0;246;"betania";246;0;100
0;22;"betanya";22;0;100
0;39;"betel";39;0;100
325;158734;"beth";159059;0.204326696383103;99.7956733036169
0;286;"betha";286;0;100
0;6;"bethal";6;0;100
0;89;"bethan";89;0;100
0;188;"bethanee";188;0;100
0;631;"bethaney";631;0;100
0;1020;"bethani";1020;0;100
0;156;"bethania";156;0;100
0;3616;"bethanie";3616;0;100
0;2802;"bethann";2802;0;100
0;1263;"bethanne";1263;0;100
0;6;"bethanni";6;0;100
0;143;"bethannie";143;0;100
0;233;"bethanny";233;0;100
184;96506;"bethany";96690;0.190298893370566;99.8097011066294
0;6;"bethanya";6;0;100
0;5;"bethanye";5;0;100
0;34;"bethe";34;0;100
0;7;"bethea";7;0;100
980;4587;"bethel";5567;17.6037363032154;82.3962636967846
0;5;"bethellen";5;0;100
0;48;"bethena";48;0;100
0;221;"bethene";221;0;100
0;10;"bethenia";10;0;100
0;84;"bethenny";84;0;100
0;268;"betheny";268;0;100
0;22;"bethia";22;0;100
0;5;"bethie";5;0;100
0;20;"bethina";20;0;100
0;30;"bethine";30;0;100
0;366;"bethlehem";366;0;100
0;6;"bethlyn";6;0;100
0;47;"bethney";47;0;100
0;18;"bethony";18;0;100
0;306;"bethsaida";306;0;100
0;5;"bethsheba";5;0;100
0;27;"bethsy";27;0;100
0;11;"bethy";11;0;100
0;55;"bethyl";55;0;100
0;11;"bethzabel";11;0;100
0;5;"bethzabeth";5;0;100
0;321;"bethzaida";321;0;100
0;5;"bethzaira";5;0;100
0;18;"bethzi";18;0;100
0;360;"bethzy";360;0;100
5;0;"betim";5;100;0
0;980;"betina";980;0;100
53;0;"beto";53;100;0
0;8;"betony";8;0;100
0;97;"betrice";97;0;100
0;15;"betrina";15;0;100
0;782;"betsabe";782;0;100
0;5;"betsabet";5;0;100
0;15;"betsabeth";15;0;100
0;776;"betsaida";776;0;100
0;5;"betsayda";5;0;100
0;17;"betselot";17;0;100
0;2406;"betsey";2406;0;100
0;162;"betsi";162;0;100
0;206;"betsie";206;0;100
0;23;"betsua";23;0;100
10;47861;"betsy";47871;0.0208894737941551;99.9791105262058
0;5;"betsye";5;0;100
0;5;"bett";5;0;100
0;78;"betta";78;0;100
22;34809;"bette";34831;0.0631621256926301;99.9368378743074
0;37;"betteann";37;0;100
0;5;"bettee";5;0;100
0;71;"bettejane";71;0;100
0;18;"bettejean";18;0;100
0;15;"bettejo";15;0;100
0;29;"bettelou";29;0;100
0;119;"bettey";119;0;100
0;849;"betti";849;0;100
0;10;"bettiann";10;0;100
0;6;"bettianne";6;0;100
83;35655;"bettie";35738;0.232245788796239;99.7677542112038
0;22;"bettijane";22;0;100
0;11;"bettilou";11;0;100
0;6403;"bettina";6403;0;100
0;5;"bettine";5;0;100
0;24;"bettsy";24;0;100
3619;994560;"betty";998179;0.362560222164562;99.6374397778354
0;1402;"bettyann";1402;0;100
0;116;"bettyanne";116;0;100
47;22874;"bettye";22921;0.205052135596178;99.7949478644038
0;788;"bettyjane";788;0;100
0;421;"bettyjean";421;0;100
0;764;"bettyjo";764;0;100
0;136;"bettylee";136;0;100
0;1390;"bettylou";1390;0;100
0;22;"bettylu";22;0;100
0;130;"bettymae";130;0;100
0;5;"bettymarie";5;0;100
0;5;"bettzy";5;0;100
0;102;"betul";102;0;100
0;44;"bety";44;0;100
0;171;"betzabe";171;0;100
0;37;"betzabel";37;0;100
0;29;"betzabet";29;0;100
0;259;"betzabeth";259;0;100
0;1370;"betzaida";1370;0;100
0;89;"betzaira";89;0;100
224;0;"betzalel";224;100;0
0;131;"betzayda";131;0;100
0;32;"betzayra";32;0;100
0;8;"betzhy";8;0;100
0;40;"betzi";40;0;100
0;904;"betzy";904;0;100
219;0;"beuford";219;100;0
0;1029;"beula";1029;0;100
201;63432;"beulah";63633;0.315873839045778;99.6841261609542
0;403;"beuna";403;0;100
0;17;"beunca";17;0;100
0;26;"beunka";26;0;100
5;998;"bev";1003;0.498504486540379;99.5014955134596
0;156;"beva";156;0;100
542;66;"bevan";608;89.1447368421053;10.8552631578947
13;131;"bevely";144;9.02777777777778;90.9722222222222
0;269;"bevelyn";269;0;100
0;5;"bevereley";5;0;100
0;335;"beverely";335;0;100
0;57;"beverle";57;0;100
0;2277;"beverlee";2277;0;100
397;12975;"beverley";13372;2.96889021836674;97.0311097816333
0;38;"beverli";38;0;100
0;320;"beverlie";320;0;100
0;5;"beverlin";5;0;100
4450;376730;"beverly";381180;1.1674274620914;98.8325725379086
0;140;"beverlyann";140;0;100
0;43;"beverlye";43;0;100
0;544;"beverlyn";544;0;100
0;11;"bevery";11;0;100
0;22;"bevie";22;0;100
129;1012;"bevin";1141;11.3058720420684;88.6941279579316
6;0;"bevis";6;100;0
17;0;"bevon";17;100;0
0;29;"bevyn";29;0;100
7;0;"bex";7;100;0
8;0;"bexar";8;100;0
0;77;"bexlee";77;0;100
0;47;"bexleigh";47;0;100
47;638;"bexley";685;6.86131386861314;93.1386861313869
0;12;"bexli";12;0;100
0;5;"bexlie";5;0;100
33;0;"bexton";33;100;0
0;153;"beya";153;0;100
0;10;"beyah";10;0;100
6;0;"beyan";6;100;0
0;10;"beyanka";10;0;100
0;6;"beyda";6;0;100
0;141;"beyla";141;0;100
0;181;"beyonca";181;0;100
0;1943;"beyonce";1943;0;100
0;5;"beyoncee";5;0;100
0;118;"beyonka";118;0;100
0;61;"beyounce";61;0;100
0;5;"beyunka";5;0;100
0;117;"beyza";117;0;100
0;106;"beza";106;0;100
16;0;"bezaleel";16;100;0
23;0;"bezalel";23;100;0
0;38;"bezawit";38;0;100
0;49;"bg";49;0;100
0;135;"bhakti";135;0;100
183;0;"bharat";183;100;0
82;0;"bharath";82;100;0
206;0;"bhargav";206;100;0
5;0;"bhargava";5;100;0
0;30;"bhargavi";30;0;100
0;109;"bhavana";109;0;100
0;23;"bhavani";23;0;100
96;0;"bhavesh";96;100;0
0;11;"bhavi";11;0;100
175;0;"bhavik";175;100;0
0;84;"bhavika";84;0;100
181;0;"bhavin";181;100;0
0;23;"bhavini";23;0;100
0;36;"bhavna";36;0;100
72;289;"bhavya";361;19.9445983379501;80.0554016620499
0;32;"bhoomi";32;0;100
0;5;"bhoomika";5;0;100
0;5;"bhrianna";5;0;100
0;144;"bhumi";144;0;100
0;23;"bhumika";23;0;100
44;0;"bhuvan";44;100;0
0;14;"bhuvi";14;0;100
0;12;"bia";12;0;100
0;6;"biaca";6;0;100
0;5;"biafra";5;0;100
37;0;"biaggio";37;100;0
1011;0;"biagio";1011;100;0
6;29;"biak";35;17.1428571428571;82.8571428571429
0;211;"biana";211;0;100
0;7;"bianaca";7;0;100
195;71132;"bianca";71327;0.273388758815035;99.726611241185
0;10;"biancamarie";10;0;100
0;25;"biancca";25;0;100
0;86;"biance";86;0;100
0;54;"biancha";54;0;100
0;40;"biancia";40;0;100
9;71;"bianco";80;11.25;88.75
0;5;"bianet";5;0;100
0;11;"bianeth";11;0;100
0;612;"bianey";612;0;100
0;33;"bianica";33;0;100
0;2177;"bianka";2177;0;100
0;5;"biankah";5;0;100
0;138;"bianna";138;0;100
0;130;"biannca";130;0;100
0;87;"bianney";87;0;100
0;7;"bianny";7;0;100
0;17;"biatris";17;0;100
0;21;"biatriz";21;0;100
0;5;"biaunca";5;0;100
35;0;"bibb";35;100;0
5;0;"bibek";5;100;0
0;503;"bibi";503;0;100
0;23;"bibian";23;0;100
0;1293;"bibiana";1293;0;100
0;50;"bibianna";50;0;100
15;0;"bibiano";15;100;0
10;0;"bicente";10;100;0
0;142;"bich";142;0;100
7;0;"bictor";7;100;0
5;0;"bidal";5;100;0
0;158;"biddie";158;0;100
0;10;"biddy";10;0;100
19;0;"bidwell";19;100;0
11;0;"biel";11;100;0
0;12;"bielka";12;0;100
0;8;"bienvenida";8;0;100
405;0;"bienvenido";405;100;0
254;0;"biff";254;100;0
0;10;"biftu";10;0;100
57;0;"bige";57;100;0
6;0;"bihaan";6;100;0
0;128;"bijal";128;0;100
968;29;"bijan";997;97.0912738214644;2.90872617853561
80;20;"bijon";100;80;20
0;224;"bijou";224;0;100
0;28;"bijoux";28;0;100
17;0;"biju";17;100;0
30;0;"biko";30;100;0
14;0;"bikram";14;100;0
85;0;"bilaal";85;100;0
4361;5;"bilal";4366;99.885478699038;0.114521300961979
0;66;"bilan";66;0;100
132;0;"bilbo";132;100;0
0;29;"bilen";29;0;100
5;0;"bilguun";5;100;0
0;47;"bilinda";47;0;100
0;5;"biljana";5;0;100
158845;716;"bill";159561;99.5512687937529;0.448731206247141
0;11;"billa";11;0;100
142;0;"billal";142;100;0
23;28;"bille";51;45.0980392156863;54.9019607843137
5;601;"billee";606;0.825082508250825;99.1749174917492
522;0;"billey";522;100;0
5;1721;"billi";1726;0.289687137891078;99.7103128621089
31326;100969;"billie";132295;23.6788994293057;76.3211005706943
0;191;"billiejean";191;0;100
0;1455;"billiejo";1455;0;100
0;6;"billiejoe";6;0;100
0;183;"billijo";183;0;100
5;0;"billion";5;100;0
5;0;"billison";5;100;0
381940;5347;"billy";387287;98.6193701311947;1.3806298688053
112;3360;"billye";3472;3.2258064516129;96.7741935483871
79;0;"billyjack";79;100;0
34;44;"billyjo";78;43.5897435897436;56.4102564102564
398;0;"billyjoe";398;100;0
46;0;"billyray";46;100;0
0;45;"bilma";45;0;100
5;0;"bilol";5;100;0
0;5;"bilon";5;0;100
0;5;"bilqis";5;0;100
10;0;"bily";10;100;0
6;0;"bimal";6;100;0
5;0;"bimbo";5;100;0
11;0;"bin";11;100;0
0;977;"bina";977;0;100
0;5;"binaca";5;0;100
0;38;"binah";38;0;100
0;5;"binca";5;0;100
0;175;"bindi";175;0;100
0;67;"bindu";67;0;100
0;16;"bindy";16;0;100
0;23;"bineta";23;0;100
6;0;"binford";6;100;0
356;0;"bing";356;100;0
66;0;"bingham";66;100;0
477;38;"binh";515;92.621359223301;7.37864077669903
0;5;"binisha";5;0;100
0;5;"binita";5;0;100
0;5;"binky";5;0;100
100;368;"binnie";468;21.3675213675214;78.6324786324786
0;426;"binta";426;0;100
0;29;"binti";29;0;100
0;405;"bintou";405;0;100
0;52;"bintu";52;0;100
8;0;"binu";8;100;0
660;0;"binyamin";660;100;0
878;0;"binyomin";878;100;0
0;15;"bioleta";15;0;100
120;0;"bion";120;100;0
0;716;"bionca";716;0;100
0;8;"bionce";8;0;100
0;5;"bionda";5;0;100
0;55;"bionka";55;0;100
164;0;"biran";164;100;0
0;9;"biranna";9;0;100
242;0;"birch";242;100;0
11;0;"birchard";11;100;0
5;0;"birche";5;100;0
7;0;"birchel";7;100;0
0;26;"birchie";26;0;100
54;21;"bird";75;72;28
0;478;"birda";478;0;100
20;348;"birdell";368;5.43478260869565;94.5652173913043
0;163;"birdella";163;0;100
0;102;"birdena";102;0;100
0;6;"birdene";6;0;100
0;18;"birder";18;0;100
0;469;"birdia";469;0;100
101;9238;"birdie";9339;1.08148624049684;98.9185137595032
0;30;"birdine";30;0;100
0;5;"birdye";5;0;100
6;0;"biren";6;100;0
34;0;"birger";34;100;0
0;275;"birgit";275;0;100
0;84;"birgitta";84;0;100
0;5;"birgitte";5;0;100
0;533;"biridiana";533;0;100
5;0;"birk";5;100;0
0;12;"birklee";12;0;100
0;22;"birkley";22;0;100
183;0;"birl";183;100;0
72;0;"birney";72;100;0
6;0;"biron";6;100;0
184;5;"birt";189;97.3544973544974;2.64550264550265
0;19;"birta";19;0;100
0;1826;"birtha";1826;0;100
0;5;"birthel";5;0;100
0;710;"birtie";710;0;100
0;51;"birttany";51;0;100
0;5;"birty";5;0;100
94;0;"biruk";94;100;0
0;5;"biruta";5;0;100
0;23;"birute";23;0;100
0;5;"birydiana";5;0;100
0;19;"bisa";19;0;100
0;30;"bisan";30;0;100
0;26;"bisceglia";26;0;100
11;0;"bisente";11;100;0
28;0;"bishara";28;100;0
0;5;"bisharo";5;0;100
12;0;"bisher";12;100;0
4985;5;"bishop";4990;99.8997995991984;0.100200400801603
74;0;"bishoy";74;100;0
0;7;"bisleidy";7;0;100
0;210;"bisma";210;0;100
0;41;"bismah";41;0;100
25;0;"bismarck";25;100;0
45;0;"bismark";45;100;0
0;5;"bisola";5;0;100
10;0;"bison";10;100;0
0;11;"bissan";11;0;100
0;21;"bissie";21;0;100
0;109;"bita";109;0;100
0;50;"bitania";50;0;100
0;16;"bitanya";16;0;100
0;92;"bitha";92;0;100
0;17;"bithiah";17;0;100
0;16;"bitia";16;0;100
0;16;"bitsy";16;0;100
0;22;"bittany";22;0;100
5;7;"bivian";12;41.6666666666667;58.3333333333333
0;246;"biviana";246;0;100
16;0;"bix";16;100;0
15;12;"bixby";27;55.5555555555556;44.4444444444444
0;5;"biyanca";5;0;100
0;5;"biyanka";5;0;100
688;5;"bj";693;99.2784992784993;0.721500721500722
0;9;"bjana";9;0;100
55;0;"bjarne";55;100;0
6;0;"bjay";6;100;0
2621;0;"bjorn";2621;100;0
0;5;"bla";5;0;100
25;0;"blace";25;100;0
5;0;"blackie";5;100;0
1866;0;"blade";1866;100;0
781;0;"bladen";781;100;0
1059;0;"bladimir";1059;100;0
84;0;"bladyn";84;100;0
7;0;"blaid";7;100;0
6;0;"blaide";6;100;0
112;0;"blaiden";112;100;0
6;0;"blaidyn";6;100;0
34;0;"blaik";34;100;0
175;123;"blaike";298;58.7248322147651;41.2751677852349
0;32;"blaiklee";32;0;100
0;34;"blaikley";34;0;100
2205;17;"blain";2222;99.2349234923492;0.765076507650765
30642;1028;"blaine";31670;96.7540258920114;3.24597410798863
14297;13584;"blair";27881;51.2786485420179;48.7213514579821
54;3437;"blaire";3491;1.54683471784589;98.4531652821541
6811;523;"blaise";7334;92.868830106354;7.13116989364603
38;0;"blaiz";38;100;0
1430;167;"blaize";1597;89.5428929242329;10.4571070757671
170118;8174;"blake";178292;95.4153859960065;4.58461400399345
18;518;"blakelee";536;3.35820895522388;96.6417910447761
0;277;"blakeleigh";277;0;100
102;722;"blakeley";824;12.378640776699;87.621359223301
0;30;"blakeli";30;0;100
0;22;"blakelie";22;0;100
1104;5967;"blakely";7071;15.6130674586339;84.3869325413661
0;422;"blakelyn";422;0;100
0;215;"blakelynn";215;0;100
5;0;"blaken";5;100;0
0;20;"blakeney";20;0;100
0;17;"blakesley";17;0;100
0;70;"blaklee";70;0;100
0;63;"blakleigh";63;0;100
49;299;"blakley";348;14.0804597701149;85.9195402298851
0;5;"blaklie";5;0;100
0;5;"blakney";5;0;100
22;0;"blan";22;100;0
126;24575;"blanca";24701;0.510100805635399;99.4898991943646
0;5;"blancaestela";5;0;100
30;5234;"blanch";5264;0.569908814589666;99.4300911854103
0;5;"blancha";5;0;100
408;0;"blanchard";408;100;0
184;69567;"blanche";69751;0.263795501139769;99.7362044988602
0;1297;"blanchie";1297;0;100
408;0;"bland";408;100;0
0;66;"blandina";66;0;100
0;17;"blandine";17;0;100
77;0;"blandon";77;100;0
0;6;"blandy";6;0;100
4184;11;"blane";4195;99.7377830750894;0.262216924910608
5;7;"blaney";12;41.6666666666667;58.3333333333333
0;68;"blanka";68;0;100
0;189;"blannie";189;0;100
417;0;"blanton";417;100;0
2742;0;"blas";2742;100;0
0;187;"blasa";187;0;100
768;0;"blase";768;100;0
5;0;"blass";5;100;0
5;0;"blayd";5;100;0
235;0;"blayde";235;100;0
582;0;"blayden";582;100;0
13;0;"blaydin";13;100;0
25;0;"blaydon";25;100;0
33;0;"blayk";33;100;0
621;545;"blayke";1166;53.2590051457976;46.7409948542024
0;89;"blayklee";89;0;100
0;5;"blaykleigh";5;0;100
64;0;"blayn";64;100;0
3574;399;"blayne";3973;89.9572111754342;10.0427888245658
0;6;"blayr";6;0;100
0;95;"blayre";95;0;100
16;0;"blayse";16;100;0
15;0;"blayson";15;100;0
11;0;"blayten";11;100;0
248;0;"blayton";248;100;0
51;0;"blayz";51;100;0
838;39;"blayze";877;95.5530216647662;4.44697833523375
5;0;"blaz";5;100;0
0;5;"blaza";5;0;100
5774;405;"blaze";6179;93.445541349733;6.55445865026703
33;0;"blazen";33;100;0
10;0;"blazer";10;100;0
201;0;"blease";201;100;0
0;6;"bleeker";6;0;100
0;5;"bleidy";5;0;100
0;174;"blen";174;0;100
0;1016;"blenda";1016;0;100
0;5;"blendia";5;0;100
0;18;"bleona";18;0;100
5;0;"blerim";5;100;0
0;5;"blerina";5;0;100
0;23;"blerta";23;0;100
202;183;"bless";385;52.4675324675325;47.5324675324675
75;167;"blessed";242;30.9917355371901;69.0082644628099
0;102;"blessen";102;0;100
0;5;"blessence";5;0;100
0;306;"blessin";306;0;100
191;2255;"blessing";2446;7.80866721177433;92.1913327882257
0;81;"blessings";81;0;100
0;5;"blessn";5;0;100
12;0;"blesson";12;100;0
0;16;"blessy";16;0;100
0;198;"blessyn";198;0;100
52;56;"bleu";108;48.1481481481481;51.8518518518518
0;119;"blia";119;0;100
0;1115;"blima";1115;0;100
0;72;"blimi";72;0;100
0;289;"blimie";289;0;100
0;508;"blimy";508;0;100
5;0;"blin";5;100;0
0;226;"blinda";226;0;100
173;1218;"bliss";1391;12.4370956146657;87.5629043853343
0;11;"blissany";11;0;100
0;18;"blithe";18;0;100
0;25;"blodwen";25;0;100
0;59;"blodwyn";59;0;100
0;5;"blon";5;0;100
0;11;"blondean";11;0;100
15;1474;"blondell";1489;1.0073875083949;98.9926124916051
0;57;"blondena";57;0;100
0;365;"blondie";365;0;100
0;74;"blondina";74;0;100
0;201;"blondine";201;0;100
0;11;"bloneva";11;0;100
255;0;"blong";255;100;0
0;374;"blonnie";374;0;100
0;5;"bloomie";5;0;100
0;191;"blossie";191;0;100
0;2599;"blossom";2599;0;100
8;0;"blouncie";8;100;0
194;100;"blu";294;65.9863945578231;34.0136054421769
575;237;"blue";812;70.8128078817734;29.1871921182266
277;0;"bluford";277;100;0
0;311;"bluma";311;0;100
50;5;"bly";55;90.9090909090909;9.09090909090909
0;5;"blynda";5;0;100
11;0;"blynn";11;100;0
0;103;"blyss";103;0;100
0;11;"blyth";11;0;100
214;4217;"blythe";4431;4.82960956894606;95.1703904310539
0;6;"bnai";6;0;100
9779;621;"bo";10400;94.0288461538462;5.97115384615385
10;0;"boady";10;100;0
1597;0;"boaz";1597;100;0
91773;322;"bob";92095;99.6503610402302;0.349638959769803
6;0;"boback";6;100;0
122;0;"bobak";122;100;0
17;0;"boban";17;100;0
10;0;"bobb";10;100;0
0;567;"bobbe";567;0;100
0;10;"bobbee";10;0;100
0;10;"bobbetta";10;0;100
0;667;"bobbette";667;0;100
64;23558;"bobbi";23622;0.270933875201084;99.7290661247989
18363;87861;"bobbie";106224;17.2870537731586;82.7129462268414
0;38;"bobbiejean";38;0;100
0;1009;"bobbiejo";1009;0;100
0;6;"bobbielee";6;0;100
0;26;"bobbiesue";26;0;100
0;1231;"bobbijo";1231;0;100
0;5;"bobbilee";5;0;100
0;5;"bobbilynn";5;0;100
0;11;"bobbisue";11;0;100
312905;9617;"bobby";322522;97.0181879065614;2.98181209343859
97;3171;"bobbye";3268;2.96817625458996;97.03182374541
0;6;"bobbyetta";6;0;100
0;160;"bobbyjo";160;0;100
89;0;"bobbyjoe";89;100;0
15;0;"bobbylee";15;100;0
0;101;"bobetta";101;0;100
0;1464;"bobette";1464;0;100
0;593;"bobi";593;0;100
377;420;"bobie";797;47.3023839397742;52.6976160602258
0;16;"bobijo";16;0;100
5;0;"bobo";5;100;0
0;7;"bobra";7;0;100
374;0;"boby";374;100;0
11;0;"bocar";11;100;0
47;0;"bocephus";47;100;0
5;0;"bodan";5;100;0
2446;0;"bode";2446;100;0
10;0;"bodean";10;100;0
399;5;"bodee";404;98.7623762376238;1.23762376237624
2339;0;"boden";2339;100;0
386;0;"bodey";386;100;0
5;0;"bodhan";5;100;0
3835;115;"bodhi";3950;97.0886075949367;2.91139240506329
36;0;"bodhin";36;100;0
330;0;"bodi";330;100;0
2920;5;"bodie";2925;99.8290598290598;0.170940170940171
145;0;"bodin";145;100;0
36;0;"bodyn";36;100;0
771;7;"boe";778;99.1002570694087;0.89974293059126
11;0;"boede";11;100;0
57;0;"boedy";57;100;0
73;0;"boen";73;100;0
0;8;"boey";8;0;100
34;0;"bogar";34;100;0
33;0;"bogart";33;100;0
490;0;"bogdan";490;100;0
0;6;"bogdana";6;0;100
32;0;"bohan";32;100;0
27;0;"bohannon";27;100;0
726;0;"bohdan";726;100;0
5;0;"bohde";5;100;0
79;0;"bohden";79;100;0
171;0;"bohdi";171;100;0
12;0;"bohen";12;100;0
56;0;"bohumil";56;100;0
16;0;"boice";16;100;0
38;0;"boise";38;100;0
5;0;"boisey";5;100;0
11;0;"boisy";11;100;0
25;0;"bojan";25;100;0
18;0;"bol";18;100;0
6;0;"bolaji";6;100;0
0;5;"bolanle";5;0;100
49;0;"bolden";49;100;0
255;0;"boleslaus";255;100;0
277;0;"boleslaw";277;100;0
7;0;"bolin";7;100;0
10;0;"bolish";10;100;0
237;0;"bolivar";237;100;0
0;5;"bolivia";5;0;100
5;0;"bolling";5;100;0
148;0;"bolton";148;100;0
62;45;"boluwatife";107;57.9439252336449;42.0560747663551
116;0;"bomani";116;100;0
5;0;"bomer";5;100;0
269;0;"bon";269;100;0
10;176;"bona";186;5.37634408602151;94.6236559139785
0;5;"bonalyn";5;0;100
7;0;"bonanza";7;100;0
11;0;"bonard";11;100;0
0;5;"boncile";5;0;100
196;6;"bond";202;97.029702970297;2.97029702970297
0;53;"bonda";53;0;100
0;6;"boneita";6;0;100
5;5;"bonell";10;50;50
0;159;"boneta";159;0;100
0;92;"bonetta";92;0;100
0;7;"boneva";7;0;100
5;0;"boney";5;100;0
10;0;"bong";10;100;0
59;0;"bonham";59;100;0
0;368;"boni";368;0;100
0;10;"bonieta";10;0;100
148;0;"boniface";148;100;0
0;28;"bonifacia";28;0;100
1525;0;"bonifacio";1525;100;0
0;5;"bonique";5;0;100
12;37678;"bonita";37690;0.0318386840010613;99.9681613159989
0;5;"bonitta";5;0;100
0;1080;"bonna";1080;0;100
0;366;"bonne";366;0;100
0;76;"bonnee";76;0;100
0;240;"bonnell";240;0;100
0;10;"bonnelle";10;0;100
285;0;"bonner";285;100;0
0;170;"bonnetta";170;0;100
0;27;"bonnette";27;0;100
5;447;"bonney";452;1.10619469026549;98.8938053097345
0;1401;"bonni";1401;0;100
0;5;"bonnibel";5;0;100
3888;321837;"bonnie";325725;1.19364494588994;98.8063550541101
0;89;"bonniejean";89;0;100
0;15;"bonniejo";15;0;100
0;50;"bonnielee";50;0;100
0;32;"bonnielou";32;0;100
0;683;"bonnita";683;0;100
0;10;"bonnitta";10;0;100
261;6172;"bonny";6433;4.05720503653039;95.9427949634696
0;364;"bonnye";364;0;100
0;5;"bonzie";5;0;100
10934;5;"booker";10939;99.9542919828138;0.0457080171862145
88;0;"bookert";88;100;0
32;0;"boomer";32;100;0
5;0;"boon";5;100;0
2529;0;"boone";2529;100;0
37;0;"booth";37;100;0
28;125;"boots";153;18.3006535947712;81.6993464052288
0;45;"bopha";45;0;100
316;97;"bora";413;76.5133171912833;23.4866828087167
15;0;"borach";15;100;0
7;0;"boran";7;100;0
215;0;"borden";215;100;0
0;334;"borghild";334;0;100
0;5;"borgny";5;0;100
4236;0;"boris";4236;100;0
9;0;"borja";9;100;0
5;0;"born";5;100;0
46;0;"borna";46;100;0
880;0;"boruch";880;100;0
23;0;"borys";23;100;0
204;0;"bosco";204;100;0
15;0;"bose";15;100;0
0;5;"bosede";5;0;100
40;0;"bosie";40;100;0
234;0;"boss";234;100;0
50;0;"bossie";50;100;0
90;0;"bosten";90;100;0
23;0;"bostin";23;100;0
6900;629;"boston";7529;91.6456368707664;8.35436312923363
156;363;"bostyn";519;30.0578034682081;69.9421965317919
0;34;"bostynn";34;0;100
5;0;"boswell";5;100;0
328;0;"boubacar";328;100;0
10;0;"boulder";10;100;0
5;0;"boun";5;100;0
11;0;"bourne";11;100;0
5;0;"bouvier";5;100;0
140;5;"bow";145;96.551724137931;3.44827586206897
46;0;"bowan";46;100;0
263;0;"bowden";263;100;0
5;0;"bowdie";5;100;0
14;0;"bowdrie";14;100;0
92;0;"bowdy";92;100;0
96;0;"bowe";96;100;0
5302;91;"bowen";5393;98.3126274800668;1.68737251993325
5;0;"bower";5;100;0
569;275;"bowie";844;67.4170616113744;32.5829383886256
15;0;"bowin";15;100;0
601;0;"bowman";601;100;0
77;11;"bowyn";88;87.5;12.5
651;0;"boy";651;100;0
34;0;"boyan";34;100;0
5359;58;"boyce";5417;98.9292966586672;1.07070334133284
26135;65;"boyd";26200;99.7519083969466;0.248091603053435
81;0;"boyde";81;100;0
23;0;"boyden";23;100;0
5;0;"boyed";5;100;0
7;0;"boyer";7;100;0
117;0;"boykin";117;100;0
6;0;"boynton";6;100;0
57;0;"boysie";57;100;0
5;0;"boz";5;100;0
0;45;"bozena";45;0;100
105;0;"brace";105;100;0
0;5;"bracelyn";5;0;100
0;5;"bracelynn";5;0;100
74;0;"bracen";74;100;0
29;20;"bracey";49;59.1836734693878;40.8163265306122
99;0;"brach";99;100;0
0;1776;"bracha";1776;0;100
0;39;"bracie";39;0;100
401;0;"brack";401;100;0
556;0;"bracken";556;100;0
42;0;"brackston";42;100;0
82;5;"bracy";87;94.2528735632184;5.74712643678161
25;0;"bracyn";25;100;0
82755;233;"brad";82988;99.7192365161228;0.280763483877187
428;0;"bradan";428;100;0
5;0;"bradbury";5;100;0
653;0;"bradd";653;100;0
106;0;"bradden";106;100;0
369;0;"braddock";369;100;0
27;0;"braddox";27;100;0
33;79;"bradee";112;29.4642857142857;70.5357142857143
60;0;"bradely";60;100;0
43516;273;"braden";43789;99.3765557560118;0.623444243988216
5;0;"braderick";5;100;0
699;9;"bradey";708;98.728813559322;1.27118644067797
5;0;"bradfield";5;100;0
31553;39;"bradford";31592;99.8765510255761;0.123448974423905
0;612;"bradi";612;0;100
201;476;"bradie";677;29.6898079763663;70.3101920236337
402;0;"bradin";402;100;0
3139;230;"bradlee";3369;93.1730483823093;6.82695161769071
11;318;"bradleigh";329;3.3434650455927;96.6565349544073
302332;1495;"bradley";303827;99.5079436653095;0.492056334690465
0;5;"bradli";5;0;100
11;47;"bradlie";58;18.9655172413793;81.0344827586207
9165;11;"bradly";9176;99.8801220575414;0.119877942458588
15;0;"bradlyn";15;100;0
5;0;"bradney";5;100;0
11;0;"bradnon";11;100;0
2008;0;"bradon";2008;100;0
176;0;"bradrick";176;100;0
68;0;"bradshaw";68;100;0
5;0;"bradson";5;100;0
85419;1689;"brady";87108;98.0610276897644;1.93897231023557
7;0;"bradyen";7;100;0
4244;217;"bradyn";4461;95.1356198161847;4.86438018381529
15;5;"bradynn";20;75;25
108;170;"brae";278;38.8489208633094;61.1510791366906
5;0;"braecyn";5;100;0
910;0;"braedan";910;100;0
12861;230;"braeden";13091;98.2430677564739;1.75693224352609
143;0;"braedin";143;100;0
3801;0;"braedon";3801;100;0
44;0;"braedy";44;100;0
1970;271;"braedyn";2241;87.9071842927265;12.0928157072735
5;0;"braegan";5;100;0
0;17;"braela";17;0;100
32;0;"braelan";32;100;0
0;239;"braelee";239;0;100
0;7;"braelei";7;0;100
0;289;"braeleigh";289;0;100
206;0;"braelen";206;100;0
0;78;"braeley";78;0;100
0;18;"braeli";18;0;100
0;38;"braelie";38;0;100
263;194;"braelin";457;57.5492341356674;42.4507658643326
0;5;"braelinn";5;0;100
374;0;"braelon";374;100;0
0;31;"braely";31;0;100
836;7513;"braelyn";8349;10.0131752305665;89.9868247694335
0;6;"braelyne";6;0;100
102;4550;"braelynn";4652;2.19260533104041;97.8073946689596
0;118;"braelynne";118;0;100
5;0;"braesen";5;100;0
80;0;"braeson";80;100;0
12;0;"braesyn";12;100;0
65;0;"braeton";65;100;0
0;5;"braeya";5;0;100
10;0;"brage";10;100;0
7;0;"braham";7;100;0
253;0;"braheem";253;100;0
5;0;"brahian";5;100;0
63;0;"brahim";63;100;0
10;0;"brahin";10;100;0
226;0;"brahm";226;100;0
6;0;"brahms";6;100;0
179;0;"braian";179;100;0
131;0;"braidan";131;100;0
6668;152;"braiden";6820;97.7712609970674;2.22873900293255
439;0;"braidon";439;100;0
6;17;"braidy";23;26.0869565217391;73.9130434782609
492;83;"braidyn";575;85.5652173913043;14.4347826086957
21;0;"braijon";21;100;0
0;484;"brailee";484;0;100
0;63;"braileigh";63;0;100
151;0;"brailen";151;100;0
5;895;"brailey";900;0.555555555555556;99.4444444444444
11;0;"brailin";11;100;0
68;0;"brailon";68;100;0
0;43;"braily";43;0;100
271;795;"brailyn";1066;25.422138836773;74.577861163227
19;578;"brailynn";597;3.18257956448911;96.8174204355109
4586;10;"brain";4596;99.7824194952132;0.217580504786771
0;10;"braina";10;0;100
129;0;"brainard";129;100;0
0;20;"brainna";20;0;100
13;0;"brais";13;100;0
5;0;"braisen";5;100;0
0;7;"braisley";7;0;100
208;0;"braison";208;100;0
0;5;"braiya";5;0;100
8;0;"brajon";8;100;0
6;0;"bralan";6;100;0
0;77;"bralee";77;0;100
0;6;"bralei";6;0;100
0;352;"braleigh";352;0;100
301;5;"bralen";306;98.3660130718954;1.63398692810458
11;246;"braley";257;4.28015564202335;95.7198443579767
0;7;"bralie";7;0;100
110;0;"bralin";110;100;0
325;0;"brallan";325;100;0
121;0;"bralon";121;100;0
431;280;"bralyn";711;60.6188466947961;39.3811533052039
93;402;"bralynn";495;18.7878787878788;81.2121212121212
0;10;"bralynne";10;0;100
1147;0;"bram";1147;100;0
173;0;"bran";173;100;0
0;31;"brana";31;0;100
0;69;"branae";69;0;100
7;0;"branan";7;100;0
0;17;"branasia";17;0;100
257;0;"brance";257;100;0
484;0;"branch";484;100;0
10;0;"branco";10;100;0
7;0;"brancon";7;100;0
0;17;"brancy";17;0;100
255;18;"brand";273;93.4065934065934;6.59340659340659
0;1097;"branda";1097;0;100
0;160;"brandace";160;0;100
0;5;"brandais";5;0;100
20;0;"brandal";20;100;0
7;0;"brandale";7;100;0
31;0;"brandall";31;100;0
0;575;"brandalyn";575;0;100
0;127;"brandalynn";127;0;100
5554;96;"brandan";5650;98.3008849557522;1.69911504424779
11;0;"brandarius";11;100;0
0;17;"brandasia";17;0;100
21;0;"branddon";21;100;0
0;1141;"brande";1141;0;100
0;5;"brandea";5;0;100
0;5469;"brandee";5469;0;100
0;39;"brandeis";39;0;100
52;13;"brandel";65;80;20
91;6;"brandell";97;93.8144329896907;6.18556701030928
0;177;"brandelyn";177;0;100
0;5;"brandelynn";5;0;100
26892;330;"branden";27222;98.7877452060833;1.21225479391669
5;0;"brandenn";5;100;0
5;0;"brander";5;100;0
0;5;"brandessa";5;0;100
0;209;"brandey";209;0;100
389;101411;"brandi";101800;0.382121807465619;99.6178781925344
0;19;"brandia";19;0;100
0;5;"brandiann";5;0;100
0;1033;"brandice";1033;0;100
29;15764;"brandie";15793;0.183625656936618;99.8163743430634
0;189;"brandii";189;0;100
0;60;"brandilee";60;0;100
0;663;"brandilyn";663;0;100
0;116;"brandilynn";116;0;100
2671;137;"brandin";2808;95.1210826210826;4.87891737891738
0;6;"brandina";6;0;100
84;730;"brandis";814;10.3194103194103;89.6805896805897
0;15;"brandise";15;0;100
0;5;"brandisha";5;0;100
0;15;"brandiss";15;0;100
67;0;"brandley";67;100;0
0;41;"brandlyn";41;0;100
38;0;"brandn";38;100;0
1890;0;"brando";1890;100;0
105;0;"brandol";105;100;0
0;145;"brandolyn";145;0;100
289;0;"brandom";289;100;0
750127;4125;"brandon";754252;99.4531005552521;0.546899444747909
21;0;"brandonjames";21;100;0
5;0;"brandonkyle";5;100;0
227;0;"brandonlee";227;100;0
30;0;"brandonmichael";30;100;0
122;0;"brandonn";122;100;0
5;0;"brandonray";5;100;0
6;0;"brandson";6;100;0
5533;38;"brandt";5571;99.3178962484294;0.682103751570634
34;0;"brandtley";34;100;0
27;0;"brandtly";27;100;0
6;0;"brandton";6;100;0
99;0;"brandun";99;100;0
2228;106065;"brandy";108293;2.05738136352303;97.942618636477
0;5;"brandyann";5;0;100
0;100;"brandyce";100;0;100
0;485;"brandye";485;0;100
0;27;"brandylee";27;0;100
0;6;"brandylynn";6;0;100
4576;423;"brandyn";4999;91.5383076615323;8.46169233846769
0;6;"braneisha";6;0;100
5;0;"branen";5;100;0
0;25;"branesha";25;0;100
59;0;"branford";59;100;0
8;0;"branham";8;100;0
0;18;"brania";18;0;100
0;34;"braniah";34;0;100
31;39;"branigan";70;44.2857142857143;55.7142857142857
0;47;"branisha";47;0;100
0;227;"braniya";227;0;100
0;171;"braniyah";171;0;100
60;0;"branko";60;100;0
14;0;"branlee";14;100;0
11;0;"branly";11;100;0
17;0;"brann";17;100;0
0;136;"branna";136;0;100
376;11;"brannan";387;97.1576227390181;2.84237726098191
261;0;"branndon";261;100;0
364;0;"brannen";364;100;0
10;0;"brannick";10;100;0
16;7;"brannigan";23;69.5652173913043;30.4347826086957
7;0;"brannock";7;100;0
4524;116;"brannon";4640;97.5;2.5
240;0;"branon";240;100;0
11;0;"branoon";11;100;0
623;0;"bransen";623;100;0
5;0;"bransford";5;100;0
6017;5;"branson";6022;99.9169711059449;0.0830288940551312
79;0;"branston";79;100;0
217;0;"bransyn";217;100;0
9141;10;"brant";9151;99.8907223254289;0.109277674571085
24;0;"branten";24;100;0
1355;172;"brantlee";1527;88.7360838244925;11.2639161755075
5;74;"brantleigh";79;6.32911392405063;93.6708860759494
19355;650;"brantley";20005;96.7508122969258;3.24918770307423
0;16;"brantlie";16;0;100
725;5;"brantly";730;99.3150684931507;0.684931506849315
5;0;"brantlyn";5;100;0
832;0;"branton";832;100;0
54;0;"brantson";54;100;0
0;37;"branwen";37;0;100
0;7;"branwyn";7;0;100
0;20;"brany";20;0;100
0;29;"branya";29;0;100
0;14;"branyah";14;0;100
163;0;"brasen";163;100;0
5;0;"brashad";5;100;0
23;0;"brashaun";23;100;0
34;0;"brashawn";34;100;0
6;0;"brasher";6;100;0
12;0;"brasi";12;100;0
0;6;"brasia";6;0;100
131;0;"brason";131;100;0
5;0;"braston";5;100;0
0;6;"braulia";6;0;100
4432;0;"braulio";4432;100;0
294;0;"braun";294;100;0
129;17;"brave";146;88.3561643835616;11.6438356164384
412;0;"braven";412;100;0
57;21;"bravery";78;73.0769230769231;26.9230769230769
23;0;"bravin";23;100;0
134;0;"bravlio";134;100;0
11;0;"bravo";11;100;0
5;0;"bravon";5;100;0
5;0;"bravyn";5;100;0
35;0;"brawley";35;100;0
178;0;"brax";178;100;0
138;0;"braxden";138;100;0
80;0;"braxdon";80;100;0
23;0;"braxdyn";23;100;0
68;0;"braxen";68;100;0
12;7;"braxlee";19;63.1578947368421;36.8421052631579
0;5;"braxleigh";5;0;100
32;14;"braxley";46;69.5652173913043;30.4347826086957
221;0;"braxon";221;100;0
67;0;"braxson";67;100;0
6;0;"braxsten";6;100;0
262;0;"braxston";262;100;0
11;0;"braxstyn";11;100;0
32;0;"braxtan";32;100;0
1187;5;"braxten";1192;99.5805369127517;0.419463087248322
335;5;"braxtin";340;98.5294117647059;1.47058823529412
42071;692;"braxton";42763;98.3817786404134;1.61822135958656
1044;256;"braxtyn";1300;80.3076923076923;19.6923076923077
11;10;"braxtynn";21;52.3809523809524;47.6190476190476
11;0;"braxx";11;100;0
83;0;"braxxton";83;100;0
448;28;"bray";476;94.1176470588235;5.88235294117647
0;322;"braya";322;0;100
0;92;"brayah";92;0;100
269;0;"brayam";269;100;0
13809;18;"brayan";13827;99.8698199175526;0.130180082447386
0;48;"brayana";48;0;100
0;59;"brayanna";59;0;100
281;0;"brayant";281;100;0
5;0;"brayce";5;100;0
195;0;"braycen";195;100;0
1032;10;"braydan";1042;99.0403071017274;0.959692898272553
37;0;"brayde";37;100;0
5;63;"braydee";68;7.35294117647059;92.6470588235294
108521;963;"brayden";109484;99.120419422016;0.879580577983998
39;0;"braydenn";39;100;0
0;6;"braydi";6;0;100
949;11;"braydin";960;98.8541666666667;1.14583333333333
424;0;"braydn";424;100;0
12630;23;"braydon";12653;99.8182249268948;0.181775073105192
416;0;"braydyn";416;100;0
0;11;"brayelle";11;0;100
126;0;"brayen";126;100;0
10;0;"brayhan";10;100;0
0;386;"brayla";386;0;100
0;47;"braylah";47;0;100
1028;50;"braylan";1078;95.3617810760668;4.63821892393321
43;0;"brayland";43;100;0
0;5;"brayle";5;0;100
0;89;"braylea";89;0;100
65;4353;"braylee";4418;1.47125396106836;98.5287460389316
0;73;"braylei";73;0;100
0;1207;"brayleigh";1207;0;100
8258;489;"braylen";8747;94.4095118326283;5.59048816737167
5;0;"braylend";5;100;0
11;5;"braylenn";16;68.75;31.25
0;171;"brayley";171;0;100
0;118;"brayli";118;0;100
0;498;"braylie";498;0;100
2165;1189;"braylin";3354;64.5497912939773;35.4502087060227
0;95;"braylinn";95;0;100
97;0;"brayln";97;100;0
14470;118;"braylon";14588;99.1911159857417;0.808884014258294
367;501;"braylyn";868;42.2811059907834;57.7188940092166
103;886;"braylynn";989;10.4145601617796;89.5854398382204
0;14;"braylynne";14;0;100
193;0;"brayn";193;100;0
5;0;"braynt";5;100;0
247;0;"brayon";247;100;0
0;15;"brayonna";15;0;100
369;0;"braysen";369;100;0
5;0;"brayshaun";5;100;0
6;0;"brayshawn";6;100;0
1918;0;"brayson";1918;100;0
5;0;"brayston";5;100;0
157;0;"brayten";157;100;0
2113;22;"brayton";2135;98.9695550351288;1.03044496487119
20;0;"brayven";20;100;0
14;0;"brayzen";14;100;0
75;0;"brazen";75;100;0
44;365;"brazil";409;10.7579462102689;89.242053789731
177;0;"brazos";177;100;0
0;455;"bre";455;0;100
0;5082;"brea";5082;0;100
0;6;"breaanna";6;0;100
11;0;"breaden";11;100;0
0;843;"breah";843;0;100
0;6;"breahanna";6;0;100
0;521;"breahna";521;0;100
0;16;"breahnna";16;0;100
0;10;"breaira";10;0;100
0;36;"breaja";36;0;100
0;21;"breajah";21;0;100
56;0;"breaker";56;100;0
0;40;"breale";40;0;100
0;5;"brealeigh";5;0;100
0;10;"brealle";10;0;100
0;150;"brealyn";150;0;100
0;178;"brealynn";178;0;100
10;144;"brean";154;6.49350649350649;93.5064935064935
0;11072;"breana";11072;0;100
0;216;"breanah";216;0;100
0;39;"breanca";39;0;100
0;202;"breanda";202;0;100
164;0;"breandan";164;100;0
0;7;"breandra";7;0;100
0;6;"breandrea";6;0;100
0;135;"breane";135;0;100
0;19;"breania";19;0;100
0;5705;"breann";5705;0;100
65;80807;"breanna";80872;0.0803739242259373;99.9196260757741
0;554;"breannah";554;0;100
0;10177;"breanne";10177;0;100
0;49;"breannia";49;0;100
0;42;"breannon";42;0;100
0;5;"breara";5;0;100
0;54;"breasha";54;0;100
0;30;"breashia";30;0;100
0;1241;"breasia";1241;0;100
0;6;"breasya";6;0;100
5;16;"breaun";21;23.8095238095238;76.1904761904762
0;1456;"breauna";1456;0;100
0;635;"breaunna";635;0;100
0;198;"breawna";198;0;100
0;5;"breayla";5;0;100
0;5;"breayna";5;0;100
0;8;"breazae";8;0;100
0;23;"breazia";23;0;100
5;0;"brec";5;100;0
0;30;"brecca";30;0;100
198;0;"breccan";198;100;0
0;5;"brecia";5;0;100
2031;393;"breck";2424;83.7871287128713;16.2128712871287
121;0;"breckan";121;100;0
2737;663;"brecken";3400;80.5;19.5
19;0;"brecker";19;100;0
1041;142;"breckin";1183;87.9966187658495;12.0033812341505
0;12;"brecklin";12;0;100
0;442;"brecklyn";442;0;100
0;121;"brecklynn";121;0;100
118;0;"breckon";118;100;0
177;606;"breckyn";783;22.6053639846743;77.3946360153257
0;13;"breckynn";13;0;100
11;0;"brecon";11;100;0
0;90;"breda";90;0;100
20;0;"bredan";20;100;0
5;0;"bredyn";5;100;0
17;8313;"bree";8330;0.204081632653061;99.7959183673469
0;362;"breea";362;0;100
0;41;"breeah";41;0;100
0;6;"breeahna";6;0;100
0;110;"breean";110;0;100
0;1702;"breeana";1702;0;100
0;1355;"breeann";1355;0;100
0;3106;"breeanna";3106;0;100
0;5;"breeannah";5;0;100
0;344;"breeanne";344;0;100
0;55;"breeauna";55;0;100
0;5;"breeaunna";5;0;100
11;40;"breece";51;21.5686274509804;78.4313725490196
0;5;"breegan";5;0;100
0;14;"breelan";14;0;100
0;6;"breeland";6;0;100
0;11;"breelee";11;0;100
0;18;"breeleigh";18;0;100
0;96;"breeley";96;0;100
0;5;"breelin";5;0;100
0;66;"breella";66;0;100
0;161;"breelle";161;0;100
0;107;"breely";107;0;100
0;895;"breelyn";895;0;100
0;329;"breelynn";329;0;100
0;5;"breen";5;0;100
0;829;"breena";829;0;100
0;145;"breeona";145;0;100
0;127;"breeonna";127;0;100
76;22;"brees";98;77.5510204081633;22.4489795918367
0;5;"breesa";5;0;100
0;5;"breese";5;0;100
0;14;"breesha";14;0;100
0;53;"breeya";53;0;100
0;5;"breeyah";5;0;100
0;11;"breeyana";11;0;100
0;5;"breeyanna";5;0;100
10;11;"breez";21;47.6190476190476;52.3809523809524
0;37;"breeza";37;0;100
47;674;"breeze";721;6.51872399445215;93.4812760055479
0;17;"breezi";17;0;100
0;76;"breezie";76;0;100
0;554;"breezy";554;0;100
5;0;"breh";5;100;0
0;27;"brehan";27;0;100
0;28;"brehana";28;0;100
0;176;"brehanna";176;0;100
0;5;"brehea";5;0;100
19;0;"brehon";19;100;0
0;70;"brei";70;0;100
0;392;"breia";392;0;100
0;13;"breiah";13;0;100
0;315;"breiana";315;0;100
0;18;"breiann";18;0;100
0;434;"breianna";434;0;100
0;11;"breianne";11;0;100
20;0;"breiden";20;100;0
0;5;"breidy";5;0;100
5;0;"breidyn";5;100;0
0;213;"breigh";213;0;100
0;5;"breigha";5;0;100
0;6;"breighana";6;0;100
0;37;"breighanna";37;0;100
5;0;"breighden";5;100;0
0;31;"breighlyn";31;0;100
0;20;"breighlynn";20;0;100
50;0;"breighton";50;100;0
0;28;"breilyn";28;0;100
0;5;"breilynn";5;0;100
0;18;"brein";18;0;100
0;42;"breina";42;0;100
0;158;"breindel";158;0;100
0;370;"breindy";370;0;100
0;7;"breinne";7;0;100
137;45;"breion";182;75.2747252747253;24.7252747252747
0;88;"breiona";88;0;100
0;74;"breionna";74;0;100
0;15;"breisha";15;0;100
5;0;"breitlin";5;100;0
0;7;"brejae";7;0;100
5;0;"brejon";5;100;0
333;0;"brek";333;100;0
138;0;"breken";138;100;0
0;5;"brekia";5;0;100
31;0;"brekin";31;100;0
0;5;"brekka";5;0;100
0;7;"brekke";7;0;100
316;22;"brekken";338;93.491124260355;6.50887573964497
6;0;"brekkin";6;100;0
0;5;"brekkyn";5;0;100
0;104;"breklyn";104;0;100
0;15;"breklynn";15;0;100
5;0;"brekon";5;100;0
42;85;"brekyn";127;33.0708661417323;66.9291338582677
68;0;"brelan";68;100;0
323;52;"breland";375;86.1333333333333;13.8666666666667
0;88;"brelee";88;0;100
0;313;"breleigh";313;0;100
5;0;"brelen";5;100;0
34;0;"brelin";34;100;0
0;13;"brelle";13;0;100
29;0;"brelon";29;100;0
0;30;"brely";30;0;100
38;478;"brelyn";516;7.36434108527132;92.6356589147287
5;688;"brelynn";693;0.721500721500722;99.2784992784993
5;0;"bremen";5;100;0
480;144;"bren";624;76.9230769230769;23.0769230769231
0;755;"brena";755;0;100
0;521;"brenae";521;0;100
0;5;"brenai";5;0;100
797;0;"brenan";797;100;0
5;0;"brenard";5;100;0
0;39;"brenasia";39;0;100
0;38;"brenay";38;0;100
0;5;"brenaya";5;0;100
5;0;"brence";5;100;0
0;56;"brend";56;0;100
2122;606527;"brenda";608649;0.348641006557145;99.6513589934429
0;5;"brendaa";5;0;100
0;425;"brendalee";425;0;100
0;16;"brendalis";16;0;100
0;157;"brendaliz";157;0;100
0;80;"brendaly";80;0;100
0;253;"brendalyn";253;0;100
0;41;"brendalynn";41;0;100
88693;325;"brendan";89018;99.6349053000517;0.365094699948325
0;5;"brendasia";5;0;100
5;19;"brendell";24;20.8333333333333;79.1666666666667
0;6;"brendella";6;0;100
24731;42;"brenden";24773;99.8304605820853;0.169539417914665
0;24;"brender";24;0;100
0;11;"brendetta";11;0;100
0;118;"brendi";118;0;100
0;155;"brendia";155;0;100
706;0;"brendin";706;100;0
0;107;"brendolyn";107;0;100
19343;22;"brendon";19365;99.8863929770204;0.113607022979602
207;0;"brendt";207;100;0
0;324;"brendy";324;0;100
1283;0;"brendyn";1283;100;0
0;22;"brene";22;0;100
0;10;"brenea";10;0;100
0;158;"brenee";158;0;100
0;10;"breneisha";10;0;100
318;0;"brenen";318;100;0
5;0;"brener";5;100;0
0;37;"brenesha";37;0;100
0;5;"breneshia";5;0;100
0;275;"brenetta";275;0;100
0;23;"brenette";23;0;100
31;0;"brenham";31;100;0
0;16;"brenia";16;0;100
0;11;"breniah";11;0;100
0;11;"brenice";11;0;100
0;5;"brenicia";5;0;100
0;5;"brenika";5;0;100
157;5;"brenin";162;96.9135802469136;3.08641975308642
0;110;"brenisha";110;0;100
0;55;"brenita";55;0;100
0;131;"breniya";131;0;100
0;114;"breniyah";114;0;100
0;375;"brenlee";375;0;100
0;206;"brenleigh";206;0;100
22;620;"brenley";642;3.42679127725857;96.5732087227414
0;29;"brenli";29;0;100
0;49;"brenlie";49;0;100
0;75;"brenly";75;0;100
0;63;"brenlyn";63;0;100
0;54;"brenlynn";54;0;100
63;64;"brenn";127;49.6062992125984;50.3937007874016
0;27982;"brenna";27982;0;100
0;6;"brennae";6;0;100
0;511;"brennah";511;0;100
30603;1993;"brennan";32596;93.8857528531108;6.11424714688919
0;5;"brennda";5;0;100
56;0;"brenndan";56;100;0
73;0;"brennden";73;100;0
26;0;"brenndon";26;100;0
8571;178;"brennen";8749;97.9654817693451;2.03451823065493
1017;10;"brenner";1027;99.0262901655307;0.973709834469328
17;0;"brennick";17;100;0
207;0;"brennin";207;100;0
0;12;"brennley";12;0;100
4007;0;"brennon";4007;100;0
5;0;"brennus";5;100;0
119;139;"brennyn";258;46.1240310077519;53.8759689922481
52;0;"breno";52;100;0
266;0;"brenon";266;100;0
10;0;"brensen";10;100;0
191;0;"brenson";191;100;0
5;0;"brenston";5;100;0
138478;567;"brent";139045;99.5922183465784;0.407781653421554
36;0;"brentan";36;100;0
805;0;"brenten";805;100;0
157;0;"brentin";157;100;0
455;84;"brentlee";539;84.4155844155844;15.5844155844156
0;17;"brentleigh";17;0;100
2740;190;"brentley";2930;93.5153583617747;6.48464163822526
1117;18;"brently";1135;98.4140969162996;1.58590308370044
0;107;"brentney";107;0;100
0;6;"brentnie";6;0;100
14116;18;"brenton";14134;99.8726475166266;0.127352483373426
11;0;"brentson";11;100;0
294;0;"brentt";294;100;0
5;0;"brentten";5;100;0
182;0;"brentton";182;100;0
5;0;"brentwood";5;100;0
197;0;"brentyn";197;100;0
0;185;"brenya";185;0;100
113;37;"brenyn";150;75.3333333333333;24.6666666666667
2150;290;"breon";2440;88.1147540983607;11.8852459016393
0;1974;"breona";1974;0;100
0;30;"breonah";30;0;100
0;38;"breonca";38;0;100
0;37;"breonda";37;0;100
0;5;"breondra";5;0;100
0;143;"breonia";143;0;100
0;47;"breonica";47;0;100
0;15;"breonka";15;0;100
0;4994;"breonna";4994;0;100
0;6;"breonnah";6;0;100
0;45;"breonne";45;0;100
6;0;"breontae";6;100;0
6;5;"breonte";11;54.5454545454545;45.4545454545455
0;57;"breosha";57;0;100
0;5;"brescia";5;0;100
0;26;"breseis";26;0;100
0;159;"bresha";159;0;100
0;67;"breshae";67;0;100
0;5;"breshai";5;0;100
17;0;"breshaun";17;100;0
0;38;"breshauna";38;0;100
44;35;"breshawn";79;55.6962025316456;44.3037974683544
0;24;"breshawna";24;0;100
0;104;"breshay";104;0;100
0;5;"breshayla";5;0;100
0;20;"breshey";20;0;100
0;6;"breshia";6;0;100
0;10;"breshonna";10;0;100
0;5;"breshuna";5;0;100
116;86;"breslin";202;57.4257425742574;42.5742574257426
0;180;"breslyn";180;0;100
0;17;"breslynn";17;0;100
29614;232;"bret";29846;99.2226764055485;0.777323594451518
0;119;"breta";119;0;100
7;0;"brete";7;100;0
0;5;"bretha";5;0;100
37;0;"bretley";37;100;0
0;44;"bretney";44;0;100
413;0;"breton";413;100;0
157067;3271;"brett";160338;97.9599346380771;2.04006536192294
0;414;"bretta";414;0;100
0;133;"brettany";133;0;100
11;573;"brette";584;1.88356164383562;98.1164383561644
21;0;"bretten";21;100;0
5;0;"brettlee";5;100;0
43;0;"brettley";43;100;0
16;0;"brettly";16;100;0
0;121;"brettney";121;0;100
0;5;"brettnie";5;0;100
1015;0;"bretton";1015;100;0
0;156;"breuna";156;0;100
0;276;"breunna";276;0;100
211;0;"brevan";211;100;0
14;0;"brevard";14;100;0
140;0;"breven";140;100;0
1037;0;"brevin";1037;100;0
96;0;"brevon";96;100;0
194;11;"brevyn";205;94.6341463414634;5.36585365853659
386;0;"brewer";386;100;0
345;0;"brewster";345;100;0
33;0;"brex";33;100;0
0;24;"brexlee";24;0;100
0;39;"brexley";39;0;100
0;5;"brexlie";5;0;100
0;12;"brexlyn";12;0;100
29;0;"brexten";29;100;0
10;0;"brextin";10;100;0
514;0;"brexton";514;100;0
24;0;"brextyn";24;100;0
23;0;"brey";23;100;0
0;525;"breya";525;0;100
0;152;"breyah";152;0;100
20;10;"breyan";30;66.6666666666667;33.3333333333333
0;1093;"breyana";1093;0;100
0;5;"breyanah";5;0;100
0;1348;"breyanna";1348;0;100
0;14;"breyannah";14;0;100
0;17;"breyanne";17;0;100
0;10;"breyauna";10;0;100
0;14;"breyawna";14;0;100
266;0;"breydan";266;100;0
912;0;"breyden";912;100;0
0;5;"breydi";5;0;100
19;0;"breydin";19;100;0
543;0;"breydon";543;100;0
0;5;"breyell";5;0;100
0;35;"breyelle";35;0;100
27;0;"breyen";27;100;0
106;13;"breyer";119;89.0756302521009;10.9243697478992
131;0;"breylan";131;100;0
0;16;"breylee";16;0;100
126;0;"breylen";126;100;0
133;33;"breylin";166;80.1204819277108;19.8795180722892
261;0;"breylon";261;100;0
0;6;"breylyn";6;0;100
0;27;"breylynn";27;0;100
0;5;"breyn";5;0;100
616;95;"breyon";711;86.6385372714487;13.3614627285513
0;494;"breyona";494;0;100
0;18;"breyonce";18;0;100
0;15;"breyonia";15;0;100
0;841;"breyonna";841;0;100
138;0;"breyson";138;100;0
181;0;"breyton";181;100;0
0;6;"breyunna";6;0;100
0;7;"brezae";7;0;100
0;5;"breze";5;0;100
0;6;"brezhane";6;0;100
6;5;"brezlin";11;54.5454545454545;45.4545454545455
0;81;"brezlyn";81;0;100
0;12;"brezlynn";12;0;100
0;5;"brezzy";5;0;100
0;6;"brhea";6;0;100
5;0;"brhett";5;100;0
0;7;"brhianna";7;0;100
0;211;"bri";211;0;100
55;13835;"bria";13890;0.395968322534197;99.6040316774658
0;657;"briah";657;0;100
0;1145;"briahna";1145;0;100
0;178;"briahnna";178;0;100
0;25;"briaja";25;0;100
0;12;"briajah";12;0;100
0;14;"brialle";14;0;100
32;0;"briam";32;100;0
0;6;"briamarie";6;0;100
1162200;4566;"brian";1166766;99.6086618910733;0.391338108926726
201;92116;"briana";92317;0.217728045755386;99.7822719542446
0;408;"brianah";408;0;100
0;5;"brianalee";5;0;100
0;5;"brianamarie";5;0;100
5;0;"briananthony";5;100;0
0;550;"brianca";550;0;100
0;17;"briance";17;0;100
5;1815;"brianda";1820;0.274725274725275;99.7252747252747
0;5;"briandra";5;0;100
55;296;"briane";351;15.6695156695157;84.3304843304843
0;150;"briani";150;0;100
0;33;"briania";33;0;100
0;23;"brianica";23;0;100
0;5;"brianie";5;0;100
0;5;"brianka";5;0;100
20;1535;"briann";1555;1.28617363344051;98.7138263665595
418;247792;"brianna";248210;0.168405785423633;99.8315942145764
0;1399;"briannah";1399;0;100
0;5;"briannalee";5;0;100
0;10;"briannan";10;0;100
32;20094;"brianne";20126;0.158998310642949;99.841001689357
0;5;"brianney";5;0;100
0;252;"brianni";252;0;100
0;69;"briannia";69;0;100
0;6;"briannica";6;0;100
0;55;"briannie";55;0;100
0;130;"briannon";130;0;100
0;461;"brianny";461;0;100
939;0;"briant";939;100;0
5;89;"briante";94;5.31914893617021;94.6808510638298
0;189;"briany";189;0;100
3300;2036;"briar";5336;61.8440779610195;38.1559220389805
0;54;"briara";54;0;100
0;62;"briarrose";62;0;100
0;30;"briasha";30;0;100
0;622;"briasia";622;0;100
0;1327;"briauna";1327;0;100
0;446;"briaunna";446;0;100
0;115;"briawna";115;0;100
5;0;"briayan";5;100;0
0;5;"briazia";5;0;100
28;0;"bric";28;100;0
14834;354;"brice";15188;97.6692125362128;2.3307874637872
0;449;"briceida";449;0;100
0;25;"briceidy";25;0;100
0;58;"bricelyn";58;0;100
0;10;"bricelynn";10;0;100
856;0;"bricen";856;100;0
175;0;"briceson";175;100;0
5;0;"briceston";5;100;0
37;0;"briceton";37;100;0
0;202;"briceyda";202;0;100
0;21;"brichelle";21;0;100
0;245;"bricia";245;0;100
369;0;"brick";369;100;0
20;0;"bricker";20;100;0
0;5;"bricola";5;0;100
73;0;"bricyn";73;100;0
5;0;"bridan";5;100;0
43;0;"briden";43;100;0
0;44;"bridey";44;0;100
48;5;"bridge";53;90.5660377358491;9.43396226415094
4179;5;"bridger";4184;99.8804971319312;0.119502868068834
26;0;"bridges";26;100;0
150;88157;"bridget";88307;0.169861958848109;99.8301380411519
0;28;"bridgete";28;0;100
0;12968;"bridgett";12968;0;100
0;36;"bridgetta";36;0;100
16;23106;"bridgette";23122;0.0691981662485944;99.9308018337514
0;446;"bridgid";446;0;100
0;1275;"bridgit";1275;0;100
0;150;"bridgitt";150;0;100
0;627;"bridgitte";627;0;100
0;338;"bridie";338;0;100
0;11;"bridjette";11;0;100
0;182;"bridney";182;0;100
11;0;"bridon";11;100;0
0;6;"bridy";6;0;100
5;0;"bridyn";5;100;0
0;2630;"brie";2630;0;100
0;144;"briea";144;0;100
0;5;"brieah";5;0;100
0;989;"brieana";989;0;100
0;718;"brieann";718;0;100
0;3153;"brieanna";3153;0;100
0;662;"brieanne";662;0;100
0;582;"briel";582;0;100
0;26;"briela";26;0;100
0;96;"briele";96;0;100
0;28;"brielee";28;0;100
0;204;"briell";204;0;100
0;6124;"briella";6124;0;100
0;57;"briellah";57;0;100
0;27491;"brielle";27491;0;100
0;142;"brielyn";142;0;100
0;129;"brielynn";129;0;100
3539;5;"brien";3544;99.8589164785553;0.141083521444695
0;132;"briena";132;0;100
0;1602;"brienna";1602;0;100
5;1313;"brienne";1318;0.379362670713202;99.6206373292868
0;5;"brieon";5;0;100
0;38;"brieona";38;0;100
0;160;"brieonna";160;0;100
414;225;"brier";639;64.7887323943662;35.2112676056338
0;34;"brierra";34;0;100
0;5;"brierre";5;0;100
0;42;"briesha";42;0;100
0;211;"brietta";211;0;100
0;6;"briette";6;0;100
0;5;"brieya";5;0;100
49;0;"brig";49;100;0
11;0;"brigden";11;100;0
11;0;"brigdon";11;100;0
0;500;"briget";500;0;100
0;474;"brigett";474;0;100
0;163;"brigetta";163;0;100
0;5621;"brigette";5621;0;100
144;0;"brigg";144;100;0
0;67;"briggett";67;0;100
0;184;"briggette";184;0;100
0;91;"briggitte";91;0;100
2659;16;"briggs";2675;99.4018691588785;0.598130841121495
26;0;"briggston";26;100;0
2588;0;"brigham";2588;100;0
0;487;"brighid";487;0;100
0;15;"brighley";15;0;100
203;5;"bright";208;97.5961538461538;2.40384615384615
98;61;"brighten";159;61.6352201257862;38.3647798742138
0;13;"brightly";13;0;100
2113;1167;"brighton";3280;64.4207317073171;35.5792682926829
0;122;"brightyn";122;0;100
0;5909;"brigid";5909;0;100
0;655;"brigida";655;0;100
313;0;"brigido";313;100;0
0;6;"brigina";6;0;100
0;1223;"brigit";1223;0;100
0;17;"brigita";17;0;100
0;120;"brigitt";120;0;100
0;520;"brigitta";520;0;100
0;8594;"brigitte";8594;0;100
8;0;"brigston";8;100;0
0;197;"brihana";197;0;100
0;723;"brihanna";723;0;100
0;49;"brihany";49;0;100
17;0;"brij";17;100;0
0;19;"brijae";19;0;100
13;0;"brijesh";13;100;0
0;5;"brijet";5;0;100
0;25;"brijette";25;0;100
0;10;"brijida";10;0;100
18;0;"brijido";18;100;0
0;13;"brijin";13;0;100
38;0;"brik";38;100;0
19;0;"brilan";19;100;0
0;16;"brilea";16;0;100
23;1045;"brilee";1068;2.15355805243446;97.8464419475655
0;12;"brilei";12;0;100
0;716;"brileigh";716;0;100
5;0;"brilen";5;100;0
1226;5329;"briley";6555;18.7032799389779;81.2967200610221
0;10;"brilie";10;0;100
0;6;"brilliance";6;0;100
12;0;"brilliant";12;100;0
40;259;"brilyn";299;13.3779264214047;86.6220735785953
5;657;"brilynn";662;0.755287009063444;99.2447129909366
0;5;"brilynne";5;0;100
37;374;"brin";411;9.00243309002433;90.9975669099757
5;1273;"brina";1278;0.391236306729264;99.6087636932707
0;123;"brinae";123;0;100
0;2110;"brinda";2110;0;100
97;0;"brinden";97;100;0
0;5;"brinder";5;0;100
0;11;"brindi";11;0;100
5;0;"brindin";5;100;0
0;48;"brindle";48;0;100
0;70;"brindley";70;0;100
26;0;"brindon";26;100;0
0;99;"brindy";99;0;100
0;29;"brinesha";29;0;100
0;5;"briney";5;0;100
0;16;"brinisha";16;0;100
0;49;"briniya";49;0;100
0;50;"briniyah";50;0;100
13;0;"brink";13;100;0
0;118;"brinklee";118;0;100
38;1010;"brinkley";1048;3.62595419847328;96.3740458015267
0;5;"brinlea";5;0;100
0;1567;"brinlee";1567;0;100
0;5;"brinlei";5;0;100
0;363;"brinleigh";363;0;100
103;6721;"brinley";6824;1.50937866354045;98.4906213364596
0;6;"brinli";6;0;100
0;20;"brinlie";20;0;100
0;188;"brinly";188;0;100
0;45;"brinlyn";45;0;100
0;55;"brinlynn";55;0;100
15;501;"brinn";516;2.90697674418605;97.0930232558139
0;408;"brinna";408;0;100
0;5;"brinnlee";5;0;100
0;198;"brinnley";198;0;100
0;10;"brinnly";10;0;100
0;11;"brinslee";11;0;100
0;99;"brinsley";99;0;100
305;6;"brinson";311;98.0707395498392;1.92926045016077
54;0;"brint";54;100;0
0;5;"brintney";5;0;100
758;0;"brinton";758;100;0
0;22;"brinya";22;0;100
2683;84;"brion";2767;96.9642211781713;3.0357788218287
0;1667;"briona";1667;0;100
0;34;"brionca";34;0;100
11;54;"brione";65;16.9230769230769;83.0769230769231
0;11;"brioni";11;0;100
0;5;"brionica";5;0;100
0;4792;"brionna";4792;0;100
0;35;"brionnah";35;0;100
15;438;"brionne";453;3.3112582781457;96.6887417218543
0;6;"brionni";6;0;100
0;172;"briony";172;0;100
0;7585;"brisa";7585;0;100
0;5;"brisaida";5;0;100
0;6;"brisais";6;0;100
0;13;"brisamar";13;0;100
0;19;"brisayda";19;0;100
36;0;"brisco";36;100;0
68;0;"briscoe";68;100;0
0;2270;"briseida";2270;0;100
0;97;"briseidy";97;0;100
0;969;"briseis";969;0;100
0;135;"briselda";135;0;100
48;0;"brisen";48;100;0
0;1405;"briseyda";1405;0;100
0;89;"brisha";89;0;100
0;22;"brishae";22;0;100
0;5;"brishana";5;0;100
5;0;"brishaun";5;100;0
0;5;"brishauna";5;0;100
11;0;"brishawn";11;100;0
7;0;"brishen";7;100;0
0;5;"brishon";5;0;100
0;310;"brisia";310;0;100
0;6;"brisna";6;0;100
0;5;"brisny";5;0;100
969;0;"brison";969;100;0
0;2417;"brissa";2417;0;100
0;5;"brisseida";5;0;100
0;10;"brisseyda";10;0;100
0;570;"brissia";570;0;100
0;222;"bristal";222;0;100
15;22;"bristen";37;40.5405405405405;59.4594594594595
5;0;"brister";5;100;0
6;12;"bristin";18;33.3333333333333;66.6666666666667
454;5653;"bristol";6107;7.43409202554446;92.5659079744555
346;0;"briston";346;100;0
0;16;"bristy";16;0;100
0;79;"bristyl";79;0;100
0;88;"bristyn";88;0;100
34;0;"brisyn";34;100;0
623;146;"brit";769;81.0143042912874;18.9856957087126
0;1083;"brita";1083;0;100
690;580;"britain";1270;54.3307086614173;45.6692913385827
0;101;"britainy";101;0;100
26;11;"britan";37;70.2702702702703;29.7297297297297
0;15;"britane";15;0;100
0;133;"britanee";133;0;100
0;261;"britaney";261;0;100
0;1363;"britani";1363;0;100
0;124;"britania";124;0;100
0;423;"britanie";423;0;100
0;5;"britanna";5;0;100
0;57;"britanni";57;0;100
0;10;"britannia";10;0;100
0;20;"britannica";20;0;100
0;784;"britanny";784;0;100
0;6338;"britany";6338;0;100
0;37;"britanya";37;0;100
0;67;"briteny";67;0;100
0;12;"brithanny";12;0;100
0;576;"brithany";576;0;100
0;129;"brithney";129;0;100
0;6;"brithny";6;0;100
77;10;"britian";87;88.5057471264368;11.4942528735632
0;180;"britiany";180;0;100
0;13;"britinee";13;0;100
0;92;"britiney";92;0;100
0;276;"britini";276;0;100
0;66;"britiny";66;0;100
21;214;"british";235;8.93617021276596;91.063829787234
0;13;"britlany";13;0;100
0;69;"britlee";69;0;100
0;18;"britleigh";18;0;100
0;150;"britley";150;0;100
0;131;"britlyn";131;0;100
0;18;"britlynn";18;0;100
0;5;"britnae";5;0;100
0;5;"britnai";5;0;100
0;120;"britnay";120;0;100
0;282;"britne";282;0;100
0;1690;"britnee";1690;0;100
0;45;"britnei";45;0;100
83;34348;"britney";34431;0.241061833812553;99.7589381661874
0;4315;"britni";4315;0;100
0;959;"britnie";959;0;100
0;1886;"britny";1886;0;100
0;11;"britnye";11;0;100
521;5;"briton";526;99.0494296577947;0.950570342205323
4616;2900;"britt";7516;61.4156466205428;38.5843533794572
0;3401;"britta";3401;0;100
367;290;"brittain";657;55.8599695585997;44.1400304414003
0;11;"brittainey";11;0;100
0;5;"brittaini";5;0;100
0;531;"brittainy";531;0;100
448;819;"brittan";1267;35.3591160220994;64.6408839779006
0;11;"brittana";11;0;100
0;6;"brittanae";6;0;100
0;226;"brittane";226;0;100
0;664;"brittanee";664;0;100
0;3280;"brittaney";3280;0;100
22;11717;"brittani";11739;0.187409489735071;99.8125905102649
0;402;"brittania";402;0;100
0;6;"brittanica";6;0;100
0;4730;"brittanie";4730;0;100
0;5;"brittanii";5;0;100
0;150;"brittanni";150;0;100
0;63;"brittannie";63;0;100
0;389;"brittanny";389;0;100
0;20;"brittant";20;0;100
1078;357757;"brittany";358835;0.300416626025889;99.6995833739741
0;123;"brittanya";123;0;100
0;118;"brittanyann";118;0;100
0;41;"brittanye";41;0;100
0;11;"brittanylee";11;0;100
0;5;"brittanymarie";5;0;100
0;6;"brittanynicole";6;0;100
0;5;"brittary";5;0;100
0;69;"brittay";69;0;100
0;18;"britte";18;0;100
492;337;"britten";829;59.3486127864898;40.6513872135103
0;82;"britteney";82;0;100
0;20;"britteni";20;0;100
0;1450;"britteny";1450;0;100
0;22;"britthany";22;0;100
84;26;"brittian";110;76.3636363636364;23.6363636363636
0;5;"brittiana";5;0;100
0;12;"brittiani";12;0;100
0;737;"brittiany";737;0;100
0;58;"brittie";58;0;100
113;222;"brittin";335;33.7313432835821;66.2686567164179
0;40;"brittina";40;0;100
0;23;"brittinay";23;0;100
0;31;"brittine";31;0;100
0;56;"brittinee";56;0;100
0;339;"brittiney";339;0;100
0;747;"brittini";747;0;100
0;69;"brittinie";69;0;100
0;597;"brittiny";597;0;100
0;55;"brittish";55;0;100
0;18;"brittlee";18;0;100
0;110;"brittley";110;0;100
0;100;"brittlyn";100;0;100
0;26;"brittlynn";26;0;100
0;5;"brittna";5;0;100
0;72;"brittnae";72;0;100
0;22;"brittnany";22;0;100
0;1619;"brittnay";1619;0;100
0;263;"brittne";263;0;100
0;38;"brittnea";38;0;100
0;2822;"brittnee";2822;0;100
0;128;"brittnei";128;0;100
265;81755;"brittney";82020;0.323091928797854;99.6769080712021
0;17;"brittneyann";17;0;100
6;5985;"brittni";5991;0.100150225338007;99.899849774662
0;2301;"brittnie";2301;0;100
0;5;"brittnii";5;0;100
0;3584;"brittny";3584;0;100
0;97;"brittnye";97;0;100
5698;1628;"britton";7326;77.7777777777778;22.2222222222222
0;28;"brittoni";28;0;100
0;213;"brittony";213;0;100
0;7;"britttany";7;0;100
0;411;"brittyn";411;0;100
0;133;"brityn";133;0;100
0;6;"britynn";6;0;100
0;16;"britza";16;0;100
0;30;"britzel";30;0;100
0;81;"britzy";81;0;100
0;50;"briuna";50;0;100
0;115;"briunna";115;0;100
115;0;"brix";115;100;0
5;0;"brixen";5;100;0
0;34;"brixley";34;0;100
55;0;"brixon";55;100;0
10;5;"brixten";15;66.6666666666667;33.3333333333333
5;0;"brixtin";5;100;0
1037;112;"brixton";1149;90.2523933855527;9.74760661444735
0;26;"brixtyn";26;0;100
5;0;"brixx";5;100;0
0;220;"briya";220;0;100
0;177;"briyah";177;0;100
101;0;"briyan";101;100;0
0;775;"briyana";775;0;100
0;16;"briyanah";16;0;100
0;719;"briyanna";719;0;100
0;42;"briyelle";42;0;100
0;13;"briyit";13;0;100
0;11;"briyith";11;0;100
23;0;"briyon";23;100;0
0;47;"briyona";47;0;100
0;191;"briyonna";191;0;100
0;1182;"briza";1182;0;100
0;320;"brizeida";320;0;100
0;5;"brizeth";5;0;100
0;180;"brizeyda";180;0;100
0;35;"brizia";35;0;100
0;5;"brizleth";5;0;100
0;90;"brizza";90;0;100
0;5;"brizzia";5;0;100
53;0;"brnadon";53;100;0
29;0;"brndon";29;100;0
905;0;"broadus";905;100;0
89;0;"broady";89;100;0
2426;0;"broc";2426;100;0
30;0;"broch";30;100;0
0;710;"brocha";710;0;100
39963;75;"brock";40038;99.8126779559419;0.187322044058145
15;0;"brockman";15;100;0
10;0;"brockston";10;100;0
719;0;"brockton";719;100;0
15;0;"brocton";15;100;0
72;0;"brodan";72;100;0
10;0;"brodderick";10;100;0
7;0;"broddrick";7;100;0
117;0;"brode";117;100;0
573;15;"brodee";588;97.4489795918367;2.55102040816327
1418;0;"broden";1418;100;0
6;0;"broder";6;100;0
188;0;"broderic";188;100;0
8159;0;"broderick";8159;100;0
11;0;"broderik";11;100;0
1075;0;"brodey";1075;100;0
5;0;"brodhi";5;100;0
609;130;"brodi";739;82.4086603518268;17.5913396481732
9066;368;"brodie";9434;96.0992156031376;3.90078439686241
122;0;"brodin";122;100;0
23;0;"brodix";23;100;0
5;0;"brodney";5;100;0
101;0;"brodric";101;100;0
1679;0;"brodrick";1679;100;0
25;0;"brodus";25;100;0
63409;228;"brody";63637;99.6417178685356;0.3582821314644
293;0;"brodyn";293;100;0
69;0;"broedy";69;100;0
3561;754;"brogan";4315;82.5260718424102;17.4739281575898
146;0;"brogen";146;100;0
99;21;"broghan";120;82.5;17.5
5;0;"brogyn";5;100;0
5;0;"brohdy";5;100;0
272;0;"brok";272;100;0
80;0;"brolin";80;100;0
81;0;"broly";81;100;0
25;0;"brom";25;100;0
15;0;"bromley";15;100;0
378;0;"bron";378;100;0
0;39;"brona";39;0;100
0;5;"bronagh";5;0;100
109;0;"bronc";109;100;0
5;0;"bronce";5;100;0
60;0;"bronco";60;100;0
0;174;"bronda";174;0;100
70;0;"brondon";70;100;0
0;5;"bronica";5;0;100
17;0;"bronis";17;100;0
343;0;"bronislaus";343;100;0
0;6;"bronislava";6;0;100
247;0;"bronislaw";247;100;0
0;53;"bronislawa";53;0;100
16;0;"bronko";16;100;0
7;0;"bronn";7;100;0
0;38;"bronna";38;0;100
22;0;"bronner";22;100;0
8;65;"bronnie";73;10.958904109589;89.041095890411
138;0;"bronsen";138;100;0
8293;0;"bronson";8293;100;0
11;0;"bronston";11;100;0
50;0;"bronsyn";50;100;0
18;827;"bronte";845;2.1301775147929;97.8698224852071
0;14;"bronti";14;0;100
0;826;"bronwen";826;0;100
0;3309;"bronwyn";3309;0;100
0;32;"bronwynn";32;0;100
909;12;"bronx";921;98.6970684039088;1.30293159609121
29;0;"bronxton";29;100;0
27;0;"bronze";27;100;0
3257;10275;"brook";13532;24.068873780668;75.931126219332
0;6;"brookann";6;0;100
2006;187200;"brooke";189206;1.06022007758739;98.9397799224126
0;5;"brookeann";5;0;100
0;79;"brookelin";79;0;100
0;93;"brookelle";93;0;100
0;3109;"brookelyn";3109;0;100
0;10;"brookelyne";10;0;100
0;2994;"brookelynn";2994;0;100
0;258;"brookelynne";258;0;100
25;0;"brooker";25;100;0
84;44;"brookes";128;65.625;34.375
7;530;"brookie";537;1.30353817504655;98.6964618249534
0;31;"brooklan";31;0;100
0;134;"brooklee";134;0;100
0;33;"brookleigh";33;0;100
0;228;"brooklen";228;0;100
0;5;"brooklenn";5;0;100
0;82;"brookley";82;0;100
5;1853;"brooklin";1858;0.269106566200215;99.7308934337998
0;193;"brooklinn";193;0;100
0;5;"brooklon";5;0;100
0;10;"brookly";10;0;100
1293;92302;"brooklyn";93595;1.38148405363534;98.6185159463647
0;671;"brooklyne";671;0;100
0;5;"brooklynmarie";5;0;100
20;28749;"brooklynn";28769;0.0695192742187772;99.9304807257812
0;1751;"brooklynne";1751;0;100
0;10;"brooklynrose";10;0;100
23139;1157;"brooks";24296;95.2378992426737;4.76210075732631
0;5;"brooksey";5;0;100
0;603;"brooksie";603;0;100
0;14;"brooksley";14;0;100
15;0;"brookson";15;100;0
25;0;"brookston";25;100;0
0;5;"brookyln";5;0;100
81;0;"broox";81;100;0
0;35;"brooxie";35;0;100
17;0;"bror";17;100;0
20;0;"brosnan";20;100;0
16;0;"brother";16;100;0
59;0;"broughton";59;100;0
40;0;"broward";40;100;0
5;0;"browder";5;100;0
5;0;"browdy";5;100;0
1293;5;"brown";1298;99.6147919876733;0.385208012326656
11;0;"brownell";11;100;0
504;706;"brownie";1210;41.6528925619835;58.3471074380165
62;0;"browning";62;100;0
16;0;"brownlow";16;100;0
44;0;"brox";44;100;0
223;0;"broxton";223;100;0
0;12;"brttany";12;0;100
380429;1388;"bruce";381817;99.63647506528;0.363524934720036
5;0;"brucelee";5;100;0
0;495;"brucha";495;0;100
0;281;"bruchy";281;0;100
0;27;"brucie";27;0;100
230;0;"bruin";230;100;0
59;0;"bruk";59;100;0
18;0;"bruke";18;100;0
0;927;"bruna";927;0;100
5;27;"brunell";32;15.625;84.375
0;63;"brunella";63;0;100
0;16;"brunelle";16;0;100
10;0;"bruner";10;100;0
0;376;"brunetta";376;0;100
0;138;"brunette";138;0;100
0;22;"brunhilda";22;0;100
0;1056;"brunilda";1056;0;100
0;5;"brunna";5;0;100
15229;0;"bruno";15229;100;0
26;0;"brunson";26;100;0
5;0;"bruster";5;100;0
42;0;"brutus";42;100;0
36;0;"bry";36;100;0
6;300;"brya";306;1.96078431372549;98.0392156862745
0;135;"bryah";135;0;100
0;63;"bryahna";63;0;100
73;0;"bryam";73;100;0
377306;1712;"bryan";379018;99.548306412888;0.451693587111958
0;5883;"bryana";5883;0;100
0;118;"bryanah";118;0;100
5;0;"bryand";5;100;0
0;94;"bryanda";94;0;100
0;6;"bryani";6;0;100
108;359;"bryann";467;23.1263383297645;76.8736616702355
0;18457;"bryanna";18457;0;100
0;248;"bryannah";248;0;100
0;1030;"bryanne";1030;0;100
48839;232;"bryant";49071;99.5272156670946;0.472784332905382
1255;332;"bryar";1587;79.0800252047889;20.9199747952111
0;5;"bryasha";5;0;100
0;20;"bryasia";20;0;100
0;109;"bryauna";109;0;100
0;6;"bryaunna";6;0;100
109766;2931;"bryce";112697;97.3992209198115;2.60077908018847
0;95;"brycelyn";95;0;100
0;78;"brycelynn";78;0;100
10090;26;"brycen";10116;99.7429814155793;0.25701858442072
5;0;"brycenn";5;100;0
23;0;"bryceon";23;100;0
400;0;"bryceson";400;100;0
329;0;"bryceton";329;100;0
0;6;"brycie";6;0;100
207;0;"brycin";207;100;0
5;0;"brycn";5;100;0
7;0;"brycon";7;100;0
15;0;"brycson";15;100;0
5;0;"brycyn";5;100;0
147;0;"brydan";147;100;0
1522;23;"bryden";1545;98.5113268608414;1.48867313915858
0;5;"brydie";5;0;100
6;0;"brydin";6;100;0
455;0;"brydon";455;100;0
28;10;"brye";38;73.6842105263158;26.3157894736842
0;5;"bryell";5;0;100
0;61;"bryella";61;0;100
0;372;"bryelle";372;0;100
422;0;"bryen";422;100;0
0;5;"bryenna";5;0;100
32;0;"bryent";32;100;0
1250;116;"bryer";1366;91.5080527086384;8.49194729136164
0;14;"bryhana";14;0;100
0;20;"bryhanna";20;0;100
26;0;"bryheem";26;100;0
0;5;"bryia";5;0;100
33;0;"bryian";33;100;0
0;5;"bryiana";5;0;100
0;11;"bryianna";11;0;100
5;0;"bryice";5;100;0
16;0;"bryin";16;100;0
19;0;"bryken";19;100;0
59;0;"bryker";59;100;0
0;43;"bryla";43;0;100
930;77;"brylan";1007;92.3535253227408;7.64647467725919
38;0;"bryland";38;100;0
0;222;"brylea";222;0;100
0;5;"bryleah";5;0;100
426;8153;"brylee";8579;4.96561370789136;95.0343862921086
0;204;"brylei";204;0;100
0;3108;"bryleigh";3108;0;100
414;50;"brylen";464;89.2241379310345;10.7758620689655
176;0;"bryler";176;100;0
62;252;"bryley";314;19.7452229299363;80.2547770700637
0;161;"bryli";161;0;100
5;1725;"brylie";1730;0.289017341040462;99.7109826589595
0;5;"bryliee";5;0;100
189;162;"brylin";351;53.8461538461538;46.1538461538462
0;51;"brylinn";51;0;100
445;0;"brylon";445;100;0
22;86;"brylyn";108;20.3703703703704;79.6296296296296
0;300;"brylynn";300;0;100
1199;6440;"bryn";7639;15.6957716978662;84.3042283021338
0;1394;"bryna";1394;0;100
0;33;"brynae";33;0;100
0;171;"brynda";171;0;100
0;28;"bryndal";28;0;100
63;0;"bryndan";63;100;0
0;7;"bryndee";7;0;100
262;0;"brynden";262;100;0
0;5;"bryndis";5;0;100
0;128;"bryndle";128;0;100
197;0;"bryndon";197;100;0
109;6;"bryne";115;94.7826086956522;5.21739130434783
0;15;"brynesha";15;0;100
0;10;"brynia";10;0;100
0;5;"bryniah";5;0;100
0;7;"brynisha";7;0;100
0;104;"brynja";104;0;100
0;141;"brynlea";141;0;100
10;9411;"brynlee";9421;0.106145844390192;99.8938541556098
0;68;"brynlei";68;0;100
0;1289;"brynleigh";1289;0;100
0;1782;"brynley";1782;0;100
0;302;"brynli";302;0;100
0;613;"brynlie";613;0;100
0;6;"brynlin";6;0;100
0;41;"brynly";41;0;100
0;58;"brynlyn";58;0;100
0;86;"brynlynn";86;0;100
331;21646;"brynn";21977;1.50612003458161;98.4938799654184
0;2754;"brynna";2754;0;100
0;151;"brynnan";151;0;100
0;2410;"brynne";2410;0;100
7;15;"brynnen";22;31.8181818181818;68.1818181818182
33;0;"brynner";33;100;0
0;11;"brynnlea";11;0;100
0;703;"brynnlee";703;0;100
0;211;"brynnleigh";211;0;100
0;495;"brynnley";495;0;100
0;23;"brynnli";23;0;100
0;78;"brynnlie";78;0;100
0;89;"brynnly";89;0;100
0;5;"brynsley";5;0;100
6;0;"brynson";6;100;0
17;0;"brynt";17;100;0
11;0;"brynton";11;100;0
0;5;"brynzlee";5;0;100
14512;17;"bryon";14529;99.8829926354188;0.117007364581182
0;181;"bryona";181;0;100
0;869;"bryonna";869;0;100
0;204;"bryony";204;0;100
135;0;"bryor";135;100;0
0;29;"brysa";29;0;100
119;0;"brysan";119;100;0
150;6;"bryse";156;96.1538461538462;3.84615384615385
0;53;"bryseida";53;0;100
2364;6;"brysen";2370;99.746835443038;0.253164556962025
5;0;"bryshaun";5;100;0
31;0;"bryshawn";31;100;0
9;0;"bryshere";9;100;0
15;0;"bryshon";15;100;0
191;0;"brysin";191;100;0
54188;230;"bryson";54418;99.5773457311919;0.422654268808115
10;0;"brysonn";10;100;0
0;192;"bryssa";192;0;100
0;5;"bryssia";5;0;100
0;561;"brystal";561;0;100
96;0;"brysten";96;100;0
19;0;"brystin";19;100;0
0;12;"brystle";12;0;100
14;749;"brystol";763;1.8348623853211;98.1651376146789
855;0;"bryston";855;100;0
59;0;"brysun";59;100;0
82;0;"brysyn";82;100;0
10;0;"brytan";10;100;0
0;79;"brytani";79;0;100
0;7;"brytanie";7;0;100
0;10;"brytanni";10;0;100
0;11;"brytany";11;0;100
151;7;"bryten";158;95.5696202531646;4.43037974683544
10;0;"brytin";10;100;0
0;10;"brytne";10;0;100
0;63;"brytnee";63;0;100
0;103;"brytney";103;0;100
0;141;"brytni";141;0;100
0;23;"brytnie";23;0;100
2647;170;"bryton";2817;93.9652112176074;6.03478878239262
0;205;"bryttani";205;0;100
0;19;"bryttanie";19;0;100
0;235;"bryttany";235;0;100
0;10;"bryttnee";10;0;100
0;62;"bryttney";62;0;100
0;57;"bryttni";57;0;100
0;11;"bryttnie";11;0;100
0;6;"bryttnii";6;0;100
14;0;"bryxton";14;100;0
0;5;"btittany";5;0;100
54;0;"bub";54;100;0
481;0;"bubba";481;100;0
138;0;"bubber";138;100;0
0;5;"bubbles";5;0;100
15;0;"bubby";15;100;0
29;0;"buchanan";29;100;0
5844;0;"buck";5844;100;0
5;0;"buckey";5;100;0
11;0;"buckie";11;100;0
650;0;"buckley";650;100;0
10;0;"buckner";10;100;0
995;0;"bucky";995;100;0
8652;0;"bud";8652;100;0
1045;0;"budd";1045;100;0
1481;5;"buddie";1486;99.6635262449529;0.336473755047106
22257;45;"buddy";22302;99.7982243744956;0.201775625504439
265;0;"bueford";265;100;0
1116;0;"buel";1116;100;0
0;16;"buela";16;0;100
0;1285;"buelah";1285;0;100
816;0;"buell";816;100;0
0;835;"buena";835;0;100
5;0;"buenaventura";5;100;0
6;0;"bufard";6;100;0
31;47;"buff";78;39.7435897435897;60.2564102564103
0;96;"buffey";96;0;100
0;194;"buffi";194;0;100
0;868;"buffie";868;0;100
507;0;"bufford";507;100;0
6;3263;"buffy";3269;0.183542367696543;99.8164576323035
10616;110;"buford";10726;98.974454596308;1.02554540369196
5;0;"bugra";5;100;0
27;0;"bukhari";27;100;0
0;887;"bula";887;0;100
0;2714;"bulah";2714;0;100
0;89;"bular";89;0;100
0;22;"buleah";22;0;100
297;0;"bulmaro";297;100;0
6;0;"bulut";6;100;0
17;0;"bun";17;100;0
0;657;"buna";657;0;100
5;0;"bundy";5;100;0
0;30;"bunia";30;0;100
0;48;"bunice";48;0;100
0;6;"bunie";6;0;100
16;0;"bunion";16;100;0
0;26;"bunita";26;0;100
5;0;"bunk";5;100;0
0;30;"bunni";30;0;100
62;794;"bunnie";856;7.24299065420561;92.7570093457944
149;1815;"bunny";1964;7.58655804480652;92.4134419551935
132;0;"bunyan";132;100;0
16;0;"bunyon";16;100;0
22;0;"burach";22;100;0
270;0;"burak";270;100;0
5;0;"bural";5;100;0
6;0;"burbon";6;100;0
22;0;"burce";22;100;0
161;0;"burch";161;100;0
29;0;"burchard";29;100;0
5;0;"burchel";5;100;0
22;0;"burchell";22;100;0
321;56;"burdell";377;85.1458885941645;14.8541114058355
0;51;"burdella";51;0;100
0;5;"burdelle";5;0;100
0;5;"burdena";5;0;100
0;5;"burdene";5;0;100
240;0;"burdett";240;100;0
0;17;"burdetta";17;0;100
1703;127;"burdette";1830;93.0601092896175;6.93989071038251
0;5;"burdie";5;0;100
0;5;"burdine";5;0;100
56;0;"burech";56;100;0
183;0;"burel";183;100;0
11;0;"burell";11;100;0
724;0;"buren";724;100;0
51;0;"burford";51;100;0
0;22;"burgandi";22;0;100
0;5;"burgandie";5;0;100
0;196;"burgandy";196;0;100
1074;0;"burgess";1074;100;0
11;0;"burgin";11;100;0
0;277;"burgundy";277;0;100
163;0;"burhan";163;100;0
143;0;"burhanuddin";143;100;0
5;0;"burie";5;100;0
6;0;"burim";6;100;0
226;0;"burk";226;100;0
3606;37;"burke";3643;98.9843535547626;1.01564644523744
0;28;"burklee";28;0;100
0;13;"burkleigh";13;0;100
48;44;"burkley";92;52.1739130434783;47.8260869565217
6868;19;"burl";6887;99.7241179032961;0.275882096703935
0;13;"burla";13;0;100
62;0;"burle";62;100;0
0;5;"burleen";5;0;100
456;0;"burleigh";456;100;0
26;0;"burlen";26;100;0
0;69;"burlene";69;0;100
2152;40;"burley";2192;98.1751824817518;1.82481751824817
139;40;"burlie";179;77.6536312849162;22.3463687150838
400;0;"burlin";400;100;0
0;6;"burline";6;0;100
98;0;"burlon";98;100;0
11;0;"burlyn";11;100;0
0;923;"burma";923;0;100
0;5;"burmah";5;0;100
120;0;"burman";120;100;0
0;122;"burna";122;0;100
17;0;"burnace";17;100;0
0;135;"burnadette";135;0;100
0;27;"burnadine";27;0;100
6;0;"burnam";6;100;0
331;0;"burnard";331;100;0
0;12;"burneice";12;0;100
2775;593;"burnell";3368;82.3931116389549;17.6068883610451
0;17;"burnelle";17;0;100
57;5;"burnes";62;91.9354838709677;8.06451612903226
0;7;"burnese";7;0;100
40;0;"burness";40;100;0
34;0;"burnest";34;100;0
0;21;"burnestine";21;0;100
23;0;"burnet";23;100;0
0;5;"burneta";5;0;100
1525;283;"burnett";1808;84.3473451327434;15.6526548672566
0;754;"burnetta";754;0;100
233;764;"burnette";997;23.370110330993;76.629889669007
848;5;"burney";853;99.4138335287222;0.586166471277843
130;0;"burnham";130;100;0
1332;1572;"burnice";2904;45.8677685950413;54.1322314049587
844;57;"burnie";901;93.6736958934517;6.32630410654828
0;53;"burniece";53;0;100
842;90;"burnis";932;90.343347639485;9.65665236051502
0;30;"burnita";30;0;100
11;0;"burnley";11;100;0
567;0;"burns";567;100;0
47;0;"buron";47;100;0
679;0;"burr";679;100;0
322;0;"burrel";322;100;0
1391;0;"burrell";1391;100;0
10;0;"burrill";10;100;0
162;0;"burris";162;100;0
5;0;"burrus";5;100;0
6093;0;"burt";6093;100;0
0;10;"burtha";10;0;100
0;6;"burtie";6;0;100
479;0;"burtis";479;100;0
21597;48;"burton";21645;99.7782397782398;0.221760221760222
5;0;"buruk";5;100;0
10;0;"burvin";10;100;0
167;0;"burwell";167;100;0
138;0;"buryl";138;100;0
0;15;"buse";15;0;100
68;0;"bush";68;100;0
0;666;"bushra";666;0;100
0;40;"busra";40;0;100
5;0;"buss";5;100;0
7818;5;"buster";7823;99.9360859005497;0.0639140994503387
3383;0;"butch";3383;100;0
816;0;"butler";816;100;0
0;10;"butterfly";10;0;100
6;0;"buxton";6;100;0
33;0;"buz";33;100;0
261;0;"buzz";261;100;0
48;0;"buzzy";48;100;0
5;0;"bwana";5;100;0
75;0;"byan";75;100;0
0;422;"byanca";422;0;100
0;279;"byanka";279;0;100
109;0;"byard";109;100;0
0;8;"byata";8;0;100
109;0;"byford";109;100;0
27;5;"byntlee";32;84.375;15.625
217;0;"bynum";217;100;0
0;6;"byonce";6;0;100
0;10;"byra";10;0;100
1384;0;"byran";1384;100;0
198;0;"byrant";198;100;0
17;0;"byrce";17;100;0
605;108;"byrd";713;84.8527349228611;15.1472650771388
0;361;"byrdie";361;0;100
62;0;"byren";62;100;0
531;53;"byrl";584;90.9246575342466;9.07534246575342
32;28;"byrle";60;53.3333333333333;46.6666666666667
98;0;"byrne";98;100;0
0;26;"byrnece";26;0;100
78427;298;"byron";78725;99.621467132423;0.378532867577009
9;0;"byrum";9;100;0
34;0;"byson";34;100;0
5;0;"caaden";5;100;0
0;16;"caaliyah";16;0;100
24;0;"caanan";24;100;0
0;69;"caasi";69;0;100
180;0;"cabe";180;100;0
34;0;"cabel";34;100;0
0;69;"cabela";69;0;100
87;0;"cabell";87;100;0
0;134;"cabella";134;0;100
134;0;"cable";134;100;0
269;0;"cabot";269;100;0
5;0;"cabral";5;100;0
5;0;"cabren";5;100;0
0;108;"cabria";108;0;100
0;21;"cabrielle";21;0;100
0;324;"cabrina";324;0;100
0;75;"cabrini";75;0;100
67;0;"cace";67;100;0
0;29;"cacee";29;0;100
17;201;"cacey";218;7.79816513761468;92.2018348623853
710;458;"cache";1168;60.7876712328767;39.2123287671233
0;285;"cachet";285;0;100
0;116;"caci";116;0;100
0;26;"cacia";26;0;100
0;75;"cacie";75;0;100
0;52;"cacy";52;0;100
10;0;"cad";10;100;0
0;5;"cada";5;0;100
289;0;"cadan";289;100;0
5;874;"cadance";879;0.568828213879408;99.4311717861206
372;0;"cadarius";372;100;0
44;0;"cadarrius";44;100;0
66;0;"cadden";66;100;0
0;43;"caddie";43;0;100
25613;104;"cade";25717;99.5955982424077;0.404401757592254
0;55;"cadedra";55;0;100
0;400;"cadee";400;0;100
0;12;"cadeidra";12;0;100
0;5;"cadeisha";5;0;100
0;20;"cadeja";20;0;100
0;10;"cadejah";10;0;100
129;0;"cadel";129;100;0
85;0;"cadell";85;100;0
6;0;"cadem";6;100;0
12;0;"cademon";12;100;0
57173;830;"caden";58003;98.569039532438;1.43096046756202
1306;18563;"cadence";19869;6.5730535004278;93.4269464995722
0;11;"cadense";11;0;100
0;40;"cadesha";40;0;100
0;18;"cadeshia";18;0;100
0;15;"cadesia";15;0;100
5;0;"cadet";5;100;0
0;118;"cadey";118;0;100
6;0;"cadge";6;100;0
0;13;"cadhla";13;0;100
0;232;"cadi";232;0;100
0;34;"cadia";34;0;100
7;0;"cadian";7;100;0
0;737;"cadie";737;0;100
48;0;"cadien";48;100;0
0;80;"cadience";80;0;100
0;17;"cadijah";17;0;100
6;0;"cadillac";6;100;0
630;16;"cadin";646;97.5232198142415;2.47678018575851
0;111;"cadince";111;0;100
0;5;"cadisha";5;0;100
238;0;"cadon";238;100;0
17;10;"cadrian";27;62.962962962963;37.037037037037
20;2243;"cady";2263;0.883782589482987;99.116217410517
922;372;"cadyn";1294;71.2519319938176;28.7480680061824
0;265;"cadynce";265;0;100
11;0;"caed";11;100;0
153;0;"caedan";153;100;0
0;27;"caedance";27;0;100
1821;29;"caeden";1850;98.4324324324324;1.56756756756757
0;155;"caedence";155;0;100
69;0;"caedin";69;100;0
809;0;"caedmon";809;100;0
362;0;"caedon";362;100;0
290;77;"caedyn";367;79.0190735694823;20.9809264305177
3217;13;"cael";3230;99.5975232198142;0.402476780185758
0;444;"caela";444;0;100
0;6;"caelainn";6;0;100
1971;606;"caelan";2577;76.4842840512223;23.5157159487777
403;0;"caeleb";403;100;0
0;59;"caelee";59;0;100
0;206;"caeleigh";206;0;100
457;67;"caelen";524;87.2137404580153;12.7862595419847
0;422;"caeley";422;0;100
0;580;"caeli";580;0;100
0;21;"caelia";21;0;100
0;100;"caelie";100;0;100
308;406;"caelin";714;43.1372549019608;56.8627450980392
7;0;"caelix";7;100;0
118;0;"caellum";118;100;0
5;0;"caelob";5;100;0
37;0;"caelon";37;100;0
293;0;"caelum";293;100;0
0;28;"caely";28;0;100
5;2071;"caelyn";2076;0.240847784200385;99.7591522157996
0;369;"caelynn";369;0;100
0;66;"caera";66;0;100
4921;0;"caesar";4921;100;0
42;10;"caesare";52;80.7692307692308;19.2307692307692
6;0;"caeser";6;100;0
109;0;"caeson";109;100;0
13;0;"caesyn";13;100;0
88;0;"caetano";88;100;0
0;24;"caetlin";24;0;100
0;21;"caetlyn";21;0;100
10;0;"caezar";10;100;0
0;5;"caffey";5;0;100
0;88;"caffie";88;0;100
28;0;"caffrey";28;100;0
11;0;"cagan";11;100;0
849;0;"cage";849;100;0
15;0;"cager";15;100;0
105;186;"cagney";291;36.0824742268041;63.9175257731959
5;0;"cahari";5;100;0
16;0;"cahill";16;100;0
0;11;"cahlia";11;0;100
146;0;"cahlil";146;100;0
0;5;"cahlin";5;0;100
6;0;"cahmari";6;100;0
7;0;"cahner";7;100;0
0;111;"cahterine";111;0;100
0;5;"cahya";5;0;100
749;278;"cai";1027;72.9308666017527;27.0691333982473
0;495;"caia";495;0;100
0;33;"caiah";33;0;100
158;0;"caid";158;100;0
0;5;"caida";5;0;100
339;0;"caidan";339;100;0
0;185;"caidance";185;0;100
63;0;"caide";63;100;0
0;5;"caidee";5;0;100
16500;442;"caiden";16942;97.3910990437965;2.60890095620352
93;927;"caidence";1020;9.11764705882353;90.8823529411765
6;0;"caidenn";6;100;0
89;0;"caidin";89;100;0
198;0;"caidon";198;100;0
0;5;"caidy";5;0;100
571;379;"caidyn";950;60.1052631578947;39.8947368421053
0;69;"caidynce";69;0;100
333;0;"caige";333;100;0
59;0;"cail";59;100;0
0;1124;"caila";1124;0;100
0;114;"cailah";114;0;100
133;71;"cailan";204;65.1960784313726;34.8039215686275
0;11;"caile";11;0;100
68;17;"cailean";85;80;20
220;0;"caileb";220;100;0
0;1465;"cailee";1465;0;100
0;139;"caileen";139;0;100
0;979;"caileigh";979;0;100
211;197;"cailen";408;51.7156862745098;48.2843137254902
0;3510;"cailey";3510;0;100
0;81;"caili";81;0;100
0;213;"cailie";213;0;100
30;3502;"cailin";3532;0.849377123442808;99.1506228765572
0;54;"cailley";54;0;100
242;0;"caillou";242;100;0
0;7;"cailon";7;0;100
0;5;"cailtin";5;0;100
6;0;"cailum";6;100;0
0;143;"caily";143;0;100
0;4987;"cailyn";4987;0;100
0;930;"cailynn";930;0;100
0;22;"cailynne";22;0;100
56;0;"caiman";56;100;0
41;0;"caimen";41;100;0
6;0;"caimin";6;100;0
5;0;"caimon";5;100;0
5416;0;"cain";5416;100;0
720;0;"cainan";720;100;0
1482;0;"caine";1482;100;0
286;0;"cainen";286;100;0
15;0;"cainin";15;100;0
36;0;"cainon";36;100;0
442;0;"caio";442;100;0
0;750;"caira";750;0;100
0;5;"cairah";5;0;100
9;0;"cairee";9;100;0
0;28;"cairi";28;0;100
5;0;"cairl";5;100;0
0;5;"cairn";5;0;100
1523;170;"cairo";1693;89.9586532782044;10.0413467217956
33;0;"cairon";33;100;0
0;40;"cairra";40;0;100
169;0;"caisen";169;100;0
0;44;"caisey";44;0;100
0;23;"caisha";23;0;100
0;44;"caisley";44;0;100
0;6;"caislynn";6;0;100
431;0;"caison";431;100;0
21;19;"caisyn";40;52.5;47.5
0;134;"cait";134;0;100
0;10;"caite";10;0;100
0;5;"caitelyn";5;0;100
0;20;"caithlin";20;0;100
0;28;"caitie";28;0;100
0;36;"caitilin";36;0;100
0;5;"caitilyn";5;0;100
0;21;"caitin";21;0;100
0;84;"caitlain";84;0;100
0;1047;"caitlan";1047;0;100
0;96;"caitland";96;0;100
0;383;"caitlen";383;0;100
283;111119;"caitlin";111402;0.254034936536148;99.7459650634638
0;16;"caitline";16;0;100
0;133;"caitlinn";133;0;100
34;51316;"caitlyn";51350;0.0662122687439143;99.9337877312561
0;22;"caitlynd";22;0;100
0;86;"caitlyne";86;0;100
0;4761;"caitlynn";4761;0;100
0;375;"caitlynne";375;0;100
0;10;"caitria";10;0;100
0;405;"caitrin";405;0;100
0;202;"caitriona";202;0;100
0;5;"caitryn";5;0;100
0;41;"caity";41;0;100
0;5;"caityln";5;0;100
0;5;"caitylyn";5;0;100
904;0;"caius";904;100;0
0;280;"caiya";280;0;100
0;37;"caiyah";37;0;100
16;0;"caiyden";16;100;0
11;0;"cajuan";11;100;0
33;0;"cajun";33;100;0
5008;10;"cal";5018;99.8007174172977;0.199282582702272
0;431;"cala";431;0;100
355;0;"calab";355;100;0
10;0;"calaeb";10;100;0
0;476;"calah";476;0;100
163;0;"calahan";163;100;0
0;152;"calais";152;0;100
0;19;"calamity";19;0;100
627;20;"calan";647;96.9088098918083;3.09119010819165
0;5;"calanda";5;0;100
0;1741;"calandra";1741;0;100
0;100;"calandria";100;0;100
0;26;"calani";26;0;100
0;5;"calantha";5;0;100
0;5;"calanthe";5;0;100
0;5;"calasia";5;0;100
0;121;"calaya";121;0;100
0;52;"calayah";52;0;100
0;6;"calaysia";6;0;100
9;0;"calbe";9;100;0
261;0;"calbert";261;100;0
8;0;"calcifer";8;100;0
59;0;"calden";59;100;0
1338;26;"calder";1364;98.0938416422287;1.90615835777126
0;625;"caldonia";625;0;100
549;0;"caldwell";549;100;0
7831;84;"cale";7915;98.9387239418825;1.0612760581175
0;162;"calea";162;0;100
19;0;"caleab";19;100;0
0;467;"caleah";467;0;100
5;0;"caleal";5;100;0
269245;580;"caleb";269825;99.7850458630594;0.21495413694061
12;0;"calebe";12;100;0
5;0;"calebjames";5;100;0
6;0;"caled";6;100;0
0;67;"caledonia";67;0;100
0;658;"calee";658;0;100
66;0;"caleel";66;100;0
0;106;"caleen";106;0;100
0;40;"caleena";40;0;100
0;17;"caleesha";17;0;100
0;55;"caleesi";55;0;100
0;38;"calei";38;0;100
0;12;"caleia";12;0;100
0;5;"caleiah";5;0;100
0;5039;"caleigh";5039;0;100
0;113;"caleigha";113;0;100
6;0;"calek";6;100;0
98;0;"calel";98;100;0
323;0;"calem";323;100;0
2071;221;"calen";2292;90.3577661431065;9.64223385689354
0;141;"calena";141;0;100
0;65;"calene";65;0;100
6;0;"caleob";6;100;0
11;0;"calep";11;100;0
0;10;"calese";10;0;100
0;30;"calesha";30;0;100
0;15;"caleshia";15;0;100
0;5;"caletha";5;0;100
22;0;"calev";22;100;0
21;0;"calex";21;100;0
151;2396;"caley";2547;5.92854338437377;94.0714566156262
0;29;"caleya";29;0;100
0;50;"caleyah";50;0;100
7;0;"calhan";7;100;0
202;0;"calhoun";202;100;0
149;15044;"cali";15193;0.980714802869743;99.0192851971303
0;624;"calia";624;0;100
0;245;"caliah";245;0;100
22;0;"calian";22;100;0
0;432;"caliana";432;0;100
0;105;"caliann";105;0;100
0;157;"calianna";157;0;100
0;60;"calianne";60;0;100
488;0;"calib";488;100;0
105;5;"caliber";110;95.4545454545455;4.54545454545455
0;5;"calice";5;0;100
0;27;"calicia";27;0;100
0;36;"calida";36;0;100
0;1338;"calie";1338;0;100
65;0;"calieb";65;100;0
0;12;"caliee";12;0;100
0;100;"caliegh";100;0;100
10;0;"caliel";10;100;0
0;5;"caliese";5;0;100
0;185;"california";185;0;100
0;41;"calii";41;0;100
41;0;"calijah";41;100;0
10;0;"calik";10;100;0
134;0;"calil";134;100;0
0;7;"calilynn";7;0;100
0;16;"calimarie";16;0;100
955;223;"calin";1178;81.0696095076401;18.9303904923599
0;504;"calina";504;0;100
0;71;"calinda";71;0;100
0;10;"caline";10;0;100
0;6;"calionna";6;0;100
0;60;"caliope";60;0;100
14;0;"calip";14;100;0
196;0;"caliph";196;100;0
0;20;"calirae";20;0;100
0;45;"calirose";45;0;100
0;5;"calis";5;0;100
0;153;"calisa";153;0;100
0;362;"calise";362;0;100
0;240;"calisha";240;0;100
0;32;"calisi";32;0;100
0;782;"calissa";782;0;100
0;22;"calisse";22;0;100
0;6267;"calista";6267;0;100
5;0;"calisto";5;100;0
69;0;"calistro";69;100;0
0;5;"calita";5;0;100
376;0;"calix";376;100;0
0;35;"calixta";35;0;100
457;0;"calixto";457;100;0
10;0;"calixtro";10;100;0
0;130;"caliya";130;0;100
0;1194;"caliyah";1194;0;100
0;8;"calizza";8;0;100
0;3000;"calla";3000;0;100
136;19;"callaghan";155;87.741935483871;12.258064516129
0;5;"callah";5;0;100
1010;448;"callahan";1458;69.2729766803841;30.7270233196159
0;11;"callalily";11;0;100
2953;1063;"callan";4016;73.5308764940239;26.4691235059761
0;6;"callandra";6;0;100
0;5;"callasandra";5;0;100
215;203;"callaway";418;51.4354066985646;48.5645933014354
0;218;"calle";218;0;100
0;660;"callee";660;0;100
0;267;"calleen";267;0;100
0;1886;"calleigh";1886;0;100
4262;395;"callen";4657;91.5181447283659;8.4818552716341
0;13;"calletana";13;0;100
37;0;"calletano";37;100;0
0;902;"calley";902;0;100
0;4092;"calli";4092;0;100
0;447;"callia";447;0;100
0;41;"calliah";41;0;100
0;49;"calliana";49;0;100
0;6;"callianna";6;0;100
0;28;"callianne";28;0;100
558;51529;"callie";52087;1.07128458156546;98.9287154184345
0;29;"callieann";29;0;100
0;54;"calliegh";54;0;100
0;5;"calliemae";5;0;100
116;7;"callin";123;94.3089430894309;5.69105691056911
0;1675;"calliope";1675;0;100
34;0;"callis";34;100;0
0;7;"callisa";7;0;100
0;14;"callison";14;0;100
0;5;"callissa";5;0;100
0;2096;"callista";2096;0;100
5;0;"callister";5;100;0
0;37;"callisto";37;0;100
35;0;"callon";35;100;0
191;18;"calloway";209;91.3875598086124;8.61244019138756
3894;0;"callum";3894;100;0
0;1687;"cally";1687;0;100
0;7;"callye";7;0;100
5;364;"callyn";369;1.3550135501355;98.6449864498645
0;51;"callysta";51;0;100
5;0;"calman";5;100;0
15;0;"calmer";15;100;0
722;0;"calob";722;100;0
0;26;"calogera";26;0;100
432;0;"calogero";432;100;0
57;0;"calon";57;100;0
0;10;"calondra";10;0;100
0;5;"calonia";5;0;100
0;12;"calsey";12;0;100
0;7;"caltlin";7;0;100
299;0;"calton";299;100;0
167;0;"calub";167;100;0
0;16;"caludia";16;0;100
1263;0;"calum";1263;100;0
5;0;"calvan";5;100;0
37;55;"calvary";92;40.2173913043478;59.7826086956522
155;0;"calven";155;100;0
1639;0;"calvert";1639;100;0
5;0;"calvester";5;100;0
195118;1192;"calvin";196310;99.3927971066171;0.607202893382915
0;127;"calvina";127;0;100
0;6;"calvinesha";6;0;100
21;0;"calvion";21;100;0
53;0;"calvon";53;100;0
86;0;"calvyn";86;100;0
0;127;"caly";127;0;100
64;0;"calyb";64;100;0
0;5;"calyce";5;0;100
75;677;"calyn";752;9.97340425531915;90.0265957446808
0;369;"calynn";369;0;100
0;5;"calynne";5;0;100
0;200;"calypso";200;0;100
0;63;"calyse";63;0;100
0;283;"calyssa";283;0;100
0;448;"calysta";448;0;100
47;40;"calyx";87;54.0229885057471;45.9770114942529
1778;360;"cam";2138;83.1618334892423;16.8381665107577
0;5;"cama";5;0;100
5;0;"camacho";5;100;0
0;5;"camaira";5;0;100
0;10;"camaiya";10;0;100
0;196;"camala";196;0;100
0;12;"camalla";12;0;100
15;49;"camani";64;23.4375;76.5625
142;0;"camar";142;100;0
81;696;"camara";777;10.4247104247104;89.5752895752896
19;0;"camare";19;100;0
6;5;"camaree";11;54.5454545454545;45.4545454545455
54;5;"camaren";59;91.5254237288136;8.47457627118644
23;0;"camareon";23;100;0
947;645;"camari";1592;59.4849246231156;40.5150753768844
0;189;"camaria";189;0;100
0;5;"camariah";5;0;100
21;194;"camarie";215;9.76744186046512;90.2325581395349
5;0;"camarii";5;100;0
5;0;"camario";5;100;0
511;0;"camarion";511;100;0
0;11;"camariyah";11;0;100
13;19;"camaro";32;40.625;59.375
680;52;"camaron";732;92.896174863388;7.10382513661202
5;5;"camarri";10;50;50
0;63;"camary";63;0;100
0;147;"camaryn";147;0;100
0;34;"camas";34;0;100
113;71;"camauri";184;61.4130434782609;38.5869565217391
5;0;"camaury";5;100;0
0;72;"camay";72;0;100
0;240;"camaya";240;0;100
0;5;"cambel";5;0;100
73;193;"cambell";266;27.4436090225564;72.5563909774436
0;155;"cambelle";155;0;100
27;455;"camber";482;5.60165975103734;94.3983402489627
0;10;"camberly";10;0;100
0;5;"cambi";5;0;100
0;39;"cambra";39;0;100
0;108;"cambre";108;0;100
0;161;"cambrea";161;0;100
0;1669;"cambree";1669;0;100
0;37;"cambreigh";37;0;100
103;0;"cambren";103;100;0
0;96;"cambrey";96;0;100
0;557;"cambri";557;0;100
0;4706;"cambria";4706;0;100
0;10;"cambriah";10;0;100
53;46;"cambridge";99;53.5353535353535;46.4646464646465
0;1434;"cambrie";1434;0;100
0;5;"cambriella";5;0;100
0;17;"cambrielle";17;0;100
54;0;"cambron";54;100;0
0;601;"cambry";601;0;100
0;6;"cambrya";6;0;100
31;131;"cambryn";162;19.1358024691358;80.8641975308642
0;5;"cambrynn";5;0;100
109;0;"camdan";109;100;0
39284;2744;"camden";42028;93.471019320453;6.52898067954697
253;0;"camdin";253;100;0
846;0;"camdon";846;100;0
2474;2039;"camdyn";4513;54.8194105916242;45.1805894083758
21;55;"camdynn";76;27.6315789473684;72.3684210526316
0;5;"camea";5;0;100
0;6;"cameca";6;0;100
0;6;"camecia";6;0;100
0;13;"camee";13;0;100
0;5;"cameika";5;0;100
0;5;"cameil";5;0;100
0;37;"cameisha";37;0;100
0;66;"cameka";66;0;100
0;768;"camela";768;0;100
0;2518;"camelia";2518;0;100
0;1102;"camella";1102;0;100
0;107;"camelle";107;0;100
0;2335;"camellia";2335;0;100
10;0;"camello";10;100;0
5;0;"camelo";5;100;0
0;5;"camely";5;0;100
55;10;"camen";65;84.6153846153846;15.3846153846154
213;1482;"cameo";1695;12.5663716814159;87.4336283185841
5;0;"cameon";5;100;0
0;106;"camera";106;0;100
914;838;"cameran";1752;52.1689497716895;47.8310502283105
1259;211;"cameren";1470;85.6462585034014;14.3537414965986
0;11;"cameria";11;0;100
553;236;"camerin";789;70.0887198986058;29.9112801013942
0;23;"camerina";23;0;100
21;0;"camerino";21;100;0
17;0;"camerion";17;100;0
266409;26677;"cameron";293086;90.897893451069;9.10210654893103
6;0;"camerone";6;100;0
51;0;"camerron";51;100;0
5;0;"camerson";5;100;0
0;56;"camery";56;0;100
691;2434;"cameryn";3125;22.112;77.888
0;11;"camerynn";11;0;100
0;457;"camesha";457;0;100
0;126;"cameshia";126;0;100
0;172;"camey";172;0;100
0;5239;"cami";5239;0;100
0;411;"camia";411;0;100
0;197;"camiah";197;0;100
0;11;"camica";11;0;100
0;1587;"camie";1587;0;100
35;15;"camiel";50;70;30
0;268;"camielle";268;0;100
0;5;"camiesha";5;0;100
0;76;"camika";76;0;100
55;86;"camil";141;39.0070921985816;60.9929078014184
49;55664;"camila";55713;0.0879507475813544;99.9120492524186
0;142;"camilah";142;0;100
33;882;"camile";915;3.60655737704918;96.3934426229508
0;9;"camili";9;0;100
0;487;"camilia";487;0;100
0;26;"camill";26;0;100
6;20523;"camilla";20529;0.0292269472453602;99.9707730527546
0;5;"camillah";5;0;100
1319;64082;"camille";65401;2.01678873411722;97.9832112658828
0;5;"camillemarie";5;0;100
0;1340;"camillia";1340;0;100
0;5;"camillie";5;0;100
805;0;"camillo";805;100;0
47;0;"camillus";47;100;0
0;15;"camilly";15;0;100
0;5;"camillya";5;0;100
5267;0;"camilo";5267;100;0
0;37;"camily";37;0;100
0;48;"camilya";48;0;100
0;139;"camira";139;0;100
0;6;"camirah";6;0;100
43;0;"camiren";43;100;0
8;0;"camiron";8;100;0
0;27;"camiryn";27;0;100
0;10;"camisa";10;0;100
0;988;"camisha";988;0;100
0;5;"camishia";5;0;100
0;424;"camiya";424;0;100
0;479;"camiyah";479;0;100
5;5;"camlin";10;50;50
0;12;"camlyn";12;0;100
5;0;"camm";5;100;0
201;0;"cammeron";201;100;0
0;652;"cammi";652;0;100
28;3725;"cammie";3753;0.746069810818012;99.253930189182
0;11;"cammille";11;0;100
26;0;"cammron";26;100;0
0;1505;"cammy";1505;0;100
45;0;"camon";45;100;0
0;23;"camoni";23;0;100
6;0;"camonte";6;100;0
0;358;"camora";358;0;100
0;32;"camorah";32;0;100
8;0;"camoren";8;100;0
0;17;"camori";17;0;100
0;6;"camorra";6;0;100
0;10;"camoya";10;0;100
67;0;"camp";67;100;0
4308;5118;"campbell";9426;45.7033736473584;54.2966263526416
0;21;"campbelle";21;0;100
5;0;"camper";5;100;0
5;0;"campion";5;100;0
5;0;"campton";5;100;0
0;11;"camra";11;0;100
288;18;"camran";306;94.1176470588235;5.88235294117647
0;232;"camree";232;0;100
5786;545;"camren";6331;91.3915653135366;8.60843468646343
17;0;"camreon";17;100;0
0;49;"camrey";49;0;100
0;550;"camri";550;0;100
0;398;"camrie";398;0;100
971;221;"camrin";1192;81.4597315436242;18.5402684563758
5;0;"camrion";5;100;0
13700;399;"camron";14099;97.1700120575927;2.82998794240726
6;0;"camrun";6;100;0
120;1214;"camry";1334;8.99550224887556;91.0044977511244
3691;24417;"camryn";28108;13.1314928134339;86.8685071865661
0;5;"camryne";5;0;100
36;502;"camrynn";538;6.69144981412639;93.3085501858736
0;7;"camrynne";7;0;100
0;182;"camy";182;0;100
0;535;"camya";535;0;100
0;88;"camyah";88;0;100
0;40;"camyia";40;0;100
0;18;"camyiah";18;0;100
0;139;"camyla";139;0;100
0;75;"camylle";75;0;100
0;93;"camyra";93;0;100
0;5;"camyrah";5;0;100
0;5;"camyri";5;0;100
0;5;"camyria";5;0;100
0;31;"camyrn";31;0;100
11;5;"camyron";16;68.75;31.25
372;0;"can";372;100;0
0;521;"cana";521;0;100
3675;264;"canaan";3939;93.2977913175933;6.7022086824067
0;5;"canace";5;0;100
0;54;"canada";54;0;100
28;5;"canan";33;84.8484848484848;15.1515151515152
0;398;"canary";398;0;100
0;6;"canasia";6;0;100
0;186;"canda";186;0;100
158;84321;"candace";84479;0.187028729033251;99.8129712709667
5;0;"candan";5;100;0
0;2294;"candance";2294;0;100
0;168;"candas";168;0;100
0;30;"candase";30;0;100
0;93;"cande";93;0;100
0;33;"candece";33;0;100
0;885;"candee";885;0;100
0;60;"candela";60;0;100
0;2334;"candelaria";2334;0;100
2275;0;"candelario";2275;100;0
199;0;"canden";199;100;0
0;161;"candence";161;0;100
0;7;"candes";7;0;100
0;19;"candess";19;0;100
0;7344;"candi";7344;0;100
0;210;"candia";210;0;100
0;94;"candiace";94;0;100
0;6;"candiance";6;0;100
0;23;"candias";23;0;100
0;11;"candic";11;0;100
155;67548;"candice";67703;0.228941110438238;99.7710588895618
0;62;"candid";62;0;100
0;3572;"candida";3572;0;100
2010;0;"candido";2010;100;0
0;2984;"candie";2984;0;100
0;5;"candiece";5;0;100
0;87;"candies";87;0;100
0;44;"candina";44;0;100
0;5125;"candis";5125;0;100
0;1153;"candise";1153;0;100
0;286;"candiss";286;0;100
0;131;"candita";131;0;100
0;5;"candius";5;0;100
0;24;"candle";24;0;100
62;5;"candler";67;92.5373134328358;7.46268656716418
138;0;"candon";138;100;0
0;1815;"candra";1815;0;100
0;11;"candrea";11;0;100
0;15;"candria";15;0;100
0;11;"candrice";11;0;100
0;241;"candus";241;0;100
100;28166;"candy";28266;0.353781928819076;99.6462180711809
0;2995;"candyce";2995;0;100
0;11;"candye";11;0;100
0;5;"candys";5;0;100
0;10;"candyse";10;0;100
202;0;"cane";202;100;0
0;25;"canei";25;0;100
0;47;"caneisha";47;0;100
12;0;"canek";12;100;0
0;45;"canela";45;0;100
35;0;"canelo";35;100;0
5;0;"canen";5;100;0
0;161;"canesha";161;0;100
0;41;"caneshia";41;0;100
0;5;"canessa";5;0;100
6;0;"canh";6;100;0
0;13;"cania";13;0;100
0;12;"caniah";12;0;100
0;38;"canice";38;0;100
0;16;"caniesha";16;0;100
6;0;"canin";6;100;0
81;0;"canio";81;100;0
0;270;"canisha";270;0;100
0;7;"canishia";7;0;100
0;12;"canita";12;0;100
0;261;"caniya";261;0;100
0;235;"caniyah";235;0;100
0;68;"canna";68;0;100
157;0;"cannan";157;100;0
142;0;"cannen";142;100;0
5;157;"cannie";162;3.08641975308642;96.9135802469136
10;0;"cannin";10;100;0
6670;144;"cannon";6814;97.886703845025;2.11329615497505
1837;24;"canon";1861;98.7103707684041;1.28962923159592
0;25;"cansas";25;0;100
0;5;"cansu";5;0;100
0;5;"cante";5;0;100
0;39;"cantina";39;0;100
387;0;"canton";387;100;0
0;24;"cantrece";24;0;100
403;65;"cantrell";468;86.1111111111111;13.8888888888889
0;51;"cantrice";51;0;100
108;0;"canuto";108;100;0
0;23;"canya";23;0;100
13;0;"canye";13;100;0
5;0;"canyen";5;100;0
0;5;"canyla";5;0;100
7;0;"canyn";7;100;0
2668;153;"canyon";2821;94.5763913505849;5.4236086494151
0;91;"caoilainn";91;0;100
0;46;"caoilinn";46;0;100
0;239;"caoimhe";239;0;100
24;0;"caolan";24;100;0
55;0;"cap";55;100;0
6;0;"cape";6;100;0
0;5;"capella";5;0;100
113;0;"capers";113;100;0
0;482;"capitola";482;0;100
166;0;"capone";166;100;0
5;0;"capp";5;100;0
0;36;"cappie";36;0;100
5;5;"cappy";10;50;50
0;5;"caprece";5;0;100
0;26;"caprecia";26;0;100
5;28;"capree";33;15.1515151515152;84.8484848484848
0;29;"capresha";29;0;100
57;2963;"capri";3020;1.88741721854305;98.112582781457
0;173;"capria";173;0;100
0;12;"caprial";12;0;100
0;42;"capriana";42;0;100
0;27;"caprica";27;0;100
170;3276;"caprice";3446;4.93325594892629;95.0667440510737
0;267;"capricia";267;0;100
0;69;"caprina";69;0;100
0;11;"caprise";11;0;100
0;146;"caprisha";146;0;100
257;0;"captain";257;100;0
0;217;"captola";217;0;100
0;37;"captolia";37;0;100
0;107;"capucine";107;0;100
5;0;"capus";5;100;0
10;0;"car";10;100;0
62;50986;"cara";51048;0.121454317505093;99.8785456824949
0;52;"carabella";52;0;100
0;11;"carabelle";11;0;100
0;54;"caragan";54;0;100
0;72;"caragh";72;0;100
0;833;"carah";833;0;100
0;70;"caral";70;0;100
0;840;"caralee";840;0;100
0;22;"caraleigh";22;0;100
0;38;"caralena";38;0;100
0;87;"caralina";87;0;100
0;868;"caraline";868;0;100
0;1081;"caralyn";1081;0;100
0;11;"caralyne";11;0;100
0;279;"caralynn";279;0;100
0;189;"caramia";189;0;100
0;13;"caramie";13;0;100
0;116;"caran";116;0;100
37;0;"carbon";37;100;0
0;5;"carcyn";5;0;100
46;0;"cardae";46;100;0
119;0;"cardale";119;100;0
138;0;"cardarius";138;100;0
6;0;"cardea";6;100;0
22;0;"cardel";22;100;0
0;140;"cardelia";140;0;100
2287;23;"cardell";2310;99.004329004329;0.995670995670996
0;20;"cardella";20;0;100
270;32;"carden";302;89.4039735099338;10.5960264900662
306;0;"carder";306;100;0
23;0;"cardero";23;100;0
0;13;"cardia";13;0;100
0;18;"cardie";18;0;100
17;0;"cardier";17;100;0
299;25;"cardin";324;92.2839506172839;7.71604938271605
0;10;"cardine";10;0;100
6;0;"cardis";6;100;0
0;5;"cardiss";5;0;100
51;0;"cardon";51;100;0
0;12;"cardyn";12;0;100
5;0;"care";5;100;0
0;134;"caree";134;0;100
90;0;"careem";90;100;0
0;213;"careen";213;0;100
0;60;"careena";60;0;100
0;19;"careese";19;0;100
145;60;"carel";205;70.7317073170732;29.2682926829268
0;61;"careli";61;0;100
15;0;"carell";15;100;0
0;5;"carelle";5;0;100
0;115;"carely";115;0;100
0;5;"carelyn";5;0;100
0;9528;"caren";9528;0;100
0;321;"carena";321;0;100
0;9;"carenda";9;0;100
0;50;"carene";50;0;100
6;0;"careron";6;100;0
0;42;"caresa";42;0;100
0;5;"caresha";5;0;100
0;209;"caress";209;0;100
0;1217;"caressa";1217;0;100
0;338;"caresse";338;0;100
0;292;"caretha";292;0;100
0;47;"caretta";47;0;100
16446;12662;"carey";29108;56.4999312903669;43.5000687096331
0;15;"careyann";15;0;100
55;12518;"cari";12573;0.437445319335083;99.5625546806649
0;215;"caria";215;0;100
0;91;"cariah";91;0;100
0;153;"cariana";153;0;100
0;281;"cariann";281;0;100
0;76;"carianna";76;0;100
0;496;"carianne";496;0;100
0;5;"caribbean";5;0;100
20;0;"caribe";20;100;0
0;25;"carice";25;0;100
0;25;"caricia";25;0;100
0;1742;"caridad";1742;0;100
0;22;"caridee";22;0;100
0;4369;"carie";4369;0;100
0;12;"cariel";12;0;100
0;12;"carielle";12;0;100
5;0;"carig";5;100;0
0;86;"carigan";86;0;100
0;27;"caril";27;0;100
0;14;"carilee";14;0;100
0;11;"carilla";11;0;100
0;425;"carilyn";425;0;100
0;12;"carilynn";12;0;100
0;132;"carime";132;0;100
0;4515;"carin";4515;0;100
35;14841;"carina";14876;0.235278300618446;99.7647216993816
0;8;"carinda";8;0;100
0;594;"carine";594;0;100
0;23;"carington";23;0;100
0;168;"carinna";168;0;100
0;216;"carinne";216;0;100
5;0;"cario";5;100;0
28;0;"carion";28;100;0
0;929;"caris";929;0;100
0;3000;"carisa";3000;0;100
0;15;"carise";15;0;100
0;69;"carisha";69;0;100
0;11;"carisia";11;0;100
0;494;"carisma";494;0;100
0;5;"cariss";5;0;100
12;27765;"carissa";27777;0.0432012096338698;99.9567987903661
0;26;"carisse";26;0;100
0;15;"carissia";15;0;100
0;5;"carista";5;0;100
0;1087;"carita";1087;0;100
0;17;"caritina";17;0;100
0;8;"cariya";8;0;100
0;38;"cariyah";38;0;100
0;108;"carizma";108;0;100
489011;3067;"carl";492078;99.3767248281776;0.623275171822353
426;148060;"carla";148486;0.286895734277979;99.713104265722
40;25;"carlan";65;61.5384615384615;38.4615384615385
0;5;"carlana";5;0;100
10;0;"carland";10;100;0
0;16;"carlann";16;0;100
5;0;"carlanthony";5;100;0
174;59;"carlas";233;74.6781115879828;25.3218884120172
0;36;"carlasia";36;0;100
0;11;"carlaya";11;0;100
0;25;"carlaysia";25;0;100
462;144;"carle";606;76.2376237623762;23.7623762376238
0;304;"carlea";304;0;100
0;73;"carleah";73;0;100
0;608;"carlean";608;0;100
0;27;"carlecia";27;0;100
308;11455;"carlee";11763;2.61837966505143;97.3816203349486
0;6712;"carleen";6712;0;100
0;105;"carleena";105;0;100
0;32;"carleene";32;0;100
0;99;"carlei";99;0;100
0;5102;"carleigh";5102;0;100
0;11;"carleigha";11;0;100
0;26;"carleisha";26;0;100
87;465;"carlen";552;15.7608695652174;84.2391304347826
0;1371;"carlena";1371;0;100
0;15109;"carlene";15109;0;100
10;0;"carlens";10;100;0
12;0;"carleon";12;100;0
664;5;"carles";669;99.2526158445441;0.747384155455904
0;5;"carlese";5;0;100
0;190;"carlesha";190;0;100
0;11;"carleshia";11;0;100
0;22;"carlesia";22;0;100
150;0;"carless";150;100;0
74;0;"carlester";74;100;0
0;8;"carlet";8;0;100
0;176;"carleta";176;0;100
0;488;"carletha";488;0;100
0;70;"carlethia";70;0;100
4697;0;"carleton";4697;100;0
0;33;"carlett";33;0;100
0;3055;"carletta";3055;0;100
0;1019;"carlette";1019;0;100
410;15977;"carley";16387;2.50198327942882;97.4980167205712
5;0;"carlhenry";5;100;0
5;8224;"carli";8229;0.0607607242678333;99.9392392757322
0;131;"carlia";131;0;100
0;19;"carliana";19;0;100
0;10;"carlianna";10;0;100
0;12;"carlianne";12;0;100
0;118;"carlicia";118;0;100
1261;13817;"carlie";15078;8.36317814033691;91.6368218596631
0;11;"carliee";11;0;100
0;17;"carliegh";17;0;100
15;0;"carlile";15;100;0
2430;1736;"carlin";4166;58.3293326932309;41.6706673067691
0;1112;"carlina";1112;0;100
0;89;"carlinda";89;0;100
5;1648;"carline";1653;0.302480338777979;99.697519661222
0;133;"carling";133;0;100
1221;178;"carlis";1399;87.276626161544;12.723373838456
0;1001;"carlisa";1001;0;100
0;193;"carlise";193;0;100
0;665;"carlisha";665;0;100
0;5;"carlishia";5;0;100
0;61;"carlisia";61;0;100
1474;360;"carlisle";1834;80.370774263904;19.629225736096
85;304;"carliss";389;21.8508997429306;78.1491002570694
0;657;"carlissa";657;0;100
0;5;"carlissia";5;0;100
0;1353;"carlita";1353;0;100
0;5;"carlitha";5;0;100
1143;0;"carlito";1143;100;0
477;0;"carlitos";477;100;0
0;5;"carlitta";5;0;100
0;124;"carliyah";124;0;100
0;7;"carlla";7;0;100
0;5;"carlleen";5;0;100
0;6;"carllene";6;0;100
14250;80;"carlo";14330;99.4417306350314;0.558269364968597
858;187;"carlon";1045;82.1052631578947;17.8947368421053
282402;2021;"carlos";284423;99.2894386178333;0.710561382166702
5;0;"carlosadrian";5;100;0
46;0;"carlosalberto";46;100;0
12;0;"carlosantonio";12;100;0
84;0;"carlosdaniel";84;100;0
12;0;"carlose";12;100;0
21;0;"carloseduardo";21;100;0
5;0;"carlosjavier";5;100;0
5;0;"carlosjr";5;100;0
50;0;"carlosmanuel";50;100;0
6;0;"carloss";6;100;0
0;1936;"carlota";1936;0;100
0;6029;"carlotta";6029;0;100
0;16;"carlotte";16;0;100
510;0;"carlous";510;100;0
0;248;"carloyn";248;0;100
654;0;"carlson";654;100;0
5;0;"carlston";5;100;0
47935;277;"carlton";48212;99.4254542437567;0.574545756243259
525;10;"carlus";535;98.1308411214953;1.86915887850467
5;0;"carlvin";5;100;0
160;62357;"carly";62517;0.255930386934754;99.7440696130652
0;54;"carlyann";54;0;100
0;1060;"carlye";1060;0;100
3630;175;"carlyle";3805;95.4007884362681;4.59921156373193
67;4159;"carlyn";4226;1.58542356838618;98.4145764316138
0;207;"carlyne";207;0;100
0;695;"carlynn";695;0;100
0;517;"carlyon";517;0;100
0;13;"carlyrose";13;0;100
0;6;"carlyse";6;0;100
0;5;"carlysha";5;0;100
0;35;"carlysia";35;0;100
14;0;"carlysle";14;100;0
0;33;"carlyssa";33;0;100
0;5;"carlyssia";5;0;100
0;4035;"carma";4035;0;100
0;14;"carmah";14;0;100
0;6;"carmala";6;0;100
0;5;"carmalena";5;0;100
0;90;"carmaleta";90;0;100
0;16;"carmaletta";16;0;100
0;5;"carmaline";5;0;100
0;415;"carmalita";415;0;100
1083;2395;"carman";3478;31.1385853939045;68.8614146060955
0;5;"carmani";5;0;100
0;5;"carmecia";5;0;100
0;18;"carmeisha";18;0;100
1338;6997;"carmel";8335;16.0527894421116;83.9472105578884
5;22829;"carmela";22834;0.0218971708855216;99.9781028291145
0;25;"carmeleta";25;0;100
0;10;"carmeletta";10;0;100
0;697;"carmelia";697;0;100
0;1345;"carmelina";1345;0;100
0;182;"carmeline";182;0;100
0;6756;"carmelita";6756;0;100
0;58;"carmelite";58;0;100
5;0;"carmelito";5;100;0
0;12;"carmelitta";12;0;100
12;152;"carmell";164;7.31707317073171;92.6829268292683
0;19066;"carmella";19066;0;100
0;304;"carmelle";304;0;100
0;94;"carmellia";94;0;100
1713;21;"carmello";1734;98.7889273356401;1.21107266435986
9930;5;"carmelo";9935;99.9496728736789;0.0503271263210871
0;8;"carmelyn";8;0;100
16537;135520;"carmen";152057;10.8755269405552;89.1244730594448
0;11;"carmena";11;0;100
0;414;"carmencita";414;0;100
0;5;"carmene";5;0;100
0;17;"carmenita";17;0;100
0;42;"carmenlita";42;0;100
166;0;"carmeron";166;100;0
0;8;"carmesa";8;0;100
0;192;"carmesha";192;0;100
0;33;"carmeshia";33;0;100
0;5;"carmesia";5;0;100
0;23;"carmetta";23;0;100
33;51;"carmi";84;39.2857142857143;60.7142857142857
0;19;"carmia";19;0;100
200;0;"carmichael";200;100;0
60;368;"carmie";428;14.018691588785;85.981308411215
0;5;"carmila";5;0;100
0;33;"carmilita";33;0;100
0;410;"carmilla";410;0;100
0;6;"carmille";6;0;100
129;787;"carmin";916;14.0829694323144;85.9170305676856
0;1199;"carmina";1199;0;100
0;50;"carmindy";50;0;100
12543;475;"carmine";13018;96.3512060224305;3.64879397756952
0;6;"carminia";6;0;100
185;0;"carmino";185;100;0
0;77;"carmisha";77;0;100
0;187;"carmita";187;0;100
1245;1576;"carmon";2821;44.1332860687699;55.8667139312301
0;20;"carmya";20;0;100
0;665;"carmyn";665;0;100
41;0;"carmyne";41;100;0
0;15;"carmynn";15;0;100
0;5;"carna";5;0;100
0;37;"carnation";37;0;100
10;0;"carneal";10;100;0
0;39;"carneisha";39;0;100
208;0;"carnel";208;100;0
0;214;"carnelia";214;0;100
95;0;"carnelius";95;100;0
4494;546;"carnell";5040;89.1666666666667;10.8333333333333
0;70;"carnella";70;0;100
5;0;"carnes";5;100;0
0;143;"carnesha";143;0;100
0;60;"carneshia";60;0;100
0;150;"carnetta";150;0;100
491;6;"carney";497;98.7927565392354;1.20724346076459
90;22;"carnie";112;80.3571428571429;19.6428571428571
0;195;"carnisha";195;0;100
0;55;"carnita";55;0;100
5;259;"caro";264;1.89393939393939;98.1060606060606
8615;815546;"carol";824161;1.04530546822769;98.9546945317723
0;1094;"carola";1094;0;100
0;148;"carolan";148;0;100
0;5590;"carolann";5590;0;100
0;1159;"carolanne";1159;0;100
139;0;"carold";139;100;0
0;5;"caroldean";5;0;100
0;5;"caroldine";5;0;100
264;110625;"carole";110889;0.238075913751589;99.7619240862484
0;21;"carolea";21;0;100
0;84;"caroleann";84;0;100
0;4453;"carolee";4453;0;100
0;272;"caroleen";272;0;100
0;69;"caroleena";69;0;100
0;12;"carolen";12;0;100
0;395;"carolena";395;0;100
0;739;"carolene";739;0;100
0;20;"caroletta";20;0;100
0;29;"carolette";29;0;100
0;6;"carolgene";6;0;100
0;93;"carolie";93;0;100
0;1231;"carolin";1231;0;100
137;41093;"carolina";41230;0.332282318699976;99.6677176813
0;37;"carolinda";37;0;100
303;211850;"caroline";212153;0.142821454327773;99.8571785456722
0;5;"carolita";5;0;100
0;171;"caroljean";171;0;100
0;6;"caroljo";6;0;100
776;1302;"caroll";2078;37.3435996150144;62.6564003849856
0;188;"carolle";188;0;100
0;263;"carollee";263;0;100
0;5;"carollou";5;0;100
0;207;"carollyn";207;0;100
0;232;"carollynn";232;0;100
59;0;"carolos";59;100;0
129;0;"carols";129;100;0
0;11;"carolsue";11;0;100
10;0;"carolus";10;100;0
0;112;"caroly";112;0;100
1619;552252;"carolyn";553871;0.292306331257639;99.7076936687424
0;162;"carolyna";162;0;100
0;3444;"carolyne";3444;0;100
0;6074;"carolynn";6074;0;100
0;971;"carolynne";971;0;100
0;6;"carolyon";6;0;100
918;3179;"caron";4097;22.4066390041494;77.5933609958506
0;53;"caronda";53;0;100
17;0;"caros";17;100;0
0;22;"caroyl";22;0;100
0;5;"caroyn";5;0;100
15;0;"carpenter";15;100;0
5;0;"carper";5;100;0
200;0;"carr";200;100;0
0;1206;"carra";1206;0;100
0;5;"carragan";5;0;100
0;149;"carrah";149;0;100
5;0;"carranza";5;100;0
0;42;"carre";42;0;100
0;6;"carree";6;0;100
0;72;"carreen";72;0;100
395;11;"carrel";406;97.2906403940887;2.70935960591133
427;64;"carrell";491;86.9653767820774;13.0346232179226
0;385;"carren";385;0;100
0;5;"carrena";5;0;100
0;198;"carrera";198;0;100
0;19;"carressa";19;0;100
6;47;"carrey";53;11.3207547169811;88.6792452830189
0;3460;"carri";3460;0;100
0;12;"carriana";12;0;100
0;105;"carriann";105;0;100
0;15;"carrianna";15;0;100
0;294;"carrianne";294;0;100
484;0;"carrick";484;100;0
1074;238802;"carrie";239876;0.447731327852724;99.5522686721473
0;669;"carrieann";669;0;100
0;209;"carrieanne";209;0;100
0;5;"carriebell";5;0;100
0;6;"carrielynn";6;0;100
10;1003;"carrigan";1013;0.987166831194472;99.0128331688055
0;222;"carrin";222;0;100
0;157;"carrina";157;0;100
0;156;"carrine";156;0;100
1682;2369;"carrington";4051;41.5206121945199;58.4793878054801
5;0;"carrion";5;100;0
17;16;"carris";33;51.5151515151515;48.4848484848485
0;547;"carrisa";547;0;100
0;960;"carrissa";960;0;100
6031;4252;"carrol";10283;58.650199358164;41.349800641836
5;0;"carrold";5;100;0
0;51;"carrole";51;0;100
34601;5887;"carroll";40488;85.4598893499308;14.5401106500692
0;10;"carrolle";10;0;100
0;284;"carrolyn";284;0;100
98;459;"carron";557;17.5942549371634;82.4057450628366
152;0;"carrson";152;100;0
295;1241;"carry";1536;19.2057291666667;80.7942708333333
0;63;"carrye";63;0;100
0;28;"carryl";28;0;100
0;22;"carryn";22;0;100
11;0;"carsan";11;100;0
0;17;"carsandra";17;0;100
2925;822;"carsen";3747;78.062449959968;21.937550040032
0;30;"carshena";30;0;100
15;0;"carsie";15;100;0
81;0;"carsin";81;100;0
97549;6442;"carson";103991;93.805233145176;6.19476685482397
1988;5;"carsten";1993;99.7491219267436;0.250878073256397
542;0;"carston";542;100;0
6;0;"carstyn";6;100;0
1170;2679;"carsyn";3849;30.3975058456742;69.6024941543258
0;61;"carsynn";61;0;100
57;0;"cartavious";57;100;0
92;0;"cartel";92;100;0
19;0;"cartell";19;100;0
139121;4526;"carter";143647;96.8492206589765;3.15077934102348
5;0;"carterjames";5;100;0
5;0;"carterlee";5;100;0
399;0;"cartez";399;100;0
0;66;"cartha";66;0;100
237;0;"carthel";237;100;0
16;0;"carthell";16;100;0
906;135;"cartier";1041;87.0317002881844;12.9682997118156
0;104;"cartina";104;0;100
0;5;"cartisha";5;0;100
0;6;"cartlin";6;0;100
0;29;"cartney";29;0;100
147;0;"cartrell";147;100;0
0;5;"cartrina";5;0;100
5;0;"caruso";5;100;0
520;0;"carvel";520;100;0
180;0;"carvell";180;100;0
5;0;"carven";5;100;0
2015;17;"carver";2032;99.1633858267717;0.836614173228347
5;0;"carveth";5;100;0
10;0;"carville";10;100;0
717;0;"carvin";717;100;0
28;0;"carvis";28;100;0
7;0;"carvon";7;100;0
26;0;"carwin";26;100;0
33;0;"carwyn";33;100;0
23985;5265;"cary";29250;82;18
0;5;"carya";5;0;100
0;11;"caryann";11;0;100
0;11;"carye";11;0;100
339;6336;"caryl";6675;5.07865168539326;94.9213483146067
0;230;"caryle";230;0;100
0;47;"caryll";47;0;100
0;792;"carylon";792;0;100
0;12168;"caryn";12168;0;100
0;6;"caryna";6;0;100
0;84;"carynn";84;0;100
0;26;"caryol";26;0;100
0;1969;"carys";1969;0;100
0;39;"caryss";39;0;100
0;198;"caryssa";198;0;100
56;0;"carzell";56;100;0
97;0;"cas";97;100;0
0;10;"casadee";10;0;100
0;11;"casadi";11;0;100
0;61;"casady";61;0;100
0;5;"casandr";5;0;100
7;15632;"casandra";15639;0.04475989513396;99.955240104866
123;0;"casanova";123;100;0
0;118;"casara";118;0;100
0;46;"casarah";46;0;100
0;772;"casaundra";772;0;100
0;5;"casaya";5;0;100
5;0;"casch";5;100;0
0;5;"cascia";5;0;100
6;0;"casden";6;100;0
5959;0;"case";5959;100;0
0;5;"casea";5;0;100
0;245;"casee";245;0;100
0;31;"caselyn";31;0;100
0;22;"caselynn";22;0;100
3592;17;"casen";3609;99.5289553893045;0.471044610695483
25;0;"caseton";25;100;0
109581;75730;"casey";185311;59.1335646561726;40.8664353438274
0;20;"caseyann";20;0;100
0;5;"caseylynn";5;0;100
16385;52;"cash";16437;99.6836405670134;0.316359432986555
0;117;"casha";117;0;100
0;76;"cashae";76;0;100
0;11;"cashala";11;0;100
0;5;"cashana";5;0;100
0;6;"cashanda";6;0;100
0;7;"cashanti";7;0;100
0;15;"cashara";15;0;100
15;0;"cashaun";15;100;0
65;0;"cashawn";65;100;0
0;141;"cashay";141;0;100
24;0;"cashden";24;100;0
42;68;"cashe";110;38.1818181818182;61.8181818181818
0;18;"cashea";18;0;100
0;6;"casheena";6;0;100
197;0;"cashel";197;100;0
31;0;"cashen";31;100;0
6;0;"cashion";6;100;0
16;0;"cashious";16;100;0
121;0;"cashis";121;100;0
227;0;"cashius";227;100;0
14;16;"cashlin";30;46.6666666666667;53.3333333333333
0;123;"cashlyn";123;0;100
0;78;"cashlynn";78;0;100
323;565;"cashmere";888;36.3738738738739;63.6261261261261
5;0;"cashmiere";5;100;0
31;6;"cashmir";37;83.7837837837838;16.2162162162162
21;0;"cashon";21;100;0
11;0;"cashous";11;100;0
42;0;"cashten";42;100;0
5;0;"cashtin";5;100;0
1190;0;"cashton";1190;100;0
49;0;"cashtyn";49;100;0
158;0;"cashus";158;100;0
0;1075;"casi";1075;0;100
0;225;"casia";225;0;100
0;10;"casiah";10;0;100
0;12;"casiana";12;0;100
15;0;"casiano";15;100;0
0;88;"casidee";88;0;100
0;11;"casidhe";11;0;100
0;346;"casidy";346;0;100
18;4732;"casie";4750;0.378947368421053;99.6210526315789
0;161;"casilda";161;0;100
1877;0;"casimer";1877;100;0
0;57;"casimera";57;0;100
5;0;"casimere";5;100;0
35;0;"casimier";35;100;0
4816;0;"casimir";4816;100;0
0;474;"casimira";474;0;100
1031;0;"casimiro";1031;100;0
86;0;"casin";86;100;0
0;5;"casina";5;0;100
15;0;"casino";15;100;0
25;0;"casius";25;100;0
0;5;"casiyah";5;0;100
0;17;"caslyn";17;0;100
255;0;"casmer";255;100;0
0;5;"casmera";5;0;100
62;0;"casmere";62;100;0
58;0;"casmier";58;100;0
0;5;"casmin";5;0;100
281;14;"casmir";295;95.2542372881356;4.74576271186441
0;96;"casmira";96;0;100
7761;60;"cason";7821;99.2328346758727;0.76716532412735
0;1061;"casondra";1061;0;100
0;5;"casonja";5;0;100
0;51;"casonya";51;0;100
248;0;"caspar";248;100;0
4156;0;"casper";4156;100;0
772;0;"caspian";772;100;0
1634;128;"cass";1762;92.7355278093076;7.26447219069239
0;216;"cassadee";216;0;100
0;108;"cassadi";108;0;100
0;169;"cassadie";169;0;100
0;6;"cassadra";6;0;100
87;1055;"cassady";1142;7.61821366024518;92.3817863397548
0;11;"cassand";11;0;100
0;55;"cassanda";55;0;100
0;24;"cassander";24;0;100
0;10;"cassandera";10;0;100
0;152;"cassandr";152;0;100
377;166747;"cassandra";167124;0.225581005720303;99.7744189942797
0;547;"cassandre";547;0;100
0;23;"cassandrea";23;0;100
0;72;"cassandria";72;0;100
0;11;"cassanora";11;0;100
26;0;"cassanova";26;100;0
0;131;"cassara";131;0;100
0;5;"cassarah";5;0;100
0;2392;"cassaundra";2392;0;100
0;39;"cassedy";39;0;100
0;45;"cassee";45;0;100
30;0;"cassel";30;100;0
89;0;"cassell";89;100;0
11;0;"cassen";11;100;0
0;7;"cassendra";7;0;100
155;1666;"cassey";1821;8.5118066996156;91.4881933003844
0;2284;"cassi";2284;0;100
0;1555;"cassia";1555;0;100
0;25;"cassiah";25;0;100
173;0;"cassian";173;100;0
0;43;"cassiana";43;0;100
0;11;"cassiday";11;0;100
0;702;"cassidee";702;0;100
0;74;"cassidey";74;0;100
0;805;"cassidi";805;0;100
0;455;"cassidie";455;0;100
3228;54157;"cassidy";57385;5.6251633702187;94.3748366297813
375;43681;"cassie";44056;0.851189395315054;99.1488106046849
143;34;"cassiel";177;80.7909604519774;19.2090395480226
0;7;"cassietta";7;0;100
6;0;"cassin";6;100;0
0;5;"cassina";5;0;100
0;272;"cassiopeia";272;0;100
0;45;"cassiopia";45;0;100
0;358;"cassity";358;0;100
4842;0;"cassius";4842;100;0
0;5;"casslyn";5;0;100
57;0;"casson";57;100;0
0;8;"cassondr";8;0;100
0;4310;"cassondra";4310;0;100
0;5;"cassonia";5;0;100
0;97;"cassundra";97;0;100
0;1989;"cassy";1989;0;100
0;6;"cassye";6;0;100
0;6;"casta";6;0;100
0;188;"castella";188;0;100
100;0;"casten";100;100;0
81;0;"caster";81;100;0
1319;22;"castiel";1341;98.3594332587621;1.64056674123788
85;0;"castin";85;100;0
0;6;"castina";6;0;100
186;0;"castle";186;100;0
21;0;"casto";21;100;0
367;0;"caston";367;100;0
221;0;"castor";221;100;0
0;5;"castoria";5;0;100
6;0;"castro";6;100;0
111;0;"castulo";111;100;0
5;0;"castyn";5;100;0
0;30;"casundra";30;0;100
275;0;"caswell";275;100;0
122;86;"casy";208;58.6538461538462;41.3461538461538
263;26;"casyn";289;91.0034602076124;8.99653979238754
0;275;"catalaya";275;0;100
0;6;"catalayah";6;0;100
117;0;"cataldo";117;100;0
0;62;"catalea";62;0;100
0;46;"cataleah";46;0;100
0;5;"cataleena";5;0;100
0;32;"cataleia";32;0;100
0;97;"catalena";97;0;100
0;3374;"cataleya";3374;0;100
0;86;"cataleyah";86;0;100
0;120;"catalia";120;0;100
0;5;"catalin";5;0;100
7;16877;"catalina";16884;0.0414593698175788;99.9585406301824
217;0;"catalino";217;100;0
0;10;"cataliya";10;0;100
0;10;"cataliyah";10;0;100
0;26;"catalya";26;0;100
0;90;"catalyna";90;0;100
0;26;"catana";26;0;100
0;23;"catara";23;0;100
0;6;"catarena";6;0;100
0;3110;"catarina";3110;0;100
1621;0;"catarino";1621;100;0
0;37;"catasha";37;0;100
18;0;"catch";18;100;0
151;0;"catcher";151;100;0
0;1551;"cate";1551;0;100
0;19;"cateena";19;0;100
0;20;"catelaya";20;0;100
0;45;"cateleya";45;0;100
0;370;"catelin";370;0;100
11;0;"catello";11;100;0
0;2188;"catelyn";2188;0;100
0;788;"catelynn";788;0;100
0;5;"catelynne";5;0;100
0;28;"catena";28;0;100
0;6;"catenia";6;0;100
0;397;"catera";397;0;100
0;32;"cateria";32;0;100
0;171;"caterin";171;0;100
0;2580;"caterina";2580;0;100
0;68;"caterine";68;0;100
0;6;"caternia";6;0;100
0;82;"caterra";82;0;100
0;29;"catessa";29;0;100
0;18;"catey";18;0;100
0;11;"cath";11;0;100
0;149;"catha";149;0;100
40;0;"cathal";40;100;0
0;323;"cathaleen";323;0;100
0;21;"cathalene";21;0;100
0;26;"cathaleya";26;0;100
0;5;"cathalia";5;0;100
0;99;"cathalina";99;0;100
0;10;"cathaline";10;0;100
97;0;"cathan";97;100;0
0;277;"catharina";277;0;100
0;11643;"catharine";11643;0;100
0;30;"cathay";30;0;100
0;255;"cathe";255;0;100
0;27;"cathee";27;0;100
0;61;"catheleen";61;0;100
0;47;"cathelene";47;0;100
0;92;"catheline";92;0;100
0;27;"cather";27;0;100
0;10;"catheren";10;0;100
0;256;"catherene";256;0;100
0;1111;"catherin";1111;0;100
0;891;"catherina";891;0;100
1784;633853;"catherine";635637;0.280663334576181;99.7193366654238
0;20;"catherline";20;0;100
0;1036;"cathern";1036;0;100
0;10;"catherne";10;0;100
0;1717;"catheryn";1717;0;100
0;226;"catheryne";226;0;100
0;2216;"cathey";2216;0;100
0;2536;"cathi";2536;0;100
0;34;"cathia";34;0;100
0;5586;"cathie";5586;0;100
0;10;"cathirine";10;0;100
0;5;"cathlean";5;0;100
10;29802;"cathleen";29812;0.0335435395142895;99.9664564604857
0;10;"cathlena";10;0;100
0;829;"cathlene";829;0;100
0;116;"cathlin";116;0;100
0;5;"cathlina";5;0;100
0;89;"cathline";89;0;100
0;349;"cathlyn";349;0;100
0;15;"cathreen";15;0;100
0;69;"cathren";69;0;100
0;33;"cathrin";33;0;100
0;50;"cathrina";50;0;100
0;7326;"cathrine";7326;0;100
0;15865;"cathryn";15865;0;100
0;535;"cathryne";535;0;100
0;6;"cathrynn";6;0;100
343;170066;"cathy";170409;0.201280448802587;99.7987195511974
0;135;"cathyann";135;0;100
0;125;"cathye";125;0;100
0;50;"cathyjo";50;0;100
0;5;"cathylee";5;0;100
0;15;"cathyleen";15;0;100
0;60;"cathyrn";60;0;100
0;44;"cati";44;0;100
0;295;"catia";295;0;100
0;41;"catiana";41;0;100
0;959;"catie";959;0;100
0;10;"catilaya";10;0;100
0;5;"catileya";5;0;100
0;58;"catilin";58;0;100
0;94;"catilyn";94;0;100
8;4178;"catina";4186;0.191113234591495;99.8088867654085
0;6;"catine";6;0;100
0;17;"catinia";17;0;100
0;11;"catinna";11;0;100
0;33;"catiria";33;0;100
0;45;"catisha";45;0;100
446;1055;"catlin";1501;29.7135243171219;70.2864756828781
0;601;"catlyn";601;0;100
0;143;"catlynn";143;0;100
363;0;"cato";363;100;0
182;58;"caton";240;75.8333333333333;24.1666666666667
0;38;"catonya";38;0;100
0;174;"catori";174;0;100
0;6;"catoria";6;0;100
0;6;"catosha";6;0;100
0;20;"catoya";20;0;100
0;5;"catrease";5;0;100
0;47;"catrece";47;0;100
0;6;"catreena";6;0;100
205;0;"catrell";205;100;0
0;365;"catrena";365;0;100
0;20;"catrenia";20;0;100
0;17;"catrese";17;0;100
0;5;"catressa";5;0;100
0;5;"catria";5;0;100
0;6;"catriana";6;0;100
0;1005;"catrice";1005;0;100
0;73;"catricia";73;0;100
0;39;"catrin";39;0;100
0;10045;"catrina";10045;0;100
0;74;"catrinia";74;0;100
0;5;"catrinna";5;0;100
0;580;"catriona";580;0;100
0;6;"catrisha";6;0;100
0;5;"cattalaya";5;0;100
0;199;"cattaleya";199;0;100
0;10;"cattibrie";10;0;100
0;53;"cattie";53;0;100
0;15;"cattina";15;0;100
0;629;"cattleya";629;0;100
0;182;"caty";182;0;100
0;11;"catya";11;0;100
6;0;"caua";6;100;0
10;0;"cauan";10;100;0
0;6;"caudie";6;0;100
43;0;"caulder";43;100;0
11;0;"caulen";11;100;0
173;0;"caulin";173;100;0
18;0;"caullin";18;100;0
187;0;"cauy";187;100;0
53;0;"cavalli";53;100;0
1429;0;"cavan";1429;100;0
38;0;"cavanaugh";38;100;0
18;0;"cavani";18;100;0
5;0;"cavari";5;100;0
34;0;"cavell";34;100;0
220;0;"caven";220;100;0
5;0;"cavett";5;100;0
1267;0;"cavin";1267;100;0
96;0;"cavion";96;100;0
183;0;"cavon";183;100;0
11;0;"cavonte";11;100;0
0;19;"cawanda";19;0;100
0;6;"cawanna";6;0;100
11;241;"cay";252;4.36507936507936;95.6349206349206
0;157;"caya";157;0;100
501;1107;"cayce";1608;31.1567164179104;68.8432835820896
0;364;"caycee";364;0;100
28;0;"caycen";28;100;0
0;128;"cayci";128;0;100
0;39;"caycie";39;0;100
60;0;"cayd";60;100;0
229;5;"caydan";234;97.8632478632479;2.13675213675214
0;311;"caydance";311;0;100
255;0;"cayde";255;100;0
0;184;"caydee";184;0;100
30423;1634;"cayden";32057;94.9028293352466;5.09717066475341
178;2941;"caydence";3119;5.7069573581276;94.2930426418724
17;0;"caydenn";17;100;0
377;36;"caydin";413;91.2832929782082;8.71670702179177
0;40;"caydince";40;0;100
75;0;"caydn";75;100;0
574;0;"caydon";574;100;0
64;0;"caydyn";64;100;0
0;47;"caye";47;0;100
24;364;"cayenne";388;6.18556701030928;93.8144329896907
0;32;"cayetana";32;0;100
694;0;"cayetano";694;100;0
22;0;"cayl";22;100;0
0;10407;"cayla";10407;0;100
0;398;"caylah";398;0;100
154;241;"caylan";395;38.9873417721519;61.0126582278481
0;19;"caylani";19;0;100
250;133;"cayle";383;65.2741514360313;34.7258485639687
0;143;"caylea";143;0;100
868;0;"cayleb";868;100;0
0;8184;"caylee";8184;0;100
0;5;"cayleeann";5;0;100
0;88;"cayleen";88;0;100
0;108;"caylei";108;0;100
0;1856;"cayleigh";1856;0;100
10;0;"caylem";10;100;0
284;565;"caylen";849;33.4511189634865;66.5488810365135
0;20;"caylene";20;0;100
5;0;"cayler";5;100;0
0;1128;"cayley";1128;0;100
0;401;"cayli";401;0;100
0;18;"cayliana";18;0;100
7;0;"caylib";7;100;0
0;1474;"caylie";1474;0;100
87;2285;"caylin";2372;3.66779089376054;96.3322091062395
0;7;"caylinn";7;0;100
58;0;"caylob";58;100;0
231;12;"caylon";243;95.0617283950617;4.93827160493827
94;82;"caylor";176;53.4090909090909;46.5909090909091
6;0;"caylub";6;100;0
33;0;"caylum";33;100;0
0;424;"caylyn";424;0;100
0;313;"caylynn";313;0;100
810;250;"cayman";1060;76.4150943396226;23.5849056603774
257;18;"caymen";275;93.4545454545455;6.54545454545455
46;0;"caymon";46;100;0
6;0;"caymus";6;100;0
12;0;"cayn";12;100;0
46;0;"caynan";46;100;0
295;0;"cayne";295;100;0
43;0;"caynen";43;100;0
10;0;"cayo";10;100;0
0;5;"cayra";5;0;100
44;20;"cayse";64;68.75;31.25
0;17;"caysee";17;0;100
1023;34;"caysen";1057;96.7833491012299;3.2166508987701
5;0;"caysey";5;100;0
0;10;"caysi";10;0;100
0;155;"caysie";155;0;100
43;0;"caysin";43;100;0
0;5;"cayslee";5;0;100
2922;31;"cayson";2953;98.9502201151371;1.04977988486285
0;5;"caytie";5;0;100
0;5;"caytlen";5;0;100
0;282;"caytlin";282;0;100
0;157;"caytlyn";157;0;100
0;8;"caytlynn";8;0;100
111;27;"cayton";138;80.4347826086957;19.5652173913043
12;0;"cayvion";12;100;0
97;0;"caz";97;100;0
0;54;"cazandra";54;0;100
15;0;"cazden";15;100;0
39;18;"caziah";57;68.4210526315789;31.5789473684211
0;6;"caziyah";6;0;100
17;0;"cazzie";17;100;0
5;0;"cchristopher";5;100;0
0;562;"ceaira";562;0;100
0;173;"ceairra";173;0;100
0;5;"cealie";5;0;100
29;0;"cean";29;100;0
0;278;"ceana";278;0;100
0;12;"ceandra";12;0;100
5;0;"ceandre";5;100;0
0;11;"ceann";11;0;100
0;641;"ceanna";641;0;100
0;1507;"ceara";1507;0;100
0;10;"cearah";10;0;100
0;41;"cearia";41;0;100
0;336;"cearra";336;0;100
3363;0;"ceasar";3363;100;0
13;0;"ceasare";13;100;0
807;0;"ceaser";807;100;0
0;117;"ceasia";117;0;100
0;5;"ceason";5;0;100
29;0;"ceazar";29;100;0
0;94;"ceazia";94;0;100
155;0;"cebastian";155;100;0
0;6;"cebell";6;0;100
83;0;"cebert";83;100;0
0;5;"cebria";5;0;100
0;31;"cebrina";31;0;100
6;0;"cebron";6;100;0
0;388;"cece";388;0;100
0;32;"ceceila";32;0;100
0;302;"ceceilia";302;0;100
0;5;"cecel";5;0;100
0;15;"cecele";15;0;100
11;52838;"cecelia";52849;0.0208140172945562;99.9791859827054
0;31;"cecelie";31;0;100
10;0;"cecelio";10;100;0
0;10;"cecellia";10;0;100
0;80;"cecely";80;0;100
0;88;"ceci";88;0;100
0;127;"cecia";127;0;100
10;0;"cecial";10;100;0
103456;6426;"cecil";109882;94.1519084108407;5.84809158915928
0;793;"cecila";793;0;100
191;18707;"cecile";18898;1.0106889617949;98.9893110382051
0;212;"cecilee";212;0;100
0;131;"ceciley";131;0;100
0;26;"cecili";26;0;100
177;91059;"cecilia";91236;0.194002367486518;99.8059976325135
0;352;"cecilie";352;0;100
2288;0;"cecilio";2288;100;0
0;24;"cecilla";24;0;100
0;944;"cecille";944;0;100
0;487;"cecillia";487;0;100
0;17;"cecilly";17;0;100
0;7401;"cecily";7401;0;100
0;58;"cecilya";58;0;100
0;230;"ceclia";230;0;100
0;42;"cecy";42;0;100
0;12;"cecyle";12;0;100
0;116;"cecylia";116;0;100
1196;850;"cedar";2046;58.455522971652;41.544477028348
89;0;"cedarius";89;100;0
47;0;"ceddrick";47;100;0
60;5;"cedell";65;92.3076923076923;7.69230769230769
0;34;"cedella";34;0;100
7;0;"cedeno";7;100;0
0;5;"cederia";5;0;100
103;0;"cederic";103;100;0
304;0;"cederick";304;100;0
0;75;"cedra";75;0;100
0;6;"cedrea";6;0;100
0;38;"cedria";38;0;100
0;32;"cedriana";32;0;100
0;26;"cedrianna";26;0;100
40077;278;"cedric";40355;99.311113864453;0.68888613554702
0;69;"cedrica";69;0;100
12;0;"cedrice";12;100;0
5965;10;"cedrick";5975;99.8326359832636;0.167364016736402
0;83;"cedricka";83;0;100
58;0;"cedrie";58;100;0
134;0;"cedrik";134;100;0
0;28;"cedrika";28;0;100
0;26;"cedrina";26;0;100
0;18;"cee";18;0;100
0;10;"ceeanna";10;0;100
219;0;"ceejay";219;100;0
126;0;"ceferino";126;100;0
0;5;"ceianna";5;0;100
0;49;"ceiara";49;0;100
0;773;"ceil";773;0;100
0;5;"ceila";5;0;100
0;272;"ceili";272;0;100
0;11;"ceilia";11;0;100
0;107;"ceilidh";107;0;100
0;5;"ceinna";5;0;100
5;0;"ceion";5;100;0
0;5;"ceionna";5;0;100
0;354;"ceira";354;0;100
0;573;"ceirra";573;0;100
132;0;"cejay";132;100;0
0;15;"ceji";15;0;100
0;85;"cela";85;0;100
0;16;"celaya";16;0;100
0;129;"cele";129;0;100
0;5;"celebrity";5;0;100
0;49;"celecia";49;0;100
0;10;"celedonia";10;0;100
112;0;"celedonio";112;100;0
0;18;"celeena";18;0;100
0;4513;"celena";4513;0;100
0;1620;"celene";1620;0;100
0;198;"celenia";198;0;100
0;5;"celenne";5;0;100
0;8;"celeny";8;0;100
0;6;"celerina";6;0;100
10;0;"celerino";10;100;0
0;181;"celes";181;0;100
0;73;"celese";73;0;100
0;5;"celess";5;0;100
0;5;"celesse";5;0;100
0;996;"celest";996;0;100
0;1994;"celesta";1994;0;100
57;55602;"celeste";55659;0.102409313857597;99.8975906861424
180;221;"celester";401;44.8877805486284;55.1122194513716
0;1030;"celestia";1030;0;100
0;502;"celestial";502;0;100
0;5;"celestie";5;0;100
6;0;"celestin";6;100;0
0;2310;"celestina";2310;0;100
232;9208;"celestine";9440;2.45762711864407;97.5423728813559
2477;0;"celestino";2477;100;0
0;12;"celestte";12;0;100
0;24;"celeta";24;0;100
0;5;"celetha";5;0;100
74;49877;"celia";49951;0.148145182278633;99.8518548177214
0;9;"celiana";9;0;100
0;183;"celica";183;0;100
0;351;"celicia";351;0;100
0;32;"celida";32;0;100
0;431;"celie";431;0;100
0;6;"celimar";6;0;100
0;55;"celin";55;0;100
6;13953;"celina";13959;0.042983021706426;99.9570169782936
0;1080;"celinda";1080;0;100
0;10413;"celine";10413;0;100
0;176;"celines";176;0;100
0;5;"celinez";5;0;100
0;5;"celinna";5;0;100
33;0;"celio";33;100;0
0;11;"celis";11;0;100
0;324;"celisa";324;0;100
0;150;"celise";150;0;100
0;5;"celisha";5;0;100
0;44;"celissa";44;0;100
0;113;"celisse";113;0;100
0;207;"celita";207;0;100
0;12;"celiyah";12;0;100
0;147;"cella";147;0;100
0;11;"celleste";11;0;100
0;30;"cellestine";30;0;100
0;46;"cellia";46;0;100
0;87;"cellie";87;0;100
0;20;"cellina";20;0;100
5;0;"cellus";5;100;0
0;80;"celsa";80;0;100
0;29;"celsea";29;0;100
0;223;"celsey";223;0;100
0;5;"celsi";5;0;100
0;56;"celsie";56;0;100
2157;0;"celso";2157;100;0
17;0;"celton";17;100;0
104;0;"celvin";104;100;0
0;5;"cely";5;0;100
0;6;"celyn";6;0;100
0;56;"celyna";56;0;100
0;10;"celyne";10;0;100
0;7;"celynn";7;0;100
86;0;"cem";86;100;0
7;0;"cemal";7;100;0
0;12;"cemiyah";12;0;100
0;17;"cemone";17;0;100
0;11;"cemre";11;0;100
0;5;"cemya";5;0;100
6;371;"cena";377;1.59151193633952;98.4084880636605
0;6;"cenae";6;0;100
0;7;"cenai";7;0;100
0;18;"cenaida";18;0;100
0;5;"cendi";5;0;100
0;11;"cendra";11;0;100
0;332;"cendy";332;0;100
0;45;"cenedra";45;0;100
5;0;"cengiz";5;100;0
0;125;"cenia";125;0;100
0;11;"cenie";11;0;100
0;10;"cenith";10;0;100
0;105;"ceniya";105;0;100
0;115;"ceniyah";115;0;100
0;5;"cennedy";5;0;100
0;26;"cennie";26;0;100
0;15;"centeria";15;0;100
0;14;"centhia";14;0;100
5;0;"central";5;100;0
11;0;"centrell";11;100;0
5;0;"centwane";5;100;0
0;11;"cenya";11;0;100
21;2134;"ceola";2155;0.974477958236659;99.0255220417633
0;18;"ceolia";18;0;100
42;0;"ceon";42;100;0
0;22;"ceona";22;0;100
0;75;"ceonna";75;0;100
24;0;"cepeda";24;100;0
817;0;"cephas";817;100;0
997;0;"cephus";997;100;0
29;0;"cequan";29;100;0
0;1337;"cera";1337;0;100
0;38;"cerah";38;0;100
5;0;"cerdic";5;100;0
0;11;"cerelia";11;0;100
0;52;"ceren";52;0;100
0;513;"cerena";513;0;100
0;63;"cereniti";63;0;100
0;938;"cerenity";938;0;100
0;29;"ceres";29;0;100
0;28;"ceresa";28;0;100
0;10;"cerese";10;0;100
0;46;"ceretha";46;0;100
33;0;"cergio";33;100;0
0;78;"ceri";78;0;100
0;104;"ceria";104;0;100
0;62;"ceriah";62;0;100
0;5;"ceridwen";5;0;100
0;513;"cerina";513;0;100
0;68;"cerinity";68;0;100
0;5;"cerisa";5;0;100
0;696;"cerise";696;0;100
0;461;"cerissa";461;0;100
0;104;"cerita";104;0;100
0;26;"ceriyah";26;0;100
5;0;"cerjio";5;100;0
11;0;"ceron";11;100;0
28;0;"cerone";28;100;0
0;171;"cerra";171;0;100
0;5;"cerri";5;0;100
0;102;"cerria";102;0;100
0;7;"cerridwen";7;0;100
0;6;"cerrie";6;0;100
0;5;"cerrisa";5;0;100
0;10;"cerrissa";10;0;100
73;0;"cerrone";73;100;0
105;0;"cervando";105;100;0
10;0;"cervante";10;100;0
18;0;"cervantes";18;100;0
0;159;"cerys";159;0;100
0;12;"cesalie";12;0;100
70408;315;"cesar";70723;99.5546003421801;0.445399657819945
613;0;"cesare";613;100;0
81;0;"cesareo";81;100;0
0;56;"cesaria";56;0;100
0;12;"cesarina";12;0;100
1047;0;"cesario";1047;100;0
21;0;"cesc";21;100;0
0;6;"cescily";6;0;100
12;0;"cesear";12;100;0
0;1041;"cesia";1041;0;100
0;67;"cesiah";67;0;100
5;0;"cesidio";5;100;0
0;11;"cesilee";11;0;100
0;5;"cesiley";5;0;100
0;760;"cesilia";760;0;100
0;10;"cesilie";10;0;100
0;97;"cesily";97;0;100
0;5;"cesira";5;0;100
0;50;"cesley";50;0;100
0;48;"ceslie";48;0;100
0;24;"cessily";24;0;100
0;6;"cessna";6;0;100
0;53;"cetera";53;0;100
58;0;"ceth";58;100;0
8;0;"cetric";8;100;0
0;5;"cevanna";5;0;100
0;6;"cevera";6;0;100
0;5;"cevilla";5;0;100
240;0;"cevin";240;100;0
11;0;"cevion";11;100;0
27;0;"cevon";27;100;0
0;5;"ceyana";5;0;100
0;5;"ceyara";5;0;100
0;88;"ceyda";88;0;100
0;5;"ceylan";5;0;100
0;66;"ceylin";66;0;100
81;0;"ceylon";81;100;0
0;5;"ceyonce";5;0;100
0;18;"ceyonna";18;0;100
0;38;"cezanne";38;0;100
642;0;"cezar";642;100;0
253;37;"cha";290;87.2413793103448;12.7586206896552
0;11;"chaarvi";11;0;100
0;5;"chaaya";5;0;100
0;95;"chabeli";95;0;100
0;6;"chabelli";6;0;100
0;63;"chabely";63;0;100
0;126;"chablis";126;0;100
0;5;"chabria";5;0;100
4668;129;"chace";4797;97.3108192620388;2.68918073796123
9;0;"chachi";9;100;0
239426;1039;"chad";240465;99.567920487389;0.432079512610983
0;5;"chada";5;0;100
0;29;"chadae";29;0;100
6;0;"chadarius";6;100;0
2445;0;"chadd";2445;100;0
333;0;"chaddrick";333;100;0
18;137;"chade";155;11.6129032258065;88.3870967741936
125;0;"chaden";125;100;0
45;0;"chaderick";45;100;0
43;0;"chadi";43;100;0
0;6;"chadijah";6;0;100
5;0;"chadlee";5;100;0
417;0;"chadley";417;100;0
7;0;"chadly";7;100;0
5;0;"chadman";5;100;0
43;5;"chadney";48;89.5833333333333;10.4166666666667
194;0;"chadric";194;100;0
2347;0;"chadrick";2347;100;0
25;0;"chadron";25;100;0
0;38;"chadsity";38;0;100
6;0;"chadwell";6;100;0
11;0;"chadwic";11;100;0
31;0;"chadwich";31;100;0
12983;22;"chadwick";13005;99.8308342945021;0.169165705497885
158;0;"chadwin";158;100;0
37;0;"chadwyck";37;100;0
0;5;"chadyeane";5;0;100
148;175;"chae";323;45.8204334365325;54.1795665634675
5;0;"chaeden";5;100;0
399;0;"chael";399;100;0
0;231;"chaela";231;0;100
0;262;"chaeli";262;0;100
0;8;"chaely";8;0;100
0;75;"chaelyn";75;0;100
0;24;"chaelynn";24;0;100
0;6;"chaena";6;0;100
5;5;"chaffee";10;50;50
311;180;"chai";491;63.3401221995927;36.6598778004073
0;60;"chaia";60;0;100
11;0;"chaiden";11;100;0
0;18;"chaila";18;0;100
0;16;"chailee";16;0;100
0;19;"chailey";19;0;100
0;41;"chaille";41;0;100
0;144;"chailyn";144;0;100
0;5;"chailynn";5;0;100
8538;6;"chaim";8544;99.9297752808989;0.0702247191011236
5;0;"chain";5;100;0
0;10;"chairity";10;0;100
0;107;"chairty";107;0;100
131;5;"chais";136;96.3235294117647;3.67647058823529
981;332;"chaise";1313;74.7143945163747;25.2856054836253
0;5;"chaislyn";5;0;100
30;0;"chaison";30;100;0
5;0;"chaisson";5;100;0
0;25;"chaisty";25;0;100
6;0;"chaitan";6;100;0
155;0;"chaitanya";155;100;0
0;7;"chaithra";7;0;100
0;123;"chaitra";123;0;100
0;5;"chaiya";5;0;100
262;841;"chaka";1103;23.7533998186763;76.2466001813237
0;37;"chakakhan";37;0;100
0;76;"chakara";76;0;100
0;58;"chakayla";58;0;100
0;5;"chakela";5;0;100
0;5;"chakelia";5;0;100
0;25;"chakera";25;0;100
0;10;"chakeria";10;0;100
0;17;"chaketa";17;0;100
0;5;"chakevia";5;0;100
0;5;"chakeya";5;0;100
0;159;"chakia";159;0;100
0;11;"chakina";11;0;100
0;229;"chakira";229;0;100
0;134;"chakita";134;0;100
0;17;"chakiya";17;0;100
0;10;"chakka";10;0;100
16;0;"chakong";16;100;0
11;0;"chakotay";11;100;0
0;10;"chakya";10;0;100
0;54;"chakyra";54;0;100
0;139;"chala";139;0;100
0;5;"chalan";5;0;100
0;54;"chalanda";54;0;100
0;15;"chalandra";15;0;100
14;0;"chale";14;100;0
0;36;"chalea";36;0;100
0;145;"chalee";145;0;100
0;6;"chalei";6;0;100
31;0;"chalen";31;100;0
0;31;"chalena";31;0;100
0;132;"chalene";132;0;100
188;0;"chales";188;100;0
0;73;"chalese";73;0;100
0;70;"chalet";70;0;100
0;11;"chalette";11;0;100
0;162;"chaley";162;0;100
0;15;"chali";15;0;100
0;18;"chalia";18;0;100
0;260;"chalice";260;0;100
0;10;"chalie";10;0;100
0;26;"chalina";26;0;100
33;0;"chalino";33;100;0
0;5;"chalis";5;0;100
0;119;"chalisa";119;0;100
0;222;"chalise";222;0;100
0;5;"chalissa";5;0;100
0;5;"chalisse";5;0;100
0;28;"chalita";28;0;100
0;24;"chaliyah";24;0;100
71;5;"challen";76;93.4210526315789;6.57894736842105
5;5;"challie";10;50;50
31;97;"challis";128;24.21875;75.78125
0;5;"challise";5;0;100
17;0;"chalmas";17;100;0
1357;0;"chalmer";1357;100;0
1048;0;"chalmers";1048;100;0
53;0;"chalmus";53;100;0
22;133;"chalon";155;14.1935483870968;85.8064516129032
0;128;"chalonda";128;0;100
38;0;"chalres";38;100;0
0;120;"chalsea";120;0;100
0;76;"chalsey";76;0;100
0;9;"chalsie";9;0;100
5;0;"chaly";5;100;0
0;27;"chalyce";27;0;100
0;71;"chalyn";71;0;100
0;5;"chalynn";5;0;100
0;13;"chalyse";13;0;100
0;10;"chama";10;0;100
0;63;"chamaine";63;0;100
224;0;"chamar";224;100;0
0;76;"chamara";76;0;100
0;84;"chamari";84;0;100
5;0;"chamarion";5;100;0
0;5;"chamarra";5;0;100
0;5;"chamaya";5;0;100
7;0;"chamber";7;100;0
100;6;"chamberlain";106;94.3396226415094;5.66037735849057
5;0;"chamberlin";5;100;0
0;7;"chamberlyn";7;0;100
15;0;"chambers";15;100;0
0;7;"chambre";7;0;100
0;15;"chambria";15;0;100
0;193;"chameka";193;0;100
5;5;"chamel";10;50;50
0;5;"chamelle";5;0;100
0;38;"chamere";38;0;100
0;48;"chamia";48;0;100
0;129;"chamika";129;0;100
0;74;"chamille";74;0;100
0;27;"chamique";27;0;100
0;27;"chamira";27;0;100
0;14;"chamisa";14;0;100
0;5;"chamise";5;0;100
0;54;"chamiya";54;0;100
0;10;"chamiyah";10;0;100
994;0;"champ";994;100;0
0;517;"champagne";517;0;100
0;23;"champaign";23;0;100
0;44;"champaigne";44;0;100
0;25;"champaine";25;0;100
0;22;"champale";22;0;100
0;10;"champane";10;0;100
0;107;"champayne";107;0;100
264;0;"champion";264;100;0
5;0;"chamroeun";5;100;0
0;119;"chamya";119;0;100
979;212;"chan";1191;82.1998320738875;17.8001679261125
0;10578;"chana";10578;0;100
0;406;"chanae";406;0;100
0;184;"chanah";184;0;100
0;10;"chanai";10;0;100
80;0;"chanan";80;100;0
76;0;"chananya";76;100;0
0;7;"chanavia";7;0;100
0;61;"chanay";61;0;100
0;54;"chanaya";54;0;100
110;0;"chanc";110;100;0
45103;1137;"chance";46240;97.5410899653979;2.45891003460208
0;7;"chancee";7;0;100
128;0;"chanceler";128;100;0
23;0;"chanceller";23;100;0
2190;0;"chancellor";2190;100;0
740;0;"chancelor";740;100;0
0;11;"chances";11;0;100
23;0;"chanceton";23;100;0
1170;480;"chancey";1650;70.9090909090909;29.0909090909091
0;56;"chanci";56;0;100
27;191;"chancie";218;12.3853211009174;87.6146788990826
18;0;"chancler";18;100;0
605;209;"chancy";814;74.3243243243243;25.6756756756757
16;6079;"chanda";6095;0.262510254306809;99.7374897456932
0;5;"chandace";5;0;100
0;40;"chandal";40;0;100
0;5;"chandale";5;0;100
54;0;"chandan";54;100;0
0;96;"chandani";96;0;100
13;12;"chandar";25;52;48
41;6;"chandara";47;87.2340425531915;12.7659574468085
5;0;"chande";5;100;0
0;5;"chandee";5;0;100
0;143;"chandel";143;0;100
0;104;"chandell";104;0;100
0;242;"chandelle";242;0;100
52;0;"chanden";52;100;0
8;0;"chander";8;100;0
0;242;"chandi";242;0;100
0;49;"chandice";49;0;100
0;34;"chandini";34;0;100
56;98;"chandlar";154;36.3636363636364;63.6363636363636
32370;7846;"chandler";40216;80.4903520986672;19.5096479013328
0;11;"chandley";11;0;100
95;0;"chandlor";95;100;0
0;13;"chandlyr";13;0;100
0;400;"chandni";400;0;100
304;0;"chandon";304;100;0
66;17238;"chandra";17304;0.381414701803051;99.6185852981969
0;41;"chandre";41;0;100
0;261;"chandrea";261;0;100
0;10;"chandrell";10;0;100
0;192;"chandria";192;0;100
0;161;"chandrika";161;0;100
0;5;"chandris";5;0;100
0;91;"chandy";91;0;100
316;128;"chane";444;71.1711711711712;28.8288288288288
0;58;"chanea";58;0;100
0;176;"chanee";176;0;100
0;19;"chaneice";19;0;100
0;64;"chaneka";64;0;100
85;16398;"chanel";16483;0.515682824728508;99.4843171752715
0;167;"chanele";167;0;100
0;2767;"chanell";2767;0;100
0;6;"chanella";6;0;100
0;4901;"chanelle";4901;0;100
0;5;"chanelly";5;0;100
0;56;"chanequa";56;0;100
0;69;"chanese";69;0;100
0;5;"chanet";5;0;100
0;29;"chaneta";29;0;100
0;80;"chanetta";80;0;100
0;75;"chanette";75;0;100
406;1204;"chaney";1610;25.2173913043478;74.7826086956522
0;9;"chaneyra";9;0;100
307;5;"chang";312;98.3974358974359;1.6025641025641
27;0;"changa";27;100;0
11;0;"chanh";11;100;0
0;596;"chani";596;0;100
0;348;"chania";348;0;100
0;59;"chaniah";59;0;100
0;563;"chanice";563;0;100
0;839;"chanie";839;0;100
0;132;"chaniece";132;0;100
0;17;"chaniel";17;0;100
0;16;"chanielle";16;0;100
0;233;"chanika";233;0;100
0;12;"chanille";12;0;100
11;301;"chanin";312;3.52564102564103;96.474358974359
15;0;"chanina";15;100;0
13;14;"chaning";27;48.1481481481481;51.8518518518518
0;198;"chaniqua";198;0;100
0;74;"chanique";74;0;100
0;333;"chanise";333;0;100
0;404;"chanita";404;0;100
0;11;"chanity";11;0;100
0;630;"chaniya";630;0;100
0;272;"chaniyah";272;0;100
0;5;"chanlee";5;0;100
415;161;"chanler";576;72.0486111111111;27.9513888888889
0;128;"chanley";128;0;100
5;862;"channa";867;0.576701268742791;99.4232987312572
0;192;"channah";192;0;100
0;12;"channan";12;0;100
5;0;"channce";5;100;0
0;1479;"channel";1479;0;100
0;391;"channell";391;0;100
0;275;"channelle";275;0;100
16;0;"channen";16;100;0
22;0;"channer";22;100;0
0;487;"channie";487;0;100
60;45;"channin";105;57.1428571428571;42.8571428571429
6052;3237;"channing";9289;65.1523307137474;34.8476692862526
373;729;"channon";1102;33.8475499092559;66.1524500907441
15;33;"channy";48;31.25;68.75
33;0;"chano";33;100;0
0;5;"chanoa";5;0;100
73;0;"chanoch";73;100;0
26;62;"chanon";88;29.5454545454545;70.4545454545455
32;0;"chans";32;100;0
1038;16;"chanse";1054;98.4819734345351;1.5180265654649
5;0;"chansler";5;100;0
156;0;"chanson";156;100;0
39;0;"chanston";39;100;0
5;0;"chant";5;100;0
0;861;"chanta";861;0;100
0;510;"chantae";510;0;100
0;5;"chantai";5;0;100
0;5;"chantail";5;0;100
7;8278;"chantal";8285;0.0844900422450211;99.915509957755
0;319;"chantale";319;0;100
0;39;"chantall";39;0;100
0;286;"chantalle";286;0;100
0;21;"chantasia";21;0;100
0;97;"chantavia";97;0;100
0;1108;"chantay";1108;0;100
0;6;"chantaye";6;0;100
33;3944;"chante";3977;0.829771184309781;99.1702288156902
0;109;"chantea";109;0;100
0;44;"chanteal";44;0;100
0;291;"chantee";291;0;100
11;14772;"chantel";14783;0.0744097950348373;99.9255902049652
0;419;"chantele";419;0;100
5;3479;"chantell";3484;0.143513203214696;99.8564867967853
0;105;"chantella";105;0;100
8;6508;"chantelle";6516;0.122774708410068;99.8772252915899
0;81;"chanteria";81;0;100
0;47;"chantey";47;0;100
0;5;"chantez";5;0;100
30;34;"chantha";64;46.875;53.125
5;0;"chanthy";5;100;0
0;110;"chanti";110;0;100
0;301;"chantia";301;0;100
0;22;"chantice";22;0;100
0;5;"chantiel";5;0;100
0;221;"chantil";221;0;100
0;5;"chantile";5;0;100
0;10;"chantill";10;0;100
0;68;"chantille";68;0;100
0;249;"chantilly";249;0;100
0;5;"chantily";5;0;100
0;45;"chantina";45;0;100
0;5;"chantis";5;0;100
0;7;"chantise";7;0;100
0;11;"chantle";11;0;100
5;0;"chantler";5;100;0
0;18;"chantol";18;0;100
5;0;"chanton";5;100;0
0;5;"chantoria";5;0;100
19;35;"chantra";54;35.1851851851852;64.8148148148148
0;5;"chantrea";5;0;100
0;11;"chantrel";11;0;100
0;127;"chantrell";127;0;100
0;28;"chantrelle";28;0;100
0;71;"chantrice";71;0;100
146;0;"chantry";146;100;0
0;31;"chanty";31;0;100
1079;0;"chantz";1079;100;0
0;745;"chany";745;0;100
0;187;"chanya";187;0;100
0;33;"chanyah";33;0;100
0;5;"chanyce";5;0;100
0;13;"chanyia";13;0;100
247;0;"chanz";247;100;0
245;0;"chanze";245;100;0
289;36;"chao";325;88.9230769230769;11.0769230769231
81;0;"chaos";81;100;0
37;0;"chap";37;100;0
42;119;"chapel";161;26.0869565217391;73.9130434782609
0;5;"chapelle";5;0;100
233;45;"chapin";278;83.8129496402878;16.1870503597122
22;0;"chaplin";22;100;0
785;0;"chapman";785;100;0
42;5;"chappell";47;89.3617021276596;10.6382978723404
26;5;"chaquan";31;83.8709677419355;16.1290322580645
0;59;"chaquana";59;0;100
0;5;"chaquanna";5;0;100
0;12;"chaqueta";12;0;100
0;52;"chaquetta";52;0;100
0;5;"chaquilla";5;0;100
22;5;"chaquille";27;81.4814814814815;18.5185185185185
0;525;"chaquita";525;0;100
0;7;"chaquitta";7;0;100
0;488;"char";488;0;100
0;949;"chara";949;0;100
0;11;"charade";11;0;100
0;204;"charae";204;0;100
0;5;"charaine";5;0;100
100;0;"charan";100;100;0
0;5;"charanda";5;0;100
0;18;"charay";18;0;100
351;0;"charbel";351;100;0
5;0;"chard";5;100;0
0;123;"charda";123;0;100
0;698;"chardae";698;0;100
0;127;"chardai";127;0;100
0;10;"chardanae";10;0;100
0;10;"chardanay";10;0;100
5;0;"chardarius";5;100;0
0;6;"chardasia";6;0;100
0;215;"charday";215;0;100
0;568;"charde";568;0;100
0;18;"chardee";18;0;100
0;11;"chardell";11;0;100
0;5;"chardey";5;0;100
0;20;"chardon";20;0;100
0;26;"chardonae";26;0;100
0;80;"chardonay";80;0;100
0;26;"chardonnae";26;0;100
0;638;"chardonnay";638;0;100
0;5;"chare";5;0;100
0;11;"charea";11;0;100
0;17;"charece";17;0;100
0;432;"charee";432;0;100
0;28;"chareen";28;0;100
0;105;"chareese";105;0;100
0;29;"charel";29;0;100
0;135;"charell";135;0;100
0;429;"charelle";429;0;100
134;0;"charels";134;100;0
0;17;"charemon";17;0;100
0;5;"charen";5;0;100
0;69;"charene";69;0;100
69;0;"chares";69;100;0
0;435;"charese";435;0;100
0;17;"charessa";17;0;100
0;38;"charesse";38;0;100
0;5;"charetta";5;0;100
0;5;"charette";5;0;100
6;0;"charger";6;100;0
0;5;"charhonda";5;0;100
0;1179;"chari";1179;0;100
0;35;"charia";35;0;100
0;106;"chariah";106;0;100
0;738;"charice";738;0;100
0;135;"charidy";135;0;100
0;331;"charie";331;0;100
0;5;"chariel";5;0;100
0;17;"charielle";17;0;100
5;0;"charies";5;100;0
0;5;"chariese";5;0;100
0;69;"charika";69;0;100
0;10;"charilyn";10;0;100
0;110;"charina";110;0;100
46;3780;"charis";3826;1.20230005227392;98.7976999477261
0;395;"charisa";395;0;100
0;2154;"charise";2154;0;100
0;418;"charish";418;0;100
0;5;"charisha";5;0;100
0;3425;"charisma";3425;0;100
0;38;"chariss";38;0;100
0;5019;"charissa";5019;0;100
0;5284;"charisse";5284;0;100
0;6;"charissma";6;0;100
97;0;"charistopher";97;100;0
0;1406;"charita";1406;0;100
0;47;"charitee";47;0;100
18;0;"charith";18;100;0
0;5;"charitha";5;0;100
0;229;"chariti";229;0;100
0;116;"charitie";116;0;100
0;43;"charito";43;0;100
39;33485;"charity";33524;0.116334566280873;99.8836654337191
0;32;"chariya";32;0;100
0;41;"chariyah";41;0;100
0;163;"charizma";163;0;100
0;5;"charkita";5;0;100
36;66;"charl";102;35.2941176470588;64.7058823529412
0;7983;"charla";7983;0;100
0;5;"charlae";5;0;100
0;5;"charlain";5;0;100
0;395;"charlaine";395;0;100
0;15;"charlan";15;0;100
0;27;"charlana";27;0;100
0;10;"charlanda";10;0;100
0;237;"charlane";237;0;100
0;71;"charlann";71;0;100
0;57;"charlanne";57;0;100
15;0;"charlas";15;100;0
0;10;"charlay";10;0;100
0;193;"charlayne";193;0;100
0;525;"charlcie";525;0;100
0;5;"charlcy";5;0;100
924;131;"charle";1055;87.5829383886256;12.4170616113744
0;369;"charlea";369;0;100
0;5;"charleah";5;0;100
0;1289;"charlean";1289;0;100
0;6;"charleane";6;0;100
0;10;"charlecia";10;0;100
225;10146;"charlee";10371;2.16951113682384;97.8304888631762
0;11;"charleeann";11;0;100
0;7333;"charleen";7333;0;100
0;205;"charleene";205;0;100
0;120;"charlei";120;0;100
0;4298;"charleigh";4298;0;100
16;6;"charlemagne";22;72.7272727272727;27.2727272727273
0;80;"charlen";80;0;100
0;1809;"charlena";1809;0;100
383;132628;"charlene";133011;0.287946109720249;99.7120538902797
2295302;11934;"charles";2307236;99.4827577239606;0.517242276039382
0;93;"charlesa";93;0;100
7;0;"charlesanthony";7;100;0
0;474;"charlese";474;0;100
5;0;"charlesedward";5;100;0
0;1303;"charlesetta";1303;0;100
0;41;"charlesha";41;0;100
0;92;"charlesia";92;0;100
5;0;"charlesjoseph";5;100;0
21;0;"charleson";21;100;0
5;0;"charlesten";5;100;0
0;128;"charlestine";128;0;100
2048;683;"charleston";2731;74.9908458440132;25.0091541559868
0;25;"charlestyn";25;0;100
0;23;"charleszetta";23;0;100
0;644;"charlet";644;0;100
0;30;"charleta";30;0;100
0;65;"charletha";65;0;100
82;0;"charleton";82;100;0
0;252;"charlett";252;0;100
0;1106;"charletta";1106;0;100
0;3749;"charlette";3749;0;100
18856;7026;"charley";25882;72.8537207325554;27.1462792674446
119;5704;"charli";5823;2.04362012708226;97.9563798729177
0;28;"charlia";28;0;100
0;27;"charliann";27;0;100
0;26;"charlianne";26;0;100
0;25;"charlice";25;0;100
0;26;"charlicia";26;0;100
151851;20879;"charlie";172730;87.9123487523881;12.0876512476119
0;47;"charlieann";47;0;100
0;74;"charliee";74;0;100
0;40;"charliegh";40;0;100
0;5;"charliemae";5;0;100
0;99;"charliene";99;0;100
0;10;"charlierae";10;0;100
0;18;"charlierose";18;0;100
181;0;"charlies";181;100;0
0;10;"charliese";10;0;100
0;63;"charlii";63;0;100
0;37;"charlin";37;0;100
0;156;"charlina";156;0;100
0;48;"charlinda";48;0;100
0;6160;"charline";6160;0;100
0;5;"charlirae";5;0;100
102;22;"charlis";124;82.258064516129;17.741935483871
0;596;"charlisa";596;0;100
0;756;"charlise";756;0;100
0;61;"charlisha";61;0;100
0;5;"charlisia";5;0;100
0;7;"charliss";7;0;100
0;110;"charlissa";110;0;100
0;24;"charlisse";24;0;100
0;433;"charlita";433;0;100
0;10;"charliyah";10;0;100
0;4588;"charlize";4588;0;100
0;5;"charlla";5;0;100
10;0;"charlles";10;100;0
0;5;"charloette";5;0;100
0;20;"charlon";20;0;100
0;5;"charlona";5;0;100
0;6;"charlonda";6;0;100
0;145;"charlot";145;0;100
0;10;"charlote";10;0;100
0;470;"charlott";470;0;100
0;939;"charlotta";939;0;100
676;327805;"charlotte";328481;0.205795769009471;99.7942042309905
0;6;"charlotteann";6;0;100
0;10;"charlottee";10;0;100
0;6;"charlottemarie";6;0;100
0;10;"charlotterose";10;0;100
0;64;"charlottie";64;0;100
0;5;"charlottle";5;0;100
711;0;"charls";711;100;0
0;5;"charlsa";5;0;100
14;0;"charlse";14;100;0
0;17;"charlsea";17;0;100
0;253;"charlsey";253;0;100
0;2016;"charlsie";2016;0;100
21;0;"charlston";21;100;0
3382;5;"charlton";3387;99.8523767345734;0.147623265426631
1025;1855;"charly";2880;35.5902777777778;64.4097222222222
0;6;"charlyann";6;0;100
0;282;"charlye";282;0;100
0;5;"charlyee";5;0;100
0;1802;"charlyn";1802;0;100
0;5;"charlynda";5;0;100
0;1132;"charlyne";1132;0;100
0;752;"charlynn";752;0;100
0;28;"charlynne";28;0;100
0;55;"charlyse";55;0;100
0;15;"charlytte";15;0;100
0;34;"charlyze";34;0;100
5;0;"charlz";5;100;0
0;346;"charm";346;0;100
0;274;"charma";274;0;100
0;20;"charmae";20;0;100
0;334;"charmagne";334;0;100
0;40;"charmaigne";40;0;100
0;995;"charmain";995;0;100
20;15270;"charmaine";15290;0.13080444735121;99.8691955526488
0;154;"charman";154;0;100
0;754;"charmane";754;0;100
0;18;"charmarie";18;0;100
0;1416;"charmayne";1416;0;100
0;10;"charme";10;0;100
0;10;"charmecia";10;0;100
0;104;"charmeka";104;0;100
0;214;"charmel";214;0;100
0;32;"charmell";32;0;100
0;5;"charmella";5;0;100
0;101;"charmelle";101;0;100
0;38;"charmen";38;0;100
0;10;"charmi";10;0;100
0;5;"charmia";5;0;100
0;473;"charmian";473;0;100
0;6;"charmica";6;0;100
0;54;"charmie";54;0;100
0;63;"charmika";63;0;100
0;621;"charmin";621;0;100
0;309;"charmine";309;0;100
12;0;"charming";12;100;0
0;220;"charmion";220;0;100
0;5;"charmisa";5;0;100
0;107;"charmon";107;0;100
0;18;"charmonique";18;0;100
0;519;"charna";519;0;100
0;418;"charnae";418;0;100
0;16;"charnai";16;0;100
0;164;"charnay";164;0;100
0;5;"charnaye";5;0;100
0;109;"charne";109;0;100
0;24;"charnea";24;0;100
0;5;"charnece";5;0;100
0;83;"charnee";83;0;100
0;22;"charneice";22;0;100
0;5;"charneka";5;0;100
0;66;"charnel";66;0;100
0;195;"charnele";195;0;100
0;655;"charnell";655;0;100
0;471;"charnelle";471;0;100
0;83;"charnese";83;0;100
0;23;"charnesha";23;0;100
0;5;"charneshia";5;0;100
0;5;"charnesia";5;0;100
0;23;"charnessa";23;0;100
0;184;"charnetta";184;0;100
0;192;"charnette";192;0;100
0;11;"charney";11;0;100
0;194;"charnice";194;0;100
0;92;"charniece";92;0;100
0;62;"charnika";62;0;100
0;29;"charniqua";29;0;100
0;22;"charnique";22;0;100
0;215;"charnise";215;0;100
0;30;"charnisha";30;0;100
0;32;"charnissa";32;0;100
0;359;"charnita";359;0;100
0;23;"charny";23;0;100
6;238;"charo";244;2.45901639344262;97.5409836065574
57;0;"charod";57;100;0
0;18;"charol";18;0;100
0;5;"charolene";5;0;100
0;22;"charolet";22;0;100
0;235;"charolett";235;0;100
0;3208;"charolette";3208;0;100
0;38;"charolotte";38;0;100
0;5;"charolyn";5;0;100
215;1001;"charon";1216;17.6809210526316;82.3190789473684
0;5;"charona";5;0;100
0;187;"charonda";187;0;100
5;16;"charone";21;23.8095238095238;76.1904761904762
0;5;"charotte";5;0;100
0;33;"charquita";33;0;100
0;51;"charra";51;0;100
0;19;"charrell";19;0;100
0;16;"charrelle";16;0;100
0;15;"charri";15;0;100
0;65;"charrie";65;0;100
0;220;"charrise";220;0;100
0;30;"charrissa";30;0;100
0;79;"charrisse";79;0;100
0;18;"charro";18;0;100
50;356;"charron";406;12.3152709359606;87.6847290640394
0;5;"charry";5;0;100
0;34;"charryse";34;0;100
0;22;"charsie";22;0;100
0;5;"charta";5;0;100
0;6;"chartese";6;0;100
5;0;"chartez";5;100;0
0;12;"charu";12;0;100
0;11;"charvae";11;0;100
0;24;"charvette";24;0;100
0;5;"charvey";5;0;100
97;0;"charvez";97;100;0
0;212;"charvi";212;0;100
22;0;"charvik";22;100;0
179;0;"charvis";179;100;0
0;5;"charvon";5;0;100
0;7;"chary";7;0;100
0;782;"charyl";782;0;100
0;5;"charylene";5;0;100
0;54;"charyn";54;0;100
0;16;"charysse";16;0;100
2597;10;"chas";2607;99.6164173379363;0.383582662063675
0;6;"chasadee";6;0;100
0;15;"chasadie";15;0;100
0;135;"chasady";135;0;100
0;11;"chasaty";11;0;100
155034;3397;"chase";158431;97.8558489184566;2.14415108154338
0;132;"chaselyn";132;0;100
0;65;"chaselynn";65;0;100
1713;0;"chasen";1713;100;0
5;0;"chasetin";5;100;0
280;0;"chaseton";280;100;0
0;241;"chasey";241;0;100
0;5;"chasia";5;0;100
0;28;"chasidee";28;0;100
0;21;"chasidi";21;0;100
0;2200;"chasidy";2200;0;100
0;28;"chasie";28;0;100
100;0;"chasin";100;100;0
0;64;"chasitee";64;0;100
0;380;"chasiti";380;0;100
0;274;"chasitie";274;0;100
0;29;"chasitity";29;0;100
0;20;"chasitiy";20;0;100
0;56;"chasitty";56;0;100
23;23790;"chasity";23813;0.096585898458825;99.9034141015412
67;10;"chaska";77;87.012987012987;12.987012987013
56;0;"chaske";56;100;0
15;0;"chaskel";15;100;0
0;150;"chaslyn";150;0;100
0;18;"chaslynn";18;0;100
0;12;"chasmin";12;0;100
0;108;"chasmine";108;0;100
0;27;"chasney";27;0;100
1087;0;"chason";1087;100;0
10;0;"chass";10;100;0
0;10;"chassady";10;0;100
22;0;"chasse";22;100;0
0;5;"chassi";5;0;100
0;5;"chassica";5;0;100
0;5;"chassidi";5;0;100
0;3290;"chassidy";3290;0;100
0;200;"chassie";200;0;100
0;7;"chassiti";7;0;100
0;5;"chassitty";5;0;100
0;2174;"chassity";2174;0;100
0;18;"chassy";18;0;100
0;312;"chasta";312;0;100
5;5;"chastain";10;50;50
5;0;"chastan";5;100;0
5;0;"chasteen";5;100;0
0;40;"chastelin";40;0;100
0;11;"chasteline";11;0;100
0;158;"chastelyn";158;0;100
0;8;"chastelyne";8;0;100
271;5;"chasten";276;98.1884057971015;1.81159420289855
0;542;"chastidy";542;0;100
0;5;"chastie";5;0;100
414;126;"chastin";540;76.6666666666667;23.3333333333333
0;26;"chastina";26;0;100
0;36;"chastine";36;0;100
0;9626;"chastity";9626;0;100
498;0;"chaston";498;100;0
0;92;"chasty";92;0;100
5;0;"chastyn";5;100;0
5;0;"chaswick";5;100;0
0;74;"chasya";74;0;100
92;0;"chasyn";92;100;0
5;0;"chat";5;100;0
0;10;"chata";10;0;100
0;5;"chatal";5;0;100
0;5;"chataqua";5;0;100
0;102;"chatara";102;0;100
0;10;"chatavia";10;0;100
107;34;"chatham";141;75.886524822695;24.113475177305
0;26;"chatherine";26;0;100
0;19;"chatia";19;0;100
0;5;"chatina";5;0;100
16;0;"chatman";16;100;0
0;26;"chatney";26;0;100
27;0;"chato";27;100;0
0;19;"chatoya";19;0;100
0;5;"chatrice";5;0;100
0;88;"chattie";88;0;100
107;371;"chau";478;22.3849372384937;77.6150627615063
428;11;"chaun";439;97.49430523918;2.50569476082005
0;248;"chauna";248;0;100
101;0;"chaunce";101;100;0
8825;508;"chauncey";9333;94.5569484624451;5.44305153755491
0;5;"chaunci";5;0;100
0;18;"chauncie";18;0;100
1210;33;"chauncy";1243;97.3451327433628;2.65486725663717
0;123;"chaunda";123;0;100
0;574;"chaundra";574;0;100
0;70;"chaunice";70;0;100
0;82;"chaunta";82;0;100
0;126;"chauntae";126;0;100
0;61;"chauntay";61;0;100
0;464;"chaunte";464;0;100
0;28;"chauntee";28;0;100
0;497;"chauntel";497;0;100
0;34;"chauntell";34;0;100
0;202;"chauntelle";202;0;100
0;32;"chauntia";32;0;100
0;5;"chauntrice";5;0;100
0;5;"chaurice";5;0;100
0;2480;"chava";2480;0;100
0;5;"chavah";5;0;100
5;0;"chavas";5;100;0
0;10;"chavaughn";10;0;100
0;5;"chave";5;0;100
0;120;"chavela";120;0;100
0;17;"chaveli";17;0;100
0;6;"chavella";6;0;100
0;24;"chavelle";24;0;100
0;38;"chavely";38;0;100
806;8;"chavez";814;99.017199017199;0.982800982800983
0;48;"chavi";48;0;100
0;98;"chavie";98;0;100
864;0;"chavis";864;100;0
0;45;"chaviva";45;0;100
55;671;"chavon";726;7.57575757575758;92.4242424242424
0;19;"chavonda";19;0;100
0;36;"chavone";36;0;100
0;28;"chavonna";28;0;100
0;512;"chavonne";512;0;100
0;5;"chavonte";5;0;100
0;362;"chavy";362;0;100
0;19;"chawana";19;0;100
0;17;"chawanda";17;0;100
0;15;"chawanna";15;0;100
187;40;"chawn";227;82.3788546255507;17.6211453744493
0;5;"chawna";5;0;100
374;54;"chay";428;87.3831775700935;12.6168224299065
10;11427;"chaya";11437;0.0874355163067238;99.9125644836933
0;78;"chayah";78;0;100
27;5;"chayan";32;84.375;15.625
5;0;"chayane";5;100;0
0;11;"chayanna";11;0;100
394;223;"chayanne";617;63.8573743922204;36.1426256077796
1564;278;"chayce";1842;84.9077090119435;15.0922909880565
271;6;"chayden";277;97.8339350180505;2.16606498194946
5;0;"chaydon";5;100;0
0;50;"chaye";50;0;100
0;51;"chayenne";51;0;100
0;77;"chayil";77;0;100
97;0;"chayim";97;100;0
0;919;"chayla";919;0;100
0;177;"chaylee";177;0;100
0;27;"chaylen";27;0;100
0;27;"chaylene";27;0;100
0;33;"chaylin";33;0;100
0;6;"chaylyn";6;0;100
0;5;"chaylynn";5;0;100
0;192;"chayna";192;0;100
54;0;"chaynce";54;100;0
240;25;"chayne";265;90.5660377358491;9.43396226415094
0;5;"chaynee";5;0;100
0;5;"chayni";5;0;100
1874;780;"chayse";2654;70.6103993971364;29.3896006028636
94;0;"chaysen";94;100;0
166;0;"chayson";166;100;0
7;0;"chaysten";7;100;0
14;0;"chayston";14;100;0
24;0;"chayten";24;100;0
1554;6;"chayton";1560;99.6153846153846;0.384615384615385
5;0;"chayzen";5;100;0
9341;160;"chaz";9501;98.3159667403431;1.68403325965688
6;0;"chazaray";6;100;0
5;0;"chazden";5;100;0
187;0;"chaze";187;100;0
0;56;"chazity";56;0;100
0;103;"chazlyn";103;0;100
0;30;"chazlynn";30;0;100
7;0;"chazman";7;100;0
0;57;"chazmin";57;0;100
0;35;"chazmine";35;0;100
13;0;"chazmon";13;100;0
5;0;"chazten";5;100;0
15;0;"chazton";15;100;0
1257;29;"chazz";1286;97.7449455676516;2.25505443234837
1969;364;"che";2333;84.3977711101586;15.6022288898414
15;80;"chea";95;15.7894736842105;84.2105263157895
0;18;"chealse";18;0;100
0;225;"chealsea";225;0;100
0;128;"chealsey";128;0;100
0;44;"chealsie";44;0;100
0;37;"chealsy";37;0;100
39;0;"ched";39;100;0
20;0;"chedrick";20;100;0
0;35;"chedva";35;0;100
325;209;"chee";534;60.8614232209738;39.1385767790262
46;0;"cheemeng";46;100;0
0;41;"cheena";41;0;100
26;0;"cheenou";26;100;0
5;0;"cheenue";5;100;0
0;5;"cheerful";5;0;100
0;81;"cheetara";81;0;100
145;0;"cheick";145;100;0
335;0;"cheikh";335;100;0
0;121;"cheila";121;0;100
0;7;"cheilon";7;0;100
0;5;"cheire";5;0;100
0;10;"cheisa";10;0;100
0;22;"cheisea";22;0;100
0;5;"chejuana";5;0;100
0;151;"chekesha";151;0;100
0;11;"cheketa";11;0;100
0;15;"chekita";15;0;100
0;474;"chela";474;0;100
0;72;"chelan";72;0;100
0;11;"chelbe";11;0;100
0;129;"chelbi";129;0;100
0;109;"chelbie";109;0;100
0;499;"chelby";499;0;100
0;58;"chelce";58;0;100
0;67;"chelcea";67;0;100
0;238;"chelcee";238;0;100
0;152;"chelcey";152;0;100
0;236;"chelci";236;0;100
0;20;"chelcia";20;0;100
0;763;"chelcie";763;0;100
0;183;"chelcy";183;0;100
0;86;"chele";86;0;100
0;13;"chelea";13;0;100
0;16;"chelena";16;0;100
0;22;"chelene";22;0;100
0;180;"chelesa";180;0;100
0;46;"chelese";46;0;100
0;66;"chelesea";66;0;100
0;6;"chelesy";6;0;100
0;16;"chelette";16;0;100
0;10;"cheli";10;0;100
0;12;"chelia";12;0;100
0;96;"chelisa";96;0;100
0;192;"chelise";192;0;100
0;37;"chelita";37;0;100
0;120;"chella";120;0;100
0;342;"chelle";342;0;100
0;18;"chelley";18;0;100
0;86;"chelli";86;0;100
0;171;"chellie";171;0;100
0;141;"chellsea";141;0;100
0;5;"chellsee";5;0;100
0;52;"chellsey";52;0;100
0;70;"chellsie";70;0;100
0;152;"chelly";152;0;100
0;5;"chelon";5;0;100
0;5;"chelonda";5;0;100
0;1107;"chelsa";1107;0;100
0;386;"chelsae";386;0;100
0;49;"chelsay";49;0;100
0;838;"chelse";838;0;100
447;158393;"chelsea";158840;0.281415260639637;99.7185847393604
0;29;"chelseaann";29;0;100
0;10;"chelseaanne";10;0;100
0;5;"chelsealynn";5;0;100
0;21;"chelseamarie";21;0;100
0;12;"chelseay";12;0;100
0;1723;"chelsee";1723;0;100
0;161;"chelsei";161;0;100
0;5;"chelsen";5;0;100
65;31068;"chelsey";31133;0.208781678604696;99.7912183213953
0;3998;"chelsi";3998;0;100
0;386;"chelsia";386;0;100
0;13649;"chelsie";13649;0;100
0;6;"chelssie";6;0;100
0;11;"chelssy";11;0;100
0;3131;"chelsy";3131;0;100
0;114;"chelsye";114;0;100
16;0;"chelton";16;100;0
0;15;"cheltzie";15;0;100
0;37;"chely";37;0;100
0;5;"chelyn";5;0;100
0;21;"chelynne";21;0;100
0;6;"chelzie";6;0;100
0;23;"chemaine";23;0;100
0;5;"chemane";5;0;100
34;0;"chemar";34;100;0
0;82;"chemeka";82;0;100
0;17;"chemene";17;0;100
0;79;"chemere";79;0;100
0;73;"chemika";73;0;100
0;43;"chemise";43;0;100
156;52;"chen";208;75;25
0;150;"chena";150;0;100
0;110;"chenae";110;0;100
0;6;"chenavia";6;0;100
0;61;"chenay";61;0;100
0;23;"chenda";23;0;100
0;9;"chendra";9;0;100
11;64;"chene";75;14.6666666666667;85.3333333333333
0;23;"chenea";23;0;100
0;59;"chenee";59;0;100
0;6;"cheneka";6;0;100
0;83;"chenel";83;0;100
0;5;"chenele";5;0;100
0;256;"chenell";256;0;100
0;797;"chenelle";797;0;100
0;42;"chenequa";42;0;100
0;10;"chenese";10;0;100
119;208;"cheney";327;36.3914373088685;63.6085626911315
611;38;"cheng";649;94.1448382126348;5.85516178736518
5;0;"chengyu";5;100;0
0;10;"chenia";10;0;100
0;37;"chenice";37;0;100
0;9;"cheniece";9;0;100
20;0;"chenier";20;100;0
0;81;"chenika";81;0;100
0;207;"chenille";207;0;100
0;29;"chenin";29;0;100
0;59;"cheniqua";59;0;100
0;42;"chenique";42;0;100
0;289;"chenise";289;0;100
0;376;"chenita";376;0;100
0;34;"cheniya";34;0;100
0;62;"chennel";62;0;100
0;5;"chennell";5;0;100
0;10;"chennelle";10;0;100
0;1633;"chenoa";1633;0;100
0;69;"chenoah";69;0;100
0;15;"chentel";15;0;100
0;10;"chenxi";10;0;100
5;0;"chenyu";5;100;0
108;0;"cheo";108;100;0
0;5;"chequetta";5;0;100
0;325;"chequita";325;0;100
110;1694;"cher";1804;6.09756097560976;93.9024390243902
0;468;"chera";468;0;100
0;183;"cherae";183;0;100
0;11;"cherakee";11;0;100
0;72;"cheral";72;0;100
0;6;"cheralee";6;0;100
0;144;"cheralyn";144;0;100
0;46;"cheramie";46;0;100
0;128;"cheray";128;0;100
0;1347;"chere";1347;0;100
0;17;"cherea";17;0;100
0;42;"cherece";42;0;100
0;2048;"cheree";2048;0;100
0;26;"chereen";26;0;100
0;101;"chereese";101;0;100
0;37;"chereka";37;0;100
0;21;"cherel";21;0;100
0;394;"cherell";394;0;100
0;1669;"cherelle";1669;0;100
0;19;"cherelyn";19;0;100
0;18;"cherena";18;0;100
0;184;"cherene";184;0;100
0;108;"cheresa";108;0;100
0;757;"cherese";757;0;100
0;24;"cheresse";24;0;100
0;5;"cheretta";5;0;100
0;15;"cherette";15;0;100
0;8;"cherhonda";8;0;100
12;36016;"cheri";36028;0.0333074275563451;99.9666925724436
0;199;"cheria";199;0;100
0;5;"cheriah";5;0;100
0;5;"cheriann";5;0;100
0;10;"cherianne";10;0;100
0;132;"cherica";132;0;100
0;1136;"cherice";1136;0;100
0;6;"chericka";6;0;100
0;28;"cherida";28;0;100
0;106;"cheridan";106;0;100
0;5;"cheridyn";5;0;100
26;29848;"cherie";29874;0.0870322019147084;99.9129677980853
0;6;"cheriece";6;0;100
0;14;"cheriese";14;0;100
24;0;"cherif";24;100;0
0;286;"cherika";286;0;100
0;231;"cheril";231;0;100
0;23;"cherilee";23;0;100
0;5;"cherill";5;0;100
0;2359;"cherilyn";2359;0;100
0;216;"cherilynn";216;0;100
0;16;"cherin";16;0;100
0;210;"cherina";210;0;100
0;132;"cherine";132;0;100
0;149;"cheris";149;0;100
0;178;"cherisa";178;0;100
0;4459;"cherise";4459;0;100
0;9584;"cherish";9584;0;100
0;6;"cherisha";6;0;100
0;161;"cherissa";161;0;100
0;1064;"cherisse";1064;0;100
0;1051;"cherita";1051;0;100
0;531;"cherith";531;0;100
0;229;"cherity";229;0;100
0;383;"cherl";383;0;100
0;15;"cherle";15;0;100
0;50;"cherlene";50;0;100
5;0;"cherles";5;100;0
0;55;"cherlin";55;0;100
0;12;"cherline";12;0;100
0;5;"cherlonda";5;0;100
0;989;"cherly";989;0;100
0;6;"cherlyl";6;0;100
0;1870;"cherlyn";1870;0;100
0;255;"cherlynn";255;0;100
0;178;"chermaine";178;0;100
0;8;"chermeka";8;0;100
6;0;"cherod";6;100;0
332;2384;"cherokee";2716;12.2238586156112;87.7761413843888
0;17;"cherol";17;0;100
0;60;"cherolyn";60;0;100
99;635;"cheron";734;13.4877384196185;86.5122615803815
0;164;"cheronda";164;0;100
0;7;"cherone";7;0;100
0;17;"cherra";17;0;100
0;75;"cherre";75;0;100
0;53;"cherree";53;0;100
0;32;"cherrel";32;0;100
0;433;"cherrell";433;0;100
0;848;"cherrelle";848;0;100
0;4143;"cherri";4143;0;100
0;10;"cherrica";10;0;100
0;32;"cherrice";32;0;100
0;4304;"cherrie";4304;0;100
0;61;"cherril";61;0;100
0;173;"cherrill";173;0;100
0;10;"cherrilyn";10;0;100
0;5;"cherrilynn";5;0;100
0;105;"cherrise";105;0;100
0;518;"cherrish";518;0;100
0;5;"cherrisse";5;0;100
0;47;"cherrita";47;0;100
5;317;"cherron";322;1.5527950310559;98.4472049689441
0;5;"cherronda";5;0;100
135;11162;"cherry";11297;1.19500752412145;98.8049924758785
0;5;"cherryann";5;0;100
0;18;"cherrye";18;0;100
0;1757;"cherryl";1757;0;100
0;22;"cherryle";22;0;100
0;10;"cherryll";10;0;100
0;29;"cherub";29;0;100
0;10;"chervon";10;0;100
0;7;"chervonne";7;0;100
0;567;"chery";567;0;100
0;153;"cheryal";153;0;100
0;44;"cheryce";44;0;100
0;76;"cherye";76;0;100
0;89;"cheryel";89;0;100
980;439135;"cheryl";440115;0.222669075128092;99.7773309248719
0;5;"cheryla";5;0;100
0;12;"cherylan";12;0;100
0;1011;"cherylann";1011;0;100
0;79;"cherylanne";79;0;100
0;5475;"cheryle";5475;0;100
0;129;"cherylee";129;0;100
0;330;"cherylene";330;0;100
0;66;"cherylin";66;0;100
0;2629;"cheryll";2629;0;100
0;43;"cherylle";43;0;100
0;11;"cheryllee";11;0;100
0;6;"cheryllyn";6;0;100
0;69;"cheryllynn";69;0;100
0;5;"cheryllynne";5;0;100
0;226;"cheryln";226;0;100
0;378;"cherylyn";378;0;100
0;209;"cherylynn";209;0;100
0;193;"cheryn";193;0;100
0;21;"cheryse";21;0;100
0;157;"cherysh";157;0;100
10;0;"ches";10;100;0
0;32;"chesa";32;0;100
0;5;"chesica";5;0;100
0;11;"cheska";11;0;100
480;0;"cheskel";480;100;0
250;0;"chesky";250;100;0
0;45;"cheslea";45;0;100
10;11;"chesleigh";21;47.6190476190476;52.3809523809524
2157;574;"chesley";2731;78.9820578542658;21.0179421457342
0;28;"cheslie";28;0;100
0;45;"chesna";45;0;100
0;183;"chesnee";183;0;100
121;2053;"chesney";2174;5.56577736890524;94.4342226310948
0;63;"chesni";63;0;100
0;162;"chesnie";162;0;100
24;0;"chess";24;100;0
0;408;"chessa";408;0;100
0;86;"chessica";86;0;100
0;571;"chessie";571;0;100
6;0;"chesten";6;100;0
114855;809;"chester";115664;99.3005602434638;0.699439756536174
34;0;"chesterfield";34;100;0
0;22;"chesterine";22;0;100
6;0;"chestin";6;100;0
0;115;"chestina";115;0;100
5;307;"chestine";312;1.6025641025641;98.3974358974359
25;0;"chestley";25;100;0
796;0;"cheston";796;100;0
5687;0;"chet";5687;100;0
416;0;"chetan";416;100;0
0;23;"chetana";23;0;100
6;0;"chetanna";6;100;0
0;73;"chetara";73;0;100
5;0;"chethan";5;100;0
264;0;"chett";264;100;0
6;0;"cheval";6;100;0
0;6;"chevala";6;0;100
27;0;"chevalier";27;100;0
23;0;"chevas";23;100;0
0;6;"chevaun";6;0;100
0;21;"chevell";21;0;100
0;67;"chevella";67;0;100
191;2534;"chevelle";2725;7.00917431192661;92.9908256880734
0;113;"chevette";113;0;100
110;0;"cheveyo";110;100;0
69;0;"chevez";69;100;0
0;80;"chevi";80;0;100
17;64;"chevie";81;20.9876543209877;79.0123456790123
264;11;"chevis";275;96;4
63;555;"chevon";618;10.1941747572816;89.8058252427185
0;11;"chevonda";11;0;100
0;11;"chevone";11;0;100
0;602;"chevonne";602;0;100
2717;567;"chevy";3284;82.7344701583435;17.2655298416565
5;0;"chew";5;100;0
76;72;"chey";148;51.3513513513513;48.6486486486487
0;132;"cheyan";132;0;100
0;48;"cheyana";48;0;100
0;173;"cheyane";173;0;100
0;1616;"cheyann";1616;0;100
0;1431;"cheyanna";1431;0;100
0;14677;"cheyanne";14677;0;100
0;145;"cheyeanne";145;0;100
0;5;"cheyeene";5;0;100
22;720;"cheyene";742;2.96495956873315;97.0350404312669
0;15;"cheyenn";15;0;100
0;715;"cheyenna";715;0;100
2647;66272;"cheyenne";68919;3.84074057952089;96.1592594204791
0;318;"cheyla";318;0;100
0;20;"cheylee";20;0;100
0;5;"cheylin";5;0;100
0;5;"cheylyn";5;0;100
0;52;"cheylynn";52;0;100
0;124;"cheyna";124;0;100
903;115;"cheyne";1018;88.7033398821218;11.2966601178782
5;28;"cheyney";33;15.1515151515152;84.8484848484848
0;249;"cheynne";249;0;100
0;159;"cheyrl";159;0;100
25;0;"cheyton";25;100;0
108;27;"chez";135;80;20
0;33;"cheza";33;0;100
9;6;"chezarae";15;60;40
5;0;"chezaray";5;100;0
15;5;"chezare";20;75;25
11;0;"chezkel";11;100;0
7;0;"chezky";7;100;0
0;158;"chezney";158;0;100
0;21;"cheznie";21;0;100
460;595;"chi";1055;43.6018957345972;56.3981042654028
69;214;"chia";283;24.3816254416961;75.6183745583039
6;0;"chiagoziem";6;100;0
0;22;"chiaki";22;0;100
21;0;"chiam";21;100;0
0;491;"chiamaka";491;0;100
0;5;"chiamanda";5;0;100
0;5;"chian";5;0;100
0;215;"chiana";215;0;100
0;56;"chiane";56;0;100
0;5;"chiani";5;0;100
0;120;"chiann";120;0;100
0;117;"chianna";117;0;100
0;355;"chianne";355;0;100
5;74;"chiante";79;6.32911392405063;93.6708860759494
20;388;"chianti";408;4.90196078431373;95.0980392156863
0;4254;"chiara";4254;0;100
0;5;"chiarra";5;0;100
128;0;"chibueze";128;100;0
110;0;"chibuike";110;100;0
110;0;"chibuikem";110;100;0
16;0;"chibuzo";16;100;0
5;0;"chibuzor";5;100;0
11;0;"chic";11;100;0
41;0;"chicago";41;100;0
77;0;"chick";77;100;0
940;0;"chico";940;100;0
0;5;"chicora";5;0;100
0;63;"chicquita";63;0;100
5;0;"chidalu";5;100;0
178;365;"chidera";543;32.780847145488;67.219152854512
190;0;"chidi";190;100;0
76;0;"chidiebere";76;100;0
16;0;"chidiebube";16;100;0
0;11;"chidima";11;0;100
0;41;"chidimma";41;0;100
0;279;"chidinma";279;0;100
58;0;"chidozie";58;100;0
260;0;"chidubem";260;100;0
0;5;"chidumebi";5;0;100
0;32;"chie";32;0;100
6;0;"chiebuka";6;100;0
29;0;"chiedozie";29;100;0
5;0;"chiedu";5;100;0
116;0;"chief";116;100;0
0;293;"chieko";293;0;100
6;0;"chiem";6;100;0
20;0;"chiemeka";20;100;0
0;14;"chiemela";14;0;100
6;0;"chiemerie";6;100;0
0;5;"chiemi";5;0;100
5;0;"chien";5;100;0
0;5;"chierika";5;0;100
0;469;"chiffon";469;0;100
128;6;"chigozie";134;95.5223880597015;4.47761194029851
19;6;"chigozirim";25;76;24
6;0;"chih";6;100;0
0;110;"chihiro";110;0;100
112;0;"chijioke";112;100;0
28;337;"chika";365;7.67123287671233;92.3287671232877
0;31;"chikaima";31;0;100
0;5;"chikamara";5;0;100
31;25;"chikamso";56;55.3571428571429;44.6428571428571
0;12;"chikara";12;0;100
164;0;"chike";164;100;0
0;11;"chiketa";11;0;100
22;0;"chikezie";22;100;0
0;92;"chikita";92;0;100
78;53;"child";131;59.5419847328244;40.4580152671756
0;6;"childnotnamed";6;0;100
201;0;"chilton";201;100;0
0;5;"chilyn";5;0;100
272;0;"chima";272;100;0
0;5;"chimamaka";5;0;100
0;207;"chimamanda";207;0;100
59;0;"chimaobi";59;100;0
10;0;"chimaobim";10;100;0
7;0;"chimdi";7;100;0
0;15;"chimeka";15;0;100
0;223;"chimene";223;0;100
20;0;"chimeng";20;100;0
0;41;"chimera";41;0;100
5;824;"chimere";829;0.60313630880579;99.3968636911942
5;0;"chimereze";5;100;0
0;11;"chimira";11;0;100
53;0;"chin";53;100;0
10;4491;"china";4501;0.222172850477672;99.7778271495223
0;71;"chinara";71;0;100
0;36;"chinasa";36;0;100
0;65;"chinaza";65;0;100
0;39;"chinda";39;0;100
369;0;"chinedu";369;100;0
65;0;"chinedum";65;100;0
0;11;"chineka";11;0;100
0;27;"chinelle";27;0;100
5;131;"chinelo";136;3.67647058823529;96.3235294117647
0;5;"chineme";5;0;100
38;5;"chinemerem";43;88.3720930232558;11.6279069767442
0;176;"chinenye";176;0;100
0;11;"chinere";11;0;100
0;5;"chinesta";5;0;100
0;5;"chinester";5;0;100
0;5;"chineta";5;0;100
0;20;"chinetta";20;0;100
0;5;"chineye";5;0;100
84;30;"ching";114;73.6842105263158;26.3157894736842
19;0;"chinh";19;100;0
0;19;"chinika";19;0;100
0;86;"chiniqua";86;0;100
0;263;"chinita";263;0;100
0;5;"chinitta";5;0;100
152;0;"chinmay";152;100;0
0;67;"chinmayi";67;0;100
0;38;"chinna";38;0;100
112;0;"chino";112;100;0
5;0;"chinomso";5;100;0
78;0;"chinonso";78;100;0
0;11;"chinonye";11;0;100
11;0;"chinou";11;100;0
5;0;"chintan";5;100;0
15;0;"chinua";15;100;0
0;16;"chinue";16;0;100
0;148;"chinwe";148;0;100
0;16;"chinwendu";16;0;100
0;562;"chinyere";562;0;100
86;0;"chioke";86;100;0
0;822;"chioma";822;0;100
3159;0;"chip";3159;100;0
302;0;"chipper";302;100;0
0;6;"chiquana";6;0;100
0;26;"chiqueta";26;0;100
0;71;"chiquetta";71;0;100
0;5;"chiquia";5;0;100
0;18;"chiquila";18;0;100
6;6216;"chiquita";6222;0.0964320154291225;99.9035679845709
0;5;"chiquitha";5;0;100
0;8;"chiquitia";8;0;100
0;168;"chiquitta";168;0;100
0;12;"chiquta";12;0;100
0;17;"chira";17;0;100
13;0;"chiraag";13;100;0
661;0;"chirag";661;100;0
0;5;"chirelle";5;0;100
0;5;"chiriga";5;0;100
5;0;"chirles";5;100;0
0;5;"chirley";5;0;100
51;5;"chiron";56;91.0714285714286;8.92857142857143
12;0;"chirs";12;100;0
10;0;"chirstian";10;100;0
0;313;"chirstina";313;0;100
0;117;"chirstine";117;0;100
1051;0;"chirstopher";1051;100;0
0;85;"chirsty";85;0;100
0;206;"chisa";206;0;100
0;5;"chisara";5;0;100
0;34;"chisato";34;0;100
11;0;"chisholm";11;100;0
0;5;"chisimdi";5;0;100
165;399;"chisom";564;29.2553191489362;70.7446808510638
219;0;"chistian";219;100;0
0;5;"chistie";5;0;100
0;282;"chistina";282;0;100
0;68;"chistine";68;0;100
1430;0;"chistopher";1430;100;0
0;5;"chisty";5;0;100
72;0;"chisum";72;100;0
0;47;"chitara";47;0;100
0;5;"chitina";5;0;100
0;6;"chitose";6;0;100
0;33;"chitra";33;0;100
134;0;"chivas";134;100;0
0;207;"chivon";207;0;100
0;130;"chivonne";130;0;100
0;18;"chiya";18;0;100
0;11;"chiye";11;0;100
0;138;"chiyeko";138;0;100
0;130;"chiyo";130;0;100
0;5;"chiyoka";5;0;100
0;544;"chiyoko";544;0;100
0;14;"chiyono";14;0;100
0;149;"chizara";149;0;100
11;173;"chizaram";184;5.97826086956522;94.0217391304348
0;11;"chizitelu";11;0;100
0;11;"chizitere";11;0;100
0;16;"chiziterem";16;0;100
0;14;"chizoba";14;0;100
0;5;"chizu";5;0;100
0;11;"chizue";11;0;100
0;169;"chizuko";169;0;100
0;6;"chlo";6;0;100
0;26;"chloa";26;0;100
308;195417;"chloe";195725;0.157363647975476;99.8426363520245
0;94;"chloeann";94;0;100
0;61;"chloeanne";61;0;100
0;1569;"chloee";1569;0;100
0;14;"chloegrace";14;0;100
0;6;"chloeigh";6;0;100
0;6;"chloejane";6;0;100
0;34;"chloelynn";34;0;100
0;11;"chloemae";11;0;100
0;58;"chloemarie";58;0;100
0;1077;"chloey";1077;0;100
0;43;"chloi";43;0;100
0;1421;"chloie";1421;0;100
0;119;"chlora";119;0;100
0;27;"chlorene";27;0;100
0;10;"chlorine";10;0;100
0;225;"chloris";225;0;100
0;26;"chloye";26;0;100
205;5;"choice";210;97.6190476190476;2.38095238095238
17;0;"chol";17;100;0
0;1606;"chole";1606;0;100
0;5;"cholena";5;0;100
266;0;"chon";266;100;0
0;37;"chona";37;0;100
0;189;"chonda";189;0;100
0;218;"chondra";218;0;100
336;228;"chong";564;59.5744680851064;40.4255319148936
0;213;"chonita";213;0;100
0;10;"chonna";10;0;100
0;17;"chontae";17;0;100
0;58;"chonte";58;0;100
0;62;"chontel";62;0;100
0;16;"chontell";16;0;100
0;5;"chontelle";5;0;100
59;0;"chord";59;100;0
0;6;"chorlette";6;0;100
98;35;"chosen";133;73.6842105263158;26.3157894736842
6;0;"chosyn";6;100;0
60;0;"chou";60;100;0
86;390;"choua";476;18.0672268907563;81.9327731092437
73;16;"choya";89;82.0224719101124;17.9775280898876
42;33;"choyce";75;56;44
44;0;"chozen";44;100;0
0;5;"chquita";5;0;100
0;10;"chree";10;0;100
0;6;"chrie";6;0;100
142744;22899;"chris";165643;86.1756910947037;13.8243089052963
0;92;"chrisa";92;0;100
0;12;"chrisalyn";12;0;100
0;5;"chrisalynn";5;0;100
0;6;"chrisan";6;0;100
5;0;"chrisander";5;100;0
0;283;"chrisandra";283;0;100
85;0;"chrisangel";85;100;0
0;440;"chrisann";440;0;100
0;80;"chrisanna";80;0;100
0;287;"chrisanne";287;0;100
0;5;"chrisanthe";5;0;100
0;5;"chrisanthi";5;0;100
17;0;"chrisanthony";17;100;0
5;0;"chrisaun";5;100;0
146;0;"chrisean";146;100;0
0;5;"chrisel";5;0;100
0;304;"chriselda";304;0;100
0;32;"chriselle";32;0;100
0;414;"chrisette";414;0;100
0;119;"chrisha";119;0;100
5;0;"chrishad";5;100;0
0;12;"chrishae";12;0;100
0;113;"chrishana";113;0;100
0;13;"chrishanda";13;0;100
0;42;"chrishanna";42;0;100
5;0;"chrishaud";5;100;0
252;5;"chrishaun";257;98.0544747081712;1.94552529182879
0;73;"chrishauna";73;0;100
0;5;"chrishaunda";5;0;100
500;48;"chrishawn";548;91.2408759124088;8.75912408759124
0;81;"chrishawna";81;0;100
0;10;"chrishay";10;0;100
0;11;"chrishayla";11;0;100
0;5;"chrishea";5;0;100
0;38;"chrishell";38;0;100
0;145;"chrishelle";145;0;100
0;5;"chrishiya";5;0;100
0;5;"chrishna";5;0;100
208;0;"chrishon";208;100;0
0;5;"chrishona";5;0;100
0;135;"chrishonda";135;0;100
0;12;"chrishonna";12;0;100
62;0;"chrishun";62;100;0
0;5;"chrishya";5;0;100
0;16;"chrisi";16;0;100
0;230;"chrisie";230;0;100
0;10;"chrisina";10;0;100
0;5;"chrisinda";5;0;100
0;15;"chrisine";15;0;100
8;0;"chrisitan";8;100;0
0;5;"chrisitne";5;0;100
0;12;"chrisiyah";12;0;100
0;32;"chrisley";32;0;100
0;5;"chrisly";5;0;100
0;533;"chrislyn";533;0;100
0;321;"chrislynn";321;0;100
0;119;"chrisma";119;0;100
6;10;"chrisna";16;37.5;62.5
757;0;"chrisopher";757;100;0
108;0;"chrisotpher";108;100;0
0;98;"chrisoula";98;0;100
15;0;"chrispher";15;100;0
10;0;"chrispin";10;100;0
459;150;"chriss";609;75.3694581280788;24.6305418719212
0;667;"chrissa";667;0;100
0;52;"chrissandra";52;0;100
10;0;"chrissean";10;100;0
0;22;"chrissette";22;0;100
0;31;"chrissey";31;0;100
34;0;"chrisshawn";34;100;0
0;76;"chrissi";76;0;100
0;6;"chrissiana";6;0;100
0;1068;"chrissie";1068;0;100
0;4236;"chrissy";4236;0;100
3371;52;"christ";3423;98.4808647385334;1.51913526146655
27;32560;"christa";32587;0.0828551262773499;99.9171448737226
0;661;"christabel";661;0;100
0;60;"christabell";60;0;100
0;158;"christabella";158;0;100
0;242;"christabelle";242;0;100
29;0;"christafer";29;100;0
2037;305;"christain";2342;86.9769427839453;13.0230572160547
0;9589;"christal";9589;0;100
0;5;"christale";5;0;100
0;17;"christalle";17;0;100
0;288;"christalyn";288;0;100
0;51;"christalynn";51;0;100
1459;1366;"christan";2825;51.646017699115;48.353982300885
0;219;"christana";219;0;100
0;6;"christann";6;0;100
0;36;"christanna";36;0;100
0;22;"christany";22;0;100
691;0;"christapher";691;100;0
6;0;"christaphor";6;100;0
0;5;"christasha";5;0;100
0;136;"christasia";136;0;100
0;331;"christe";331;0;100
0;167;"christean";167;0;100
0;6;"christeanna";6;0;100
0;180;"christee";180;0;100
0;2667;"christeen";2667;0;100
0;274;"christeena";274;0;100
0;3644;"christel";3644;0;100
0;6;"christela";6;0;100
0;465;"christell";465;0;100
0;682;"christella";682;0;100
0;940;"christelle";940;0;100
2045;11395;"christen";13440;15.2157738095238;84.7842261904762
0;2466;"christena";2466;0;100
0;4892;"christene";4892;0;100
0;11;"christenia";11;0;100
286;0;"christepher";286;100;0
5;0;"christer";5;100;0
30;0;"christerfer";30;100;0
276;0;"christerpher";276;100;0
8;0;"christerphor";8;100;0
0;40;"christey";40;0;100
46;0;"christhian";46;100;0
88;0;"christhoper";88;100;0
41;0;"christhopher";41;100;0
22;20859;"christi";20881;0.105358938748144;99.8946410612519
82;725;"christia";807;10.1610904584882;89.8389095415118
851;0;"christiaan";851;100;0
5;0;"christiam";5;100;0
406919;19352;"christian";426271;95.4601650123982;4.53983498760178
0;9892;"christiana";9892;0;100
0;6;"christianah";6;0;100
5;0;"christianalexan";5;100;0
12;0;"christiananthon";12;100;0
7;0;"christiandaniel";7;100;0
6;2236;"christiane";2242;0.267618198037467;99.7323818019625
22;0;"christianjacob";22;100;0
136;0;"christianjames";136;100;0
10;0;"christianjay";10;100;0
17;0;"christianjohn";17;100;0
22;0;"christianjoseph";22;100;0
5;0;"christianjoshua";5;100;0
11;0;"christianmichae";11;100;0
0;308;"christiann";308;0;100
0;2886;"christianna";2886;0;100
0;1423;"christianne";1423;0;100
611;0;"christiano";611;100;0
13;0;"christianpaul";13;100;0
5;0;"christianson";5;100;0
873;45575;"christie";46448;1.87952118498105;98.1204788150189
0;6;"christieann";6;0;100
0;5;"christielee";5;0;100
898;136;"christien";1034;86.8471953578337;13.1528046421663
0;6;"christiene";6;0;100
0;40;"christienne";40;0;100
179;0;"christifer";179;100;0
984;11108;"christin";12092;8.13761164406219;91.8623883559378
1987;472785;"christina";474772;0.418516677478874;99.5814833225211
0;163;"christinamarie";163;0;100
2030;580379;"christine";582409;0.348552306025491;99.6514476939745
0;92;"christinea";92;0;100
0;5;"christineanne";5;0;100
0;26;"christinejoy";26;0;100
0;26;"christinemarie";26;0;100
0;5;"christing";5;0;100
0;1284;"christinia";1284;0;100
0;75;"christinna";75;0;100
62;0;"christino";62;100;0
1148;17;"christion";1165;98.5407725321888;1.45922746781116
0;102;"christiona";102;0;100
0;97;"christionna";97;0;100
35;0;"christiopher";35;100;0
620;0;"christipher";620;100;0
0;22;"christiyana";22;0;100
0;61;"christl";61;0;100
0;526;"christle";526;0;100
0;31;"christlyn";31;0;100
0;11;"christlynn";11;0;100
0;154;"christmas";154;0;100
0;105;"christna";105;0;100
0;60;"christne";60;0;100
576;0;"christo";576;100;0
742;0;"christobal";742;100;0
0;37;"christobel";37;0;100
59;0;"christof";59;100;0
3607;0;"christofer";3607;100;0
49;0;"christoff";49;100;0
717;0;"christoffer";717;100;0
25;0;"christofher";25;100;0
1090;0;"christoher";1090;100;0
424;0;"christohper";424;100;0
13;0;"christohpher";13;100;0
0;243;"christol";243;0;100
0;6;"christola";6;0;100
1108;231;"christon";1339;82.7483196415235;17.2516803584765
6;0;"christoopher";6;100;0
1082;0;"christop";1082;100;0
15;0;"christopehr";15;100;0
3127;0;"christoper";3127;100;0
1073;0;"christoph";1073;100;0
4538;0;"christophe";4538;100;0
9;0;"christophel";9;100;0
28;0;"christophen";28;100;0
2012435;9463;"christopher";2021898;99.5319744121612;0.468025587838753
6;0;"christopheranth";6;100;0
5;0;"christopherdavi";5;100;0
189;0;"christophere";189;100;0
103;0;"christopherjame";103;100;0
118;0;"christopherjohn";118;100;0
22;0;"christopherjose";22;100;0
5;0;"christopherjr";5;100;0
32;0;"christopherlee";32;100;0
52;0;"christophermich";52;100;0
5;0;"christopherpaul";5;100;0
11;0;"christopherryan";11;100;0
537;0;"christophor";537;100;0
403;0;"christophr";403;100;0
13;0;"christopoher";13;100;0
176;0;"christorpher";176;100;0
2604;0;"christos";2604;100;0
47;0;"christoval";47;100;0
1305;0;"christpher";1305;100;0
261;0;"christphor";261;100;0
61;0;"christpoher";61;100;0
315;0;"christropher";315;100;0
1922;98075;"christy";99997;1.92205766172985;98.0779423382701
273;5;"christyan";278;98.2014388489209;1.79856115107914
0;211;"christyana";211;0;100
0;68;"christyann";68;0;100
0;99;"christyanna";99;0;100
0;32;"christye";32;0;100
0;142;"christyl";142;0;100
0;8;"christyle";8;0;100
0;5;"christylee";5;0;100
6;1016;"christyn";1022;0.587084148727984;99.412915851272
0;388;"christyna";388;0;100
0;241;"christyne";241;0;100
0;10;"christyonna";10;0;100
0;216;"chrisy";216;0;100
7;0;"chritian";7;100;0
0;48;"chritina";48;0;100
0;8;"chritine";8;0;100
341;0;"chritopher";341;100;0
198;0;"chrles";198;100;0
22;0;"chrostopher";22;100;0
0;25;"chrsitina";25;0;100
0;11;"chrsitine";11;0;100
176;0;"chrsitopher";176;100;0
0;38;"chrstina";38;0;100
0;11;"chrstine";11;0;100
74;0;"chrstopher";74;100;0
0;22;"chryel";22;0;100
0;261;"chryl";261;0;100
21;194;"chrys";215;9.76744186046512;90.2325581395349
0;94;"chrysa";94;0;100
11;0;"chrysander";11;100;0
0;12;"chrysanne";12;0;100
0;30;"chrysanthe";30;0;100
0;32;"chrysanthemum";32;0;100
0;6;"chrysanthia";6;0;100
0;5;"chrysoula";5;0;100
0;21;"chryssa";21;0;100
0;572;"chrysta";572;0;100
5;15637;"chrystal";15642;0.0319652218386396;99.9680347781614
0;5;"chrystalyn";5;0;100
0;11;"chrystan";11;0;100
0;5;"chrysteen";5;0;100
0;77;"chrystel";77;0;100
0;7;"chrystell";7;0;100
0;39;"chrystelle";39;0;100
0;62;"chrysten";62;0;100
0;12;"chrystene";12;0;100
0;50;"chrysti";50;0;100
716;70;"chrystian";786;91.0941475826972;8.9058524173028
0;11;"chrystiana";11;0;100
0;346;"chrystie";346;0;100
0;45;"chrystin";45;0;100
0;585;"chrystina";585;0;100
0;356;"chrystine";356;0;100
0;249;"chrystle";249;0;100
362;0;"chrystopher";362;100;0
5;0;"chrystyan";5;100;0
0;25;"chrystyna";25;0;100
13;0;"chu";13;100;0
0;24;"chua";24;0;100
5;0;"chubasco";5;100;0
5;0;"chubbie";5;100;0
14;0;"chubby";14;100;0
17817;0;"chuck";17817;100;0
616;0;"chuckie";616;100;0
609;0;"chucky";609;100;0
5;76;"chudney";81;6.17283950617284;93.8271604938272
329;5;"chue";334;98.5029940119761;1.49700598802395
5;0;"chuefeng";5;100;0
27;0;"chueyee";27;100;0
10;0;"chuka";10;100;0
12;0;"chukwubuikem";12;100;0
176;0;"chukwudi";176;100;0
5;0;"chukwudubem";5;100;0
121;0;"chukwuebuka";121;100;0
588;0;"chukwuemeka";588;100;0
65;0;"chukwuka";65;100;0
181;0;"chukwuma";181;100;0
13;0;"chukwunonso";13;100;0
5;0;"chuma";5;100;0
0;11;"chumani";11;0;100
0;21;"chumy";21;0;100
98;22;"chun";120;81.6666666666667;18.3333333333333
5;0;"chuna";5;100;0
0;58;"chundra";58;0;100
198;11;"chung";209;94.7368421052632;5.26315789473684
0;5;"chunta";5;0;100
85;0;"chuong";85;100;0
11;0;"church";11;100;0
5;0;"churchel";5;100;0
95;0;"churchill";95;100;0
0;13;"chutney";13;0;100
11;0;"chuy";11;100;0
0;11;"chy";11;0;100
0;128;"chyan";128;0;100
0;10;"chyana";10;0;100
0;95;"chyane";95;0;100
0;896;"chyann";896;0;100
0;313;"chyanna";313;0;100
5;2811;"chyanne";2816;0.177556818181818;99.8224431818182
0;15;"chyeanne";15;0;100
0;5;"chyene";5;0;100
0;5;"chyenna";5;0;100
5;1356;"chyenne";1361;0.367376928728876;99.6326230712711
0;376;"chyla";376;0;100
0;12;"chylah";12;0;100
0;7;"chylar";7;0;100
0;35;"chylee";35;0;100
0;9;"chyleen";9;0;100
52;241;"chyler";293;17.7474402730375;82.2525597269625
0;14;"chyles";14;0;100
0;7;"chylie";7;0;100
0;5;"chylynn";5;0;100
0;5399;"chyna";5399;0;100
0;144;"chynah";144;0;100
0;25;"chynia";25;0;100
0;2220;"chynna";2220;0;100
0;5;"chynthia";5;0;100
0;48;"chyra";48;0;100
0;20;"chyral";20;0;100
0;265;"chyrel";265;0;100
0;28;"chyrell";28;0;100
0;15;"chyrisse";15;0;100
0;312;"chyrl";312;0;100
0;27;"chyrle";27;0;100
0;28;"chyrstal";28;0;100
0;45;"chystal";45;0;100
0;26;"chyvonne";26;0;100
0;70;"cia";70;0;100
0;5;"ciah";5;0;100
0;171;"ciaira";171;0;100
2493;22;"cian";2515;99.1252485089463;0.874751491053678
0;2131;"ciana";2131;0;100
0;5;"cianah";5;0;100
30;0;"cianan";30;100;0
0;48;"ciandra";48;0;100
0;6;"ciane";6;0;100
0;594;"ciani";594;0;100
0;5;"cianie";5;0;100
0;2356;"cianna";2356;0;100
0;19;"ciannah";19;0;100
0;46;"cianne";46;0;100
0;387;"cianni";387;0;100
0;10;"cianny";10;0;100
7;33042;"ciara";33049;0.0211806711246936;99.9788193288753
0;259;"ciarah";259;0;100
1509;30;"ciaran";1539;98.0506822612086;1.94931773879142
0;11;"ciaria";11;0;100
0;3310;"ciarra";3310;0;100
0;81;"ciarrah";81;0;100
0;11;"ciasia";11;0;100
0;10;"ciauna";10;0;100
0;5;"ciboney";5;0;100
51;0;"cicel";51;100;0
0;6;"ciceley";6;0;100
0;2303;"cicely";2303;0;100
1193;0;"cicero";1193;100;0
0;71;"cici";71;0;100
0;87;"cicilia";87;0;100
0;624;"cicily";624;0;100
0;53;"ciclali";53;0;100
0;77;"ciclaly";77;0;100
0;74;"cicley";74;0;100
187;0;"cid";187;100;0
0;11;"cidalia";11;0;100
0;56;"cidnee";56;0;100
17;870;"cidney";887;1.91657271702368;98.0834272829763
0;5;"cidni";5;0;100
0;5;"cidnie";5;0;100
0;11;"cie";11;0;100
0;5;"cieana";5;0;100
0;75;"cieanna";75;0;100
0;528;"cieara";528;0;100
0;247;"ciearra";247;0;100
95;202;"ciel";297;31.986531986532;68.013468013468
0;149;"ciela";149;0;100
0;31;"cielita";31;0;100
0;50;"ciella";50;0;100
0;55;"cielle";55;0;100
39;2725;"cielo";2764;1.410998552822;98.589001447178
0;285;"ciena";285;0;100
0;2117;"cienna";2117;0;100
5;11219;"ciera";11224;0.0445473984319316;99.9554526015681
0;107;"cierah";107;0;100
6;0;"cieran";6;100;0
0;52;"cieria";52;0;100
36;27134;"cierra";27170;0.132499079867501;99.8675009201325
0;282;"cierrah";282;0;100
0;26;"cierre";26;0;100
0;128;"cierria";128;0;100
0;6;"ciersten";6;0;100
0;92;"cigi";92;0;100
0;51;"ciin";51;0;100
0;6;"cija";6;0;100
0;579;"ciji";579;0;100
23;0;"cilas";23;100;0
0;5;"ciley";5;0;100
0;48;"cilia";48;0;100
0;149;"cilicia";149;0;100
0;32;"cilla";32;0;100
871;0;"cillian";871;100;0
5;0;"cilton";5;100;0
0;5;"cimara";5;0;100
42;6;"cimarron";48;87.5;12.5
0;60;"cimberly";60;0;100
0;202;"cimone";202;0;100
0;7;"cimora";7;0;100
15;0;"cin";15;100;0
0;114;"cina";114;0;100
0;49;"cinamon";49;0;100
472;117;"cincere";589;80.1358234295416;19.8641765704584
124;0;"cinch";124;100;0
0;5;"cind";5;0;100
0;4485;"cinda";4485;0;100
0;7;"cindal";7;0;100
0;201;"cinde";201;0;100
0;880;"cindee";880;0;100
0;203;"cindel";203;0;100
0;5;"cindell";5;0;100
0;39;"cinder";39;0;100
0;844;"cinderella";844;0;100
0;13;"cindey";13;0;100
0;7689;"cindi";7689;0;100
0;416;"cindia";416;0;100
0;1022;"cindie";1022;0;100
0;604;"cindra";604;0;100
771;255982;"cindy";256753;0.300288604222735;99.6997113957773
0;5;"cindya";5;0;100
0;15;"cindyann";15;0;100
0;6;"cindye";6;0;100
0;34;"cindylee";34;0;100
0;44;"cindylou";44;0;100
0;303;"cing";303;0;100
0;51;"ciniya";51;0;100
0;48;"ciniyah";48;0;100
0;6;"cinnamin";6;0;100
0;2022;"cinnamon";2022;0;100
327;0;"cinque";327;100;0
62;5;"cinsere";67;92.5373134328358;7.46268656716418
6;5929;"cinthia";5935;0.101095197978096;99.8989048020219
0;1730;"cinthya";1730;0;100
0;851;"cintia";851;0;100
0;5;"cintra";5;0;100
0;141;"cintya";141;0;100
0;6;"cinya";6;0;100
0;79;"cinzia";79;0;100
0;29;"ciomara";29;0;100
27;0;"cion";27;100;0
0;36;"ciona";36;0;100
0;135;"cionna";135;0;100
0;6;"cionne";6;0;100
0;6;"cionni";6;0;100
6;0;"ciprian";6;100;0
0;374;"cipriana";374;0;100
0;5;"ciprianna";5;0;100
2109;0;"cipriano";2109;100;0
0;529;"cira";529;0;100
0;117;"circe";117;0;100
183;157;"cire";340;53.8235294117647;46.1764705882353
5;0;"ciree";5;100;0
0;11;"cirena";11;0;100
0;6;"cirenia";6;0;100
0;47;"ciri";47;0;100
0;150;"ciria";150;0;100
57;0;"ciriaco";57;100;0
0;11;"cirila";11;0;100
20;0;"cirildo";20;100;0
0;16;"cirilla";16;0;100
1075;0;"cirilo";1075;100;0
5;0;"cirino";5;100;0
2239;0;"ciro";2239;100;0
0;5;"cirra";5;0;100
6;0;"cirrus";6;100;0
0;42;"cirsten";42;0;100
716;0;"cisco";716;100;0
0;5;"cisely";5;0;100
0;5;"cissie";5;0;100
0;430;"cissy";430;0;100
0;10;"cita";10;0;100
0;15;"citali";15;0;100
0;32;"citalli";32;0;100
0;5;"citally";5;0;100
0;6;"cithlali";6;0;100
0;41;"cithlaly";41;0;100
0;5;"citialli";5;0;100
0;3581;"citlali";3581;0;100
0;127;"citlalic";127;0;100
0;2172;"citlalli";2172;0;100
0;558;"citlally";558;0;100
0;2525;"citlaly";2525;0;100
0;5;"citori";5;0;100
0;11;"cittlali";11;0;100
0;6;"cittlaly";6;0;100
0;5;"civona";5;0;100
0;27;"ciya";27;0;100
0;5;"ciyah";5;0;100
0;5;"ciyana";5;0;100
0;22;"ciyanna";22;0;100
1130;133;"cj";1263;89.4695170229612;10.5304829770388
37;0;"cjay";37;100;0
34;0;"clabe";34;100;0
5;0;"clabern";5;100;0
27;0;"clabon";27;100;0
85;0;"claborn";85;100;0
0;53;"cladie";53;0;100
0;16;"clady";16;0;100
5;0;"clae";5;100;0
21;0;"claiborn";21;100;0
1189;27;"claiborne";1216;97.7796052631579;2.22039473684211
11586;3976;"clair";15562;74.4505847577432;25.5494152422568
0;1718;"claira";1718;0;100
0;9;"clairabelle";9;0;100
0;6;"clairah";6;0;100
0;5;"clairann";5;0;100
2123;176199;"claire";178322;1.19054295039311;98.8094570496069
0;5;"clairece";5;0;100
0;11;"clairemarie";11;0;100
0;47;"clairene";47;0;100
0;22;"clairese";22;0;100
0;99;"clairessa";99;0;100
0;25;"clairice";25;0;100
0;487;"clairissa";487;0;100
0;17;"clairity";17;0;100
21;0;"clairmont";21;100;0
336;0;"clance";336;100;0
71;23;"clancey";94;75.531914893617;24.468085106383
0;5;"clancie";5;0;100
1179;478;"clancy";1657;71.1526855763428;28.8473144236572
146;0;"clanton";146;100;0
856;230975;"clara";231831;0.369234485465706;99.6307655145343
0;298;"clarabel";298;0;100
0;457;"clarabell";457;0;100
0;42;"clarabella";42;0;100
0;1644;"clarabelle";1644;0;100
0;6;"clarabeth";6;0;100
0;11;"clarah";11;0;100
0;10;"clarajane";10;0;100
0;6;"claraliz";6;0;100
0;189;"claramae";189;0;100
3848;0;"clarance";3848;100;0
0;5;"claranell";5;0;100
0;62;"clarann";62;0;100
0;15;"claranne";15;0;100
0;5;"clararose";5;0;100
0;36;"clarcie";36;0;100
7;0;"clardie";7;100;0
5;0;"clardy";5;100;0
2850;27963;"clare";30813;9.24934280985298;90.750657190147
0;10;"clareatha";10;0;100
0;125;"clarece";125;0;100
0;57;"claree";57;0;100
0;55;"clareen";55;0;100
0;5;"clareese";5;0;100
17;25;"claren";42;40.4761904761905;59.5238095238095
0;10;"clarena";10;0;100
15;0;"clarenc";15;100;0
281618;1794;"clarence";283412;99.3669992801998;0.63300071980015
0;5;"clarencia";5;0;100
0;15;"clarenda";15;0;100
5;0;"clarendon";5;100;0
0;714;"clarene";714;0;100
0;35;"claresa";35;0;100
0;43;"clarese";43;0;100
0;418;"claressa";418;0;100
0;1109;"claretha";1109;0;100
0;924;"claretta";924;0;100
0;12;"clarette";12;0;100
0;56;"claria";56;0;100
0;2665;"claribel";2665;0;100
0;18;"claribell";18;0;100
0;37;"claribelle";37;0;100
0;11;"clarica";11;0;100
96;24388;"clarice";24484;0.392092795294886;99.6079072047051
0;740;"clarie";740;0;100
0;296;"clariece";296;0;100
0;33;"clarina";33;0;100
12;0;"clarince";12;100;0
0;1224;"clarinda";1224;0;100
0;1659;"clarine";1659;0;100
113;10;"clarion";123;91.869918699187;8.13008130081301
77;968;"claris";1045;7.36842105263158;92.6315789473684
0;3012;"clarisa";3012;0;100
0;1148;"clarise";1148;0;100
0;17;"clarisha";17;0;100
21;37495;"clarissa";37516;0.0559761168568078;99.9440238831432
0;1528;"clarisse";1528;0;100
0;69;"clarissia";69;0;100
0;7;"claristine";7;0;100
0;1171;"clarita";1171;0;100
0;5;"claritha";5;0;100
0;5;"claritsa";5;0;100
0;410;"clarity";410;0;100
0;403;"claritza";403;0;100
0;80;"clarivel";80;0;100
0;5;"clarixa";5;0;100
0;174;"clariza";174;0;100
42706;171;"clark";42877;99.6011847843832;0.398815215616764
3529;572;"clarke";4101;86.0521823945379;13.9478176054621
0;46;"clarkie";46;0;100
87;0;"clarkson";87;100;0
914;0;"clarnce";914;100;0
43;0;"clarnece";43;100;0
32;0;"claro";32;100;0
168;0;"claron";168;100;0
0;13;"clarra";13;0;100
0;313;"clarrisa";313;0;100
0;384;"clarrissa";384;0;100
0;31;"clarsie";31;0;100
177;214;"clary";391;45.2685421994885;54.7314578005115
0;215;"claryce";215;0;100
0;5;"clarys";5;0;100
0;212;"claryssa";212;0;100
5;0;"clash";5;100;0
0;1498;"classie";1498;0;100
0;6;"classy";6;0;100
0;21;"clata";21;0;100
40;0;"clate";40;100;0
0;74;"clatie";74;0;100
17;0;"claton";17;100;0
9185;47;"claud";9232;99.4909012131716;0.509098786828423
0;30;"clauda";30;0;100
83822;788;"claude";84610;99.0686680061458;0.931331993854154
0;5;"claudea";5;0;100
0;459;"claudean";459;0;100
0;125;"claudeen";125;0;100
38;0;"claudel";38;100;0
576;302;"claudell";878;65.6036446469248;34.3963553530752
0;30;"claudelle";30;0;100
0;671;"claudene";671;0;100
0;100;"claudett";100;0;100
0;286;"claudetta";286;0;100
11;18697;"claudette";18708;0.0587983750267265;99.9412016249733
759;124409;"claudia";125168;0.606385018535089;99.3936149814649
0;6;"claudiajoy";6;0;100
2924;3337;"claudie";6261;46.7018048235106;53.2981951764894
0;529;"claudina";529;0;100
15;11149;"claudine";11164;0.134360444285202;99.8656395557148
0;7;"claudinette";7;0;100
5079;27;"claudio";5106;99.4712103407756;0.528789659224442
351;11;"claudis";362;96.9613259668508;3.03867403314917
890;0;"claudius";890;100;0
315;14;"claudy";329;95.7446808510638;4.25531914893617
0;5;"claudya";5;0;100
317;0;"claus";317;100;0
5;0;"clausell";5;100;0
12;0;"clauzell";12;100;0
5;0;"claven";5;100;0
111;0;"clavin";111;100;0
5;0;"clavon";5;100;0
5;0;"clawson";5;100;0
285;0;"claxton";285;100;0
35751;257;"clay";36008;99.2862697178405;0.71373028215952
46;0;"claybon";46;100;0
736;0;"clayborn";736;100;0
275;0;"clayborne";275;100;0
22;0;"claybourne";22;100;0
240;0;"clayburn";240;100;0
66;0;"clayden";66;100;0
6;0;"claydon";6;100;0
5;0;"claymon";5;100;0
5;0;"clayne";5;100;0
0;35;"clayre";35;0;100
134;0;"clayson";134;100;0
20;0;"clayt";20;100;0
226;0;"clayten";226;100;0
0;11;"claytie";11;0;100
50;0;"claytin";50;100;0
126740;579;"clayton";127319;99.5452367674895;0.454763232510466
63;0;"clayvon";63;100;0
10;647;"clea";657;1.5220700152207;98.4779299847793
5;0;"cleaburn";5;100;0
0;6;"cleada";6;0;100
0;5;"cleah";5;0;100
5;0;"cleal";5;100;0
37;0;"cleamon";37;100;0
5;10;"cleao";15;33.3333333333333;66.6666666666667
0;5;"cleara";5;0;100
651;0;"clearance";651;100;0
1421;0;"clearence";1421;100;0
482;0;"clearnce";482;100;0
10;8;"cleary";18;55.5555555555556;44.4444444444444
22;0;"cleason";22;100;0
27;110;"cleaster";137;19.7080291970803;80.2919708029197
6;0;"cleaston";6;100;0
5;0;"cleat";5;100;0
0;14;"cleata";14;0;100
207;21;"cleatis";228;90.7894736842105;9.21052631578947
0;15;"cleatrice";15;0;100
893;71;"cleatus";964;92.6348547717842;7.36514522821577
362;0;"cleave";362;100;0
43;0;"cleaveland";43;100;0
142;0;"cleaven";142;100;0
0;16;"cleavie";16;0;100
16;0;"cleavland";16;100;0
241;0;"cleavon";241;100;0
85;0;"clebert";85;100;0
124;0;"cleburn";124;100;0
116;0;"cleburne";116;100;0
0;1348;"cleda";1348;0;100
0;17;"cledia";17;0;100
66;0;"cledis";66;100;0
207;245;"cledith";452;45.7964601769911;54.2035398230089
15;0;"cledus";15;100;0
103;0;"clee";103;100;0
0;5;"cleetus";5;0;100
5;0;"clegg";5;100;0
0;6;"cleidy";6;0;100
11;0;"cleighton";11;100;0
0;275;"clela";275;0;100
246;0;"cleland";246;100;0
0;513;"clelia";513;0;100
1182;0;"clell";1182;100;0
0;779;"clella";779;0;100
58;0;"clellan";58;100;0
5;7;"clellie";12;41.6666666666667;58.3333333333333
10;0;"clellon";10;100;0
3700;33;"clem";3733;99.1159924993303;0.884007500669703
0;191;"clema";191;0;100
12;0;"cleman";12;100;0
0;10;"clematine";10;0;100
12;0;"clemen";12;100;0
413;392;"clemence";805;51.304347826087;48.695652173913
0;421;"clemencia";421;0;100
1549;0;"clemens";1549;100;0
13109;6;"clement";13115;99.9542508577964;0.0457491422035837
3523;0;"clemente";3523;100;0
0;17;"clementeen";17;0;100
0;27;"clementene";27;0;100
0;1579;"clementina";1579;0;100
0;8446;"clementine";8446;0;100
281;0;"clements";281;100;0
5;0;"clemet";5;100;0
0;51;"clemetine";51;0;100
5;176;"clemie";181;2.76243093922652;97.2375690607735
0;5;"clemintine";5;0;100
0;132;"clemma";132;0;100
955;2196;"clemmie";3151;30.3078387813393;69.6921612186607
60;0;"clemmon";60;100;0
1321;0;"clemon";1321;100;0
72;0;"clemons";72;100;0
20;0;"clemont";20;100;0
0;13;"clemontine";13;0;100
17;0;"clemson";17;100;0
5;0;"clen";5;100;0
38;0;"clenard";38;100;0
60;0;"clendon";60;100;0
27;17;"clennie";44;61.3636363636364;38.6363636363636
87;0;"clennon";87;100;0
19;0;"clenon";19;100;0
199;0;"clent";199;100;0
742;0;"clenton";742;100;0
11134;28795;"cleo";39929;27.884494978587;72.115505021413
0;16;"cleoda";16;0;100
10;0;"cleodis";10;100;0
160;50;"cleofas";210;76.1904761904762;23.8095238095238
5;0;"cleofus";5;100;0
0;1176;"cleola";1176;0;100
0;5;"cleoma";5;0;100
2907;189;"cleon";3096;93.8953488372093;6.1046511627907
0;797;"cleona";797;0;100
5;1290;"cleone";1295;0.386100386100386;99.6138996138996
0;5;"cleonia";5;0;100
5;0;"cleonte";5;100;0
0;2075;"cleopatra";2075;0;100
0;5;"cleopatria";5;0;100
0;84;"cleopha";84;0;100
959;23;"cleophas";982;97.6578411405295;2.34215885947047
6;0;"cleophes";6;100;0
40;0;"cleophis";40;100;0
2023;19;"cleophus";2042;99.0695396669932;0.930460333006856
0;1608;"cleora";1608;0;100
0;17;"cleoria";17;0;100
0;312;"cleota";312;0;100
749;292;"cleotha";1041;71.9500480307397;28.0499519692603
10;0;"cleother";10;100;0
5;0;"cleothis";5;100;0
0;323;"cleotilde";323;0;100
319;0;"cleotis";319;100;0
0;40;"clera";40;0;100
158;0;"clerance";158;100;0
0;6;"clercie";6;0;100
77;0;"clerence";77;100;0
0;30;"clerissa";30;0;100
7;0;"clermont";7;100;0
0;5;"clero";5;0;100
0;10;"clesha";10;0;100
0;140;"clessie";140;0;100
55;0;"clesson";55;100;0
0;26;"clesta";26;0;100
0;5;"cleste";5;0;100
158;31;"clester";189;83.5978835978836;16.4021164021164
0;27;"clestine";27;0;100
208;0;"cleston";208;100;0
0;3930;"cleta";3930;0;100
275;0;"clete";275;100;0
16;0;"cletes";16;100;0
0;19;"cletha";19;0;100
1601;159;"cletis";1760;90.9659090909091;9.03409090909091
180;0;"cleto";180;100;0
0;54;"cletta";54;0;100
7270;262;"cletus";7532;96.5215082315454;3.47849176845459
0;5;"cletys";5;0;100
0;525;"cleva";525;0;100
3990;23;"cleve";4013;99.4268626962372;0.573137303762771
20558;87;"cleveland";20645;99.5785904577379;0.421409542262049
583;0;"cleven";583;100;0
67;0;"clever";67;100;0
74;0;"clevester";74;100;0
0;6;"clevette";6;0;100
0;5;"clevia";5;0;100
29;98;"clevie";127;22.8346456692913;77.1653543307087
98;0;"clevland";98;100;0
296;0;"clevon";296;100;0
0;6;"clhoe";6;0;100
0;49;"clida";49;0;100
718;37;"clide";755;95.0993377483444;4.90066225165563
0;5;"clidie";5;0;100
0;5;"clidy";5;0;100
200;0;"clif";200;100;0
8716;0;"cliff";8716;100;0
142;0;"cliffard";142;100;0
0;297;"cliffie";297;0;100
182686;1821;"clifford";184507;99.0130455755066;0.98695442449338
1831;0;"cliffton";1831;100;0
286;0;"cliford";286;100;0
12;0;"clift";12;100;0
0;5;"cliftina";5;0;100
68090;436;"clifton";68526;99.3637451478271;0.636254852172898
25;0;"clim";25;100;0
260;461;"climmie";721;36.0610263522885;63.9389736477115
16;0;"climon";16;100;0
14;0;"clinard";14;100;0
839;0;"cline";839;100;0
0;10;"clinesha";10;0;100
0;5;"clinetta";5;0;100
0;41;"clinique";41;0;100
5;6;"clinnie";11;45.4545454545455;54.5454545454545
31523;54;"clint";31577;99.8289894543497;0.171010545650315
93;0;"clinten";93;100;0
30;0;"clintin";30;100;0
94732;433;"clinton";95165;99.5450007881049;0.454999211895129
0;30;"clintona";30;0;100
0;36;"clintonia";36;0;100
25;610;"clio";635;3.93700787401575;96.0629921259843
0;20;"cliona";20;0;100
0;16;"clione";16;0;100
0;261;"clista";261;0;100
0;10;"clister";10;0;100
11;0;"cliston";11;100;0
2714;0;"clive";2714;100;0
0;59;"clo";59;0;100
0;70;"cloa";70;0;100
0;22;"cloda";22;0;100
0;124;"clodagh";124;0;100
0;5;"clodean";5;0;100
0;16;"clodie";16;0;100
5;3406;"cloe";3411;0.146584579302257;99.8534154206977
0;225;"cloee";225;0;100
0;5;"cloetta";5;0;100
0;1821;"cloey";1821;0;100
0;5;"cloi";5;0;100
10;0;"cloice";10;100;0
37;0;"cloid";37;100;0
0;1083;"cloie";1083;0;100
725;271;"clois";996;72.7911646586345;27.2088353413655
45;0;"cloise";45;100;0
0;194;"cloma";194;0;100
10;0;"clomer";10;100;0
0;1530;"clora";1530;0;100
6;0;"cloral";6;100;0
0;5;"cloree";5;0;100
5;0;"clorence";5;100;0
0;135;"clorene";135;0;100
0;23;"cloretta";23;0;100
0;181;"cloria";181;0;100
0;25;"clorice";25;0;100
0;10;"clorie";10;0;100
0;1302;"clorinda";1302;0;100
0;254;"clorine";254;0;100
0;153;"cloris";153;0;100
0;51;"clorisa";51;0;100
0;5;"clorise";5;0;100
0;402;"clorissa";402;0;100
0;15;"clota";15;0;100
0;16;"clote";16;0;100
0;471;"cloteal";471;0;100
0;203;"clotee";203;0;100
0;6;"cloteen";6;0;100
0;5;"clotell";5;0;100
0;24;"clotene";24;0;100
0;16;"clothilda";16;0;100
0;224;"clothilde";224;0;100
0;5;"clotie";5;0;100
0;71;"clotiel";71;0;100
0;448;"clotilda";448;0;100
0;927;"clotilde";927;0;100
0;105;"clotile";105;0;100
0;79;"clotine";79;0;100
5;0;"clotis";5;100;0
403;0;"cloud";403;100;0
42;0;"cloude";42;100;0
0;12;"cloudia";12;0;100
10;6;"cloudie";16;62.5;37.5
5;0;"clouis";5;100;0
0;122;"clova";122;0;100
34;2612;"clover";2646;1.28495842781557;98.7150415721844
0;100;"clovia";100;0;100
0;30;"clovie";30;0;100
2909;627;"clovis";3536;82.2680995475113;17.7319004524887
0;19;"clowey";19;0;100
0;49;"clowie";49;0;100
126;5;"cloy";131;96.1832061068702;3.81679389312977
877;121;"cloyce";998;87.875751503006;12.124248496994
2844;0;"cloyd";2844;100;0
148;0;"cloyde";148;100;0
0;28;"cloye";28;0;100
6;0;"cloyed";6;100;0
96;0;"cloys";96;100;0
20;0;"cloyse";20;100;0
5;0;"clu";5;100;0
0;5;"cludia";5;0;100
0;5;"clura";5;0;100
55;0;"cluster";55;100;0
6;0;"clutch";6;100;0
0;694;"clyda";694;0;100
135143;3234;"clyde";138377;97.6629064078568;2.3370935921432
0;74;"clydean";74;0;100
0;10;"clydeen";10;0;100
0;5;"clydel";5;0;100
137;83;"clydell";220;62.2727272727273;37.7272727272727
0;432;"clydene";432;0;100
0;10;"clydetta";10;0;100
0;71;"clydette";71;0;100
0;626;"clydia";626;0;100
22;842;"clydie";864;2.5462962962963;97.4537037037037
0;99;"clydine";99;0;100
18;0;"clyne";18;100;0
5;0;"clynt";5;100;0
15;0;"clynton";15;100;0
0;12;"clysta";12;0;100
0;34;"clyta";34;0;100
0;175;"clytee";175;0;100
0;5;"clytia";5;0;100
0;288;"clytie";288;0;100
0;5;"cmone";5;0;100
0;15;"cmya";15;0;100
0;11;"cne";11;0;100
0;39;"cniya";39;0;100
0;62;"cniyah";62;0;100
0;14;"cnya";14;0;100
0;50;"cnythia";50;0;100
189;0;"coady";189;100;0
142;0;"coal";142;100;0
5;0;"coalson";5;100;0
137;0;"coalton";137;100;0
20;0;"coast";20;100;0
94;0;"cobain";94;100;0
7;0;"cobalt";7;100;0
5;0;"cobb";5;100;0
5;0;"cobbie";5;100;0
623;0;"cobe";623;100;0
18;0;"cobee";18;100;0
119;0;"coben";119;100;0
13;0;"cobert";13;100;0
628;0;"cobey";628;100;0
503;166;"cobi";669;75.186846038864;24.813153961136
358;135;"cobie";493;72.6166328600406;27.3833671399594
190;0;"cobin";190;100;0
0;15;"cobina";15;0;100
20;0;"cobra";20;100;0
193;0;"coburn";193;100;0
8426;364;"coby";8790;95.8589306029579;4.14106939704209
13;0;"cobyn";13;100;0
66;0;"cochise";66;100;0
0;1151;"coco";1151;0;100
0;34;"cocoa";34;0;100
557;81;"coda";638;87.3040752351097;12.6959247648903
22;0;"coddy";22;100;0
256;185;"codee";441;58.0498866213152;41.9501133786848
10;0;"codell";10;100;0
91;0;"coden";91;100;0
5;0;"codera";5;100;0
7;0;"codero";7;100;0
5;0;"coderro";5;100;0
3159;28;"codey";3187;99.1214308126765;0.878569187323502
1857;3188;"codi";5045;36.808721506442;63.191278493558
2534;1649;"codie";4183;60.5785321539565;39.4214678460435
281419;4934;"cody";286353;98.2769518740855;1.72304812591452
6;0;"codyallen";6;100;0
28;0;"codye";28;100;0
23;0;"codyjames";23;100;0
72;0;"codylee";72;100;0
142;0;"coe";142;100;0
6;0;"coedy";6;100;0
22;0;"coehn";22;100;0
22;0;"coel";22;100;0
0;5;"coella";5;0;100
2582;0;"coen";2582;100;0
0;40;"coeta";40;0;100
0;56;"coetta";56;0;100
5;5;"coey";10;50;50
0;16;"coffy";16;0;100
53;0;"cogan";53;100;0
171;0;"cohan";171;100;0
11544;117;"cohen";11661;98.9966555183946;1.00334448160535
208;0;"cohl";208;100;0
10;0;"cohlton";10;100;0
6;0;"cohner";6;100;0
5;0;"cohutta";5;100;0
12;0;"cohyn";12;100;0
22;15;"coi";37;59.4594594594595;40.5405405405405
0;53;"coila";53;0;100
10;0;"coilin";10;100;0
6;0;"coire";6;100;0
37;0;"coit";37;100;0
20;0;"coke";20;100;0
12;0;"coker";12;100;0
81;243;"cola";324;25;75
236;0;"colan";236;100;0
0;5;"colanda";5;0;100
0;93;"colandra";93;0;100
113;6;"colbe";119;94.9579831932773;5.04201680672269
5;23;"colbee";28;17.8571428571429;82.1428571428571
53;0;"colben";53;100;0
829;0;"colbert";829;100;0
521;28;"colbey";549;94.8998178506375;5.10018214936248
64;459;"colbi";523;12.2370936902486;87.7629063097514
326;1862;"colbie";2188;14.8994515539305;85.1005484460695
88;0;"colbin";88;100;0
174;0;"colburn";174;100;0
49829;3725;"colby";53554;93.0444037793629;6.95559622063711
16;0;"colbyn";16;100;0
697;0;"colden";697;100;0
5;0;"coldin";5;100;0
129250;456;"cole";129706;99.6484356930288;0.35156430697115
0;43;"colean";43;0;100
225;0;"coleby";225;100;0
17;0;"coleden";17;100;0
5;0;"coledon";5;100;0
0;51;"colee";51;0;100
0;11979;"coleen";11979;0;100
0;10;"coleena";10;0;100
0;42;"coleene";42;0;100
0;5;"coleeta";5;0;100
0;10;"coleigh";10;0;100
15610;29;"coleman";15639;99.8145661487307;0.185433851269263
13;0;"colemon";13;100;0
529;0;"colen";529;100;0
0;61;"colena";61;0;100
0;1624;"colene";1624;0;100
5;0;"coleon";5;100;0
5;0;"coleone";5;100;0
17;0;"coleridge";17;100;0
0;5;"colesha";5;0;100
920;0;"coleson";920;100;0
89;0;"coleston";89;100;0
17;0;"colesyn";17;100;0
0;203;"coleta";203;0;100
13;0;"coleten";13;100;0
0;38;"coletha";38;0;100
37;0;"coletin";37;100;0
2802;0;"coleton";2802;100;0
0;2237;"coletta";2237;0;100
0;21727;"colette";21727;0;100
12;0;"coletyn";12;100;0
1897;253;"coley";2150;88.2325581395349;11.7674418604651
15;0;"colgan";15;100;0
0;5;"colicia";5;0;100
562;101;"colie";663;84.7662141779789;15.2337858220211
122443;435;"colin";122878;99.6459903318739;0.354009668126109
0;22;"colina";22;0;100
0;168;"colinda";168;0;100
0;79;"coline";79;0;100
0;5;"colisa";5;0;100
0;63;"colisha";63;0;100
0;25;"colista";25;0;100
0;41;"colita";41;0;100
124;0;"collan";124;100;0
330;162063;"colleen";162393;0.203210729526519;99.7967892704735
0;62;"colleena";62;0;100
0;120;"colleene";120;0;100
607;513;"collen";1120;54.1964285714286;45.8035714285714
0;10;"collena";10;0;100
0;1009;"collene";1009;0;100
0;5;"collenn";5;0;100
0;10;"collete";10;0;100
0;41;"collett";41;0;100
0;489;"colletta";489;0;100
0;7002;"collette";7002;0;100
18;0;"colley";18;100;0
1110;342;"collie";1452;76.4462809917355;23.5537190082645
1471;98;"collier";1569;93.7539834289356;6.24601657106437
74783;437;"collin";75220;99.4190374900293;0.580962509970752
0;6;"colline";6;0;100
3133;2033;"collins";5166;60.6465350367789;39.3534649632211
1287;10;"collis";1297;99.2289899768697;0.771010023130301
754;192;"collyn";946;79.7040169133192;20.2959830866808
5;5;"collynn";10;50;50
0;206;"collyns";206;0;100
537;0;"colm";537;100;0
974;0;"colman";974;100;0
5;0;"colmon";5;100;0
1296;11;"colon";1307;99.1583779648049;0.841622035195103
1064;0;"colonel";1064;100;0
59;0;"colorado";59;100;0
5;0;"colquitt";5;100;0
317;0;"colsen";317;100;0
2346;0;"colson";2346;100;0
26;0;"colsten";26;100;0
766;0;"colston";766;100;0
39;0;"colsyn";39;100;0
14441;11;"colt";14452;99.9238859673402;0.0761140326598395
702;0;"coltan";702;100;0
13634;0;"colten";13634;100;0
3767;0;"colter";3767;100;0
2312;0;"coltin";2312;100;0
10;0;"coltn";10;100;0
111200;172;"colton";111372;99.8455626189707;0.154437381029343
281;0;"coltrane";281;100;0
1238;0;"coltyn";1238;100;0
86;0;"colum";86;100;0
0;43;"columba";43;0;100
5;586;"columbia";591;0.846023688663283;99.1539763113367
0;30;"columbine";30;0;100
5;0;"columbo";5;100;0
6568;0;"columbus";6568;100;0
930;0;"colvin";930;100;0
48;0;"colwyn";48;100;0
19;0;"colyer";19;100;0
676;10;"colyn";686;98.5422740524781;1.45772594752187
0;6;"colynn";6;0;100
5;17;"coma";22;22.7272727272727;77.2727272727273
0;9;"comaneci";9;0;100
11;0;"comari";11;100;0
0;17;"comeka";17;0;100
0;6;"comekia";6;0;100
0;11;"comelia";11;0;100
787;0;"comer";787;100;0
0;5;"comesha";5;0;100
0;202;"comfort";202;0;100
0;35;"comilla";35;0;100
0;7;"comisha";7;0;100
5;0;"commer";5;100;0
39;17;"commie";56;69.6428571428571;30.3571428571429
298;0;"commodore";298;100;0
5;0;"common";5;100;0
62;0;"compton";62;100;0
383;0;"con";383;100;0
0;46;"cona";46;0;100
47;0;"conagher";47;100;0
121;0;"conal";121;100;0
516;0;"conall";516;100;0
1844;0;"conan";1844;100;0
5;0;"conant";5;100;0
48;0;"conar";48;100;0
757;0;"conard";757;100;0
968;5059;"concepcion";6027;16.0610585697694;83.9389414302306
0;31;"concepsion";31;0;100
0;676;"conception";676;0;100
5;13968;"concetta";13973;0.0357832963572604;99.9642167036427
0;253;"concettina";253;0;100
47;0;"concetto";47;100;0
0;1691;"concha";1691;0;100
0;15;"conchata";15;0;100
0;5;"concheta";5;0;100
0;625;"conchetta";625;0;100
0;1470;"conchita";1470;0;100
15;205;"conda";220;6.81818181818182;93.1818181818182
0;5;"condace";5;0;100
5;0;"conde";5;100;0
5;0;"condie";5;100;0
0;5;"condol";5;0;100
0;12;"condola";12;0;100
0;5;"condoleezza";5;0;100
6;0;"condon";6;100;0
0;20;"condra";20;0;100
5;0;"condredge";5;100;0
5;0;"condy";5;100;0
0;5;"conelia";5;0;100
34;0;"conell";34;100;0
114;0;"coner";114;100;0
0;27;"conesha";27;0;100
42;0;"coney";42;100;0
0;5;"conferina";5;0;100
40;0;"confesor";40;100;0
48;0;"cong";48;100;0
0;421;"congetta";421;0;100
5;0;"congress";5;100;0
0;436;"coni";436;0;100
0;12;"conie";12;0;100
0;43;"conisha";43;0;100
0;63;"conita";63;0;100
0;11;"conjetta";11;0;100
768;0;"conlan";768;100;0
62;29;"conlee";91;68.1318681318681;31.8681318681319
0;56;"conleigh";56;0;100
3491;263;"conley";3754;92.9941395844433;7.00586041555674
229;0;"conlin";229;100;0
13;0;"conlon";13;100;0
119;0;"conn";119;100;0
0;95;"conna";95;0;100
5;0;"connal";5;100;0
6;0;"connall";6;100;0
5;0;"connan";5;100;0
591;31;"connar";622;95.016077170418;4.98392282958199
21;0;"connard";21;100;0
0;15;"conne";15;0;100
0;216;"connee";216;0;100
6;0;"connel";6;100;0
1489;5;"connell";1494;99.665327978581;0.334672021419009
89;125;"connelly";214;41.588785046729;58.411214953271
50901;787;"conner";51688;98.4774028788113;1.52259712118867
145;0;"connery";145;100;0
5;0;"conney";5;100;0
0;917;"conni";917;0;100
0;5;"connice";5;0;100
6757;265672;"connie";272429;2.48027926542328;97.5197207345767
5;0;"connis";5;100;0
16;0;"connley";16;100;0
18;5;"connolly";23;78.2608695652174;21.7391304347826
197630;1530;"connor";199160;99.2317734484836;0.768226551516369
0;5;"connstance";5;0;100
158;413;"conny";571;27.6707530647986;72.3292469352014
0;43;"connye";43;0;100
146;0;"cono";146;100;0
0;5;"conola";5;0;100
21457;69;"conor";21526;99.6794574003531;0.320542599646939
0;9;"conquista";9;0;100
33396;16;"conrad";33412;99.9521130132886;0.0478869867113612
0;25;"conrada";25;0;100
2120;0;"conrado";2120;100;0
5;0;"conred";5;100;0
245;0;"conroy";245;100;0
0;97;"consandra";97;0;100
6;268;"consepcion";274;2.18978102189781;97.8102189781022
0;71;"consetta";71;0;100
0;15;"consiglia";15;0;100
0;8;"constanc";8;0;100
419;137836;"constance";138255;0.303063180355141;99.6969368196449
0;109;"constancia";109;0;100
32;0;"constancio";32;100;0
0;5;"constande";5;0;100
0;5;"constandina";5;0;100
5;0;"constandinos";5;100;0
354;26;"constant";380;93.1578947368421;6.8421052631579
170;0;"constantin";170;100;0
0;604;"constantina";604;0;100
5792;31;"constantine";5823;99.4676283702559;0.532371629744118
1350;0;"constantino";1350;100;0
637;0;"constantinos";637;100;0
0;626;"constanza";626;0;100
0;5;"constence";5;0;100
0;5;"constina";5;0;100
0;1999;"consuela";1999;0;100
0;908;"consuella";908;0;100
0;83;"consuello";83;0;100
90;16697;"consuelo";16787;0.536129147554655;99.4638708524454
0;13;"conswala";13;0;100
0;186;"conswella";186;0;100
0;35;"conswello";35;0;100
0;12;"contance";12;0;100
0;10;"contenia";10;0;100
0;5;"content";5;0;100
0;7;"contesa";7;0;100
0;1989;"contessa";1989;0;100
0;28;"contessia";28;0;100
0;484;"contina";484;0;100
0;5;"continia";5;0;100
220;0;"contrell";220;100;0
0;7;"contrella";7;0;100
0;5;"contrena";5;0;100
0;168;"contrina";168;0;100
20;0;"converse";20;100;0
2139;0;"conway";2139;100;0
49;0;"conwell";49;100;0
0;65;"conya";65;0;100
8;0;"conye";8;100;0
0;5;"conzuelo";5;0;100
0;6;"conzy";6;0;100
0;573;"cookie";573;0;100
12;0;"cooledge";12;100;0
10;0;"cooley";10;100;0
372;0;"coolidge";372;100;0
14;0;"coopar";14;100;0
76387;1588;"cooper";77975;97.9634498236614;2.03655017633857
66;0;"cope";66;100;0
41;0;"copelan";41;100;0
518;95;"copeland";613;84.5024469820555;15.4975530179445
19;0;"copelin";19;100;0
0;47;"copelyn";47;0;100
0;25;"copelynn";25;0;100
31;0;"copen";31;100;0
182;65;"copper";247;73.6842105263158;26.3157894736842
7;0;"cor";7;100;0
302;103602;"cora";103904;0.290652910378811;99.7093470896212
0;27;"corabel";27;0;100
0;26;"corabell";26;0;100
0;22;"corabella";22;0;100
0;350;"corabelle";350;0;100
0;284;"corah";284;0;100
0;589;"coraima";589;0;100
0;5;"coraine";5;0;100
191;9485;"coral";9676;1.97395618023977;98.0260438197602
0;11;"coralai";11;0;100
0;17;"coralea";17;0;100
0;2148;"coralee";2148;0;100
0;10;"coraleen";10;0;100
0;38;"coralei";38;0;100
0;83;"coraleigh";83;0;100
0;22;"coralene";22;0;100
0;41;"coralia";41;0;100
0;2256;"coralie";2256;0;100
0;6;"coralin";6;0;100
0;21;"coralina";21;0;100
0;2799;"coraline";2799;0;100
0;25;"coralis";25;0;100
0;5;"coralito";5;0;100
0;6;"coraliz";6;0;100
0;6;"coralline";6;0;100
0;6;"coraly";6;0;100
0;829;"coralyn";829;0;100
0;26;"coralyne";26;0;100
0;418;"coralynn";418;0;100
0;5;"coralynne";5;0;100
0;5;"coralys";5;0;100
0;38;"coramae";38;0;100
76;0;"coran";76;100;0
12;0;"corando";12;100;0
54;0;"coray";54;100;0
0;75;"corayma";75;0;100
0;257;"corazon";257;0;100
3033;6;"corban";3039;99.8025666337611;0.197433366238894
1369;0;"corben";1369;100;0
328;0;"corbet";328;100;0
2195;0;"corbett";2195;100;0
0;5;"corbi";5;0;100
5;12;"corbie";17;29.4117647058824;70.5882352941177
32751;531;"corbin";33282;98.4045429962142;1.59545700378583
54;0;"corbit";54;100;0
94;0;"corbitt";94;100;0
5;0;"corbon";5;100;0
1339;303;"corby";1642;81.5468940316687;18.4531059683313
2161;312;"corbyn";2473;87.3837444399515;12.6162555600485
0;5;"corbynn";5;0;100
1667;0;"cord";1667;100;0
12;338;"corda";350;3.42857142857143;96.5714285714286
486;5;"cordae";491;98.9816700610998;1.0183299389002
94;0;"cordai";94;100;0
32;0;"cordairo";32;100;0
553;0;"cordale";553;100;0
10;0;"cordalro";10;100;0
29;0;"cordara";29;100;0
16;0;"cordarell";16;100;0
12;0;"cordarian";12;100;0
41;0;"cordario";41;100;0
122;0;"cordarious";122;100;0
5;0;"cordaris";5;100;0
907;0;"cordarius";907;100;0
468;0;"cordaro";468;100;0
62;0;"cordarrel";62;100;0
80;0;"cordarrell";80;100;0
114;0;"cordarrius";114;100;0
105;0;"cordarro";105;100;0
7;0;"cordarrow";7;100;0
157;0;"cordarryl";157;100;0
181;0;"cordaryl";181;100;0
0;51;"cordasia";51;0;100
188;0;"corday";188;100;0
5;0;"corddaryl";5;100;0
574;5;"corde";579;99.1364421416235;0.863557858376511
5;0;"cordea";5;100;0
0;5;"cordeja";5;0;100
421;0;"cordel";421;100;0
0;9625;"cordelia";9625;0;100
10051;148;"cordell";10199;98.5488773409158;1.45112265908422
0;367;"cordella";367;0;100
89;5;"cordelle";94;94.6808510638298;5.31914893617021
0;51;"cordellia";51;0;100
6;0;"cordelra";6;100;0
60;0;"cordelro";60;100;0
26;0;"corden";26;100;0
134;0;"cordera";134;100;0
19;0;"corderal";19;100;0
5;0;"corderall";5;100;0
7;0;"corderia";7;100;0
5;0;"corderial";5;100;0
5;0;"corderick";5;100;0
24;0;"corderio";24;100;0
5;0;"corderious";5;100;0
79;0;"corderius";79;100;0
1689;9;"cordero";1698;99.469964664311;0.530035335689046
36;0;"corderra";36;100;0
11;0;"corderrius";11;100;0
248;0;"corderro";248;100;0
5;0;"cordes";5;100;0
0;5;"cordeshia";5;0;100
11;0;"cordey";11;100;0
15;0;"cordez";15;100;0
0;1145;"cordia";1145;0;100
167;1510;"cordie";1677;9.9582587954681;90.0417412045319
0;22;"cordilia";22;0;100
15;0;"cordin";15;100;0
58;0;"cordis";58;100;0
190;12;"cordney";202;94.059405940594;5.94059405940594
61;0;"cordon";61;100;0
0;21;"cordula";21;0;100
32;41;"cordy";73;43.8356164383562;56.1643835616438
0;22;"corea";22;0;100
0;853;"corean";853;0;100
0;7;"coreatha";7;0;100
166;392;"coree";558;29.7491039426523;70.2508960573477
0;2475;"coreen";2475;0;100
0;345;"coreena";345;0;100
0;5;"coreene";5;0;100
27;0;"corell";27;100;0
0;59;"corella";59;0;100
0;5;"corelle";5;0;100
143;109;"coren";252;56.7460317460317;43.2539682539683
0;1488;"corena";1488;0;100
0;3787;"corene";3787;0;100
0;18;"corenia";18;0;100
0;25;"corenna";25;0;100
0;24;"corenne";24;0;100
0;23;"corenthia";23;0;100
5;0;"corentin";5;100;0
89;0;"coreon";89;100;0
0;12;"coreta";12;0;100
0;505;"coretha";505;0;100
0;2352;"coretta";2352;0;100
0;6;"corette";6;0;100
180494;8848;"corey";189342;95.3269744694785;4.67302553052149
0;18;"coreyana";18;0;100
0;12;"coreyanna";12;0;100
6;0;"coreyion";6;100;0
158;0;"coreyon";158;100;0
0;8;"coreyona";8;0;100
0;5;"coreyonna";5;0;100
131;0;"corgan";131;100;0
1151;11150;"cori";12301;9.3569628485489;90.6430371514511
0;5;"coriah";5;0;100
282;21;"corian";303;93.0693069306931;6.93069306930693
0;257;"coriana";257;0;100
0;119;"coriann";119;0;100
0;318;"corianna";318;0;100
0;379;"corianne";379;0;100
1005;3537;"corie";4542;22.1268163804491;77.8731836195509
0;25;"corielle";25;0;100
0;55;"coriene";55;0;100
0;5;"corienne";5;0;100
10;0;"corieon";10;100;0
0;5;"corii";5;0;100
851;1653;"corin";2504;33.9856230031949;66.0143769968051
0;15364;"corina";15364;0;100
0;297;"corinda";297;0;100
17;13899;"corine";13916;0.122161540672607;99.8778384593274
0;635;"corinn";635;0;100
0;6728;"corinna";6728;0;100
15;46031;"corinne";46046;0.0325761195326413;99.9674238804674
0;10;"corinth";10;0;100
0;15;"corintha";15;0;100
0;1097;"corinthia";1097;0;100
692;197;"corinthian";889;77.8402699662542;22.1597300337458
26;0;"corinthians";26;100;0
305;0;"corion";305;100;0
0;45;"corionna";45;0;100
0;139;"corisa";139;0;100
0;23;"corisha";23;0;100
0;2021;"corissa";2021;0;100
0;163;"corita";163;0;100
0;5;"coriyah";5;0;100
34;0;"corkey";34;100;0
611;51;"corky";662;92.2960725075529;7.70392749244713
0;56;"corla";56;0;100
0;97;"corleen";97;0;100
0;91;"corlene";91;0;100
101;0;"corleone";101;100;0
0;7;"corless";7;0;100
0;14;"corletta";14;0;100
0;91;"corlette";91;0;100
250;292;"corley";542;46.1254612546125;53.8745387453875
17;0;"corlin";17;100;0
32;483;"corlis";515;6.21359223300971;93.7864077669903
343;2848;"corliss";3191;10.7489815104983;89.2510184895017
0;27;"corlyn";27;0;100
0;10;"corma";10;0;100
2312;0;"cormac";2312;100;0
16;0;"cormack";16;100;0
5;0;"corman";5;100;0
7;0;"cormari";7;100;0
15;0;"cormarion";15;100;0
99;0;"cormick";99;100;0
22;5;"corneal";27;81.4814814814815;18.5185185185185
5;0;"cornealius";5;100;0
6;0;"corneall";6;100;0
0;6;"cornecia";6;0;100
21;0;"corneil";21;100;0
48;0;"corneilius";48;100;0
10;0;"corneilous";10;100;0
340;0;"corneilus";340;100;0
0;128;"corneisha";128;0;100
1156;0;"cornel";1156;100;0
26;19348;"cornelia";19374;0.134200474863219;99.8657995251368
6;0;"cornelieus";6;100;0
1515;0;"cornelio";1515;100;0
2332;113;"cornelious";2445;95.3783231083844;4.62167689161554
25;0;"cornelis";25;100;0
33799;618;"cornelius";34417;98.2043757445448;1.79562425545515
11047;348;"cornell";11395;96.9460289600702;3.05397103992979
0;72;"cornella";72;0;100
16;0;"cornelle";16;100;0
0;37;"cornellia";37;0;100
144;0;"cornellius";144;100;0
242;0;"corneluis";242;100;0
0;211;"cornesha";211;0;100
0;80;"corneshia";80;0;100
0;10;"cornesia";10;0;100
0;32;"cornetta";32;0;100
65;0;"corney";65;100;0
0;10;"cornia";10;0;100
168;128;"cornie";296;56.7567567567568;43.2432432432432
0;227;"cornisha";227;0;100
0;45;"corniya";45;0;100
0;12;"corniyah";12;0;100
11;0;"corny";11;100;0
0;34;"corolyn";34;0;100
84;0;"coron";84;100;0
0;98;"corona";98;0;100
0;43;"coronda";43;0;100
0;271;"corra";271;0;100
289;0;"corrado";289;100;0
0;5;"corrah";5;0;100
0;10;"corraine";10;0;100
121;0;"corran";121;100;0
0;5;"correan";5;0;100
0;5;"corree";5;0;100
0;175;"correen";175;0;100
0;5;"correena";5;0;100
127;0;"correll";127;100;0
5;25;"corren";30;16.6666666666667;83.3333333333333
0;327;"correna";327;0;100
0;446;"correne";446;0;100
7;0;"correon";7;100;0
0;131;"corretta";131;0;100
1083;46;"correy";1129;95.925597874225;4.07440212577502
27;681;"corri";708;3.8135593220339;96.1864406779661
0;11;"corriana";11;0;100
0;19;"corrianna";19;0;100
5;0;"corrice";5;100;0
0;11;"corrida";11;0;100
1253;7781;"corrie";9034;13.8698251051583;86.1301748948417
186;38;"corrigan";224;83.0357142857143;16.9642857142857
119;1947;"corrin";2066;5.75992255566312;94.2400774443369
0;5615;"corrina";5615;0;100
0;9;"corrinda";9;0;100
0;20067;"corrine";20067;0;100
0;33;"corrinn";33;0;100
0;228;"corrinna";228;0;100
0;2048;"corrinne";2048;0;100
89;0;"corrion";89;100;0
22;13;"corris";35;62.8571428571429;37.1428571428571
0;60;"corrisa";60;0;100
0;91;"corrissa";91;0;100
33;0;"corron";33;100;0
2123;314;"corry";2437;87.1153057037341;12.8846942962659
0;663;"corryn";663;0;100
0;13;"corryne";13;0;100
0;5;"corsandra";5;0;100
0;15;"corsha";15;0;100
0;86;"corsica";86;0;100
28;0;"corson";28;100;0
1762;0;"cort";1762;100;0
0;132;"cortana";132;0;100
0;75;"cortasia";75;0;100
0;5;"cortavia";5;0;100
19;0;"cortavion";19;100;0
228;0;"cortavious";228;100;0
105;0;"cortavius";105;100;0
12;0;"cortaz";12;100;0
0;6;"cortazia";6;0;100
5;0;"cortell";5;100;0
0;8;"corteney";8;0;100
21;0;"cortes";21;100;0
9781;89;"cortez";9870;99.0982776089159;0.901722391084093
6;0;"corteze";6;100;0
0;259;"cortina";259;0;100
0;26;"cortisha";26;0;100
109;0;"cortlan";109;100;0
1902;32;"cortland";1934;98.3453981385729;1.65460186142709
80;0;"cortlandt";80;100;0
27;0;"cortlen";27;100;0
125;0;"cortlin";125;100;0
15;328;"cortlyn";343;4.3731778425656;95.6268221574344
0;143;"cortlynn";143;0;100
0;58;"cortne";58;0;100
0;617;"cortnee";617;0;100
0;35;"cortnei";35;0;100
3095;16877;"cortney";19972;15.4966953735229;84.5033046264771
0;818;"cortni";818;0;100
0;864;"cortnie";864;0;100
0;197;"cortny";197;0;100
46;0;"cortrell";46;100;0
0;5;"corutney";5;0;100
41;0;"corvell";41;100;0
0;11;"corvetta";11;0;100
0;80;"corvette";80;0;100
587;0;"corvin";587;100;0
0;5;"corvina";5;0;100
27;0;"corvon";27;100;0
23;0;"corvus";23;100;0
11;0;"corvyn";11;100;0
4114;0;"corwin";4114;100;0
441;0;"corwyn";441;100;0
5;0;"corwynn";5;100;0
125198;6476;"cory";131674;95.0817929127998;4.91820708720021
0;10;"coryana";10;0;100
0;5;"coryann";5;0;100
190;0;"corydon";190;100;0
49;0;"corye";49;100;0
13;0;"coryell";13;100;0
12;0;"coryion";12;100;0
0;898;"coryn";898;0;100
0;17;"coryna";17;0;100
0;11;"coryne";11;0;100
0;701;"corynn";701;0;100
0;397;"corynne";397;0;100
44;0;"coryon";44;100;0
0;135;"cosandra";135;0;100
212;23;"cosby";235;90.2127659574468;9.78723404255319
0;41;"cosetta";41;0;100
0;2120;"cosette";2120;0;100
0;6;"cosha";6;0;100
0;5;"cosie";5;0;100
0;153;"cosima";153;0;100
884;0;"cosimo";884;100;0
0;28;"cosma";28;0;100
15;0;"cosmas";15;100;0
1281;0;"cosme";1281;100;0
2305;0;"cosmo";2305;100;0
9;0;"cosmos";9;100;0
0;20;"cossandra";20;0;100
0;46;"cossette";46;0;100
11;0;"cossie";11;100;0
241;0;"costa";241;100;0
60;0;"costantino";60;100;0
12;0;"costanzo";12;100;0
266;0;"costas";266;100;0
0;432;"costella";432;0;100
56;5;"costello";61;91.8032786885246;8.19672131147541
92;0;"coston";92;100;0
163;0;"cote";163;100;0
0;6;"cotenia";6;0;100
141;0;"cotey";141;100;0
0;5;"cotha";5;0;100
11;49;"coti";60;18.3333333333333;81.6666666666667
17;18;"cotie";35;48.5714285714286;51.4285714285714
0;243;"cotina";243;0;100
5;0;"cotis";5;100;0
0;46;"cotrina";46;0;100
30;0;"cott";30;100;0
45;0;"cotter";45;100;0
0;28;"cottie";28;0;100
378;0;"cotton";378;100;0
140;0;"cottrell";140;100;0
5424;768;"coty";6192;87.5968992248062;12.4031007751938
0;25;"coua";25;0;100
206;0;"cougar";206;100;0
0;6;"coula";6;0;100
0;5;"coulette";5;0;100
242;0;"coulson";242;100;0
5;0;"coulten";5;100;0
599;0;"coulter";599;100;0
139;0;"coulton";139;100;0
0;142;"coumba";142;0;100
262;0;"council";262;100;0
5;0;"count";5;100;0
0;117;"countess";117;0;100
0;27;"countney";27;0;100
154;0;"couper";154;100;0
158;19;"courage";177;89.2655367231638;10.7344632768362
25;0;"courey";25;100;0
0;5;"couri";5;0;100
0;69;"courney";69;0;100
0;49;"courntey";49;0;100
298;0;"court";298;100;0
0;82;"courtany";82;0;100
250;1188;"courtenay";1438;17.3852573018081;82.6147426981919
5;1124;"courteney";1129;0.442869796279894;99.5571302037201
0;63;"courteny";63;0;100
92;0;"courtez";92;100;0
28;0;"courtlan";28;100;0
3544;209;"courtland";3753;94.4311217692513;5.56887823074873
16;0;"courtlandt";16;100;0
51;13;"courtlin";64;79.6875;20.3125
10;719;"courtlyn";729;1.37174211248285;98.6282578875172
0;287;"courtlynn";287;0;100
10;467;"courtnay";477;2.09643605870021;97.9035639412998
0;81;"courtne";81;0;100
8;1609;"courtnee";1617;0.494743351886209;99.5052566481138
0;229;"courtnei";229;0;100
22453;256928;"courtney";279381;8.03669540877869;91.9633045912213
0;11;"courtneyann";11;0;100
0;937;"courtni";937;0;100
0;2109;"courtnie";2109;0;100
5;500;"courtny";505;0.99009900990099;99.009900990099
0;5;"courtnye";5;0;100
62;0;"courvoisier";62;100;0
57;0;"coury";57;100;0
0;77;"coutney";77;0;100
0;50;"couture";50;0;100
6;0;"couy";6;100;0
5;103;"cova";108;4.62962962962963;95.3703703703704
265;18;"cove";283;93.6395759717314;6.36042402826855
28;0;"coven";28;100;0
11;0;"covert";11;100;0
131;5;"covey";136;96.3235294117647;3.67647058823529
0;5;"covie";5;0;100
44;0;"covin";44;100;0
6;0;"covington";6;100;0
5;0;"covy";5;100;0
157;0;"cowan";157;100;0
0;5;"cowana";5;0;100
0;26;"cowanda";26;0;100
175;0;"cowen";175;100;0
16058;844;"coy";16902;95.0065081055496;4.99349189445036
0;18;"coya";18;0;100
11;0;"coyal";11;100;0
406;42;"coye";448;90.625;9.375
19;0;"coyer";19;100;0
0;27;"coyla";27;0;100
111;0;"coyle";111;100;0
32;0;"coyote";32;100;0
123;0;"coyt";123;100;0
6;0;"coyte";6;100;0
6;0;"cozell";6;100;0
0;6;"cozella";6;0;100
0;557;"cozetta";557;0;100
0;1348;"cozette";1348;0;100
0;43;"cozie";43;0;100
5;0;"cozmo";5;100;0
21;101;"cozy";122;17.2131147540984;82.7868852459016
8;0;"crae";8;100;0
9;0;"crafton";9;100;0
5;0;"crag";5;100;0
5;0;"cragi";5;100;0
298323;1012;"craig";299335;99.661917249904;0.338082750096046
371;0;"craige";371;100;0
98;0;"craigory";98;100;0
55;0;"cramer";55;100;0
5;0;"cramon";5;100;0
292;0;"crandall";292;100;0
6;0;"crandon";6;100;0
5;0;"crane";5;100;0
158;0;"cranford";158;100;0
364;0;"cranston";364;100;0
37;0;"crash";37;100;0
5;0;"crate";5;100;0
366;0;"craven";366;100;0
3935;19;"crawford";3954;99.51947395043;0.480526049570056
16;0;"crawley";16;100;0
111;0;"cray";111;100;0
11;0;"crayson";11;100;0
624;0;"crayton";624;100;0
0;11;"crea";11;0;100
11;0;"cread";11;100;0
0;101;"creasie";101;0;100
151;0;"crecencio";151;100;0
0;37;"creda";37;0;100
7;0;"credell";7;100;0
12;6;"credence";18;66.6666666666667;33.3333333333333
424;783;"cree";1207;35.1284175642088;64.8715824357912
2794;0;"creed";2794;100;0
5;0;"creedan";5;100;0
5;7;"creedance";12;41.6666666666667;58.3333333333333
29;0;"creede";29;100;0
27;0;"creeden";27;100;0
154;66;"creedence";220;70;30
56;0;"creedon";56;100;0
12;0;"creedyn";12;100;0
188;0;"creek";188;100;0
5;0;"creel";5;100;0
247;0;"creg";247;100;0
179;0;"cregg";179;100;0
381;0;"creig";381;100;0
5;0;"creigh";5;100;0
3436;11;"creighton";3447;99.6808819263127;0.319118073687264
5;0;"creo";5;100;0
0;1699;"creola";1699;0;100
0;5;"creolia";5;0;100
10;0;"creon";10;100;0
0;6;"creosha";6;0;100
0;6;"crescencia";6;0;100
259;0;"crescencio";259;100;0
0;97;"crescent";97;0;100
0;47;"crescentia";47;0;100
10;0;"crescenzo";10;100;0
0;122;"cresencia";122;0;100
6;0;"cresenciano";6;100;0
862;0;"cresencio";862;100;0
0;46;"cresha";46;0;100
10;0;"creshawn";10;100;0
0;5;"cresie";5;0;100
253;0;"crespin";253;100;0
10;0;"cress";10;100;0
0;41;"cressa";41;0;100
0;93;"cressida";93;0;100
0;310;"cressie";310;0;100
0;236;"cresta";236;0;100
0;61;"crestina";61;0;100
789;0;"creston";789;100;0
0;336;"creta";336;0;100
0;17;"cretia";17;0;100
0;5;"crettie";5;0;100
2746;5;"crew";2751;99.818247909851;0.181752090149037
86;0;"crewe";86;100;0
59;0;"crews";59;100;0
11;0;"creyton";11;100;0
45;0;"crhistopher";45;100;0
309;0;"criag";309;100;0
18;0;"crichton";18;100;0
0;562;"cricket";562;0;100
0;115;"crickett";115;0;100
295;891;"crimson";1186;24.8735244519393;75.1264755480607
0;6;"crimsyn";6;0;100
2872;1088;"cris";3960;72.5252525252525;27.4747474747475
6;0;"crisangel";6;100;0
0;5;"crisann";5;0;100
0;5;"crisanna";5;0;100
0;49;"crisanta";49;0;100
191;0;"crisanto";191;100;0
0;10;"crisbel";10;0;100
0;6;"criscia";6;0;100
0;24;"crisel";24;0;100
0;1646;"criselda";1646;0;100
0;6;"criselle";6;0;100
0;7;"crisette";7;0;100
0;16;"crisha";16;0;100
6;0;"crishaun";6;100;0
39;0;"crishawn";39;100;0
10;0;"crishon";10;100;0
0;5;"crisinda";5;0;100
0;134;"crislyn";134;0;100
0;42;"crislynn";42;0;100
0;10;"crisma";10;0;100
40;0;"crisoforo";40;100;0
0;64;"crisol";64;0;100
1678;5;"crispin";1683;99.7029114676174;0.29708853238265
0;23;"crispina";23;0;100
7;0;"crispus";7;100;0
556;114;"criss";670;82.9850746268657;17.0149253731343
0;420;"crissa";420;0;100
0;15;"crissandra";15;0;100
5;0;"crissangel";5;100;0
0;20;"crissey";20;0;100
0;48;"crissi";48;0;100
0;464;"crissie";464;0;100
0;5;"crisslyn";5;0;100
5;0;"crisstopher";5;100;0
0;2582;"crissy";2582;0;100
766;0;"crist";766;100;0
0;4232;"crista";4232;0;100
0;206;"cristabel";206;0;100
0;41;"cristabella";41;0;100
35;0;"cristain";35;100;0
55;15341;"cristal";15396;0.35723564562224;99.6427643543778
0;12;"cristalina";12;0;100
0;64;"cristalle";64;0;100
0;5;"cristaly";5;0;100
0;5;"cristalyn";5;0;100
160;203;"cristan";363;44.0771349862259;55.9228650137741
0;11;"cristee";11;0;100
0;5;"cristeen";5;0;100
0;721;"cristel";721;0;100
0;608;"cristela";608;0;100
0;18;"cristell";18;0;100
0;89;"cristella";89;0;100
0;41;"cristelle";41;0;100
126;2644;"cristen";2770;4.54873646209386;95.4512635379061
0;18;"cristena";18;0;100
0;33;"cristene";33;0;100
974;0;"cristhian";974;100;0
56;0;"cristhofer";56;100;0
0;3191;"cristi";3191;0;100
0;5;"cristia";5;0;100
60403;1114;"cristian";61517;98.1891184550612;1.8108815449388
0;822;"cristiana";822;0;100
0;89;"cristianna";89;0;100
2113;0;"cristiano";2113;100;0
0;2097;"cristie";2097;0;100
21;0;"cristien";21;100;0
120;4256;"cristin";4376;2.74223034734918;97.2577696526508
270;50865;"cristina";51135;0.528014080375477;99.4719859196245
0;4062;"cristine";4062;0;100
0;10;"cristinia";10;0;100
320;0;"cristino";320;100;0
43;0;"cristion";43;100;0
0;59;"cristle";59;0;100
1073;0;"cristo";1073;100;0
6903;11;"cristobal";6914;99.8409025166329;0.159097483367081
3585;0;"cristofer";3585;100;0
5;0;"cristoffer";5;100;0
100;0;"cristofher";100;100;0
0;62;"cristol";62;0;100
97;19;"criston";116;83.6206896551724;16.3793103448276
10596;0;"cristopher";10596;100;0
35;0;"cristos";35;100;0
422;0;"cristoval";422;100;0
56;8050;"cristy";8106;0.690846286701209;99.3091537132988
29;0;"cristyan";29;100;0
0;6;"cristyl";6;0;100
0;5;"cristyle";5;0;100
0;280;"cristyn";280;0;100
0;5;"cristyna";5;0;100
106;0;"crit";106;100;0
113;0;"crixus";113;100;0
5;0;"criztian";5;100;0
0;5;"crmen";5;0;100
264;0;"crockett";264;100;0
614;0;"croix";614;100;0
0;12;"crol";12;0;100
5;0;"cromer";5;100;0
34;0;"cromwell";34;100;0
0;5;"crosbie";5;0;100
3527;320;"crosby";3847;91.6818299974006;8.31817000259943
74;34;"crosley";108;68.5185185185185;31.4814814814815
860;0;"cross";860;100;0
5;0;"crossley";5;100;0
0;5;"crosslyn";5;0;100
12;0;"crowell";12;100;0
16;0;"crowley";16;100;0
6;0;"crown";6;100;0
47;0;"croy";47;100;0
0;5;"crstal";5;0;100
543;0;"cru";543;100;0
0;79;"crucita";79;0;100
530;0;"crue";530;100;0
300;0;"cruise";300;100;0
42;0;"cruiz";42;100;0
30;0;"cruize";30;100;0
15;0;"crus";15;100;0
31;0;"cruse";31;100;0
0;37;"crusita";37;0;100
15;0;"crusoe";15;100;0
0;7;"crustal";7;0;100
21214;3989;"cruz";25203;84.1725191445463;15.8274808554537
439;0;"cruze";439;100;0
0;257;"cruzita";257;0;100
331;0;"cruzito";331;100;0
0;15;"crys";15;0;100
0;38;"crysal";38;0;100
0;7;"crysania";7;0;100
0;7;"crysany";7;0;100
0;1771;"crysta";1771;0;100
0;5;"crystabel";5;0;100
1185;329191;"crystal";330376;0.358682228733322;99.6413177712667
0;150;"crystalann";150;0;100
0;203;"crystale";203;0;100
0;65;"crystalee";65;0;100
0;5;"crystalgayle";5;0;100
0;31;"crystalin";31;0;100
0;59;"crystalina";59;0;100
0;39;"crystaline";39;0;100
0;408;"crystall";408;0;100
0;56;"crystalle";56;0;100
0;74;"crystallee";74;0;100
0;66;"crystallynn";66;0;100
0;62;"crystalmarie";62;0;100
0;32;"crystalrose";32;0;100
0;647;"crystalyn";647;0;100
0;235;"crystalynn";235;0;100
0;28;"crystan";28;0;100
0;708;"crystel";708;0;100
0;5;"crystell";5;0;100
0;11;"crystella";11;0;100
0;77;"crystelle";77;0;100
0;154;"crysten";154;0;100
0;51;"crysti";51;0;100
332;0;"crystian";332;100;0
0;42;"crystiana";42;0;100
0;29;"crystianna";29;0;100
0;90;"crystie";90;0;100
0;11;"crystil";11;0;100
0;225;"crystin";225;0;100
0;622;"crystina";622;0;100
0;28;"crystine";28;0;100
0;27;"crystl";27;0;100
0;1187;"crystle";1187;0;100
5;0;"crystofer";5;100;0
0;208;"crystol";208;0;100
24;0;"crystopher";24;100;0
0;22;"crystral";22;0;100
0;10;"crystyl";10;0;100
0;5;"crystyle";5;0;100
0;89;"crytal";89;0;100
0;5;"csilla";5;0;100
5;0;"cuahtemoc";5;100;0
146;0;"cuahutemoc";146;100;0
1088;0;"cuauhtemoc";1088;100;0
6;0;"cuauhtli";6;100;0
7;0;"cub";7;100;0
47;499;"cuba";546;8.60805860805861;91.3919413919414
34;0;"cubby";34;100;0
5;0;"cubert";5;100;0
0;5;"cubia";5;0;100
11;43;"cubie";54;20.3703703703704;79.6296296296296
0;234;"cuca";234;0;100
76;0;"cuinn";76;100;0
22;0;"cuitlahuac";22;100;0
0;38;"cula";38;0;100
323;0;"cullan";323;100;0
0;5;"culleen";5;0;100
13532;106;"cullen";13638;99.2227599354744;0.77724006452559
80;0;"culley";80;100;0
20;0;"cullie";20;100;0
384;0;"cullin";384;100;0
5;0;"cullus";5;100;0
244;0;"cully";244;100;0
11;0;"cullyn";11;100;0
125;0;"culver";125;100;0
0;115;"cuma";115;0;100
0;97;"cumi";97;0;100
59;0;"cung";59;100;0
554;0;"cuong";554;100;0
7;0;"cupertino";7;100;0
6;0;"cupid";6;100;0
0;11;"cura";11;0;100
86;0;"curby";86;100;0
0;5;"curie";5;0;100
0;28;"curissa";28;0;100
42;0;"curits";42;100;0
5;0;"curl";5;100;0
375;43;"curlee";418;89.7129186602871;10.2870813397129
0;15;"curlene";15;0;100
2524;534;"curley";3058;82.5376062786135;17.4623937213865
173;360;"curlie";533;32.4577861163227;67.5422138836773
230;6;"curly";236;97.4576271186441;2.54237288135593
1071;30;"curran";1101;97.275204359673;2.72479564032698
462;0;"curren";462;100;0
195;54;"currie";249;78.3132530120482;21.6867469879518
5;0;"currin";5;100;0
5;0;"curron";5;100;0
1496;85;"curry";1581;94.6236559139785;5.37634408602151
0;77;"curstin";77;0;100
0;5;"curstyn";5;0;100
16518;0;"curt";16518;100;0
6;0;"curtavious";6;100;0
0;5;"curteria";5;0;100
0;5;"curtesha";5;0;100
76;0;"curtez";76;100;0
0;10;"curtia";10;0;100
32;0;"curtice";32;100;0
61;0;"curties";61;100;0
0;69;"curtina";69;0;100
255889;2303;"curtis";258192;99.1080281341018;0.891971865898246
0;30;"curtisa";30;0;100
0;303;"curtisha";303;0;100
5046;0;"curtiss";5046;100;0
0;13;"curtissa";13;0;100
0;70;"curtistine";70;0;100
0;5;"curtney";5;0;100
0;22;"curtrina";22;0;100
11;0;"curtus";11;100;0
445;0;"curvin";445;100;0
0;20;"cushena";20;0;100
124;0;"custer";124;100;0
6;0;"custodio";6;100;0
82;0;"cutberto";82;100;0
151;0;"cuthbert";151;100;0
0;52;"cutina";52;0;100
688;0;"cutler";688;100;0
1339;0;"cutter";1339;100;0
626;10;"cuyler";636;98.4276729559748;1.57232704402516
3356;16;"cy";3372;99.5255041518387;0.474495848161329
0;5;"cya";5;0;100
0;25;"cyaira";25;0;100
10;0;"cyaire";10;100;0
196;957;"cyan";1153;16.9991326973114;83.0008673026886
0;205;"cyana";205;0;100
0;7;"cyane";7;0;100
0;60;"cyani";60;0;100
0;264;"cyann";264;0;100
0;349;"cyanna";349;0;100
0;267;"cyanne";267;0;100
0;30;"cyanni";30;0;100
0;5;"cyanthia";5;0;100
0;258;"cyara";258;0;100
0;12;"cyarah";12;0;100
0;35;"cyarra";35;0;100
0;20;"cyasia";20;0;100
0;149;"cybele";149;0;100
0;26;"cybelle";26;0;100
0;531;"cybil";531;0;100
0;135;"cybill";135;0;100
0;556;"cyd";556;0;100
0;210;"cydne";210;0;100
0;922;"cydnee";922;0;100
0;53;"cydnei";53;0;100
25;4945;"cydney";4970;0.503018108651911;99.4969818913481
0;577;"cydni";577;0;100
0;384;"cydnie";384;0;100
0;5;"cydny";5;0;100
46;0;"cye";46;100;0
0;115;"cyenna";115;0;100
0;24;"cyenthia";24;0;100
0;148;"cyera";148;0;100
0;5;"cyerah";5;0;100
0;296;"cyerra";296;0;100
0;17;"cyinthia";17;0;100
6;0;"cyion";6;100;0
0;260;"cyla";260;0;100
0;54;"cylah";54;0;100
92;0;"cylan";92;100;0
42;0;"cylar";42;100;0
572;0;"cylas";572;100;0
1942;15;"cyle";1957;99.2335206949412;0.766479305058763
0;355;"cylee";355;0;100
0;193;"cyleigh";193;0;100
13;0;"cylen";13;100;0
0;6;"cylena";6;0;100
536;5;"cyler";541;99.0757855822551;0.924214417744917
0;414;"cylie";414;0;100
12;0;"cylin";12;100;0
0;78;"cylinda";78;0;100
324;0;"cylis";324;100;0
561;0;"cylus";561;100;0
0;5;"cylvia";5;0;100
9;0;"cymande";9;100;0
0;27;"cymantha";27;0;100
0;5;"cymbre";5;0;100
15;0;"cymon";15;100;0
0;461;"cymone";461;0;100
0;12;"cymphonique";12;0;100
0;18;"cymphony";18;0;100
0;19;"cynae";19;0;100
0;54;"cynai";54;0;100
0;11;"cynamon";11;0;100
0;136;"cynara";136;0;100
0;7;"cynarra";7;0;100
269;141;"cyncere";410;65.609756097561;34.390243902439
0;642;"cynda";642;0;100
0;225;"cyndal";225;0;100
0;264;"cynde";264;0;100
0;735;"cyndee";735;0;100
0;155;"cyndel";155;0;100
0;3540;"cyndi";3540;0;100
0;315;"cyndia";315;0;100
0;556;"cyndie";556;0;100
0;7;"cyndil";7;0;100
0;30;"cyndle";30;0;100
0;72;"cyndra";72;0;100
0;1395;"cyndy";1395;0;100
0;12;"cynequa";12;0;100
0;6;"cynetha";6;0;100
0;190;"cynethia";190;0;100
0;182;"cynia";182;0;100
0;232;"cyniah";232;0;100
0;5;"cynii";5;0;100
0;10;"cynita";10;0;100
0;391;"cynitha";391;0;100
0;220;"cynithia";220;0;100
0;18;"cyniya";18;0;100
0;49;"cyniyah";49;0;100
0;40;"cynnamon";40;0;100
0;16;"cynne";16;0;100
0;6;"cynnthia";6;0;100
0;17;"cynteria";17;0;100
0;279;"cyntha";279;0;100
0;286;"cynthea";286;0;100
0;11;"cyntheia";11;0;100
0;16;"cynthi";16;0;100
1961;707007;"cynthia";708968;0.276599225917108;99.7234007740829
0;5;"cynthiaa";5;0;100
0;5;"cynthiaann";5;0;100
0;60;"cynthie";60;0;100
0;53;"cynthina";53;0;100
0;60;"cynthis";60;0;100
0;6;"cynthnia";6;0;100
0;174;"cynthya";174;0;100
0;483;"cyntia";483;0;100
0;40;"cyntoria";40;0;100
0;5;"cyntrell";5;0;100
7;0;"cyon";7;100;0
0;28;"cyonna";28;0;100
38;0;"cypher";38;100;0
403;493;"cypress";896;44.9776785714286;55.0223214285714
240;0;"cyprian";240;100;0
108;10;"cyprus";118;91.5254237288136;8.47457627118644
0;585;"cyra";585;0;100
0;206;"cyrah";206;0;100
14;0;"cyrano";14;100;0
0;39;"cyre";39;0;100
63;0;"cyree";63;100;0
10;0;"cyrell";10;100;0
0;5;"cyrelle";5;0;100
0;799;"cyrena";799;0;100
0;152;"cyrene";152;0;100
0;29;"cyrenity";29;0;100
0;6;"cyrenna";6;0;100
29;0;"cyress";29;100;0
0;26;"cyria";26;0;100
0;101;"cyriah";101;0;100
0;17;"cyriana";17;0;100
30;0;"cyric";30;100;0
20;0;"cyrie";20;100;0
5;0;"cyriel";5;100;0
0;7;"cyrielle";7;0;100
11311;97;"cyril";11408;99.1497194950912;0.850280504908836
36;0;"cyrill";36;100;0
0;494;"cyrilla";494;0;100
25;6;"cyrille";31;80.6451612903226;19.3548387096774
0;42;"cyrina";42;0;100
0;37;"cyrine";37;0;100
252;0;"cyris";252;100;0
0;5;"cyrita";5;0;100
40;0;"cyron";40;100;0
0;962;"cyrstal";962;0;100
19519;5;"cyrus";19524;99.9743904937513;0.0256095062487195
94;0;"cyruss";94;100;0
40;0;"cyson";40;100;0
0;155;"cystal";155;0;100
0;405;"cythia";405;0;100
0;110;"cythina";110;0;100
0;108;"cythnia";108;0;100
0;38;"cytlali";38;0;100
0;5;"cytlalli";5;0;100
0;55;"cytlaly";55;0;100
0;5;"cytnhia";5;0;100
128;0;"czar";128;100;0
0;15;"czaria";15;0;100
0;360;"czarina";360;0;100
18;0;"czeslaw";18;100;0
0;45;"czeslawa";45;0;100
186;116;"da";302;61.5894039735099;38.4105960264901
76;0;"daaiel";76;100;0
0;17;"daaimah";17;0;100
0;78;"daaiyah";78;0;100
15;0;"daan";15;100;0
0;92;"daana";92;0;100
5;0;"daandre";5;100;0
0;29;"daania";29;0;100
99;0;"daanish";99;100;0
0;57;"daanya";57;0;100
16;0;"daanyal";16;100;0
0;47;"daarina";47;0;100
242;0;"daaron";242;100;0
0;10;"daasia";10;0;100
113;0;"dabid";113;100;0
5;0;"dabin";5;100;0
0;10;"dabne";10;0;100
226;372;"dabney";598;37.7926421404682;62.2073578595318
0;191;"dabria";191;0;100
6;0;"dabriel";6;100;0
0;5;"dabrielle";5;0;100
7;0;"dabriyon";7;100;0
214;0;"dacari";214;100;0
25;0;"dacarri";25;100;0
395;18;"dace";413;95.6416464891041;4.35835351089588
0;5;"dacee";5;0;100
73;0;"dacen";73;100;0
0;607;"dacey";607;0;100
0;23;"dache";23;0;100
0;107;"dachelle";107;0;100
0;15;"dachia";15;0;100
0;61;"daci";61;0;100
0;2665;"dacia";2665;0;100
240;0;"dacian";240;100;0
0;17;"daciana";17;0;100
5;136;"dacie";141;3.54609929078014;96.4539007092199
11;0;"dacien";11;100;0
5;0;"dacio";5;100;0
18;0;"dacion";18;100;0
50;0;"dack";50;100;0
526;116;"dacoda";642;81.9314641744548;18.0685358255452
11;0;"dacorey";11;100;0
56;0;"dacorian";56;100;0
22;0;"dacorion";22;100;0
484;182;"dacota";666;72.6726726726727;27.3273273273273
76;32;"dacotah";108;70.3703703703704;29.6296296296296
0;71;"dacy";71;0;100
21;0;"daddy";21;100;0
845;0;"dade";845;100;0
99;0;"daden";99;100;0
0;5;"dadne";5;0;100
0;5;"dadra";5;0;100
593;0;"dadrian";593;100;0
0;6;"dadriana";6;0;100
0;5;"dadrianna";5;0;100
31;0;"dadrien";31;100;0
117;63;"dae";180;65;35
5;13;"daebreon";18;27.7777777777778;72.2222222222222
0;5;"daebreona";5;0;100
7;0;"daedalus";7;100;0
0;34;"daedra";34;0;100
6;0;"daedrian";6;100;0
31;0;"daedric";31;100;0
764;48;"daegan";812;94.0886699507389;5.91133004926108
66;0;"daegen";66;100;0
70;0;"daegon";70;100;0
6;0;"daehan";6;100;0
0;5;"daeisha";5;0;100
0;715;"daeja";715;0;100
0;453;"daejah";453;0;100
0;36;"daejanae";36;0;100
0;20;"daejanay";20;0;100
5;0;"daejaun";5;100;0
0;23;"daejha";23;0;100
18;0;"daejhun";18;100;0
0;15;"daejia";15;0;100
5;0;"daejion";5;100;0
29;0;"daejohn";29;100;0
349;0;"daejon";349;100;0
47;0;"daejuan";47;100;0
5;0;"daekwan";5;100;0
220;0;"daekwon";220;100;0
203;0;"dael";203;100;0
0;24;"daela";24;0;100
289;0;"daelan";289;100;0
0;12;"daelani";12;0;100
268;0;"daelen";268;100;0
343;51;"daelin";394;87.0558375634518;12.9441624365482
246;0;"daelon";246;100;0
0;10;"daely";10;0;100
500;1074;"daelyn";1574;31.7662007623888;68.2337992376112
21;666;"daelynn";687;3.05676855895197;96.943231441048
12;0;"daemen";12;100;0
44;0;"daemeon";44;100;0
154;0;"daemian";154;100;0
125;0;"daemien";125;100;0
120;0;"daemion";120;100;0
1118;0;"daemon";1118;100;0
25;0;"daemond";25;100;0
118;0;"daemyn";118;100;0
0;596;"daena";596;0;100
0;358;"daenerys";358;0;100
0;5;"daenna";5;0;100
25;0;"daeon";25;100;0
0;29;"daeonna";29;0;100
763;0;"daequan";763;100;0
52;0;"daequon";52;100;0
10;0;"daeqwon";10;100;0
6;0;"daerion";6;100;0
90;0;"daeron";90;100;0
235;0;"daesean";235;100;0
0;674;"daesha";674;0;100
346;0;"daeshaun";346;100;0
751;5;"daeshawn";756;99.3386243386243;0.661375661375661
0;20;"daeshawna";20;0;100
0;20;"daeshia";20;0;100
178;0;"daeshon";178;100;0
20;0;"daeshun";20;100;0
0;65;"daesia";65;0;100
43;0;"daeson";43;100;0
0;5;"daesy";5;0;100
221;0;"daeton";221;100;0
0;6;"daeun";6;0;100
6;0;"daevaughn";6;100;0
200;0;"daeveon";200;100;0
10;0;"daevian";10;100;0
53;0;"daevin";53;100;0
449;0;"daevion";449;100;0
885;0;"daevon";885;100;0
6;0;"daevyn";6;100;0
6;0;"daewon";6;100;0
15;0;"daeyon";15;100;0
0;7;"daeyonna";7;0;100
0;16;"daezha";16;0;100
10;0;"daezon";10;100;0
0;46;"daffany";46;0;100
0;13;"daffie";13;0;100
0;52;"daffne";52;0;100
0;202;"daffney";202;0;100
0;8;"daffy";8;0;100
0;123;"dafina";123;0;100
0;74;"dafna";74;0;100
0;2100;"dafne";2100;0;100
0;34;"dafnee";34;0;100
0;90;"dafney";90;0;100
0;5;"dafni";5;0;100
0;7;"dafnne";7;0;100
0;54;"dafny";54;0;100
49;0;"dag";49;100;0
1014;10;"dagan";1024;99.0234375;0.9765625
42;0;"dagem";42;100;0
301;27;"dagen";328;91.7682926829268;8.23170731707317
5;0;"dagger";5;100;0
39;0;"dagim";39;100;0
0;1392;"dagmar";1392;0;100
0;6;"dagmara";6;0;100
145;0;"dagmawi";145;100;0
0;12;"dagne";12;0;100
0;50;"dagney";50;0;100
0;1352;"dagny";1352;0;100
109;0;"dago";109;100;0
1638;0;"dagoberto";1638;100;0
168;0;"dagon";168;100;0
15;0;"daguan";15;100;0
20;17;"dah";37;54.0540540540541;45.945945945946
0;11;"dahabo";11;0;100
0;16;"dahana";16;0;100
30;0;"dahani";30;100;0
0;179;"dahiana";179;0;100
0;5;"dahianna";5;0;100
115;0;"dahir";115;100;0
0;29;"dahja";29;0;100
147;0;"dahl";147;100;0
0;9926;"dahlia";9926;0;100
0;16;"dahliah";16;0;100
0;9;"dahliana";9;0;100
0;216;"dahlila";216;0;100
0;20;"dahlilah";20;0;100
5;0;"dahlin";5;100;0
5;0;"dahlon";5;100;0
115;0;"dahlton";115;100;0
0;51;"dahlya";51;0;100
0;36;"dahlyla";36;0;100
11;0;"dahmari";11;100;0
153;0;"dahmir";153;100;0
5;16;"dahn";21;23.8095238095238;76.1904761904762
0;56;"dahna";56;0;100
13;0;"dahndray";13;100;0
29;0;"dahntay";29;100;0
0;13;"dahnya";13;0;100
5;0;"dahquan";5;100;0
122;64;"dai";186;65.5913978494624;34.4086021505376
0;16;"daia";16;0;100
0;6;"daiah";6;0;100
16;0;"daian";16;100;0
0;940;"daiana";940;0;100
0;5;"daianera";5;0;100
0;106;"daianna";106;0;100
11;0;"daiceon";11;100;0
210;0;"daichi";210;100;0
0;52;"daicy";52;0;100
29;0;"daid";29;100;0
146;0;"daiden";146;100;0
0;5;"daidra";5;0;100
0;5;"daidre";5;0;100
6;0;"daidrian";6;100;0
398;0;"daiel";398;100;0
0;98;"daielle";98;0;100
35;0;"daigan";35;100;0
6;0;"daigen";6;100;0
5;0;"daigo";5;100;0
5;0;"daigon";5;100;0
5;0;"daiguan";5;100;0
0;2915;"daija";2915;0;100
0;2191;"daijah";2191;0;100
0;12;"daijana";12;0;100
0;111;"daijanae";111;0;100
0;5;"daijanay";5;0;100
5;0;"daijaun";5;100;0
0;247;"daijha";247;0;100
0;40;"daijia";40;0;100
0;5;"daijiah";5;0;100
5;0;"daijohn";5;100;0
653;5;"daijon";658;99.2401215805471;0.759878419452888
5;0;"daijour";5;100;0
0;12;"daijsha";12;0;100
20;0;"daijuan";20;100;0
107;0;"daiki";107;100;0
5;0;"daikwon";5;100;0
458;145;"dail";603;75.9535655058043;24.0464344941957
0;365;"daila";365;0;100
0;59;"dailah";59;0;100
117;0;"dailan";117;100;0
0;18;"dailani";18;0;100
0;24;"dailany";24;0;100
0;116;"dailee";116;0;100
0;42;"daileen";42;0;100
0;5;"daileigh";5;0;100
318;5;"dailen";323;98.4520123839009;1.54798761609907
0;19;"dailene";19;0;100
102;181;"dailey";283;36.0424028268551;63.9575971731449
26;94;"dailin";120;21.6666666666667;78.3333333333333
178;0;"dailon";178;100;0
73;148;"daily";221;33.0316742081448;66.9683257918552
251;857;"dailyn";1108;22.6534296028881;77.3465703971119
10;269;"dailynn";279;3.584229390681;96.415770609319
0;6;"dailynne";6;0;100
7;0;"daiman";7;100;0
10;0;"daimar";10;100;0
0;6;"daimarely";6;0;100
7;0;"daimarion";7;100;0
297;0;"daimen";297;100;0
59;0;"daimeon";59;100;0
196;0;"daimian";196;100;0
123;0;"daimien";123;100;0
76;0;"daimion";76;100;0
705;0;"daimon";705;100;0
0;5;"daimond";5;0;100
20;0;"daimyan";20;100;0
1872;0;"dain";1872;100;0
5;2433;"daina";2438;0.205086136177194;99.7949138638228
5;0;"dainan";5;100;0
0;10;"dainara";10;0;100
298;298;"daine";596;50;50
92;0;"dainel";92;100;0
0;67;"dainelle";67;0;100
17;0;"dainen";17;100;0
0;7;"dainera";7;0;100
0;14;"dainette";14;0;100
13;0;"dainian";13;100;0
0;5;"dainna";5;0;100
11;0;"dainon";11;100;0
0;6;"daintry";6;0;100
0;23;"dainty";23;0;100
219;0;"daion";219;100;0
0;40;"daiona";40;0;100
0;131;"daionna";131;0;100
754;0;"daiquan";754;100;0
0;42;"daiquiri";42;0;100
54;0;"daiquon";54;100;0
45;0;"dair";45;100;0
0;1039;"daira";1039;0;100
77;6;"daire";83;92.7710843373494;7.2289156626506
5;0;"dairel";5;100;0
5;0;"dairen";5;100;0
0;10;"dairian";10;0;100
0;40;"dairin";40;0;100
13;0;"dairion";13;100;0
18;0;"dairius";18;100;0
50;0;"dairl";50;100;0
26;0;"dairo";26;100;0
212;0;"dairon";212;100;0
0;10;"dairra";10;0;100
6;0;"dairus";6;100;0
0;36;"dairy";36;0;100
0;25;"dairyn";25;0;100
0;223;"daisa";223;0;100
0;21;"daise";21;0;100
164;0;"daisean";164;100;0
0;86;"daisee";86;0;100
0;2190;"daisey";2190;0;100
0;4478;"daisha";4478;0;100
0;5;"daishae";5;0;100
0;10;"daishana";10;0;100
0;13;"daishanae";13;0;100
0;6;"daishanay";6;0;100
263;0;"daishaun";263;100;0
520;0;"daishawn";520;100;0
0;96;"daishia";96;0;100
161;0;"daishon";161;100;0
15;0;"daishun";15;100;0
0;177;"daisi";177;0;100
0;435;"daisia";435;0;100
0;844;"daisie";844;0;100
0;100;"daisja";100;0;100
0;15;"daisjah";15;0;100
98;0;"daison";98;100;0
0;143;"daissy";143;0;100
132;0;"daisuke";132;100;0
586;126035;"daisy";126621;0.462798429960275;99.5372015700397
0;10;"daisya";10;0;100
0;5;"daisye";5;0;100
0;5;"daisylynn";5;0;100
0;34;"daisymae";34;0;100
0;5;"daisymarie";5;0;100
11;0;"daiten";11;100;0
5;0;"daithi";5;100;0
149;0;"daiton";149;100;0
0;6;"daityn";6;0;100
0;48;"daiva";48;0;100
1026;0;"daivd";1026;100;0
35;0;"daiven";35;100;0
186;0;"daiveon";186;100;0
15;0;"daivian";15;100;0
5;0;"daivid";5;100;0
46;0;"daivik";46;100;0
271;0;"daivion";271;100;0
626;0;"daivon";626;100;0
5;0;"daivyon";5;100;0
53;0;"daiwik";53;100;0
0;62;"daiya";62;0;100
26;0;"daiyaan";26;100;0
0;6;"daiyah";6;0;100
36;0;"daiyan";36;100;0
0;44;"daiyana";44;0;100
28;0;"daiyon";28;100;0
0;58;"daiza";58;0;100
0;44;"daizah";44;0;100
0;84;"daizee";84;0;100
0;170;"daizha";170;0;100
0;20;"daizhane";20;0;100
7;0;"daizhaun";7;100;0
11;0;"daizhon";11;100;0
0;19;"daizia";19;0;100
0;34;"daizie";34;0;100
0;14;"daizja";14;0;100
0;10;"daizjah";10;0;100
32;0;"daizon";32;100;0
0;15;"daizsa";15;0;100
0;599;"daizy";599;0;100
0;2331;"daja";2331;0;100
0;171;"dajae";171;0;100
7;1955;"dajah";1962;0.35677879714577;99.6432212028542
0;16;"dajaha";16;0;100
5;0;"dajahn";5;100;0
0;63;"dajahnae";63;0;100
0;5;"dajahnay";5;0;100
0;120;"dajai";120;0;100
6;0;"dajan";6;100;0
0;178;"dajana";178;0;100
0;679;"dajanae";679;0;100
0;37;"dajanai";37;0;100
0;139;"dajanay";139;0;100
0;67;"dajane";67;0;100
0;13;"dajanea";13;0;100
0;69;"dajanee";69;0;100
0;204;"dajanique";204;0;100
303;0;"dajaun";303;100;0
0;10;"dajauna";10;0;100
0;5;"dajavette";5;0;100
0;87;"daje";87;0;100
0;12;"dajea";12;0;100
24;0;"dajean";24;100;0
0;10;"dajee";10;0;100
0;149;"dajha";149;0;100
0;5;"dajhia";5;0;100
32;0;"dajhon";32;100;0
0;439;"dajia";439;0;100
0;75;"dajiah";75;0;100
0;15;"dajiana";15;0;100
110;0;"dajion";110;100;0
299;0;"dajohn";299;100;0
1584;70;"dajon";1654;95.7678355501814;4.23216444981862
0;12;"dajona";12;0;100
0;29;"dajonae";29;0;100
0;6;"dajonique";6;0;100
0;25;"dajonna";25;0;100
46;0;"dajoun";46;100;0
562;23;"dajour";585;96.0683760683761;3.93162393162393
5;0;"dajoure";5;100;0
0;100;"dajsha";100;0;100
0;5;"dajshia";5;0;100
0;6;"dajua";6;0;100
3319;0;"dajuan";3319;100;0
0;132;"dajuana";132;0;100
12;0;"dajun";12;100;0
5;0;"dajuon";5;100;0
0;5;"dajza";5;0;100
70;0;"dak";70;100;0
62;0;"dakai";62;100;0
8;0;"dakaiden";8;100;0
28;0;"dakar";28;100;0
0;12;"dakara";12;0;100
1139;18;"dakarai";1157;98.4442523768366;1.55574762316335
1698;107;"dakari";1805;94.0720221606648;5.92797783933518
0;49;"dakaria";49;0;100
25;0;"dakarie";25;100;0
16;0;"dakarii";16;100;0
10;0;"dakarion";10;100;0
62;0;"dakarri";62;100;0
12;0;"dakayden";12;100;0
0;443;"dakayla";443;0;100
11;0;"dake";11;100;0
26;0;"dakeem";26;100;0
0;18;"dakeisha";18;0;100
53;0;"daken";53;100;0
0;10;"dakera";10;0;100
0;16;"dakeria";16;0;100
0;11;"dakesha";11;0;100
156;0;"dakhari";156;100;0
6;0;"dakhi";6;100;0
0;16;"dakhia";16;0;100
0;102;"dakia";102;0;100
17;0;"dakim";17;100;0
63;0;"dakin";63;100;0
64;0;"daking";64;100;0
0;57;"dakira";57;0;100
0;56;"dakisha";56;0;100
0;24;"dakita";24;0;100
0;131;"dakiya";131;0;100
0;94;"dakiyah";94;0;100
41;6;"dakkota";47;87.2340425531915;12.7659574468085
25;0;"dakoata";25;100;0
10;0;"dakobe";10;100;0
2726;682;"dakoda";3408;79.9882629107981;20.0117370892019
47;33;"dakodah";80;58.75;41.25
7;0;"dakori";7;100;0
84136;30514;"dakota";114650;73.3850850414304;26.6149149585696
2910;1851;"dakotah";4761;61.1216131064902;38.8783868935098
5;0;"dakotajames";5;100;0
56;33;"dakotta";89;62.9213483146067;37.0786516853933
6;0;"daks";6;100;0
381;0;"daksh";381;100;0
0;74;"daksha";74;0;100
5;0;"daktari";5;100;0
5;0;"dakuan";5;100;0
82;0;"dakwan";82;100;0
89;0;"dakwon";89;100;0
0;6;"dakya";6;0;100
0;5;"dakyah";5;0;100
0;55;"dakyla";55;0;100
0;54;"dakyra";54;0;100
0;5;"dakyrah";5;0;100
583;0;"dal";583;100;0
0;269;"dala";269;0;100
0;5;"dalai";5;0;100
0;31;"dalaila";31;0;100
0;232;"dalaina";232;0;100
0;6;"dalaine";6;0;100
0;6;"dalainee";6;0;100
0;5;"dalainey";5;0;100
0;6;"dalajah";6;0;100
0;329;"dalal";329;0;100
531;0;"dalan";531;100;0
0;615;"dalana";615;0;100
0;5;"dalane";5;0;100
0;5;"dalanee";5;0;100
0;522;"dalaney";522;0;100
0;163;"dalani";163;0;100
0;249;"dalanie";249;0;100
0;15;"dalanna";15;0;100
17;0;"dalano";17;100;0
85;0;"dalante";85;100;0
0;12;"dalany";12;0;100
0;21;"dalari";21;0;100
0;20;"dalarie";20;0;100
0;839;"dalary";839;0;100
24;10;"dalas";34;70.5882352941177;29.4117647058824
0;5;"dalasha";5;0;100
0;70;"dalasia";70;0;100
0;38;"dalay";38;0;100
0;107;"dalaya";107;0;100
0;96;"dalayah";96;0;100
0;5;"dalayjah";5;0;100
0;124;"dalayla";124;0;100
0;10;"dalaylah";10;0;100
0;299;"dalayna";299;0;100
0;11;"dalaynee";11;0;100
0;11;"dalayni";11;0;100
0;10;"dalaynie";10;0;100
0;8;"dalaysa";8;0;100
0;36;"dalaysha";36;0;100
0;5;"dalayshia";5;0;100
0;140;"dalaysia";140;0;100
0;5;"dalayssa";5;0;100
0;91;"dalayza";91;0;100
320;0;"dalbert";320;100;0
276507;21765;"dale";298272;92.7029691020277;7.29703089797232
0;29;"dalea";29;0;100
0;214;"daleah";214;0;100
0;24;"dalecia";24;0;100
0;11;"dalee";11;0;100
0;227;"daleen";227;0;100
0;57;"daleena";57;0;100
0;9;"daleesa";9;0;100
0;56;"daleigh";56;0;100
0;5;"daleila";5;0;100
0;69;"daleisa";69;0;100
0;20;"daleisha";20;0;100
0;76;"daleiza";76;0;100
1766;16;"dalen";1782;99.1021324354658;0.897867564534231
0;1020;"dalena";1020;0;100
0;1575;"dalene";1575;0;100
0;16;"dalenna";16;0;100
94;0;"daleon";94;100;0
18;0;"daler";18;100;0
0;11;"dalerie";11;0;100
0;21;"dalery";21;0;100
0;5;"dalesa";5;0;100
0;63;"dalesha";63;0;100
0;5;"daleshia";5;0;100
0;5;"dalesia";5;0;100
159;0;"dalessandro";159;100;0
0;7;"dalet";7;0;100
0;30;"daleth";30;0;100
5;0;"dalevon";5;100;0
0;76;"dalexa";76;0;100
0;5;"dalexia";5;0;100
115;394;"daley";509;22.5933202357564;77.4066797642436
0;5;"daleya";5;0;100
0;14;"daleyah";14;0;100
0;357;"daleysa";357;0;100
0;14;"daleysha";14;0;100
0;5;"daleysi";5;0;100
0;71;"daleyssa";71;0;100
0;4734;"daleyza";4734;0;100
0;22;"daleyzah";22;0;100
0;5;"daleyzza";5;0;100
8;0;"dalhart";8;100;0
0;10;"dalhia";10;0;100
34;102;"dali";136;25;75
6;11725;"dalia";11731;0.0511465348222658;99.9488534651777
0;557;"daliah";557;0;100
21;0;"dalian";21;100;0
0;177;"daliana";177;0;100
0;5;"dalianna";5;0;100
5;0;"dalibor";5;100;0
0;33;"dalice";33;0;100
0;180;"dalicia";180;0;100
0;23;"dalida";23;0;100
0;16;"dalijah";16;0;100
5;0;"dalil";5;100;0
0;4874;"dalila";4874;0;100
0;3257;"dalilah";3257;0;100
425;27;"dalin";452;94.0265486725664;5.97345132743363
0;418;"dalina";418;0;100
0;388;"dalinda";388;0;100
11;261;"dalis";272;4.04411764705882;95.9558823529412
0;334;"dalisa";334;0;100
0;329;"dalisha";329;0;100
0;5;"dalisia";5;0;100
0;105;"dalissa";105;0;100
0;87;"daliya";87;0;100
0;789;"daliyah";789;0;100
0;10;"daliyla";10;0;100
0;16;"daliylah";16;0;100
0;57;"daliza";57;0;100
6;0;"dall";6;100;0
0;5;"dallace";5;0;100
666;0;"dallan";666;100;0
0;462;"dallana";462;0;100
0;58;"dallanara";58;0;100
0;5;"dallary";5;0;100
58531;11615;"dallas";70146;83.44167878425;16.55832121575
0;6;"dallee";6;0;100
1050;0;"dallen";1050;100;0
0;5;"dallene";5;0;100
33;0;"dalles";33;100;0
0;31;"dalli";31;0;100
10;459;"dallie";469;2.13219616204691;97.8678038379531
4820;0;"dallin";4820;100;0
6;0;"dallion";6;100;0
838;653;"dallis";1491;56.2038900067069;43.7961099932931
601;0;"dallon";601;100;0
5;0;"dallton";5;100;0
0;169;"dally";169;0;100
0;41;"dallyce";41;0;100
194;25;"dallyn";219;88.5844748858447;11.4155251141553
0;105;"dallys";105;0;100
0;104;"dalma";104;0;100
10;0;"dalmar";10;100;0
21;0;"dalmer";21;100;0
693;0;"dalon";693;100;0
0;63;"dalonda";63;0;100
0;5;"dalonna";5;0;100
22;0;"dalonta";22;100;0
59;0;"dalontae";59;100;0
264;0;"dalonte";264;100;0
5;0;"dalonzo";5;100;0
0;68;"dalores";68;0;100
0;5;"daloris";5;0;100
0;11;"dalpha";11;0;100
0;257;"dalphine";257;0;100
7;0;"dalphus";7;100;0
5;0;"dalshawn";5;100;0
40;0;"dalson";40;100;0
30;0;"dalston";30;100;0
10;0;"daltan";10;100;0
338;0;"dalten";338;100;0
198;0;"daltin";198;100;0
79397;396;"dalton";79793;99.5037158648002;0.49628413519983
6;0;"daltry";6;100;0
286;0;"daltyn";286;100;0
0;5;"dalva";5;0;100
10;0;"dalven";10;100;0
1493;0;"dalvin";1493;100;0
22;0;"dalvon";22;100;0
12;0;"dalvyn";12;100;0
38;255;"daly";293;12.9692832764505;87.0307167235495
0;464;"dalya";464;0;100
0;49;"dalyah";49;0;100
0;86;"dalyce";86;0;100
0;430;"dalyla";430;0;100
0;339;"dalylah";339;0;100
770;373;"dalyn";1143;67.3665791776028;32.6334208223972
44;382;"dalynn";426;10.3286384976526;89.6713615023474
7;17;"dalys";24;29.1666666666667;70.8333333333333
0;5;"dalyss";5;0;100
0;10;"dalyssa";10;0;100
12;0;"dalziel";12;100;0
69;0;"dam";69;100;0
0;181;"dama";181;0;100
271;0;"damacio";271;100;0
0;5;"damaiah";5;0;100
361;0;"damain";361;100;0
33;0;"damaine";33;100;0
5;0;"damaire";5;100;0
0;27;"damaiya";27;0;100
10;0;"damaj";10;100;0
7;0;"damajae";7;100;0
17;0;"damajah";17;100;0
6;0;"damaje";6;100;0
5;0;"damal";5;100;0
0;333;"damali";333;0;100
649;0;"daman";649;100;0
2028;491;"damani";2519;80.5081381500596;19.4918618499405
99;0;"damante";99;100;0
89;0;"damany";89;100;0
983;5;"damar";988;99.4939271255061;0.506072874493927
0;944;"damara";944;0;100
5;0;"damarae";5;100;0
697;0;"damarco";697;100;0
3018;0;"damarcus";3018;100;0
113;0;"damare";113;100;0
150;10;"damarea";160;93.75;6.25
116;0;"damaree";116;100;0
5;0;"damareion";5;100;0
139;0;"damareon";139;100;0
3181;632;"damari";3813;83.4251245738264;16.5748754261736
69;367;"damaria";436;15.8256880733945;84.1743119266055
36;0;"damariae";36;100;0
0;58;"damariah";58;0;100
332;0;"damarian";332;100;0
0;14;"damariana";14;0;100
5;0;"damariay";5;100;0
99;44;"damarie";143;69.2307692307692;30.7692307692308
122;0;"damarien";122;100;0
6;0;"damarieon";6;100;0
25;0;"damarii";25;100;0
1180;0;"damario";1180;100;0
4056;0;"damarion";4056;100;0
0;12;"damariona";12;0;100
298;0;"damarious";298;100;0
512;11458;"damaris";11970;4.27736006683375;95.7226399331662
1336;0;"damarius";1336;100;0
0;17;"damariya";17;0;100
5;0;"damariye";5;100;0
33;0;"damariyon";33;100;0
0;387;"damariz";387;0;100
15;0;"damarkis";15;100;0
106;0;"damarko";106;100;0
282;0;"damarkus";282;100;0
5;0;"damarlo";5;100;0
24;0;"damarques";24;100;0
5;0;"damarquez";5;100;0
56;0;"damarquis";56;100;0
46;0;"damarr";46;100;0
5;0;"damarrea";5;100;0
130;0;"damarri";130;100;0
0;19;"damarria";19;0;100
246;0;"damarrion";246;100;0
45;0;"damarrius";45;100;0
5;0;"damarte";5;100;0
11;0;"damarus";11;100;0
0;379;"damary";379;0;100
10;0;"damaryon";10;100;0
0;504;"damarys";504;0;100
98;0;"damascus";98;100;0
5;0;"damase";5;100;0
11;0;"damasio";11;100;0
274;0;"damaso";274;100;0
21;0;"damato";21;100;0
6;0;"damauni";6;100;0
280;0;"damauri";280;100;0
12;0;"damaurion";12;100;0
18;0;"damaury";18;100;0
0;424;"damaya";424;0;100
0;23;"damayah";23;0;100
0;14;"damayanti";14;0;100
0;11;"damayia";11;0;100
0;38;"damber";38;0;100
463;0;"damean";463;100;0
0;17;"damecia";17;0;100
104;0;"dameer";104;100;0
163;0;"dameian";163;100;0
0;5;"dameika";5;0;100
1022;0;"damein";1022;100;0
870;0;"dameion";870;100;0
53;0;"dameir";53;100;0
0;88;"dameisha";88;0;100
62;0;"damek";62;100;0
0;240;"dameka";240;0;100
0;5;"damekia";5;0;100
10;0;"dameko";10;100;0
64;0;"damel";64;100;0
5;0;"damell";5;100;0
2258;0;"damen";2258;100;0
4062;0;"dameon";4062;100;0
0;5;"damera";5;0;100
189;0;"damere";189;100;0
0;47;"dameria";47;0;100
28;0;"damerion";28;100;0
35;0;"damerius";35;100;0
39;15;"dameron";54;72.2222222222222;27.7777777777778
0;281;"damesha";281;0;100
0;58;"dameshia";58;0;100
0;5;"dameta";5;0;100
0;78;"dametra";78;0;100
5;0;"dametre";5;100;0
102;0;"dametri";102;100;0
0;257;"dametria";257;0;100
0;5;"dametrice";5;0;100
5;0;"dametrious";5;100;0
10;0;"dametris";10;100;0
352;0;"dametrius";352;100;0
47;0;"dameyon";47;100;0
10;0;"dameyune";10;100;0
0;11;"dami";11;0;100
0;974;"damia";974;0;100
0;312;"damiah";312;0;100
5;0;"damiam";5;100;0
79623;321;"damian";79944;99.5984689282498;0.401531071750225
0;632;"damiana";632;0;100
31;0;"damiane";31;100;0
5;0;"damiani";5;100;0
10;0;"damiann";10;100;0
0;16;"damianna";16;0;100
399;0;"damiano";399;100;0
0;63;"damica";63;0;100
98;0;"damichael";98;100;0
70;0;"damico";70;100;0
6;34;"damie";40;15;85
76;0;"damiean";76;100;0
83;0;"damiel";83;100;0
0;5;"damielle";5;0;100
54217;260;"damien";54477;99.5227343649614;0.47726563503864
5;0;"damiene";5;100;0
194;0;"damieon";194;100;0
217;0;"damier";217;100;0
23;0;"damiere";23;100;0
0;6;"damiesha";6;0;100
0;381;"damika";381;0;100
5;0;"damilare";5;100;0
43;156;"damilola";199;21.608040201005;78.391959798995
539;0;"damin";539;100;0
0;5;"damina";5;0;100
40;0;"damine";40;100;0
0;46;"damini";46;0;100
15895;39;"damion";15934;99.7552403665119;0.244759633488139
96;0;"damione";96;100;0
0;5;"damionna";5;0;100
1388;5;"damir";1393;99.6410624551328;0.358937544867193
0;167;"damira";167;0;100
0;10;"damiracle";10;0;100
0;11;"damirah";11;0;100
56;0;"damire";56;100;0
0;171;"damisha";171;0;100
0;5;"damishia";5;0;100
6;0;"damisi";6;100;0
11;0;"damiso";11;100;0
0;1506;"damita";1506;0;100
0;40;"damitra";40;0;100
38;0;"damitri";38;100;0
6;0;"damitrius";6;100;0
5;0;"damiun";5;100;0
26;0;"damius";26;100;0
0;697;"damiya";697;0;100
0;770;"damiyah";770;0;100
6;0;"damiyan";6;100;0
36;0;"damiyon";36;100;0
0;11;"damla";11;0;100
7;0;"dammian";7;100;0
16;0;"dammion";16;100;0
79;0;"dammon";79;100;0
0;15;"damne";15;0;100
62489;316;"damon";62805;99.496855345912;0.50314465408805
0;10;"damona";10;0;100
2038;5;"damond";2043;99.7552618697993;0.244738130200685
71;0;"damondre";71;100;0
1191;0;"damone";1191;100;0
10;0;"damonee";10;100;0
5;0;"damonei";5;100;0
64;0;"damoney";64;100;0
824;290;"damoni";1114;73.967684021544;26.032315978456
0;183;"damonica";183;0;100
169;76;"damonie";245;68.9795918367347;31.0204081632653
10;0;"damonii";10;100;0
0;215;"damonique";215;0;100
22;0;"damonn";22;100;0
5;0;"damonni";5;100;0
5;0;"damonnie";5;100;0
332;0;"damont";332;100;0
297;0;"damonta";297;100;0
531;0;"damontae";531;100;0
152;0;"damontay";152;100;0
1495;0;"damonte";1495;100;0
55;0;"damontez";55;100;0
15;0;"damontra";15;100;0
7;0;"damontrae";7;100;0
14;0;"damontray";14;100;0
148;0;"damontre";148;100;0
15;0;"damori";15;100;0
32;0;"damorian";32;100;0
39;0;"damorion";39;100;0
11;0;"damorris";11;100;0
34;0;"damu";34;100;0
5;0;"damus";5;100;0
0;1224;"damya";1224;0;100
0;217;"damyah";217;0;100
349;0;"damyan";349;100;0
151;0;"damyen";151;100;0
0;153;"damyia";153;0;100
0;79;"damyiah";79;0;100
0;41;"damyla";41;0;100
86;0;"damyn";86;100;0
178;0;"damyon";178;100;0
0;85;"damyra";85;0;100
0;31;"damyria";31;0;100
5;0;"damyrion";5;100;0
5;0;"damyron";5;100;0
103041;545;"dan";103586;99.473867124901;0.526132875098952
52839;191073;"dana";243912;21.6631408048804;78.3368591951195
0;16;"danaca";16;0;100
6;6461;"danae";6467;0.0927787227462502;99.9072212772538
0;28;"danaeja";28;0;100
0;32;"danaejah";32;0;100
0;937;"danah";937;0;100
0;10;"danahe";10;0;100
0;56;"danahi";56;0;100
5;282;"danai";287;1.74216027874564;98.2578397212544
0;5;"danaia";5;0;100
0;72;"danaija";72;0;100
0;59;"danaijah";59;0;100
6;0;"danail";6;100;0
0;5;"danaira";5;0;100
0;30;"danaisa";30;0;100
0;202;"danaisha";202;0;100
0;12;"danait";12;0;100
0;61;"danaiya";61;0;100
0;5;"danaiyah";5;0;100
0;251;"danaja";251;0;100
0;260;"danajah";260;0;100
0;26;"danajha";26;0;100
0;32;"danajia";32;0;100
0;139;"danaka";139;0;100
10;0;"danal";10;100;0
5;0;"danald";5;100;0
0;90;"danalee";90;0;100
0;60;"danali";60;0;100
0;88;"danaly";88;0;100
0;55;"danalyn";55;0;100
0;33;"danalynn";33;0;100
0;163;"danamarie";163;0;100
43;0;"danan";43;100;0
0;23;"danapaola";23;0;100
0;39;"danara";39;0;100
20;0;"danard";20;100;0
30;13;"danari";43;69.7674418604651;30.2325581395349
0;71;"danaria";71;0;100
0;5;"danariah";5;0;100
121;0;"danarius";121;100;0
0;273;"danasha";273;0;100
0;158;"danashia";158;0;100
0;1290;"danasia";1290;0;100
0;5;"danautica";5;0;100
0;7;"danavia";7;0;100
0;620;"danay";620;0;100
0;682;"danaya";682;0;100
0;128;"danayah";128;0;100
0;6;"danayara";6;0;100
0;67;"danaye";67;0;100
0;5;"danayia";5;0;100
0;34;"danayja";34;0;100
0;5;"danayjah";5;0;100
0;27;"danayla";27;0;100
0;194;"danaysha";194;0;100
0;9;"danayshia";9;0;100
0;170;"danaysia";170;0;100
0;6;"danaysy";6;0;100
0;5;"danazha";5;0;100
0;32;"danazia";32;0;100
0;5;"dancia";5;0;100
0;14;"dancy";14;0;100
0;10;"dandi";10;0;100
60;605;"dandra";665;9.02255639097744;90.9774436090226
61;0;"dandrae";61;100;0
7101;37;"dandre";7138;99.4816475203138;0.518352479686187
174;910;"dandrea";1084;16.0516605166052;83.9483394833948
5;0;"dandrell";5;100;0
51;0;"dandrew";51;100;0
0;88;"dandria";88;0;100
5;0;"dandrick";5;100;0
16;0;"dandridge";16;100;0
100;5;"dandy";105;95.2380952380952;4.76190476190476
31028;376;"dane";31404;98.8027002929563;1.19729970704369
0;494;"danea";494;0;100
0;25;"daneah";25;0;100
21;6;"daneal";27;77.7777777777778;22.2222222222222
0;127;"danean";127;0;100
0;5;"daneca";5;0;100
0;64;"danecia";64;0;100
0;560;"danee";560;0;100
0;11;"daneeka";11;0;100
16;0;"daneel";16;100;0
0;1298;"daneen";1298;0;100
0;72;"daneesha";72;0;100
0;19;"daneida";19;0;100
0;10;"daneika";10;0;100
1211;32;"daneil";1243;97.4255832662912;2.57441673370877
0;5;"daneila";5;0;100
0;476;"daneille";476;0;100
0;678;"daneisha";678;0;100
0;10;"daneisy";10;0;100
0;30;"daneja";30;0;100
30;0;"danek";30;100;0
0;201;"daneka";201;0;100
318;147;"danel";465;68.3870967741936;31.6129032258064
0;12;"danela";12;0;100
0;46;"danele";46;0;100
0;90;"daneli";90;0;100
0;96;"danelia";96;0;100
0;15;"danelis";15;0;100
386;1266;"danell";1652;23.365617433414;76.634382566586
0;821;"danella";821;0;100
46;7039;"danelle";7085;0.649258997882851;99.3507410021171
0;267;"danelly";267;0;100
0;313;"danely";313;0;100
0;19;"danelys";19;0;100
58;0;"danen";58;100;0
0;321;"danene";321;0;100
0;25;"danequa";25;0;100
0;5;"danera";5;0;100
0;5;"danery";5;0;100
0;29;"danesa";29;0;100
0;87;"danese";87;0;100
12;0;"danesh";12;100;0
0;1290;"danesha";1290;0;100
0;258;"daneshia";258;0;100
0;21;"danesia";21;0;100
0;679;"danessa";679;0;100
0;11;"danet";11;0;100
0;55;"danetra";55;0;100
0;8;"danetria";8;0;100
0;143;"danett";143;0;100
0;891;"danetta";891;0;100
0;10323;"danette";10323;0;100
11;62;"daney";73;15.0684931506849;84.9315068493151
0;79;"daneya";79;0;100
0;5;"daneyah";5;0;100
0;5;"daneysha";5;0;100
374;0;"danford";374;100;0
24;0;"danforth";24;100;0
298;6;"dang";304;98.0263157894737;1.97368421052632
23;15;"dangel";38;60.5263157894737;39.4736842105263
0;366;"dangela";366;0;100
7;0;"dangello";7;100;0
7341;0;"dangelo";7341;100;0
48;0;"danger";48;100;0
5;0;"dangkhoa";5;100;0
216;0;"danh";216;100;0
832;7177;"dani";8009;10.3883131477088;89.6116868522912
5;6894;"dania";6899;0.0724742716335701;99.9275257283664
0;408;"daniah";408;0;100
9123;80;"danial";9203;99.1307182440509;0.869281755949147
0;10;"daniale";10;0;100
0;155;"danialle";155;0;100
55;0;"danian";55;100;0
0;5;"daniana";5;0;100
0;5;"daniaya";5;0;100
0;14676;"danica";14676;0;100
0;12;"danicah";12;0;100
0;695;"danice";695;0;100
0;100;"danicia";100;0;100
0;175;"danicka";175;0;100
546;261;"danie";807;67.6579925650558;32.3420074349442
18;29;"danieal";47;38.2978723404255;61.7021276595745
0;26;"daniece";26;0;100
0;7;"danieka";7;0;100
1884637;8145;"daniel";1892782;99.5696810303564;0.430318969643625
163;56836;"daniela";56999;0.285969929297005;99.714030070703
5;0;"danield";5;100;0
749;3546;"daniele";4295;17.4388824214203;82.5611175785797
0;5;"danielee";5;0;100
0;5;"danielia";5;0;100
0;11;"danielis";11;0;100
0;30;"danieliz";30;0;100
33;0;"danieljames";33;100;0
12;0;"danieljohn";12;100;0
21;0;"danieljoseph";21;100;0
13;0;"danieljr";13;100;0
798;2048;"daniell";2846;28.0393534785664;71.9606465214336
6;27143;"daniella";27149;0.0221002615197613;99.9778997384802
0;6;"daniellah";6;0;100
1895;365380;"danielle";367275;0.515962153699544;99.4840378463005
10;0;"daniellee";10;100;0
0;16;"daniellemarie";16;0;100
0;6;"daniellerose";6;0;100
0;27;"daniellie";27;0;100
0;70;"danielly";70;0;100
34;0;"daniels";34;100;0
5;0;"danielson";5;100;0
0;32;"daniely";32;0;100
0;7;"danielynn";7;0;100
0;49;"danielys";49;0;100
15;0;"danien";15;100;0
0;232;"daniesha";232;0;100
0;5;"daniette";5;0;100
196;0;"daniil";196;100;0
0;70;"danija";70;0;100
0;183;"danijah";183;0;100
6;0;"danijel";6;100;0
0;63;"danijela";63;0;100
22;0;"danik";22;100;0
0;9626;"danika";9626;0;100
0;93;"danikah";93;0;100
0;44;"danikka";44;0;100
194;0;"danil";194;100;0
25;127;"danila";152;16.4473684210526;83.5526315789474
0;35;"danilah";35;0;100
190;5;"danile";195;97.4358974358974;2.56410256410256
0;21;"danilee";21;0;100
0;5;"danilla";5;0;100
0;702;"danille";702;0;100
0;12;"danillie";12;0;100
2991;0;"danilo";2991;100;0
0;122;"danilyn";122;0;100
0;191;"danilynn";191;0;100
0;41;"danina";41;0;100
0;291;"danine";291;0;100
5;0;"danion";5;100;0
0;186;"daniqua";186;0;100
0;134;"danique";134;0;100
0;158;"danira";158;0;100
103;31;"danis";134;76.865671641791;23.134328358209
0;87;"danisa";87;0;100
0;866;"danise";866;0;100
352;0;"danish";352;100;0
0;2333;"danisha";2333;0;100
0;53;"danishia";53;0;100
0;91;"danissa";91;0;100
0;15;"danit";15;0;100
0;7489;"danita";7489;0;100
0;358;"danitra";358;0;100
0;164;"danity";164;0;100
0;844;"danitza";844;0;100
0;37;"danixa";37;0;100
0;1305;"daniya";1305;0;100
0;1238;"daniyah";1238;0;100
561;0;"daniyal";561;100;0
26;0;"daniyel";26;100;0
0;50;"daniyla";50;0;100
0;29;"daniylah";29;0;100
0;5;"daniza";5;0;100
0;5;"danja";5;0;100
0;5;"danka";5;0;100
5;0;"danl";5;100;0
26;0;"danley";26;100;0
1090;1145;"dann";2235;48.7695749440716;51.2304250559284
135;18081;"danna";18216;0.741106719367589;99.2588932806324
0;129;"dannae";129;0;100
0;534;"dannah";534;0;100
0;6;"dannaka";6;0;100
0;13;"dannalee";13;0;100
0;20;"dannaly";20;0;100
0;5;"dannalyn";5;0;100
0;26;"dannan";26;0;100
0;20;"dannapaola";20;0;100
0;5;"dannay";5;0;100
175;479;"danne";654;26.7584097859327;73.2415902140673
0;5;"dannea";5;0;100
0;5;"dannee";5;0;100
114;20;"dannel";134;85.0746268656716;14.9253731343284
142;234;"dannell";376;37.7659574468085;62.2340425531915
0;378;"dannelle";378;0;100
0;18;"dannely";18;0;100
5;0;"dannen";5;100;0
318;5;"danner";323;98.4520123839009;1.54798761609907
0;20;"dannesha";20;0;100
0;38;"dannett";38;0;100
0;148;"dannetta";148;0;100
0;2155;"dannette";2155;0;100
512;5;"danney";517;99.0328820116054;0.967117988394584
72;2050;"danni";2122;3.39302544769086;96.6069745523091
0;333;"dannia";333;0;100
39;0;"dannial";39;100;0
0;431;"dannica";431;0;100
0;5;"dannicka";5;0;100
8894;2079;"dannie";10973;81.0534949421307;18.9465050578693
2320;186;"danniel";2506;92.5778132482043;7.42218675179569
0;149;"danniela";149;0;100
0;51;"danniele";51;0;100
0;122;"danniell";122;0;100
0;159;"danniella";159;0;100
0;4039;"dannielle";4039;0;100
0;6;"dannielyn";6;0;100
0;52;"dannielynn";52;0;100
0;537;"dannika";537;0;100
0;10;"dannille";10;0;100
0;5;"dannilyn";5;0;100
0;54;"dannilynn";54;0;100
18;0;"dannion";18;100;0
181;0;"dannis";181;100;0
0;64;"dannisha";64;0;100
0;14;"dannita";14;0;100
487;92;"dannon";579;84.1105354058722;15.8894645941278
282070;1571;"danny";283641;99.4461308485022;0.553869151497844
0;62;"dannya";62;0;100
50;14;"dannye";64;78.125;21.875
11;0;"dannyel";11;100;0
0;15;"dannyell";15;0;100
0;55;"dannyelle";55;0;100
0;5;"dannylynn";5;0;100
5;0;"dannyray";5;100;0
36;0;"dano";36;100;0
261;30;"danon";291;89.6907216494845;10.3092783505155
6;0;"danovan";6;100;0
10;0;"danquan";10;100;0
9;0;"dansby";9;100;0
28;0;"danson";28;100;0
398;10;"danta";408;97.5490196078431;2.45098039215686
498;0;"dantae";498;100;0
0;16;"dantasia";16;0;100
160;0;"dantavious";160;100;0
11;0;"dantavis";11;100;0
36;0;"dantavius";36;100;0
30;0;"dantay";30;100;0
41779;460;"dante";42239;98.9109590662658;1.08904093373423
5;0;"dantee";5;100;0
5;0;"dantel";5;100;0
6;0;"danterius";6;100;0
5;0;"danterrius";5;100;0
6;0;"dantes";6;100;0
27;0;"dantez";27;100;0
1425;0;"danthony";1425;100;0
6;0;"danti";6;100;0
5;0;"dantley";5;100;0
0;6;"dantoinette";6;0;100
558;0;"danton";558;100;0
11;0;"dantoni";11;100;0
170;0;"dantonio";170;100;0
65;0;"dantre";65;100;0
19;0;"dantrel";19;100;0
587;0;"dantrell";587;100;0
22;0;"dantwan";22;100;0
5;0;"danual";5;100;0
280;5;"danuel";285;98.2456140350877;1.75438596491228
0;142;"danuta";142;0;100
0;11;"danute";11;0;100
1127;111;"dany";1238;91.0339256865913;8.96607431340872
29;3287;"danya";3316;0.874547647768396;99.1254523522316
17;0;"danyaal";17;100;0
0;5;"danyae";5;0;100
69;0;"danyael";69;100;0
0;192;"danyah";192;0;100
0;12;"danyail";12;0;100
451;176;"danyal";627;71.9298245614035;28.0701754385965
50;927;"danyale";977;5.11770726714432;94.8822927328557
0;6;"danyall";6;0;100
0;25;"danyalle";25;0;100
0;10;"danyca";10;0;100
41;12;"danye";53;77.3584905660377;22.6415094339623
0;5;"danyea";5;0;100
0;59;"danyeal";59;0;100
0;6;"danyeil";6;0;100
655;2504;"danyel";3159;20.7344096232985;79.2655903767015
0;192;"danyela";192;0;100
0;327;"danyele";327;0;100
324;2512;"danyell";2836;11.4245416078984;88.5754583921016
0;385;"danyella";385;0;100
37;5672;"danyelle";5709;0.648099492030128;99.3519005079699
0;104;"danyetta";104;0;100
0;22;"danyette";22;0;100
0;90;"danyia";90;0;100
0;51;"danyiah";51;0;100
0;89;"danyiel";89;0;100
0;15;"danyielle";15;0;100
0;217;"danyka";217;0;100
0;5;"danykah";5;0;100
75;59;"danyl";134;55.9701492537313;44.0298507462687
0;319;"danyla";319;0;100
0;104;"danylah";104;0;100
0;161;"danyle";161;0;100
0;5;"danyll";5;0;100
0;128;"danylle";128;0;100
50;0;"danylo";50;100;0
0;6;"danyne";6;0;100
98;0;"danyon";98;100;0
0;11;"danyra";11;0;100
0;36;"danysha";36;0;100
0;12;"danytza";12;0;100
557;0;"danzel";557;100;0
199;0;"danzell";199;100;0
13;0;"danzelle";13;100;0
5;0;"danziel";5;100;0
64;0;"danzig";64;100;0
189;88;"dao";277;68.2310469314079;31.7689530685921
16;0;"daon";16;100;0
0;18;"daonna";18;0;100
30;0;"daonte";30;100;0
214;0;"daoud";214;100;0
93;0;"daouda";93;100;0
0;488;"daphane";488;0;100
0;461;"daphanie";461;0;100
0;6;"daphen";6;0;100
0;578;"daphene";578;0;100
0;1496;"daphine";1496;0;100
0;634;"daphna";634;0;100
7;34081;"daphne";34088;0.020535085660643;99.9794649143394
0;347;"daphnee";347;0;100
0;1405;"daphney";1405;0;100
0;31;"daphni";31;0;100
0;754;"daphnie";754;0;100
0;48;"daphny";48;0;100
0;110;"daphyne";110;0;100
47;0;"daquain";47;100;0
7505;6;"daquan";7511;99.9201171614965;0.0798828385035282
0;100;"daquana";100;0;100
0;5;"daquanda";5;0;100
10;0;"daquandre";10;100;0
161;0;"daquane";161;100;0
143;0;"daquann";143;100;0
0;18;"daquanna";18;0;100
36;0;"daquante";36;100;0
11;0;"daquarious";11;100;0
257;0;"daquarius";257;100;0
0;18;"daquasha";18;0;100
0;13;"daquasia";13;0;100
79;0;"daquavion";79;100;0
42;0;"daquavious";42;100;0
5;0;"daquavius";5;100;0
158;0;"daquawn";158;100;0
5;0;"daquel";5;100;0
0;10;"daquesha";10;0;100
27;0;"daquez";27;100;0
5;0;"daquian";5;100;0
21;0;"daquin";21;100;0
5;0;"daquinn";5;100;0
11;0;"daquion";11;100;0
0;65;"daquisha";65;0;100
0;51;"daquita";51;0;100
492;0;"daquon";492;100;0
8;0;"daquwan";8;100;0
227;0;"daqwan";227;100;0
5;0;"daqwane";5;100;0
49;0;"daqwon";49;100;0
28;0;"dar";28;100;0
597;12137;"dara";12734;4.68823621799906;95.311763782001
6;12;"darae";18;33.3333333333333;66.6666666666667
0;901;"darah";901;0;100
14;0;"darail";14;100;0
42;0;"darain";42;100;0
23;0;"daral";23;100;0
214;0;"darald";214;100;0
0;16;"daralee";16;0;100
0;20;"daralene";20;0;100
0;27;"daraly";27;0;100
0;333;"daralyn";333;0;100
0;21;"daralynn";21;0;100
577;5;"daran";582;99.1408934707904;0.859106529209622
0;6;"darann";6;0;100
0;7;"darasimi";7;0;100
0;11;"darathy";11;0;100
66;0;"daray";66;100;0
7;0;"darayl";7;100;0
0;5;"darbee";5;0;100
0;25;"darbey";25;0;100
0;655;"darbi";655;0;100
0;391;"darbie";391;0;100
2768;7598;"darby";10366;26.7026818444916;73.2973181555084
0;7;"darcas";7;0;100
0;27;"darce";27;0;100
0;518;"darcee";518;0;100
131;1240;"darcel";1371;9.55506929248724;90.4449307075128
164;506;"darcell";670;24.4776119402985;75.5223880597015
0;143;"darcella";143;0;100
0;361;"darcelle";361;0;100
94;1951;"darcey";2045;4.59657701711491;95.4034229828851
0;8;"darchell";8;0;100
0;113;"darchelle";113;0;100
0;6260;"darci";6260;0;100
0;543;"darcia";543;0;100
0;5412;"darcie";5412;0;100
5;0;"darco";5;100;0
11;353;"darcus";364;3.02197802197802;96.978021978022
2635;21316;"darcy";23951;11.0016283244958;88.9983716755041
77;0;"dardan";77;100;0
0;50;"dardanella";50;0;100
68;0;"darden";68;100;0
0;9;"dardenella";9;0;100
0;14;"dardi";14;0;100
63;65;"dare";128;49.21875;50.78125
0;5;"darea";5;0;100
56;26;"darean";82;68.2926829268293;31.7073170731707
13;0;"dareck";13;100;0
5;0;"dareece";5;100;0
10;332;"dareen";342;2.92397660818713;97.0760233918129
0;5;"dareese";5;0;100
5;0;"dareian";5;100;0
16;5;"darein";21;76.1904761904762;23.8095238095238
109;0;"dareion";109;100;0
1353;0;"darek";1353;100;0
0;7;"dareka";7;0;100
2018;5;"darel";2023;99.7528423133959;0.247157686604053
101;0;"dareld";101;100;0
0;36;"darelene";36;0;100
0;16;"dareli";16;0;100
4794;10;"darell";4804;99.7918401332223;0.208159866777685
279;11;"darelle";290;96.2068965517241;3.79310344827586
0;164;"darely";164;0;100
0;41;"darelyn";41;0;100
0;11;"darelys";11;0;100
10540;194;"daren";10734;98.1926588410658;1.80734115893423
0;18;"darena";18;0;100
19;0;"darence";19;100;0
0;183;"darenda";183;0;100
0;137;"darene";137;0;100
406;7;"dareon";413;98.3050847457627;1.69491525423729
0;5;"dareona";5;0;100
5;0;"darese";5;100;0
0;46;"daresha";46;0;100
0;77;"dareth";77;0;100
0;5;"daretha";5;0;100
0;13;"daretta";13;0;100
52;0;"dareus";52;100;0
499;0;"darey";499;100;0
7;0;"dargan";7;100;0
5;0;"darhl";5;100;0
0;33;"darhonda";33;0;100
11;0;"darhyl";11;100;0
26;544;"dari";570;4.56140350877193;95.4385964912281
5;8106;"daria";8111;0.0616446800641105;99.9383553199359
0;372;"dariah";372;0;100
14807;6123;"darian";20930;70.7453416149068;29.2546583850932
0;2843;"dariana";2843;0;100
0;120;"dariane";120;0;100
0;136;"dariann";136;0;100
0;892;"darianna";892;0;100
0;180;"darianne";180;0;100
0;78;"darianny";78;0;100
0;29;"dariany";29;0;100
0;5;"darianys";5;0;100
58;0;"darias";58;100;0
602;0;"daric";602;100;0
0;64;"darica";64;0;100
13;1292;"darice";1305;0.996168582375479;99.0038314176245
1221;0;"darick";1221;100;0
29;0;"darico";29;100;0
0;29;"darie";29;0;100
0;5;"dariean";5;0;100
3199;453;"dariel";3652;87.5958378970427;12.4041621029573
0;542;"dariela";542;0;100
0;29;"darielis";29;0;100
29;10;"dariell";39;74.3589743589744;25.6410256410256
0;63;"dariella";63;0;100
0;832;"darielle";832;0;100
0;19;"dariely";19;0;100
0;89;"darielys";89;0;100
9702;1819;"darien";11521;84.2114399791685;15.7885600208315
0;36;"dariene";36;0;100
0;358;"darienne";358;0;100
53;0;"darieon";53;100;0
40;0;"daries";40;100;0
18;0;"darieus";18;100;0
0;11;"darihanna";11;0;100
509;0;"darik";509;100;0
0;67;"darika";67;0;100
20;0;"darikson";20;100;0
119;0;"daril";119;100;0
0;632;"darilyn";632;0;100
0;12;"darilynn";12;0;100
32179;364;"darin";32543;98.881479888148;1.11852011185201
0;533;"darina";533;0;100
0;232;"darinda";232;0;100
0;15;"darine";15;0;100
57;0;"darinel";57;100;0
0;6;"darinesha";6;0;100
0;53;"darinka";53;0;100
8924;0;"dario";8924;100;0
6687;561;"darion";7248;92.2599337748344;7.74006622516556
0;148;"dariona";148;0;100
0;224;"darionna";224;0;100
5;0;"darionne";5;100;0
20;0;"darionte";20;100;0
1453;0;"darious";1453;100;0
5;0;"darique";5;100;0
1114;603;"daris";1717;64.8806057076296;35.1193942923704
0;18;"darise";18;0;100
0;52;"darisha";52;0;100
0;5;"darisley";5;0;100
0;53;"darissa";53;0;100
0;15;"darita";15;0;100
10;0;"darith";10;100;0
0;142;"daritza";142;0;100
17;0;"dariun";17;100;0
49968;272;"darius";50240;99.4585987261146;0.54140127388535
116;0;"dariush";116;100;0
130;0;"dariusz";130;100;0
67;0;"darivs";67;100;0
0;307;"dariya";307;0;100
0;381;"dariyah";381;0;100
19;23;"dariyan";42;45.2380952380952;54.7619047619048
0;32;"dariyana";32;0;100
0;5;"dariyelle";5;0;100
176;10;"dariyon";186;94.6236559139785;5.37634408602151
21;0;"darkiel";21;100;0
23;0;"darko";23;100;0
1818;63;"darl";1881;96.6507177033493;3.34928229665072
27;41881;"darla";41908;0.0644268397442016;99.9355731602558
0;44;"darlah";44;0;100
0;5;"darlaine";5;0;100
0;6;"darlana";6;0;100
0;30;"darlane";30;0;100
57;10;"darle";67;85.0746268656716;14.9253731343284
0;884;"darlean";884;0;100
0;15;"darleane";15;0;100
0;18;"darlee";18;0;100
0;8183;"darleen";8183;0;100
0;5;"darleena";5;0;100
0;193;"darleene";193;0;100
0;174;"darlen";174;0;100
0;1535;"darlena";1535;0;100
605;203858;"darlene";204463;0.295897057169268;99.7041029428307
0;5;"darleni";5;0;100
0;5;"darlenis";5;0;100
0;18;"darlenne";18;0;100
0;125;"darleny";125;0;100
0;5;"darlenys";5;0;100
0;7;"darles";7;0;100
0;10;"darlesha";10;0;100
0;5;"darleta";5;0;100
0;16;"darleth";16;0;100
0;27;"darletha";27;0;100
0;103;"darletta";103;0;100
0;88;"darlette";88;0;100
6;6;"darley";12;50;50
0;13;"darlia";13;0;100
0;6;"darlicia";6;0;100
0;5;"darlie";5;0;100
0;5;"darlien";5;0;100
0;36;"darliene";36;0;100
44;638;"darlin";682;6.45161290322581;93.5483870967742
0;149;"darlina";149;0;100
0;224;"darlinda";224;0;100
0;5028;"darline";5028;0;100
5;761;"darling";766;0.652741514360313;99.3472584856397
0;312;"darlis";312;0;100
0;141;"darlisa";141;0;100
0;6;"darlise";6;0;100
0;82;"darlisha";82;0;100
0;10;"darliss";10;0;100
0;5;"darlita";5;0;100
10;0;"darlo";10;100;0
5;0;"darlow";5;100;0
104;72;"darly";176;59.0909090909091;40.9090909090909
0;5;"darlyene";5;0;100
21;1670;"darlyn";1691;1.24186871673566;98.7581312832643
0;5;"darlynda";5;0;100
0;1409;"darlyne";1409;0;100
0;549;"darlynn";549;0;100
0;5;"darlynne";5;0;100
0;328;"darlys";328;0;100
0;11;"darma";11;0;100
10;0;"darmani";10;100;0
5;0;"darmarcus";5;100;0
0;10;"darmesha";10;0;100
26;0;"darmon";26;100;0
0;48;"darnae";48;0;100
0;5;"darnaja";5;0;100
0;27;"darnasia";27;0;100
24;0;"darnay";24;100;0
0;28;"darnecia";28;0;100
5;0;"darnee";5;100;0
18;0;"darneil";18;100;0
0;184;"darneisha";184;0;100
982;50;"darnel";1032;95.1550387596899;4.84496124031008
27720;2382;"darnell";30102;92.0869045246163;7.9130954753837
0;731;"darnella";731;0;100
357;249;"darnelle";606;58.9108910891089;41.0891089108911
0;5;"darnese";5;0;100
0;527;"darnesha";527;0;100
0;171;"darneshia";171;0;100
0;6;"darnetha";6;0;100
0;433;"darnetta";433;0;100
0;75;"darnette";75;0;100
5;0;"darney";5;100;0
17;0;"darnez";17;100;0
0;157;"darnice";157;0;100
0;10;"darniece";10;0;100
0;10;"darniesha";10;0;100
0;32;"darnika";32;0;100
0;116;"darnise";116;0;100
0;877;"darnisha";877;0;100
0;7;"darnishia";7;0;100
0;259;"darnita";259;0;100
5;0;"darnley";5;100;0
485;0;"darol";485;100;0
4187;0;"darold";4187;100;0
0;283;"darolyn";283;0;100
7324;160;"daron";7484;97.8621058257616;2.13789417423838
0;39;"daronda";39;0;100
5;0;"darone";5;100;0
6;0;"daronn";6;100;0
5;0;"daronta";5;100;0
94;0;"daronte";94;100;0
0;66;"darothy";66;0;100
28;0;"darquan";28;100;0
12;0;"darquez";12;100;0
12;0;"darquis";12;100;0
6;0;"darquise";6;100;0
0;5;"darquisha";5;0;100
52;0;"darr";52;100;0
0;503;"darra";503;0;100
169;35;"darragh";204;82.843137254902;17.156862745098
0;798;"darrah";798;0;100
13;0;"darrain";13;100;0
385;0;"darral";385;100;0
196;0;"darrall";196;100;0
773;0;"darran";773;100;0
8;0;"darrayl";8;100;0
16;18;"darrean";34;47.0588235294118;52.9411764705882
12;0;"darreck";12;100;0
28;7;"darrein";35;80;20
12;0;"darreion";12;100;0
111;0;"darrek";111;100;0
29550;122;"darrel";29672;99.5888379617147;0.411162038285252
89;0;"darreld";89;100;0
158331;1187;"darrell";159518;99.2558833485876;0.74411665141238
243;64;"darrelle";307;79.1530944625407;20.8469055374593
0;10;"darrellyn";10;0;100
0;122;"darrelyn";122;0;100
101127;562;"darren";101689;99.4473345199579;0.552665480042089
28;0;"darrence";28;100;0
15;0;"darrent";15;100;0
324;0;"darreon";324;100;0
0;11;"darresha";11;0;100
35;0;"darrett";35;100;0
15;0;"darreus";15;100;0
43;0;"darreyl";43;100;0
0;29;"darri";29;0;100
0;159;"darria";159;0;100
0;8;"darriah";8;0;100
3240;971;"darrian";4211;76.9413440987889;23.0586559012111
0;135;"darriana";135;0;100
0;14;"darriane";14;0;100
0;31;"darrianna";31;0;100
11;0;"darrias";11;100;0
100;0;"darric";100;100;0
0;32;"darrica";32;0;100
7973;11;"darrick";7984;99.8622244488978;0.137775551102204
0;46;"darricka";46;0;100
104;21;"darrie";125;83.2;16.8
584;154;"darriel";738;79.1327913279133;20.8672086720867
11;54;"darriell";65;16.9230769230769;83.0769230769231
0;335;"darrielle";335;0;100
3029;361;"darrien";3390;89.3510324483776;10.6489675516224
5;0;"darries";5;100;0
89;0;"darrik";89;100;0
0;6;"darrika";6;0;100
75;0;"darril";75;100;0
61;0;"darrill";61;100;0
0;51;"darrilyn";51;0;100
29226;133;"darrin";29359;99.5469872952076;0.453012704792398
36;0;"darrington";36;100;0
65;0;"darrio";65;100;0
4052;149;"darrion";4201;96.4532254225185;3.54677457748155
0;138;"darriona";138;0;100
5;0;"darrione";5;100;0
0;17;"darrionna";17;0;100
374;0;"darrious";374;100;0
1937;98;"darris";2035;95.1842751842752;4.81572481572482
0;20;"darrisha";20;0;100
7246;0;"darrius";7246;100;0
0;11;"darriyah";11;0;100
347;0;"darrly";347;100;0
22;0;"darrlyn";22;100;0
78;0;"darrnell";78;100;0
5;0;"darro";5;100;0
654;0;"darrol";654;100;0
496;0;"darrold";496;100;0
396;0;"darroll";396;100;0
6030;5;"darron";6035;99.917149958575;0.0828500414250207
706;0;"darrow";706;100;0
15;0;"darrus";15;100;0
1536;0;"darry";1536;100;0
55;0;"darryal";55;100;0
15;19;"darryan";34;44.1176470588235;55.8823529411765
248;0;"darryel";248;100;0
17;0;"darryell";17;100;0
91295;1134;"darryl";92429;98.7731123348733;1.22688766512675
1431;0;"darryle";1431;100;0
0;25;"darrylin";25;0;100
1366;0;"darryll";1366;100;0
1623;39;"darryn";1662;97.6534296028881;2.34657039711191
111;0;"darryon";111;100;0
22;0;"darryus";22;100;0
0;55;"darsey";55;0;100
585;0;"darsh";585;100;0
0;83;"darsha";83;0;100
0;31;"darshae";31;0;100
649;11;"darshan";660;98.3333333333333;1.66666666666667
0;70;"darshana";70;0;100
0;6;"darshanna";6;0;100
37;0;"darshaun";37;100;0
155;0;"darshawn";155;100;0
0;83;"darshay";83;0;100
0;5;"darshea";5;0;100
0;46;"darshell";46;0;100
0;5;"darshelle";5;0;100
0;10;"darshi";10;0;100
5;0;"darshik";5;100;0
16;0;"darshil";16;100;0
0;11;"darshini";11;0;100
7;0;"darshon";7;100;0
0;105;"darsi";105;0;100
0;12;"darsie";12;0;100
10;0;"darson";10;100;0
0;10;"darsy";10;0;100
41;0;"dart";41;100;0
963;0;"dartagnan";963;100;0
8;0;"dartagnon";8;100;0
205;0;"dartanian";205;100;0
125;0;"dartanion";125;100;0
0;11;"dartanya";11;0;100
71;0;"dartanyan";71;100;0
98;0;"dartanyon";98;100;0
53;0;"dartavious";53;100;0
17;0;"dartavius";17;100;0
5;0;"dartez";5;100;0
29;0;"darth";29;100;0
0;382;"dartha";382;0;100
0;17;"darthea";17;0;100
0;12;"darthie";12;0;100
0;48;"darthula";48;0;100
0;302;"darthy";302;0;100
0;5;"dartisha";5;0;100
10;0;"dartrell";10;100;0
180;0;"daruis";180;100;0
84;0;"darus";84;100;0
30;0;"darvel";30;100;0
276;0;"darvell";276;100;0
5;0;"darvens";5;100;0
0;11;"darvi";11;0;100
3471;0;"darvin";3471;100;0
384;0;"darvis";384;100;0
54;0;"darvon";54;100;0
8;0;"darweshi";8;100;0
24125;77;"darwin";24202;99.6818444756632;0.318155524336832
5;0;"darwing";5;100;0
5;0;"darwood";5;100;0
5;0;"darwuin";5;100;0
713;0;"darwyn";713;100;0
139;24;"dary";163;85.2760736196319;14.7239263803681
0;990;"darya";990;0;100
0;44;"daryah";44;0;100
18;0;"daryal";18;100;0
446;260;"daryan";706;63.1728045325779;36.8271954674221
0;122;"daryana";122;0;100
0;5;"daryann";5;0;100
0;27;"daryanna";27;0;100
483;0;"daryel";483;100;0
8;0;"daryell";8;100;0
38;14;"daryen";52;73.0769230769231;26.9230769230769
0;6;"daryiah";6;0;100
6;11;"daryian";17;35.2941176470588;64.7058823529412
42;0;"daryk";42;100;0
62204;4409;"daryl";66613;93.3811718433339;6.61882815666612
0;34;"daryla";34;0;100
0;19;"darylann";19;0;100
2632;198;"daryle";2830;93.0035335689046;6.99646643109541
0;49;"darylene";49;0;100
1667;17;"daryll";1684;98.9904988123515;1.00950118764846
6;0;"darylle";6;100;0
2302;913;"daryn";3215;71.601866251944;28.398133748056
0;57;"daryna";57;0;100
0;5;"darynne";5;0;100
166;0;"daryon";166;100;0
299;0;"daryus";299;100;0
5;0;"darzell";5;100;0
0;10;"dasa";10;0;100
6;0;"dasaan";6;100;0
6;0;"dasael";6;100;0
5;0;"dasai";5;100;0
515;0;"dasan";515;100;0
342;951;"dasani";1293;26.4501160092807;73.5498839907193
0;5;"dasanii";5;0;100
0;25;"dasany";25;0;100
31;0;"dasaun";31;100;0
0;5;"dascha";5;0;100
91;0;"daschel";91;100;0
11;0;"daschle";11;100;0
1284;0;"dasean";1284;100;0
12;0;"dasen";12;100;0
1749;38;"dash";1787;97.8735310576385;2.1264689423615
0;3380;"dasha";3380;0;100
5;0;"dashaan";5;100;0
17;0;"dashad";17;100;0
5;243;"dashae";248;2.01612903225806;97.9838709677419
0;38;"dashai";38;0;100
18;0;"dashal";18;100;0
5;0;"dashall";5;100;0
205;10;"dashan";215;95.3488372093023;4.65116279069767
0;198;"dashana";198;0;100
0;160;"dashanae";160;0;100
0;41;"dashanay";41;0;100
0;17;"dashanda";17;0;100
10;5;"dashane";15;66.6666666666667;33.3333333333333
0;10;"dashani";10;0;100
0;96;"dashanique";96;0;100
0;80;"dashanna";80;0;100
0;15;"dashanta";15;0;100
0;181;"dashanti";181;0;100
0;35;"dashara";35;0;100
0;5;"dashari";5;0;100
0;5;"dasharia";5;0;100
2661;32;"dashaun";2693;98.8117341255106;1.18826587448942
0;181;"dashauna";181;0;100
8217;541;"dashawn";8758;93.8227905914592;6.17720940854076
0;478;"dashawna";478;0;100
0;10;"dashawnda";10;0;100
0;20;"dashawnna";20;0;100
24;294;"dashay";318;7.54716981132075;92.4528301886792
0;21;"dashaya";21;0;100
0;207;"dashayla";207;0;100
0;84;"dashea";84;0;100
24;0;"dasheem";24;100;0
0;11;"dasheena";11;0;100
0;5;"dasheika";5;0;100
448;6;"dashel";454;98.6784140969163;1.3215859030837
30;47;"dashell";77;38.961038961039;61.038961038961
0;33;"dashelle";33;0;100
0;898;"dashia";898;0;100
0;5;"dashiah";5;0;100
291;0;"dashiel";291;100;0
2025;11;"dashiell";2036;99.4597249508841;0.540275049115914
0;5;"dashima";5;0;100
0;28;"dashira";28;0;100
0;33;"dashiya";33;0;100
0;6;"dashiyah";6;0;100
0;65;"dashley";65;0;100
0;11;"dashly";11;0;100
0;5;"dashna";5;0;100
1485;33;"dashon";1518;97.8260869565217;2.17391304347826
0;34;"dashona";34;0;100
0;126;"dashonda";126;0;100
46;0;"dashone";46;100;0
0;61;"dashonna";61;0;100
0;5;"dashonte";5;0;100
5;0;"dashown";5;100;0
65;0;"dashton";65;100;0
9;0;"dashuan";9;100;0
488;0;"dashun";488;100;0
0;12;"dashya";12;0;100
0;8;"dashyia";8;0;100
0;5;"dashyra";5;0;100
0;5010;"dasia";5010;0;100
0;158;"dasiah";158;0;100
6;0;"dasian";6;100;0
0;10;"dasianae";10;0;100
0;409;"dasie";409;0;100
23;0;"dasir";23;100;0
0;45;"dasiya";45;0;100
0;49;"dasiyah";49;0;100
0;77;"dasja";77;0;100
0;13;"dasjah";13;0;100
0;5;"dasjia";5;0;100
36;51;"dasmine";87;41.3793103448276;58.6206896551724
6;0;"dasmon";6;100;0
39;0;"dasmond";39;100;0
527;0;"dason";527;100;0
0;5;"dassie";5;0;100
0;10;"dassy";10;0;100
208;0;"dastan";208;100;0
5;0;"dastyn";5;100;0
0;43;"dasya";43;0;100
524;0;"dat";524;100;0
5;0;"datari";5;100;0
0;12;"datavia";12;0;100
5;0;"datavian";5;100;0
32;0;"datavion";32;100;0
27;0;"datavious";27;100;0
5;0;"datavius";5;100;0
0;153;"datha";153;0;100
1480;0;"dathan";1480;100;0
0;35;"dathel";35;0;100
17;0;"dathen";17;100;0
0;6;"dathol";6;0;100
17;0;"dathon";17;100;0
0;5;"datia";5;0;100
5;0;"datid";5;100;0
88;0;"daton";88;100;0
0;74;"datra";74;0;100
69;0;"datrell";69;100;0
5;0;"datreon";5;100;0
0;5;"datrice";5;0;100
10;0;"datrick";10;100;0
6;5;"datril";11;54.5454545454545;45.4545454545455
10;0;"datrion";10;100;0
144;0;"datron";144;100;0
59;0;"datwan";59;100;0
10;0;"datwon";10;100;0
172;0;"daud";172;100;0
8;0;"dauda";8;100;0
15;0;"daudi";15;100;0
0;5;"daughn";5;0;100
33;0;"daughtry";33;100;0
1484;0;"daulton";1484;100;0
27;778;"daun";805;3.35403726708075;96.6459627329193
0;201;"dauna";201;0;100
0;5;"daundra";5;0;100
146;0;"daundre";146;100;0
64;218;"daune";282;22.6950354609929;77.3049645390071
5;0;"daunta";5;100;0
62;0;"dauntae";62;100;0
5;0;"dauntay";5;100;0
1477;0;"daunte";1477;100;0
0;34;"dauphine";34;0;100
0;28;"daureen";28;0;100
0;5;"dauri";5;0;100
5;85;"daurice";90;5.55555555555556;94.4444444444444
17;0;"daury";17;100;0
15;0;"dausen";15;100;0
36;0;"dauson";36;100;0
5;0;"dav";5;100;0
0;1427;"dava";1427;0;100
0;5;"davada";5;0;100
5;47;"davae";52;9.61538461538462;90.3846153846154
0;20;"davaeh";20;0;100
5;0;"davahn";5;100;0
0;16;"davalyn";16;0;100
247;78;"davan";325;76;24
0;44;"davana";44;0;100
0;163;"davanee";163;0;100
0;5;"davaney";5;0;100
0;5;"davani";5;0;100
0;12;"davanie";12;0;100
0;91;"davanna";91;0;100
14;0;"davant";14;100;0
86;0;"davanta";86;100;0
28;0;"davantae";28;100;0
5;0;"davantay";5;100;0
1266;0;"davante";1266;100;0
0;12;"davany";12;0;100
12;0;"davar";12;100;0
5;0;"davares";5;100;0
113;0;"davari";113;100;0
0;15;"davaria";15;0;100
29;0;"davarian";29;100;0
11;0;"davario";11;100;0
157;0;"davarion";157;100;0
107;0;"davarious";107;100;0
130;0;"davaris";130;100;0
318;0;"davarius";318;100;0
5;0;"davarous";5;100;0
5;0;"davarrio";5;100;0
5;0;"davarus";5;100;0
0;5;"davasha";5;0;100
0;21;"davasia";21;0;100
779;0;"davaughn";779;100;0
142;0;"davaun";142;100;0
5;0;"davaunte";5;100;0
0;20;"davaya";20;0;100
0;31;"davayah";31;0;100
29;0;"davd";29;100;0
61148;109;"dave";61257;99.8220611521948;0.177938847805149
0;83;"daveah";83;0;100
10;0;"davean";10;100;0
200;0;"daved";200;100;0
0;71;"daveda";71;0;100
11;10;"davee";21;52.3809523809524;47.6190476190476
43;0;"daveed";43;100;0
0;36;"daveen";36;0;100
0;100;"daveena";100;0;100
0;139;"daveigh";139;0;100
6;0;"davein";6;100;0
581;0;"daveion";581;100;0
0;6;"daveisha";6;0;100
17;0;"davel";17;100;0
275;0;"davell";275;100;0
95;5;"davelle";100;95;5
0;87;"davelyn";87;0;100
2254;92;"daven";2346;96.078431372549;3.92156862745098
0;400;"davena";400;0;100
5;234;"davene";239;2.09205020920502;97.907949790795
0;17;"daveney";17;0;100
0;12;"davenia";12;0;100
5;0;"davens";5;100;0
2394;16;"daveon";2410;99.3360995850622;0.663900414937759
0;26;"daveona";26;0;100
0;5;"daveonna";5;0;100
8;0;"daveontae";8;100;0
6;0;"daveonte";6;100;0
0;40;"davesha";40;0;100
0;10;"daveta";10;0;100
0;543;"davetta";543;0;100
0;557;"davette";557;0;100
3097;67;"davey";3164;97.8824273072061;2.11757269279393
0;5;"daveya";5;0;100
234;0;"daveyon";234;100;0
1073;475;"davi";1548;69.3152454780362;30.6847545219638
0;1099;"davia";1099;0;100
0;19;"daviah";19;0;100
4953;100;"davian";5053;98.0209776370473;1.9790223629527
0;674;"daviana";674;0;100
0;596;"davianna";596;0;100
18;0;"daviante";18;100;0
5;0;"daviaun";5;100;0
3586129;12836;"david";3598965;99.6433419052422;0.356658094757798
5;3971;"davida";3976;0.125754527162978;99.874245472837
19;0;"davidalexander";19;100;0
5;0;"davidallen";5;100;0
58;0;"davidanthony";58;100;0
5;0;"davidchristophe";5;100;0
799;0;"davide";799;100;0
83;0;"davidjames";83;100;0
5;0;"davidjeremiah";5;100;0
17;0;"davidjohn";17;100;0
5;0;"davidjoseph";5;100;0
11;0;"davidjr";11;100;0
168;0;"davidlee";168;100;0
153;0;"davidmichael";153;100;0
5;0;"davidpaul";5;100;0
914;0;"davidson";914;100;0
3152;733;"davie";3885;81.1325611325611;18.8674388674389
402;0;"davied";402;100;0
237;0;"daviel";237;100;0
0;75;"davielle";75;0;100
1110;0;"davien";1110;100;0
309;0;"davieon";309;100;0
205;0;"davier";205;100;0
15;0;"daviere";15;100;0
35;0;"davies";35;100;0
0;7;"daviette";7;0;100
0;8;"davika";8;0;100
0;20;"davilyn";20;0;100
9829;344;"davin";10173;96.6184999508503;3.38150004914971
0;7492;"davina";7492;0;100
0;26;"davinah";26;0;100
111;0;"davinci";111;100;0
29;0;"davinder";29;100;0
5;0;"davindra";5;100;0
96;322;"davine";418;22.9665071770335;77.0334928229665
0;22;"davinee";22;0;100
0;13;"daviney";13;0;100
0;73;"davinia";73;0;100
0;66;"davinity";66;0;100
0;16;"davinna";16;0;100
27;0;"davio";27;100;0
11213;216;"davion";11429;98.1100708723423;1.88992912765771
0;254;"daviona";254;0;100
250;11;"davione";261;95.7854406130268;4.21455938697318
20;0;"davionn";20;100;0
0;431;"davionna";431;0;100
169;68;"davionne";237;71.3080168776371;28.6919831223629
6;0;"davionta";6;100;0
36;0;"daviontae";36;100;0
101;0;"davionte";101;100;0
32;0;"davious";32;100;0
27323;797;"davis";28120;97.1657183499289;2.83428165007112
0;209;"davisha";209;0;100
251;0;"davison";251;100;0
175;0;"davit";175;100;0
0;709;"davita";709;0;100
71;0;"davius";71;100;0
0;11;"daviya";11;0;100
0;6;"daviyah";6;0;100
0;5;"daviyana";5;0;100
225;0;"daviyon";225;100;0
0;5;"davlyn";5;0;100
0;5;"davlynn";5;0;100
5;0;"davod";5;100;0
6;0;"davohn";6;100;0
12293;367;"davon";12660;97.1011058451817;2.89889415481833
0;290;"davona";290;0;100
0;67;"davonda";67;0;100
48;0;"davondre";48;100;0
551;15;"davone";566;97.3498233215548;2.65017667844523
0;16;"davonia";16;0;100
241;0;"davonn";241;100;0
0;926;"davonna";926;0;100
388;198;"davonne";586;66.2116040955631;33.7883959044369
1187;0;"davonta";1187;100;0
1352;0;"davontae";1352;100;0
17;0;"davontai";17;100;0
524;0;"davontay";524;100;0
6;0;"davontaye";6;100;0
4246;5;"davonte";4251;99.8823806163256;0.11761938367443
5;0;"davontea";5;100;0
46;0;"davontre";46;100;0
0;16;"davonya";16;0;100
6;0;"davor";6;100;0
37;0;"davron";37;100;0
5;0;"davuan";5;100;0
24;0;"davud";24;100;0
10;0;"davvid";10;100;0
2465;146;"davy";2611;94.408272692455;5.591727307545
30;0;"davyan";30;100;0
108;0;"davyd";108;100;0
13;0;"davyen";13;100;0
5;0;"davyeon";5;100;0
18;0;"davyion";18;100;0
512;68;"davyn";580;88.2758620689655;11.7241379310345
0;31;"davyne";31;0;100
0;6;"davynn";6;0;100
306;0;"davyon";306;100;0
7;0;"dawain";7;100;0
791;35;"dawan";826;95.7627118644068;4.23728813559322
0;532;"dawana";532;0;100
0;249;"dawanda";249;0;100
20;0;"dawane";20;100;0
5;0;"dawann";5;100;0
0;435;"dawanna";435;0;100
219;0;"dawaun";219;100;0
1614;0;"dawayne";1614;100;0
7;0;"dawens";7;100;0
21;0;"dawes";21;100;0
319;0;"dawid";319;100;0
12;0;"dawin";12;100;0
405;0;"dawit";405;100;0
19;0;"dawlton";19;100;0
0;5;"dawm";5;0;100
1034;288753;"dawn";289787;0.356813797720395;99.6431862022796
0;6003;"dawna";6003;0;100
0;12;"dawnae";12;0;100
0;6;"dawnda";6;0;100
0;5;"dawndee";5;0;100
0;5;"dawndi";5;0;100
0;10;"dawndra";10;0;100
0;5;"dawndria";5;0;100
0;2603;"dawne";2603;0;100
0;12;"dawnee";12;0;100
0;8;"dawneen";8;0;100
0;5;"dawneisha";5;0;100
0;22;"dawnel";22;0;100
0;369;"dawnell";369;0;100
0;30;"dawnella";30;0;100
0;526;"dawnelle";526;0;100
0;6;"dawnene";6;0;100
0;51;"dawnesha";51;0;100
0;5;"dawnett";5;0;100
0;302;"dawnetta";302;0;100
0;656;"dawnette";656;0;100
0;21;"dawni";21;0;100
0;5;"dawnica";5;0;100
0;25;"dawnie";25;0;100
0;33;"dawniel";33;0;100
0;401;"dawnielle";401;0;100
0;122;"dawnisha";122;0;100
0;348;"dawnita";348;0;100
0;723;"dawnmarie";723;0;100
0;297;"dawnn";297;0;100
0;140;"dawnna";140;0;100
0;27;"dawnne";27;0;100
0;5;"dawnta";5;0;100
5;6;"dawnte";11;45.4545454545455;54.5454545454545
0;10;"dawny";10;0;100
0;224;"dawnya";224;0;100
0;56;"dawnyel";56;0;100
0;39;"dawnyell";39;0;100
0;24;"dawnyelle";24;0;100
547;0;"dawon";547;100;0
22;0;"dawone";22;100;0
189;0;"dawood";189;100;0
29;0;"dawoud";29;100;0
361;5;"dawsen";366;98.6338797814208;1.36612021857923
33313;616;"dawson";33929;98.1844439859707;1.8155560140293
279;289;"dawsyn";568;49.1197183098592;50.8802816901408
0;9;"dawsynn";9;0;100
0;61;"dawt";61;0;100
34;0;"dawton";34;100;0
47;0;"dawuan";47;100;0
740;0;"dawud";740;100;0
0;12;"dawyn";12;0;100
15;0;"dawyne";15;100;0
6496;11;"dax";6507;99.8309512832334;0.169048716766559
5;0;"daxel";5;100;0
54;0;"daxen";54;100;0
0;6;"daxia";6;0;100
11;0;"daxin";11;100;0
628;0;"daxon";628;100;0
95;0;"daxson";95;100;0
8;0;"daxston";8;100;0
174;0;"daxten";174;100;0
61;0;"daxter";61;100;0
88;0;"daxtin";88;100;0
5608;0;"daxton";5608;100;0
170;0;"daxtyn";170;100;0
183;0;"daxx";183;100;0
6;0;"daxxon";6;100;0
11;0;"daxxton";11;100;0
13;0;"daxyn";13;100;0
130;141;"day";271;47.9704797047971;52.0295202952029
0;553;"daya";553;0;100
0;38;"dayah";38;0;100
0;6;"dayahna";6;0;100
0;818;"dayami";818;0;100
0;25;"dayamin";25;0;100
0;5;"dayamir";5;0;100
0;5;"dayamit";5;0;100
0;30;"dayamy";30;0;100
330;199;"dayan";529;62.3818525519849;37.6181474480151
0;10733;"dayana";10733;0;100
0;23;"dayanah";23;0;100
0;10;"dayanaira";10;0;100
0;6081;"dayanara";6081;0;100
0;15;"dayanari";15;0;100
0;92;"dayane";92;0;100
0;20;"dayanera";20;0;100
0;481;"dayani";481;0;100
0;12;"dayanie";12;0;100
0;213;"dayanira";213;0;100
0;74;"dayanis";74;0;100
0;13;"dayann";13;0;100
0;2795;"dayanna";2795;0;100
0;103;"dayannara";103;0;100
0;161;"dayanne";161;0;100
0;57;"dayanni";57;0;100
0;35;"dayany";35;0;100
0;7;"dayari";7;0;100
0;10;"dayasia";10;0;100
0;49;"dayatra";49;0;100
0;52;"daycee";52;0;100
30;0;"daycen";30;100;0
24;0;"dayceon";24;100;0
0;17;"daycia";17;0;100
6;0;"dayde";6;100;0
212;0;"dayden";212;100;0
0;18;"daydra";18;0;100
15;0;"daydrian";15;100;0
0;10;"daye";10;0;100
0;21;"dayeli";21;0;100
0;51;"dayelin";51;0;100
0;5;"dayesha";5;0;100
12;0;"daygan";12;100;0
6;0;"daygen";6;100;0
5;0;"daygoro";5;100;0
0;5;"dayiana";5;0;100
5;0;"dayion";5;100;0
0;519;"dayja";519;0;100
0;256;"dayjah";256;0;100
42;0;"dayjon";42;100;0
6;0;"daykota";6;100;0
5;15;"dayl";20;25;75
0;1531;"dayla";1531;0;100
0;82;"daylah";82;0;100
2229;84;"daylan";2313;96.3683527885863;3.63164721141375
5;0;"dayland";5;100;0
0;62;"daylani";62;0;100
0;5;"daylanie";5;0;100
0;7;"daylany";7;0;100
1139;2161;"dayle";3300;34.5151515151515;65.4848484848485
6;356;"daylee";362;1.65745856353591;98.3425414364641
0;203;"dayleen";203;0;100
0;13;"dayleigh";13;0;100
2704;254;"daylen";2958;91.4131169709263;8.5868830290737
0;500;"daylene";500;0;100
15;0;"dayleon";15;100;0
0;53;"dayli";53;0;100
0;30;"daylia";30;0;100
0;17;"daylie";17;0;100
1371;1030;"daylin";2401;57.1012078300708;42.8987921699292
0;5;"dayline";5;0;100
0;10;"daylinn";10;0;100
83;6;"dayln";89;93.2584269662921;6.74157303370786
2714;10;"daylon";2724;99.632892804699;0.367107195301028
188;213;"daylyn";401;46.8827930174564;53.1172069825436
29;292;"daylynn";321;9.03426791277258;90.9657320872274
10;0;"dayman";10;100;0
20;0;"daymar";20;100;0
87;0;"daymein";87;100;0
63;0;"daymen";63;100;0
130;0;"daymeon";130;100;0
0;7;"daymi";7;0;100
530;0;"daymian";530;100;0
360;0;"daymien";360;100;0
16;0;"daymin";16;100;0
194;0;"daymion";194;100;0
1576;0;"daymon";1576;100;0
847;0;"daymond";847;100;0
69;0;"dayn";69;100;0
87;14164;"dayna";14251;0.610483474843871;99.3895165251561
0;58;"daynah";58;0;100
3646;195;"dayne";3841;94.9231970840927;5.07680291590732
0;11;"daynesha";11;0;100
0;17;"daynisha";17;0;100
0;12;"daynna";12;0;100
0;5;"dayo";5;0;100
651;11;"dayon";662;98.3383685800604;1.66163141993958
0;246;"dayona";246;0;100
0;682;"dayonna";682;0;100
5;0;"dayonte";5;100;0
683;0;"dayquan";683;100;0
35;0;"dayquon";35;100;0
5;0;"dayqwan";5;100;0
0;911;"dayra";911;0;100
27;0;"dayren";27;100;0
0;5;"dayri";5;0;100
0;146;"dayrin";146;0;100
0;9;"dayris";9;0;100
18;0;"dayro";18;100;0
546;0;"dayron";546;100;0
5;0;"daysan";5;100;0
0;7;"dayse";7;0;100
124;0;"daysean";124;100;0
95;0;"daysen";95;100;0
0;2416;"daysha";2416;0;100
0;5;"dayshana";5;0;100
0;5;"dayshanay";5;0;100
370;0;"dayshaun";370;100;0
1236;5;"dayshawn";1241;99.597099113618;0.40290088638195
0;22;"dayshawna";22;0;100
0;241;"dayshia";241;0;100
233;0;"dayshon";233;100;0
34;0;"dayshun";34;100;0
0;1308;"daysi";1308;0;100
0;708;"daysia";708;0;100
0;100;"daysie";100;0;100
645;0;"dayson";645;100;0
20;0;"daysun";20;100;0
0;271;"daysy";271;0;100
239;0;"dayten";239;100;0
11;0;"daythan";11;100;0
56;0;"daytin";56;100;0
13685;492;"dayton";14177;96.5295901812795;3.47040981872046
218;630;"daytona";848;25.7075471698113;74.2924528301887
33;0;"daytron";33;100;0
6;0;"daytwan";6;100;0
9;0;"daytwon";9;100;0
0;13;"dayva";13;0;100
0;5;"dayvanee";5;0;100
5;0;"dayveion";5;100;0
109;0;"dayven";109;100;0
358;0;"dayveon";358;100;0
94;0;"dayvian";94;100;0
29;0;"dayvid";29;100;0
11;0;"dayvien";11;100;0
111;0;"dayvin";111;100;0
639;0;"dayvion";639;100;0
1379;0;"dayvon";1379;100;0
0;5;"dayvonna";5;0;100
5;0;"dayvonne";5;100;0
82;0;"dayyan";82;100;0
0;26;"dayza";26;0;100
0;11;"dayzah";11;0;100
0;83;"dayzee";83;0;100
0;76;"dayzha";76;0;100
0;10;"dayzhane";10;0;100
0;15;"dayzi";15;0;100
0;48;"dayzia";48;0;100
0;20;"dayzie";20;0;100
16;0;"daz";16;100;0
0;21;"dazah";21;0;100
0;61;"dazani";61;0;100
0;111;"dazaria";111;0;100
0;42;"dazariah";42;0;100
16;0;"dazarion";16;100;0
5;0;"dazavion";5;100;0
0;5;"dazay";5;0;100
0;5;"dazaya";5;0;100
0;115;"dazha";115;0;100
5;0;"dazhan";5;100;0
0;12;"dazhanae";12;0;100
0;154;"dazhane";154;0;100
10;0;"dazhaun";10;100;0
0;10;"dazhia";10;0;100
35;0;"dazhon";35;100;0
0;331;"dazia";331;0;100
0;159;"daziah";159;0;100
0;41;"dazie";41;0;100
11;0;"daziel";11;100;0
39;0;"dazion";39;100;0
0;58;"dazire";58;0;100
0;99;"daziya";99;0;100
0;181;"daziyah";181;0;100
0;60;"dazja";60;0;100
0;33;"dazjah";33;0;100
0;6;"dazlyn";6;0;100
0;6;"dazlynn";6;0;100
0;18;"dazmine";18;0;100
20;0;"dazmon";20;100;0
5;0;"dazmond";5;100;0
39;0;"dazon";39;100;0
0;33;"dazsha";33;0;100
0;16;"dazya";16;0;100
0;7;"dazza";7;0;100
0;28;"dazzlyn";28;0;100
5;0;"dcarlo";5;100;0
20;0;"dcarlos";20;100;0
10;0;"dcorian";10;100;0
11;0;"ddnald";11;100;0
0;25;"ddnna";25;0;100
681;641;"de";1322;51.5128593040847;48.4871406959153
17;1673;"dea";1690;1.00591715976331;98.9940828402367
202;0;"deaaron";202;100;0
39;0;"deacan";39;100;0
6429;0;"deacon";6429;100;0
0;1105;"deadra";1105;0;100
0;51;"deadre";51;0;100
0;26;"deadria";26;0;100
253;0;"deadrian";253;100;0
179;0;"deadrick";179;100;0
822;0;"deagan";822;100;0
80;0;"deagen";80;100;0
362;0;"deaglan";362;100;0
92;0;"deago";92;100;0
43;0;"deagon";43;100;0
0;191;"deah";191;0;100
0;33;"deahna";33;0;100
0;12;"deaija";12;0;100
0;16;"deaijah";16;0;100
10;0;"deair";10;100;0
0;488;"deaira";488;0;100
0;24;"deairah";24;0;100
78;0;"deaire";78;100;0
15;0;"deaires";15;100;0
0;158;"deairra";158;0;100
0;74;"deaisa";74;0;100
0;170;"deaisha";170;0;100
0;421;"deaja";421;0;100
0;377;"deajah";377;0;100
0;17;"deajanae";17;0;100
0;6;"deajane";6;0;100
0;12;"deajha";12;0;100
0;24;"deajia";24;0;100
5;0;"deajon";5;100;0
135;0;"deaken";135;100;0
184;0;"deakin";184;100;0
327;0;"deakon";327;100;0
24;0;"deakyn";24;100;0
5;0;"deal";5;100;0
0;11;"dealia";11;0;100
0;73;"dealie";73;0;100
11;0;"deallen";11;100;0
0;87;"dealva";87;0;100
0;186;"deamber";186;0;100
0;16;"deambra";16;0;100
21;0;"deamontae";21;100;0
154;0;"deamonte";154;100;0
171444;2810;"dean";174254;98.3874114797939;1.61258852020614
14;23312;"deana";23326;0.060018863071251;99.9399811369288
0;15;"deanah";15;0;100
0;6;"deanca";6;0;100
0;72;"deanda";72;0;100
846;4857;"deandra";5703;14.8342977380326;85.1657022619674
415;0;"deandrae";415;100;0
9;0;"deandray";9;100;0
26980;452;"deandre";27432;98.3522892971712;1.64771070282881
710;2207;"deandrea";2917;24.340075419952;75.659924580048
8;0;"deandres";8;100;0
284;0;"deandrew";284;100;0
7;0;"deandrey";7;100;0
0;696;"deandria";696;0;100
12;0;"deandrick";12;100;0
2718;1282;"deane";4000;67.95;32.05
0;5;"deaneen";5;0;100
0;5;"deanesha";5;0;100
0;114;"deanette";114;0;100
7;0;"deangalo";7;100;0
0;33;"deangel";33;0;100
0;1214;"deangela";1214;0;100
0;11;"deangelia";11;0;100
12;0;"deangelio";12;100;0
0;13;"deangelis";13;0;100
11;0;"deangello";11;100;0
10940;21;"deangelo";10961;99.8084116412736;0.191588358726394
14;0;"deangilo";14;100;0
57;0;"deangleo";57;100;0
168;0;"deanglo";168;100;0
0;32;"deani";32;0;100
0;79;"deania";79;0;100
20;729;"deanie";749;2.67022696929239;97.3297730307076
0;41;"deanine";41;0;100
0;10;"deanise";10;0;100
5;0;"deanjelo";5;100;0
0;10169;"deann";10169;0;100
266;133442;"deanna";133708;0.198940975857839;99.8010590241422
0;107;"deannah";107;0;100
0;197;"deanndra";197;0;100
5;14828;"deanne";14833;0.0337086226656779;99.9662913773343
0;5;"deannea";5;0;100
0;5;"deannette";5;0;100
0;17;"deannia";17;0;100
0;90;"deannie";90;0;100
204;0;"deano";204;100;0
94;0;"deanta";94;100;0
265;0;"deantae";265;100;0
18;0;"deantay";18;100;0
2532;5;"deante";2537;99.8029168309026;0.197083169097359
3003;0;"deanthony";3003;100;0
10;0;"deantoine";10;100;0
39;0;"deantonio";39;100;0
5;0;"deantony";5;100;0
7;0;"deantrae";7;100;0
207;0;"deantre";207;100;0
17;0;"deantwan";17;100;0
5;0;"deantwon";5;100;0
0;68;"deanza";68;0;100
13;0;"deaquan";13;100;0
0;188;"deara";188;0;100
0;109;"deardra";109;0;100
5;0;"deareon";5;100;0
5;55;"deari";60;8.33333333333333;91.6666666666667
0;124;"dearia";124;0;100
0;5;"deariah";5;0;100
0;35;"dearie";35;0;100
92;0;"dearies";92;100;0
74;6;"dearion";80;92.5;7.5
5;0;"dearious";5;100;0
93;0;"dearis";93;100;0
365;0;"dearius";365;100;0
792;0;"dearl";792;100;0
10;0;"dearld";10;100;0
5;0;"dearmond";5;100;0
21;0;"dearon";21;100;0
0;68;"dearra";68;0;100
0;6;"dearria";6;0;100
55;0;"dearrius";55;100;0
12;0;"dearron";12;100;0
0;316;"deasha";316;0;100
31;0;"deashawn";31;100;0
0;279;"deashia";279;0;100
0;24;"deashley";24;0;100
0;4407;"deasia";4407;0;100
0;89;"deasiah";89;0;100
0;5;"deasja";5;0;100
20;0;"deason";20;100;0
0;51;"deasya";51;0;100
37;0;"deaton";37;100;0
0;583;"deatra";583;0;100
0;14;"deatria";14;0;100
0;621;"deatrice";621;0;100
25;0;"deatrick";25;100;0
0;5;"deatta";5;0;100
0;27;"deaudra";27;0;100
15;0;"deaudre";15;100;0
0;76;"deaun";76;0;100
0;84;"deauna";84;0;100
120;318;"deaundra";438;27.3972602739726;72.6027397260274
16;0;"deaundray";16;100;0
918;0;"deaundre";918;100;0
6;33;"deaundrea";39;15.3846153846154;84.6153846153846
17;0;"deaundrey";17;100;0
0;45;"deaundria";45;0;100
0;86;"deaunna";86;0;100
34;0;"deaunta";34;100;0
27;0;"deauntae";27;100;0
361;0;"deaunte";361;100;0
7;0;"deauntre";7;100;0
5;0;"deautre";5;100;0
18;0;"deavan";18;100;0
5;0;"deavante";5;100;0
570;183;"deaven";753;75.6972111553785;24.3027888446215
69;30;"deaveon";99;69.6969696969697;30.3030303030303
0;56;"deavian";56;0;100
127;5;"deavin";132;96.2121212121212;3.78787878787879
339;193;"deavion";532;63.7218045112782;36.2781954887218
0;19;"deavionne";19;0;100
408;29;"deavon";437;93.3638443935927;6.63615560640732
24;0;"deavonte";24;100;0
0;5;"deavyn";5;0;100
0;6;"deawn";6;0;100
0;12;"deayra";12;0;100
0;20;"deaysha";20;0;100
0;65;"deaysia";65;0;100
0;62;"deazia";62;0;100
0;1450;"deb";1450;0;100
0;18;"deba";18;0;100
0;460;"debanhi";460;0;100
0;12;"debanhy";12;0;100
0;88;"debany";88;0;100
0;130;"debar";130;0;100
0;334;"debara";334;0;100
0;260;"debarah";260;0;100
0;5;"debarh";5;0;100
0;18;"debaroh";18;0;100
0;13;"debb";13;0;100
0;243;"debbe";243;0;100
0;5;"debbee";5;0;100
0;78;"debbera";78;0;100
0;5;"debbey";5;0;100
0;2972;"debbi";2972;0;100
434;187513;"debbie";187947;0.230916162535183;99.7690838374648
0;231;"debbora";231;0;100
0;617;"debborah";617;0;100
0;17;"debborrah";17;0;100
0;3651;"debbra";3651;0;100
0;113;"debbrah";113;0;100
0;9696;"debby";9696;0;100
0;47;"debbye";47;0;100
0;122;"debe";122;0;100
0;1252;"debera";1252;0;100
0;394;"deberah";394;0;100
0;65;"debhora";65;0;100
0;20;"debhra";20;0;100
0;3826;"debi";3826;0;100
0;443;"debie";443;0;100
0;44;"deboah";44;0;100
0;11;"deboarh";11;0;100
0;31;"debony";31;0;100
0;17;"debooah";17;0;100
0;5;"debor";5;0;100
28;29346;"debora";29374;0.0953223939538367;99.9046776060462
0;16;"deboraa";16;0;100
0;5;"deboraah";5;0;100
1658;739683;"deborah";741341;0.223648766222292;99.7763512337777
0;362;"deboraha";362;0;100
0;134;"deborahann";134;0;100
0;23;"deborahh";23;0;100
0;5;"deboral";5;0;100
0;33;"deboran";33;0;100
0;143;"deborh";143;0;100
0;1078;"deborha";1078;0;100
0;52;"deboria";52;0;100
11;0;"deboris";11;100;0
0;10;"deboroh";10;0;100
0;235;"deborra";235;0;100
0;941;"deborrah";941;0;100
0;6;"debr";6;0;100
1146;550290;"debra";551436;0.207821034535286;99.7921789654647
0;6;"debraa";6;0;100
0;196;"debraann";196;0;100
0;7;"debraca";7;0;100
0;4399;"debrah";4399;0;100
0;11;"debraha";11;0;100
0;11;"debrajo";11;0;100
0;198;"debralee";198;0;100
0;5;"debralyn";5;0;100
0;20;"debrann";20;0;100
0;5;"debraoh";5;0;100
0;5;"debrea";5;0;100
0;5;"debrha";5;0;100
0;297;"debria";297;0;100
0;55;"debriana";55;0;100
0;21;"debrianna";21;0;100
0;95;"debrina";95;0;100
0;5;"debrisha";5;0;100
0;24;"debro";24;0;100
0;5;"debroa";5;0;100
0;1434;"debroah";1434;0;100
0;65;"debroh";65;0;100
0;37;"debroha";37;0;100
48;0;"debron";48;100;0
0;10;"debrorah";10;0;100
0;5;"debrra";5;0;100
15;0;"debs";15;100;0
0;263;"deby";263;0;100
29;0;"decameron";29;100;0
6;0;"decan";6;100;0
0;5;"decara";5;0;100
95;0;"decari";95;100;0
10;0;"decario";10;100;0
10;0;"decarion";10;100;0
16;0;"decarius";16;100;0
0;116;"decarla";116;0;100
619;0;"decarlo";619;100;0
1154;0;"decarlos";1154;100;0
6;0;"decarri";6;100;0
6;0;"decarter";6;100;0
49;0;"decatur";49;100;0
0;5;"decca";5;0;100
16;0;"decedric";16;100;0
6;1327;"december";1333;0.450112528132033;99.549887471868
6;0;"dechane";6;100;0
0;5;"dechanel";5;0;100
5;0;"dechaun";5;100;0
0;75;"dechelle";75;0;100
0;11;"dechen";11;0;100
37;0;"dechlan";37;100;0
0;23;"decia";23;0;100
10;0;"deciderio";10;100;0
0;62;"decie";62;0;100
0;22;"decima";22;0;100
41;0;"decimus";41;100;0
68;0;"deckard";68;100;0
1131;17;"decker";1148;98.5191637630662;1.4808362369338
293;0;"decklan";293;100;0
39;0;"decklen";39;100;0
128;0;"decklin";128;100;0
139;57;"decklyn";196;70.9183673469388;29.0816326530612
28490;135;"declan";28625;99.528384279476;0.471615720524018
43;0;"declen";43;100;0
66;0;"declin";66;100;0
190;109;"declyn";299;63.5451505016722;36.4548494983278
0;74;"declynn";74;0;100
88;0;"decoda";88;100;0
5;0;"decody";5;100;0
0;11;"decola";11;0;100
0;5;"decole";5;0;100
0;21;"decora";21;0;100
123;0;"decorey";123;100;0
230;0;"decorian";230;100;0
55;0;"decorion";55;100;0
23;0;"decorius";23;100;0
44;0;"decory";44;100;0
36;5;"decota";41;87.8048780487805;12.1951219512195
7;0;"dectrick";7;100;0
0;5;"deda";5;0;100
35;0;"dedan";35;100;0
0;7;"deddie";7;0;100
123;0;"deddrick";123;100;0
0;1608;"dede";1608;0;100
0;168;"dedee";168;0;100
0;8;"dedera";8;0;100
45;0;"dederick";45;100;0
0;11;"dedi";11;0;100
0;21;"dedie";21;0;100
0;36;"dedorah";36;0;100
0;4417;"dedra";4417;0;100
0;5;"dedrah";5;0;100
0;44;"dedre";44;0;100
0;53;"dedrea";53;0;100
5;0;"dedrek";5;100;0
0;441;"dedria";441;0;100
11;0;"dedrian";11;100;0
0;5;"dedriana";5;0;100
0;6;"dedrianna";6;0;100
1793;20;"dedric";1813;98.8968560397132;1.10314396028682
4245;16;"dedrick";4261;99.6245012907768;0.375498709223187
0;7;"dedrie";7;0;100
6691;15663;"dee";22354;29.9320032209001;70.0679967790999
0;6;"deea";6;0;100
0;337;"deeana";337;0;100
0;72;"deeandra";72;0;100
5;0;"deeandre";5;100;0
0;2940;"deeann";2940;0;100
0;1942;"deeanna";1942;0;100
0;409;"deeanne";409;0;100
0;6;"deeasia";6;0;100
0;36;"deeba";36;0;100
0;5;"deeda";5;0;100
0;6;"deeddra";6;0;100
0;53;"deede";53;0;100
0;3476;"deedee";3476;0;100
0;12;"deedgra";12;0;100
0;36;"deedie";36;0;100
0;2166;"deedra";2166;0;100
0;39;"deedre";39;0;100
12;0;"deedrick";12;100;0
0;8;"deedy";8;0;100
2477;12;"deegan";2489;99.517878666131;0.482121333869024
120;5;"deejay";125;96;4
10;0;"deeken";10;100;0
0;250;"deeksha";250;0;100
0;5;"deekshitha";5;0;100
7;0;"deelan";7;100;0
0;6;"deelda";6;0;100
0;5;"deelilah";5;0;100
0;5;"deella";5;0;100
0;5;"deelynn";5;0;100
0;50;"deem";50;0;100
0;419;"deema";419;0;100
0;6;"deemah";6;0;100
18;0;"deems";18;100;0
454;5;"deen";459;98.9106753812636;1.08932461873638
5;13374;"deena";13379;0.037372000896928;99.9626279991031
0;22;"deenah";22;0;100
0;6;"deene";6;0;100
0;12;"deeneen";12;0;100
0;17;"deenie";17;0;100
0;45;"deenna";45;0;100
352;0;"deep";352;100;0
0;478;"deepa";478;0;100
554;0;"deepak";554;100;0
5;0;"deepesh";5;100;0
0;248;"deepika";248;0;100
0;7;"deepshika";7;0;100
0;12;"deepthi";12;0;100
0;148;"deepti";148;0;100
0;5;"deeqa";5;0;100
0;5;"deera";5;0;100
177;0;"deeric";177;100;0
0;151;"deerica";151;0;100
16;0;"deerick";16;100;0
0;49;"deericka";49;0;100
0;14;"deerika";14;0;100
0;22;"deesha";22;0;100
13;0;"deeshawn";13;100;0
0;50;"deethya";50;0;100
0;183;"deetra";183;0;100
0;6;"deett";6;0;100
0;1167;"deetta";1167;0;100
0;713;"deette";713;0;100
0;217;"deetya";217;0;100
0;5;"deeva";5;0;100
10;0;"deevon";10;100;0
0;186;"deeya";186;0;100
0;372;"defne";372;0;100
6;0;"defonta";6;100;0
641;0;"deforest";641;100;0
90;0;"deforrest";90;100;0
471;0;"degan";471;100;0
5;0;"degen";5;100;0
12;0;"deguan";12;100;0
72;0;"dehaven";72;100;0
0;12;"dehja";12;0;100
0;180;"dehlia";180;0;100
0;18;"dehlila";18;0;100
0;54;"deia";54;0;100
0;6;"deiadra";6;0;100
0;5;"deiah";5;0;100
0;13;"deiana";13;0;100
0;49;"deianeira";49;0;100
0;36;"deianira";36;0;100
0;10;"deianna";10;0;100
0;5;"deiara";5;0;100
5;0;"deiby";5;100;0
0;35;"deici";35;0;100
0;147;"deicy";147;0;100
0;10;"deida";10;0;100
0;10258;"deidra";10258;0;100
11;14650;"deidre";14661;0.0750289884728191;99.9249710115272
0;126;"deidrea";126;0;100
0;23;"deidree";23;0;100
0;5;"deidri";5;0;100
0;18;"deidria";18;0;100
114;0;"deidrick";114;100;0
31;0;"deighton";31;100;0
216;0;"deigo";216;100;0
0;464;"deija";464;0;100
0;283;"deijah";283;0;100
16;0;"deijon";16;100;0
0;7;"deila";7;0;100
0;16;"deilani";16;0;100
0;16;"deilany";16;0;100
0;23;"deilyn";23;0;100
6;0;"deimos";6;100;0
0;10;"deimy";10;0;100
11;0;"dein";11;100;0
0;101;"deina";101;0;100
5103;123;"deion";5226;97.646383467279;2.35361653272101
0;82;"deiona";82;0;100
0;83;"deiondra";83;0;100
421;0;"deiondre";421;100;0
6;0;"deione";6;100;0
0;97;"deionna";97;0;100
57;0;"deionta";57;100;0
103;0;"deiontae";103;100;0
22;0;"deiontay";22;100;0
274;0;"deionte";274;100;0
48;0;"deiontre";48;100;0
0;73;"deira";73;0;100
0;6;"deirde";6;0;100
0;1171;"deirdra";1171;0;100
0;16708;"deirdre";16708;0;100
0;5;"deirore";5;0;100
0;16;"deirra";16;0;100
0;10;"deise";10;0;100
11;0;"deisel";11;100;0
0;316;"deisha";316;0;100
0;569;"deisi";569;0;100
0;5;"deisree";5;0;100
0;80;"deissy";80;0;100
0;2722;"deisy";2722;0;100
6;0;"deith";6;100;0
0;1032;"deitra";1032;0;100
0;15;"deitre";15;0;100
13;0;"deitric";13;100;0
119;0;"deitrich";119;100;0
134;0;"deitrick";134;100;0
5;0;"deiveon";5;100;0
61;0;"deivi";61;100;0
5;0;"deivid";5;100;0
17;0;"deivin";17;100;0
10;7;"deivion";17;58.8235294117647;41.1764705882353
36;0;"deivy";36;100;0
6;0;"deizel";6;100;0
86;15554;"deja";15640;0.549872122762148;99.4501278772378
0;5;"dejaa";5;0;100
0;70;"dejae";70;0;100
5;3020;"dejah";3025;0.165289256198347;99.8347107438017
14;0;"dejahn";14;100;0
0;10;"dejahna";10;0;100
0;34;"dejahnae";34;0;100
0;7;"dejahnay";7;0;100
0;6;"dejahne";6;0;100
0;5;"dejahnique";5;0;100
0;75;"dejai";75;0;100
0;6;"dejamarie";6;0;100
310;13;"dejan";323;95.9752321981424;4.02476780185759
0;172;"dejana";172;0;100
0;1028;"dejanae";1028;0;100
0;50;"dejanai";50;0;100
0;201;"dejanay";201;0;100
0;5;"dejanaye";5;0;100
0;161;"dejane";161;0;100
0;20;"dejanea";20;0;100
0;265;"dejanee";265;0;100
0;5;"dejaneira";5;0;100
0;21;"dejanelle";21;0;100
0;5;"dejania";5;0;100
0;274;"dejanique";274;0;100
0;100;"dejanira";100;0;100
0;28;"dejanna";28;0;100
0;16;"dejarae";16;0;100
10;0;"dejarvis";10;100;0
431;0;"dejaun";431;100;0
5;0;"dejavion";5;100;0
106;0;"dejay";106;100;0
192;0;"dejean";192;100;0
0;16;"dejenae";16;0;100
22;0;"dejesus";22;100;0
0;112;"dejha";112;0;100
0;5;"dejhana";5;0;100
0;5;"dejhanae";5;0;100
18;0;"dejhon";18;100;0
0;228;"dejia";228;0;100
0;36;"dejiah";36;0;100
87;0;"dejion";87;100;0
407;0;"dejohn";407;100;0
0;8;"dejoire";8;0;100
2406;77;"dejon";2483;96.8989126057189;3.10108739428111
0;18;"dejona";18;0;100
0;38;"dejonae";38;0;100
0;8;"dejone";8;0;100
0;7;"dejonna";7;0;100
0;6;"dejonnae";6;0;100
5;0;"dejontae";5;100;0
55;0;"dejonte";55;100;0
21;0;"dejoun";21;100;0
225;14;"dejour";239;94.1422594142259;5.85774058577406
0;11;"dejsha";11;0;100
5145;40;"dejuan";5185;99.228543876567;0.77145612343298
0;286;"dejuana";286;0;100
26;0;"dejuane";26;100;0
12;0;"dejuante";12;100;0
5;0;"dejun";5;100;0
0;6;"dejuna";6;0;100
10;0;"dekai";10;100;0
18;0;"dekan";18;100;0
5;0;"dekanye";5;100;0
0;10;"dekara";10;0;100
279;0;"dekari";279;100;0
5;0;"dekayden";5;100;0
0;285;"dekayla";285;0;100
206;0;"deke";206;100;0
0;40;"dekeisha";40;0;100
22;0;"dekel";22;100;0
34;0;"deken";34;100;0
0;5;"dekendra";5;0;100
187;0;"dekendrick";187;100;0
13;0;"deker";13;100;0
0;20;"dekesha";20;0;100
0;10;"dekeshia";10;0;100
22;0;"dekevion";22;100;0
10;0;"dekevious";10;100;0
31;0;"dekhari";31;100;0
0;10;"dekia";10;0;100
11;0;"dekin";11;100;0
5;0;"deking";5;100;0
0;21;"dekira";21;0;100
0;70;"dekisha";70;0;100
0;5;"dekita";5;0;100
0;24;"dekiya";24;0;100
0;10;"dekiyah";10;0;100
181;0;"dekker";181;100;0
1306;0;"deklan";1306;100;0
165;0;"deklen";165;100;0
372;0;"deklin";372;100;0
361;82;"deklyn";443;81.489841986456;18.510158013544
0;71;"deklynn";71;0;100
6;0;"dekobe";6;100;0
49;11;"dekoda";60;81.6666666666667;18.3333333333333
21;0;"dekon";21;100;0
5;0;"dekorion";5;100;0
730;270;"dekota";1000;73;27
0;10;"dekotah";10;0;100
5;0;"dekoven";5;100;0
34;0;"dekwan";34;100;0
11;0;"dekwon";11;100;0
0;12;"dekyla";12;0;100
0;27;"dekyra";27;0;100
4201;672;"del";4873;86.2097270675149;13.7902729324851
5;448;"dela";453;1.1037527593819;98.8962472406181
0;35;"delacey";35;0;100
5;20;"delacy";25;20;80
0;5;"delaenie";5;0;100
0;8;"delaia";8;0;100
0;21;"delaiah";21;0;100
0;218;"delaila";218;0;100
0;113;"delailah";113;0;100
0;7;"delaili";7;0;100
5;30;"delain";35;14.2857142857143;85.7142857142857
0;1482;"delaina";1482;0;100
0;5;"delainah";5;0;100
242;2347;"delaine";2589;9.34723831595211;90.6527616840479
0;114;"delainee";114;0;100
0;1328;"delainey";1328;0;100
0;35;"delaini";35;0;100
0;82;"delainie";82;0;100
0;136;"delainy";136;0;100
0;6;"delajah";6;0;100
0;24;"delali";24;0;100
161;0;"delan";161;100;0
0;3923;"delana";3923;0;100
106;0;"delance";106;100;0
28;77;"delancey";105;26.6666666666667;73.3333333333333
5;16;"delancy";21;23.8095238095238;76.1904761904762
279;0;"deland";279;100;0
0;78;"delanda";78;0;100
147;0;"delando";147;100;0
0;20;"delandra";20;0;100
5;0;"delandre";5;100;0
0;16;"delandria";16;0;100
923;942;"delane";1865;49.4906166219839;50.5093833780161
0;5;"delanea";5;0;100
0;329;"delanee";329;0;100
0;5;"delanei";5;0;100
1105;34223;"delaney";35328;3.12783061594203;96.872169384058
15;1086;"delani";1101;1.36239782016349;98.6376021798365
0;233;"delania";233;0;100
0;4029;"delanie";4029;0;100
0;11;"delann";11;0;100
0;217;"delanna";217;0;100
0;5;"delanne";5;0;100
0;10;"delannie";10;0;100
0;48;"delanny";48;0;100
5203;71;"delano";5274;98.6537732271521;1.34622677284793
11;0;"delanor";11;100;0
5;0;"delanta";5;100;0
5;0;"delantae";5;100;0
695;0;"delante";695;100;0
0;897;"delany";897;0;100
0;5;"delanya";5;0;100
0;22;"delaphine";22;0;100
0;64;"delara";64;0;100
0;6;"delaris";6;0;100
0;5;"delasha";5;0;100
0;49;"delasia";49;0;100
5;0;"delaun";5;100;0
0;10;"delaura";10;0;100
0;5;"delauren";5;0;100
5;0;"delavan";5;100;0
0;5;"delavina";5;0;100
130;0;"delawrence";130;100;0
0;5;"delaya";5;0;100
0;22;"delayah";22;0;100
0;195;"delayla";195;0;100
0;30;"delaylah";30;0;100
0;766;"delayna";766;0;100
56;601;"delayne";657;8.52359208523592;91.4764079147641
0;177;"delaynee";177;0;100
0;11;"delayney";11;0;100
0;108;"delayni";108;0;100
0;290;"delaynie";290;0;100
0;5;"delaysha";5;0;100
0;45;"delaysia";45;0;100
0;91;"delayza";91;0;100
0;5;"delba";5;0;100
45986;122;"delbert";46108;99.7354038344756;0.264596165524421
0;369;"delberta";369;0;100
0;5;"delborah";5;0;100
0;337;"delbra";337;0;100
5;0;"delbreco";5;100;0
5;0;"delcan";5;100;0
0;74;"delcenia";74;0;100
0;11;"delci";11;0;100
0;247;"delcia";247;0;100
0;1204;"delcie";1204;0;100
0;56;"delcina";56;0;100
0;34;"delcine";34;0;100
0;11;"delcy";11;0;100
5;0;"deldon";5;100;0
0;16;"deldra";16;0;100
225;0;"deldrick";225;100;0
0;5;"delea";5;0;100
0;139;"deleah";139;0;100
0;15;"delean";15;0;100
0;11;"deleana";11;0;100
0;5;"deleatrice";5;0;100
0;336;"delecia";336;0;100
0;39;"delee";39;0;100
0;17;"deleen";17;0;100
0;17;"deleena";17;0;100
0;10;"deleesa";10;0;100
0;57;"delema";57;0;100
0;2092;"delena";2092;0;100
0;838;"delene";838;0;100
0;5;"delenia";5;0;100
0;84;"delenn";84;0;100
0;5;"delenna";5;0;100
5;0;"deleno";5;100;0
863;14;"deleon";877;98.4036488027366;1.5963511972634
0;5;"delephine";5;0;100
0;66;"delesa";66;0;100
0;83;"delesha";83;0;100
0;24;"deleshia";24;0;100
0;83;"delesia";83;0;100
0;45;"deleta";45;0;100
0;104;"deletha";104;0;100
0;11;"delethia";11;0;100
0;5;"deletta";5;0;100
0;5;"delexis";5;0;100
0;12;"delexus";12;0;100
0;42;"deleyza";42;0;100
0;38;"delfa";38;0;100
274;0;"delfin";274;100;0
0;3795;"delfina";3795;0;100
0;46;"delfinia";46;0;100
2264;0;"delfino";2264;100;0
548;0;"delford";548;100;0
22;0;"delfred";22;100;0
0;7;"delfreda";7;0;100
62;32525;"delia";32587;0.19025991959984;99.8097400804002
0;1054;"deliah";1054;0;100
0;89;"deliana";89;0;100
0;5;"delianna";5;0;100
0;5;"deliany";5;0;100
0;5;"delianys";5;0;100
0;16;"delica";16;0;100
0;15;"delice";15;0;100
0;2505;"delicia";2505;0;100
0;10;"delie";10;0;100
0;1001;"delight";1001;0;100
29;42;"delijah";71;40.8450704225352;59.1549295774648
0;2998;"delila";2998;0;100
0;33672;"delilah";33672;0;100
0;10;"delilahrose";10;0;100
0;6;"delilha";6;0;100
0;22;"delilia";22;0;100
0;157;"deliliah";157;0;100
0;21;"delima";21;0;100
0;23;"delimar";23;0;100
0;1558;"delina";1558;0;100
0;43;"delinah";43;0;100
0;2210;"delinda";2210;0;100
0;7;"delinia";7;0;100
7;0;"delino";7;100;0
98;0;"delio";98;100;0
0;3230;"delisa";3230;0;100
0;318;"delise";318;0;100
0;967;"delisha";967;0;100
0;43;"delishia";43;0;100
0;115;"delisia";115;0;100
0;401;"delissa";401;0;100
0;5;"delissia";5;0;100
0;127;"delita";127;0;100
0;10;"delite";10;0;100
0;60;"delitha";60;0;100
0;200;"deliyah";200;0;100
0;19;"deliylah";19;0;100
0;30;"deliza";30;0;100
28;0;"deljuan";28;100;0
3745;2300;"dell";6045;61.9520264681555;38.0479735318445
123;55792;"della";55915;0.219976750424752;99.7800232495753
0;27;"dellah";27;0;100
0;67;"dellamae";67;0;100
5;0;"dellan";5;100;0
0;10;"dellana";10;0;100
0;16;"dellaney";16;0;100
0;5;"dellanie";5;0;100
0;71;"dellanira";71;0;100
0;433;"dellar";433;0;100
0;11;"dellareese";11;0;100
95;0;"dellas";95;100;0
0;86;"delle";86;0;100
7;0;"dellen";7;100;0
0;21;"dellena";21;0;100
0;92;"dellene";92;0;100
0;18;"deller";18;0;100
0;319;"dellia";319;0;100
11;491;"dellie";502;2.19123505976096;97.808764940239
75;0;"dellis";75;100;0
34;0;"dellon";34;100;0
0;54;"dellora";54;0;100
16;0;"delloyd";16;100;0
1447;8277;"delma";9724;14.8807075277664;85.1192924722337
229;0;"delman";229;100;0
13916;134;"delmar";14050;99.0462633451957;0.953736654804271
10;0;"delmarco";10;100;0
0;54;"delmarie";54;0;100
11;0;"delmario";11;100;0
2257;0;"delmas";2257;100;0
7556;16;"delmer";7572;99.7886951928156;0.211304807184363
0;221;"delmi";221;0;100
0;59;"delmira";59;0;100
10;7;"delmis";17;58.8235294117647;41.1764705882353
105;0;"delmo";105;100;0
437;0;"delmon";437;100;0
11;0;"delmond";11;100;0
0;12;"delmonica";12;0;100
539;0;"delmont";539;100;0
5;0;"delmonta";5;100;0
59;0;"delmonte";59;100;0
5;0;"delmor";5;100;0
243;0;"delmore";243;100;0
66;0;"delmos";66;100;0
599;0;"delmus";599;100;0
0;541;"delmy";541;0;100
0;44;"delna";44;0;100
294;0;"delno";294;100;0
0;5;"deloice";5;0;100
122;8500;"delois";8622;1.41498492229181;98.5850150777082
0;1887;"deloise";1887;0;100
0;66;"deloma";66;0;100
1268;38;"delon";1306;97.0903522205207;2.90964777947933
5;267;"delona";272;1.83823529411765;98.1617647058823
0;296;"delonda";296;0;100
5;0;"delondo";5;100;0
46;41;"delone";87;52.8735632183908;47.1264367816092
5;0;"deloni";5;100;0
0;5;"delonia";5;0;100
0;56;"delonna";56;0;100
350;0;"delonta";350;100;0
156;0;"delontae";156;100;0
36;0;"delontay";36;100;0
1431;0;"delonte";1431;100;0
16;0;"delonzo";16;100;0
10;0;"delor";10;100;0
0;2785;"delora";2785;0;100
0;908;"deloras";908;0;100
0;5;"delorce";5;0;100
31;10;"delore";41;75.609756097561;24.390243902439
254;46;"delorean";300;84.6666666666667;15.3333333333333
12;0;"deloren";12;100;0
7;0;"delorenzo";7;100;0
430;117589;"delores";118019;0.364348113439361;99.6356518865606
0;134;"delorese";134;0;100
0;425;"deloria";425;0;100
36;10;"delorian";46;78.2608695652174;21.7391304347826
0;97;"delorice";97;0;100
0;1251;"delories";1251;0;100
93;34664;"deloris";34757;0.267571999884915;99.7324280001151
0;1311;"delorise";1311;0;100
0;79;"deloros";79;0;100
0;12;"delors";12;0;100
0;1142;"delorse";1142;0;100
0;75;"delorus";75;0;100
1248;0;"delos";1248;100;0
237;0;"deloss";237;100;0
0;15;"delouise";15;0;100
0;5;"delouris";5;0;100
398;0;"deloy";398;100;0
0;104;"deloyce";104;0;100
130;0;"deloyd";130;100;0
0;1859;"delpha";1859;0;100
0;42;"delphene";42;0;100
0;11;"delphenia";11;0;100
0;3822;"delphia";3822;0;100
0;37;"delphie";37;0;100
116;0;"delphin";116;100;0
0;840;"delphina";840;0;100
33;9786;"delphine";9819;0.336083104185762;99.6639168958142
0;23;"delphinia";23;0;100
60;0;"delphis";60;100;0
17;0;"delphus";17;100;0
107;0;"delquan";107;100;0
0;136;"delrae";136;0;100
473;0;"delray";473;100;0
64;0;"delrick";64;100;0
253;0;"delrico";253;100;0
0;17;"delrita";17;0;100
70;0;"delron";70;100;0
0;138;"delrose";138;0;100
1386;0;"delroy";1386;100;0
0;198;"delsa";198;0;100
5;0;"delsean";5;100;0
5;0;"delsen";5;100;0
0;32;"delsey";32;0;100
0;5;"delsha";5;0;100
46;0;"delshaun";46;100;0
313;0;"delshawn";313;100;0
58;0;"delshon";58;100;0
0;41;"delsia";41;0;100
0;1349;"delsie";1349;0;100
172;0;"delsin";172;100;0
65;0;"delson";65;100;0
0;97;"delsy";97;0;100
84;3326;"delta";3410;2.4633431085044;97.5366568914956
0;136;"deltha";136;0;100
0;6;"deltina";6;0;100
4583;0;"delton";4583;100;0
5;0;"deltrick";5;100;0
5;0;"deluca";5;100;0
0;17;"deluvina";17;0;100
0;265;"delva";265;0;100
17;0;"delvan";17;100;0
29;0;"delvante";29;100;0
6;0;"delvaughn";6;100;0
81;0;"delvecchio";81;100;0
6;0;"delver";6;100;0
0;25;"delvia";25;0;100
5045;22;"delvin";5067;99.565818038287;0.434181961713045
0;165;"delvina";165;0;100
6;0;"delvion";6;100;0
97;0;"delvis";97;100;0
1078;0;"delvon";1078;100;0
38;0;"delvonta";38;100;0
11;0;"delvontae";11;100;0
168;0;"delvonte";168;100;0
5;0;"delwayne";5;100;0
1805;0;"delwin";1805;100;0
25;0;"delwood";25;100;0
913;0;"delwyn";913;100;0
0;5;"dely";5;0;100
0;5;"delya";5;0;100
0;6;"delycia";6;0;100
0;467;"delyla";467;0;100
0;902;"delylah";902;0;100
71;0;"delyle";71;100;0
11;57;"delyn";68;16.1764705882353;83.8235294117647
0;78;"delynda";78;0;100
99;719;"delynn";818;12.1026894865526;87.8973105134474
0;35;"delynne";35;0;100
0;5;"delysa";5;0;100
0;17;"delyssa";17;0;100
0;6;"delyza";6;0;100
0;53;"delzora";53;0;100
0;747;"dema";747;0;100
17;0;"demacio";17;100;0
6;0;"demaine";6;100;0
26;0;"demaj";26;100;0
6;0;"demajae";6;100;0
16;0;"demaje";16;100;0
5;0;"demandre";5;100;0
367;107;"demani";474;77.4261603375527;22.5738396624473
24;0;"demante";24;100;0
5;0;"demanuel";5;100;0
1124;0;"demar";1124;100;0
0;128;"demara";128;0;100
11;0;"demarcio";11;100;0
5174;0;"demarco";5174;100;0
58;0;"demarcos";58;100;0
12608;29;"demarcus";12637;99.7705151539131;0.229484846086888
19;0;"demare";19;100;0
219;0;"demarea";219;100;0
5;0;"demarean";5;100;0
56;11;"demaree";67;83.5820895522388;16.4179104477612
39;0;"demareo";39;100;0
80;0;"demareon";80;100;0
1618;202;"demari";1820;88.9010989010989;11.0989010989011
59;316;"demaria";375;15.7333333333333;84.2666666666667
32;0;"demariae";32;100;0
0;23;"demariah";23;0;100
205;0;"demarian";205;100;0
0;5;"demariana";5;0;100
64;104;"demarie";168;38.0952380952381;61.9047619047619
5;0;"demariea";5;100;0
47;0;"demarien";47;100;0
5902;17;"demario";5919;99.7127893225207;0.287210677479304
2999;0;"demarion";2999;100;0
0;5;"demariona";5;0;100
0;7;"demarionna";7;0;100
360;0;"demarious";360;100;0
278;1009;"demaris";1287;21.6006216006216;78.3993783993784
1808;0;"demarius";1808;100;0
0;17;"demariya";17;0;100
0;22;"demariyah";22;0;100
17;0;"demariyon";17;100;0
29;0;"demark";29;100;0
6;0;"demarkas";6;100;0
5;0;"demarkio";5;100;0
117;0;"demarkis";117;100;0
652;0;"demarko";652;100;0
1140;0;"demarkus";1140;100;0
210;0;"demarlo";210;100;0
5;0;"demaro";5;100;0
5;0;"demarque";5;100;0
254;0;"demarques";254;100;0
138;0;"demarquez";138;100;0
430;0;"demarquis";430;100;0
33;0;"demarquise";33;100;0
63;0;"demarqus";63;100;0
105;0;"demarr";105;100;0
28;0;"demarre";28;100;0
11;0;"demarrea";11;100;0
5;0;"demarreon";5;100;0
55;0;"demarri";55;100;0
8;0;"demarrie";8;100;0
191;0;"demarrio";191;100;0
181;0;"demarrion";181;100;0
64;0;"demarrius";64;100;0
5;0;"demartez";5;100;0
65;0;"demarus";65;100;0
68;0;"demaryius";68;100;0
5;0;"demas";5;100;0
5;0;"demaurea";5;100;0
224;0;"demauri";224;100;0
9;11;"demauria";20;45;55
6;0;"demaurie";6;100;0
5;0;"demaurio";5;100;0
79;0;"demaurion";79;100;0
26;0;"demaury";26;100;0
0;227;"demaya";227;0;100
54;0;"demba";54;100;0
12;5;"demea";17;70.5882352941177;29.4117647058824
0;5;"demeatra";5;0;100
18;41;"demeatrice";59;30.5084745762712;69.4915254237288
5;0;"demeatrius";5;100;0
0;11;"demeca";11;0;100
0;84;"demecia";84;0;100
26;0;"demecio";26;100;0
65;0;"demeco";65;100;0
5;0;"demedrick";5;100;0
12;0;"demeir";12;100;0
0;68;"demeisha";68;0;100
0;273;"demeka";273;0;100
0;31;"demekia";31;0;100
32;0;"demeko";32;100;0
16;0;"demel";16;100;0
0;12;"demelza";12;0;100
21;0;"dementrius";21;100;0
86;0;"demere";86;100;0
0;5;"demeree";5;0;100
0;6;"demeri";6;0;100
0;49;"demeria";49;0;100
21;0;"demerick";21;100;0
10;0;"demerion";10;100;0
5;0;"demeris";5;100;0
140;0;"demerius";140;100;0
5;0;"demerrick";5;100;0
5;20;"demery";25;20;80
0;337;"demesha";337;0;100
0;96;"demeshia";96;0;100
0;27;"demeta";27;0;100
5;0;"demeter";5;100;0
0;12;"demeteria";12;0;100
23;0;"demeterius";23;100;0
0;12;"demethra";12;0;100
0;5;"demetia";5;0;100
6;0;"demetirus";6;100;0
12;4109;"demetra";4121;0.291191458383887;99.7088085416161
0;5;"demetras";5;0;100
622;12;"demetre";634;98.1072555205047;1.89274447949527
26;0;"demetree";26;100;0
97;6;"demetres";103;94.1747572815534;5.8252427184466
12;122;"demetress";134;8.95522388059701;91.044776119403
238;0;"demetreus";238;100;0
7;0;"demetrey";7;100;0
3492;158;"demetri";3650;95.6712328767123;4.32876712328767
141;10686;"demetria";10827;1.30229980604045;98.6977001939595
0;5;"demetrial";5;0;100
10;0;"demetrian";10;100;0
0;51;"demetriana";51;0;100
0;5;"demetrianna";5;0;100
127;49;"demetrias";176;72.1590909090909;27.8409090909091
2032;411;"demetric";2443;83.1764224314368;16.8235775685632
0;227;"demetrica";227;0;100
1611;1754;"demetrice";3365;47.8751857355126;52.1248142644874
5;0;"demetrices";5;100;0
0;5;"demetricia";5;0;100
700;0;"demetrick";700;100;0
23;0;"demetrics";23;100;0
31;0;"demetricus";31;100;0
297;17;"demetrie";314;94.5859872611465;5.4140127388535
61;0;"demetries";61;100;0
27;0;"demetrik";27;100;0
2874;0;"demetrio";2874;100;0
92;0;"demetrion";92;100;0
0;11;"demetriona";11;0;100
2609;0;"demetrios";2609;100;0
1650;58;"demetrious";1708;96.6042154566745;3.39578454332553
2505;892;"demetris";3397;73.7415366499853;26.2584633500147
6;25;"demetrise";31;19.3548387096774;80.6451612903226
0;5;"demetrish";5;0;100
0;27;"demetriss";27;0;100
9;0;"demetriu";9;100;0
33668;1728;"demetrius";35396;95.1180924398237;4.88190756017629
35;0;"demetrous";35;100;0
808;5;"demetruis";813;99.3849938499385;0.615006150061501
633;22;"demetrus";655;96.6412213740458;3.3587786259542
95;0;"demetry";95;100;0
12;0;"demeturis";12;100;0
0;7812;"demi";7812;0;100
0;578;"demia";578;0;100
0;213;"demiah";213;0;100
1640;14;"demian";1654;99.1535671100363;0.846432889963724
0;113;"demiana";113;0;100
0;75;"demica";75;0;100
5;0;"demicah";5;100;0
372;0;"demichael";372;100;0
16;0;"demicheal";16;100;0
75;0;"demico";75;100;0
5;0;"demid";5;100;0
0;46;"demie";46;0;100
11;0;"demien";11;100;0
5;0;"demier";5;100;0
0;23;"demii";23;0;100
0;239;"demika";239;0;100
16;0;"demiko";16;100;0
34;18;"demilade";52;65.3846153846154;34.6153846153846
10;0;"demille";10;100;0
5;0;"deming";5;100;0
6;0;"demingo";6;100;0
10;0;"demion";10;100;0
494;0;"demir";494;100;0
0;57;"demira";57;0;100
0;5;"demiracle";5;0;100
7;0;"demire";7;100;0
10;0;"demis";10;100;0
0;237;"demisha";237;0;100
0;275;"demita";275;0;100
0;596;"demitra";596;0;100
51;0;"demitre";51;100;0
1800;23;"demitri";1823;98.7383433900165;1.26165660998354
0;575;"demitria";575;0;100
6;0;"demitric";6;100;0
5;6;"demitrice";11;45.4545454545455;54.5454545454545
16;0;"demitrie";16;100;0
5;0;"demitrio";5;100;0
114;0;"demitrios";114;100;0
84;0;"demitrious";84;100;0
142;0;"demitris";142;100;0
1834;11;"demitrius";1845;99.4037940379404;0.596205962059621
134;0;"demitrus";134;100;0
47;0;"demitry";47;100;0
0;268;"demiya";268;0;100
0;355;"demiyah";355;0;100
0;47;"demmi";47;0;100
0;5;"demmie";5;0;100
821;0;"demon";821;100;0
0;15;"demona";15;0;100
5618;25;"demond";5643;99.5569732411838;0.443026758816232
5;0;"demonde";5;100;0
314;0;"demondre";314;100;0
482;0;"demone";482;100;0
5;0;"demonei";5;100;0
212;76;"demoni";288;73.6111111111111;26.3888888888889
0;339;"demonica";339;0;100
61;6;"demonie";67;91.044776119403;8.95522388059701
522;0;"demont";522;100;0
708;0;"demonta";708;100;0
620;0;"demontae";620;100;0
10;0;"demontavious";10;100;0
202;0;"demontay";202;100;0
2275;0;"demonte";2275;100;0
184;0;"demontez";184;100;0
58;0;"demontra";58;100;0
69;0;"demontrae";69;100;0
141;0;"demontray";141;100;0
496;0;"demontre";496;100;0
5;0;"demontreal";5;100;0
10;0;"demontrell";10;100;0
25;0;"demontrey";25;100;0
79;0;"demontrez";79;100;0
12;0;"demorea";12;100;0
26;0;"demorian";26;100;0
71;0;"demorio";71;100;0
26;0;"demorion";26;100;0
5;0;"demoris";5;100;0
21;0;"demorrio";21;100;0
364;0;"demorris";364;100;0
5;0;"demos";5;100;0
63;0;"demosthenes";63;100;0
0;35;"demple";35;0;100
3663;283;"dempsey";3946;92.8281804358844;7.17181956411556
7;0;"dempsie";7;100;0
119;0;"dempsy";119;100;0
0;53;"demri";53;0;100
60;0;"demtrius";60;100;0
5;0;"demus";5;100;0
0;25;"demy";25;0;100
0;666;"demya";666;0;100
0;97;"demyah";97;0;100
56;0;"demyan";56;100;0
0;44;"demyia";44;0;100
0;39;"demyiah";39;0;100
0;7;"demyla";7;0;100
0;23;"demyra";23;0;100
17;0;"den";17;100;0
56;31498;"dena";31554;0.177473537427901;99.8225264625721
0;2490;"denae";2490;0;100
0;11;"denaeja";11;0;100
0;58;"denah";58;0;100
38;0;"denahi";38;100;0
0;128;"denai";128;0;100
0;21;"denaija";21;0;100
0;20;"denaijah";20;0;100
0;67;"denaisha";67;0;100
0;5;"denaiya";5;0;100
0;147;"denaja";147;0;100
0;121;"denajah";121;0;100
0;10;"denajia";10;0;100
421;1081;"denali";1502;28.0292942743009;71.9707057256991
0;5;"denalia";5;0;100
0;81;"denaly";81;0;100
0;10;"denamarie";10;0;100
694;0;"denard";694;100;0
17;0;"denardo";17;100;0
37;5;"denari";42;88.0952380952381;11.9047619047619
0;26;"denaria";26;0;100
95;0;"denario";95;100;0
6;0;"denarious";6;100;0
330;0;"denarius";330;100;0
7;0;"denaro";7;100;0
5;0;"denarrius";5;100;0
0;40;"denasha";40;0;100
0;50;"denashia";50;0;100
0;669;"denasia";669;0;100
0;5;"denautica";5;0;100
0;510;"denay";510;0;100
0;287;"denaya";287;0;100
0;26;"denayah";26;0;100
0;43;"denaye";43;0;100
0;37;"denaysha";37;0;100
0;51;"denaysia";51;0;100
0;15;"denazia";15;0;100
20;0;"denby";20;100;0
0;6;"dencie";6;0;100
274;0;"dencil";274;100;0
10;0;"dendrick";10;100;0
223;572;"dene";795;28.0503144654088;71.9496855345912
0;376;"denea";376;0;100
0;484;"denean";484;0;100
0;104;"deneane";104;0;100
0;42;"denease";42;0;100
0;180;"denece";180;0;100
0;202;"denecia";202;0;100
5;0;"deneco";5;100;0
0;37;"denedra";37;0;100
0;912;"denee";912;0;100
0;5;"deneem";5;0;100
7;3602;"deneen";3609;0.193959545580493;99.8060404544195
0;7;"deneena";7;0;100
0;74;"deneene";74;0;100
0;5;"deneesha";5;0;100
0;290;"deneice";290;0;100
0;15;"deneil";15;0;100
0;278;"deneise";278;0;100
0;411;"deneisha";411;0;100
0;5;"deneishia";5;0;100
0;183;"deneka";183;0;100
0;10;"denekia";10;0;100
0;10;"denel";10;0;100
0;111;"denelda";111;0;100
58;419;"denell";477;12.1593291404612;87.8406708595388
6;633;"denelle";639;0.938967136150235;99.0610328638498
0;5;"denena";5;0;100
0;350;"denene";350;0;100
0;21;"denequa";21;0;100
10;0;"denerick";10;100;0
7;0;"denerio";7;100;0
10;0;"denero";10;100;0
5;0;"denes";5;100;0
0;26;"denesa";26;0;100
0;1588;"denese";1588;0;100
0;906;"denesha";906;0;100
0;347;"deneshia";347;0;100
0;71;"denesia";71;0;100
0;151;"denessa";151;0;100
0;13;"deneta";13;0;100
0;5;"denetia";5;0;100
0;470;"denetra";470;0;100
0;266;"denetria";266;0;100
0;22;"denetrice";22;0;100
0;5;"denetris";5;0;100
0;10;"denetrius";10;0;100
0;13;"denett";13;0;100
0;195;"denetta";195;0;100
0;692;"denette";692;0;100
0;5;"deneva";5;0;100
7;0;"deney";7;100;0
20;0;"denford";20;100;0
249;0;"deng";249;100;0
57;0;"denham";57;100;0
143;609;"deni";752;19.0159574468085;80.9840425531915
0;1148;"denia";1148;0;100
0;65;"deniah";65;0;100
0;194;"denica";194;0;100
0;10614;"denice";10614;0;100
0;257;"denicia";257;0;100
0;5;"denicka";5;0;100
39;0;"denico";39;100;0
0;17;"denie";17;0;100
0;1162;"deniece";1162;0;100
0;5;"deniecia";5;0;100
93;0;"deniel";93;100;0
0;5;"deniella";5;0;100
0;980;"denielle";980;0;100
0;12;"deniene";12;0;100
0;353;"deniese";353;0;100
0;98;"deniesha";98;0;100
0;31;"denija";31;0;100
0;73;"denijah";73;0;100
0;528;"denika";528;0;100
19;0;"deniko";19;100;0
0;6;"denilah";6;0;100
0;34;"denille";34;0;100
588;0;"denilson";588;100;0
5;0;"denilzon";5;100;0
1258;444;"denim";1702;73.9130434782609;26.0869565217391
5;0;"denin";5;100;0
0;116;"denina";116;0;100
0;963;"denine";963;0;100
0;137;"deniqua";137;0;100
0;34;"denique";34;0;100
0;17;"denira";17;0;100
230;0;"deniro";230;100;0
19668;813;"denis";20481;96.0304672623407;3.96953273765929
0;978;"denisa";978;0;100
1363;371725;"denise";373088;0.36532935929325;99.6346706407067
0;4278;"denisha";4278;0;100
0;7;"denishea";7;0;100
0;223;"denishia";223;0;100
0;184;"denisia";184;0;100
59;0;"denison";59;100;0
5;82;"deniss";87;5.74712643678161;94.2528735632184
0;72;"denissa";72;0;100
0;6111;"denisse";6111;0;100
0;2744;"denita";2744;0;100
0;476;"denitra";476;0;100
0;5;"denitta";5;0;100
0;357;"deniya";357;0;100
0;364;"deniyah";364;0;100
807;655;"deniz";1462;55.1983584131327;44.8016415868673
0;21;"denize";21;0;100
47;0;"denley";47;100;0
161;0;"denman";161;100;0
5;0;"denmark";5;100;0
0;2298;"denna";2298;0;100
0;5;"dennae";5;0;100
154;0;"dennard";154;100;0
0;5;"denne";5;0;100
10;28;"dennell";38;26.3157894736842;73.6842105263158
0;7;"dennen";7;0;100
38;0;"dennes";38;100;0
0;5;"dennese";5;0;100
0;10;"dennesly";10;0;100
5;0;"dennett";5;100;0
0;10;"dennetta";10;0;100
0;209;"dennette";209;0;100
218;0;"denney";218;100;0
15;159;"denni";174;8.62068965517241;91.3793103448276
0;20;"dennia";20;0;100
0;299;"dennice";299;0;100
3635;772;"dennie";4407;82.4824143408214;17.5175856591786
0;20;"dennielle";20;0;100
66;0;"dennies";66;100;0
0;50;"dennine";50;0;100
614864;2661;"dennis";617525;99.5690862718109;0.430913728189142
83;3367;"dennise";3450;2.40579710144928;97.5942028985507
0;252;"dennisha";252;0;100
0;5;"dennishia";5;0;100
728;0;"dennison";728;100;0
0;155;"dennisse";155;0;100
0;6;"dennita";6;0;100
33;0;"dennon";33;100;0
15144;395;"denny";15539;97.4580088808804;2.54199111911963
426;83;"dennys";509;83.6935166994106;16.3064833005894
706;0;"deno";706;100;0
51;0;"denon";51;100;0
0;111;"denora";111;0;100
5;0;"denoris";5;100;0
201;0;"denorris";201;100;0
0;17;"denotra";17;0;100
6;0;"denroy";6;100;0
96;0;"densel";96;100;0
0;19;"densie";19;0;100
147;0;"densil";147;100;0
427;0;"denson";427;100;0
71;0;"dent";71;100;0
4791;0;"denton";4791;100;0
29;0;"dentrell";29;100;0
14463;1435;"denver";15898;90.9737073845767;9.02629261542332
131;0;"denvil";131;100;0
140;0;"deny";140;100;0
0;124;"denya";124;0;100
0;5;"denyah";5;0;100
0;335;"denyce";335;0;100
0;32;"denyel";32;0;100
0;10;"denyell";10;0;100
0;7;"denyelle";7;0;100
0;11;"denyia";11;0;100
0;90;"denyla";90;0;100
0;26;"denylah";26;0;100
117;124;"denym";241;48.5477178423236;51.4522821576763
162;426;"denys";588;27.5510204081633;72.4489795918367
0;1322;"denyse";1322;0;100
0;22;"denysha";22;0;100
0;6;"denysse";6;0;100
64;0;"denzal";64;100;0
32;0;"denzale";32;100;0
10108;41;"denzel";10149;99.5960193122475;0.403980687752488
1206;0;"denzell";1206;100;0
50;0;"denzelle";50;100;0
18;0;"denziel";18;100;0
3745;68;"denzil";3813;98.2166273275636;1.7833726724364
20;0;"denzle";20;100;0
5;0;"denzyl";5;100;0
210;0;"deo";210;100;0
0;10;"deobrah";10;0;100
0;392;"deola";392;0;100
0;243;"deolinda";243;0;100
13890;1657;"deon";15547;89.3419952402393;10.6580047597607
0;1155;"deona";1155;0;100
17;0;"deonate";17;100;0
0;16;"deonca";16;0;100
0;5;"deonda";5;0;100
415;1354;"deondra";1769;23.4595816845676;76.5404183154324
248;0;"deondrae";248;100;0
288;0;"deondray";288;100;0
3715;15;"deondre";3730;99.597855227882;0.402144772117962
68;88;"deondrea";156;43.5897435897436;56.4102564102564
18;0;"deondrey";18;100;0
0;207;"deondria";207;0;100
10;0;"deondric";10;100;0
114;0;"deondrick";114;100;0
110;182;"deone";292;37.6712328767123;62.3287671232877
0;61;"deoni";61;0;100
0;6;"deonia";6;0;100
0;47;"deonica";47;0;100
0;5;"deonie";5;0;100
0;34;"deonka";34;0;100
0;13;"deonn";13;0;100
5;3576;"deonna";3581;0.139625802848366;99.8603741971516
47;437;"deonne";484;9.71074380165289;90.2892561983471
0;28;"deonni";28;0;100
0;10;"deonnie";10;0;100
0;6;"deonsha";6;0;100
0;6;"deonshay";6;0;100
2469;36;"deonta";2505;98.562874251497;1.43712574850299
3263;0;"deontae";3263;100;0
49;0;"deontai";49;100;0
28;0;"deontavious";28;100;0
1039;0;"deontay";1039;100;0
157;0;"deontaye";157;100;0
7577;41;"deonte";7618;99.4618009976372;0.538199002362825
33;0;"deontea";33;100;0
6;0;"deontee";6;100;0
109;0;"deontez";109;100;0
5;0;"deontia";5;100;0
135;18;"deontra";153;88.2352941176471;11.7647058823529
180;0;"deontrae";180;100;0
327;0;"deontray";327;100;0
755;0;"deontre";755;100;0
97;0;"deontrey";97;100;0
30;0;"deontrez";30;100;0
0;14;"deonza";14;0;100
0;10;"deora";10;0;100
0;64;"deosha";64;0;100
0;10;"deotha";10;0;100
22;0;"deotis";22;100;0
6;22;"deoveon";28;21.4285714285714;78.5714285714286
0;5;"deovian";5;0;100
71;43;"deovion";114;62.280701754386;37.719298245614
56;0;"depaul";56;100;0
17;0;"depree";17;100;0
21;0;"depriest";21;100;0
0;22;"deprise";22;0;100
0;5;"deqa";5;0;100
3614;5;"dequan";3619;99.8618402873722;0.138159712627798
0;34;"dequana";34;0;100
0;5;"dequanda";5;0;100
0;7;"dequandra";7;0;100
71;0;"dequandre";71;100;0
67;0;"dequane";67;100;0
72;0;"dequann";72;100;0
0;12;"dequanna";12;0;100
22;0;"dequanta";22;100;0
12;0;"dequantae";12;100;0
126;0;"dequante";126;100;0
5;0;"dequantez";5;100;0
20;0;"dequarious";20;100;0
342;0;"dequarius";342;100;0
0;5;"dequasha";5;0;100
5;0;"dequaveon";5;100;0
130;0;"dequavion";130;100;0
122;0;"dequavious";122;100;0
82;0;"dequavius";82;100;0
59;0;"dequawn";59;100;0
5;0;"dequay";5;100;0
6;0;"dequentin";6;100;0
0;11;"dequesha";11;0;100
11;0;"dequez";11;100;0
0;5;"dequilla";5;0;100
364;0;"dequincy";364;100;0
17;0;"dequindre";17;100;0
20;0;"dequinn";20;100;0
19;0;"dequinton";19;100;0
0;27;"dequisha";27;0;100
0;86;"dequita";86;0;100
172;0;"dequon";172;100;0
5;0;"dequone";5;100;0
48;0;"deqwan";48;100;0
0;190;"der";190;0;100
0;430;"dera";430;0;100
74;0;"derak";74;100;0
203;0;"deral";203;100;0
2190;0;"derald";2190;100;0
0;5;"deralyn";5;0;100
157;0;"deran";157;100;0
190;0;"deray";190;100;0
0;11;"derba";11;0;100
29;5;"derby";34;85.2941176470588;14.7058823529412
23;0;"derck";23;100;0
5;0;"derean";5;100;0
104;0;"derec";104;100;0
6375;0;"dereck";6375;100;0
5;0;"dereginald";5;100;0
37;0;"dereion";37;100;0
227865;910;"derek";228775;99.6022292645612;0.39777073543875
0;412;"dereka";412;0;100
207;0;"dereke";207;100;0
0;6;"derekia";6;0;100
65;0;"derel";65;100;0
714;0;"derell";714;100;0
80;0;"derelle";80;100;0
0;7;"derelys";7;0;100
5;0;"deremy";5;100;0
231;0;"deren";231;100;0
0;12;"derena";12;0;100
0;353;"derenda";353;0;100
0;6;"derene";6;0;100
1144;359;"dereon";1503;76.1144377910845;23.8855622089155
0;121;"dereona";121;0;100
0;62;"dereonna";62;0;100
0;46;"deresa";46;0;100
0;25;"deresha";25;0;100
0;8;"dereth";8;0;100
0;86;"deretha";86;0;100
21;0;"derex";21;100;0
16;0;"dereyon";16;100;0
13;0;"derez";13;100;0
6;0;"derf";6;100;0
0;101;"derhonda";101;0;100
0;50;"deri";50;0;100
0;25;"deria";25;0;100
0;25;"deriah";25;0;100
1166;135;"derian";1301;89.6233666410454;10.3766333589546
0;85;"deriana";85;0;100
0;39;"derianna";39;0;100
4598;0;"deric";4598;100;0
0;653;"derica";653;0;100
18;0;"derice";18;100;0
18512;39;"derick";18551;99.7897687456202;0.210231254379818
0;410;"dericka";410;0;100
331;0;"derico";331;100;0
0;16;"deridre";16;0;100
11;0;"deriek";11;100;0
25;0;"deriel";25;100;0
0;13;"derielle";13;0;100
56;0;"derien";56;100;0
5243;0;"derik";5243;100;0
0;440;"derika";440;0;100
6;0;"derike";6;100;0
798;146;"derin";944;84.5338983050847;15.4661016949153
0;11;"derina";11;0;100
0;436;"derinda";436;0;100
912;49;"derion";961;94.901144640999;5.09885535900104
0;87;"deriona";87;0;100
0;78;"derionna";78;0;100
37;0;"derious";37;100;0
5;0;"derique";5;100;0
22;0;"deris";22;100;0
0;15;"derise";15;0;100
0;52;"derisha";52;0;100
0;71;"derita";71;0;100
0;15;"derith";15;0;100
542;0;"derius";542;100;0
0;13;"deriya";13;0;100
0;88;"deriyah";88;0;100
7;0;"deriyon";7;100;0
506;0;"derk";506;100;0
306;0;"derl";306;100;0
18;0;"derle";18;100;0
0;6;"derlene";6;0;100
14;0;"derlin";14;100;0
5;0;"derlis";5;100;0
35;0;"derly";35;100;0
46;0;"dermaine";46;100;0
5;0;"dermarr";5;100;0
26;0;"dermont";26;100;0
446;0;"dermot";446;100;0
20;0;"dermott";20;100;0
0;31;"derna";31;0;100
10;0;"dernell";10;100;0
5;0;"dero";5;100;0
5;0;"deroderick";5;100;0
5;0;"deroe";5;100;0
63;0;"derold";63;100;0
11;0;"derome";11;100;0
5492;35;"deron";5527;99.3667450696581;0.633254930341958
0;387;"deronda";387;0;100
55;0;"derone";55;100;0
11;0;"deronn";11;100;0
0;5;"deronna";5;0;100
6;0;"deronne";6;100;0
25;0;"deronta";25;100;0
6;0;"derontae";6;100;0
74;0;"deronte";74;100;0
0;221;"derotha";221;0;100
218;0;"deroy";218;100;0
5;0;"derquan";5;100;0
0;125;"derra";125;0;100
418;0;"derral";418;100;0
11;0;"derrald";11;100;0
110;0;"derrall";110;100;0
67;0;"derran";67;100;0
8;0;"derrance";8;100;0
1336;0;"derreck";1336;100;0
2958;0;"derrek";2958;100;0
1174;0;"derrel";1174;100;0
5732;16;"derrell";5748;99.7216423103688;0.278357689631176
36;0;"derrelle";36;100;0
399;0;"derren";399;100;0
129;0;"derreon";129;100;0
0;56;"derri";56;0;100
0;13;"derria";13;0;100
0;5;"derriah";5;0;100
638;88;"derrian";726;87.8787878787879;12.1212121212121
0;133;"derriana";133;0;100
0;46;"derrianna";46;0;100
1420;0;"derric";1420;100;0
0;553;"derrica";553;0;100
5;0;"derrice";5;100;0
64;0;"derrich";64;100;0
141147;997;"derrick";142144;99.2985986042323;0.701401395767672
0;889;"derricka";889;0;100
102;0;"derrico";102;100;0
51;22;"derrie";73;69.8630136986301;30.1369863013699
183;0;"derrien";183;100;0
2086;0;"derrik";2086;100;0
0;168;"derrika";168;0;100
55;0;"derrike";55;100;0
198;0;"derril";198;100;0
787;0;"derrill";787;100;0
657;0;"derrin";657;100;0
24;0;"derringer";24;100;0
1307;45;"derrion";1352;96.6715976331361;3.32840236686391
0;166;"derriona";166;0;100
5;0;"derrione";5;100;0
0;22;"derrionna";22;0;100
91;0;"derrious";91;100;0
416;0;"derris";416;100;0
0;64;"derrisha";64;0;100
789;0;"derrius";789;100;0
0;12;"derriyah";12;0;100
27;0;"derrol";27;100;0
10;0;"derrold";10;100;0
1457;0;"derron";1457;100;0
9;0;"derrus";9;100;0
1541;137;"derry";1678;91.8355184743743;8.16448152562575
219;0;"derryck";219;100;0
41;0;"derryk";41;100;0
901;15;"derryl";916;98.3624454148472;1.63755458515284
5;0;"derryon";5;100;0
157;0;"dervin";157;100;0
27;0;"dervon";27;100;0
110;0;"derward";110;100;0
3736;0;"derwin";3736;100;0
1020;0;"derwood";1020;100;0
22;0;"derwyn";22;100;0
0;135;"derya";135;0;100
47;0;"deryan";47;100;0
533;0;"deryck";533;100;0
742;0;"deryk";742;100;0
0;27;"derykah";27;0;100
1825;190;"deryl";2015;90.5707196029777;9.42928039702233
47;0;"deryle";47;100;0
33;177;"deryn";210;15.7142857142857;84.2857142857143
5;0;"deryon";5;100;0
6;5;"des";11;54.5454545454545;45.4545454545455
0;239;"desa";239;0;100
19;0;"desai";19;100;0
0;5;"desales";5;0;100
0;5;"desandra";5;0;100
17;68;"desani";85;20;80
0;5;"desara";5;0;100
0;1762;"desarae";1762;0;100
0;73;"desarai";73;0;100
0;1048;"desaray";1048;0;100
0;10;"desaraye";10;0;100
0;88;"desare";88;0;100
0;82;"desarea";82;0;100
0;678;"desaree";678;0;100
0;29;"desarey";29;0;100
0;5;"desari";5;0;100
0;138;"desarie";138;0;100
16;0;"desaun";16;100;0
0;8;"desda";8;0;100
0;35;"desdemona";35;0;100
3683;11;"desean";3694;99.7022198159177;0.297780184082296
0;63;"desera";63;0;100
0;1327;"deserae";1327;0;100
0;69;"deserai";69;0;100
0;705;"deseray";705;0;100
0;193;"desere";193;0;100
0;216;"deserea";216;0;100
0;1251;"deseree";1251;0;100
0;11;"deseret";11;0;100
0;28;"deserey";28;0;100
0;92;"deseri";92;0;100
0;5;"deseria";5;0;100
0;922;"deserie";922;0;100
0;6;"desery";6;0;100
5;812;"desha";817;0.611995104039168;99.3880048959608
18;0;"deshad";18;100;0
41;185;"deshae";226;18.141592920354;81.858407079646
0;22;"deshai";22;0;100
0;5;"deshaila";5;0;100
0;33;"deshala";33;0;100
242;12;"deshan";254;95.2755905511811;4.7244094488189
0;235;"deshana";235;0;100
0;73;"deshanae";73;0;100
0;6;"deshanay";6;0;100
0;111;"deshanda";111;0;100
0;16;"deshandra";16;0;100
238;17;"deshane";255;93.3333333333333;6.66666666666667
0;15;"deshanique";15;0;100
0;339;"deshanna";339;0;100
114;193;"deshannon";307;37.1335504885993;62.8664495114006
5;0;"deshanon";5;100;0
0;61;"deshanta";61;0;100
19;68;"deshante";87;21.8390804597701;78.1609195402299
0;99;"deshanti";99;0;100
0;126;"deshara";126;0;100
6;0;"deshard";6;100;0
6;0;"deshaud";6;100;0
5164;231;"deshaun";5395;95.7182576459685;4.28174235403151
0;293;"deshauna";293;0;100
0;48;"deshaunda";48;0;100
0;21;"deshaundra";21;0;100
19;0;"deshaune";19;100;0
0;6;"deshaunta";6;0;100
5;0;"deshaunte";5;100;0
14661;1183;"deshawn";15844;92.5334511486998;7.46654885130018
0;646;"deshawna";646;0;100
0;60;"deshawnda";60;0;100
5;0;"deshawndre";5;100;0
0;13;"deshawnna";13;0;100
12;0;"deshawnte";12;100;0
183;290;"deshay";473;38.6892177589852;61.3107822410148
0;5;"deshaya";5;0;100
0;227;"deshayla";227;0;100
16;157;"deshea";173;9.2485549132948;90.7514450867052
0;5;"desheena";5;0;100
0;18;"desheila";18;0;100
0;24;"deshelia";24;0;100
0;15;"deshell";15;0;100
0;18;"deshera";18;0;100
0;91;"deshia";91;0;100
5;0;"deshion";5;100;0
0;22;"deshira";22;0;100
0;10;"deshiya";10;0;100
0;5;"deshna";5;0;100
2324;166;"deshon";2490;93.3333333333333;6.66666666666667
0;46;"deshona";46;0;100
0;334;"deshonda";334;0;100
0;92;"deshondra";92;0;100
278;51;"deshone";329;84.4984802431611;15.5015197568389
0;5;"deshonia";5;0;100
0;159;"deshonna";159;0;100
0;11;"deshonta";11;0;100
5;6;"deshonte";11;45.4545454545455;54.5454545454545
6;0;"deshown";6;100;0
10;0;"deshuan";10;100;0
1177;40;"deshun";1217;96.7132292522597;3.28677074774035
0;5;"deshuna";5;0;100
0;53;"deshunda";53;0;100
0;68;"deshundra";68;0;100
0;8;"deshya";8;0;100
2111;749;"desi";2860;73.8111888111888;26.1888111888112
0;131;"desia";131;0;100
0;37;"desiah";37;0;100
569;0;"desiderio";569;100;0
0;6;"desieree";6;0;100
0;5;"desinae";5;0;100
0;226;"desira";226;0;100
0;12518;"desirae";12518;0;100
0;6;"desiraee";6;0;100
0;70;"desirai";70;0;100
0;1730;"desiray";1730;0;100
0;111;"desiraye";111;0;100
40;4513;"desire";4553;0.878541620909291;99.1214583790907
0;1862;"desirea";1862;0;100
0;7;"desireah";7;0;100
198;81512;"desiree";81710;0.242320401419655;99.7576795985803
0;279;"desirey";279;0;100
0;10;"desiri";10;0;100
0;133;"desirie";133;0;100
0;6;"desirrae";6;0;100
0;111;"desirre";111;0;100
0;27;"desirree";27;0;100
0;5;"desitny";5;0;100
0;12;"desiya";12;0;100
0;35;"desiyah";35;0;100
0;26;"desja";26;0;100
0;13;"desjah";13;0;100
0;9;"desjambra";9;0;100
5;0;"desjon";5;100;0
62;0;"desjuan";62;100;0
0;7;"deslie";7;0;100
0;99;"deslyn";99;0;100
0;44;"deslynn";44;0;100
0;444;"desma";444;0;100
174;0;"desman";174;100;0
11;0;"desmand";11;100;0
0;15;"desmariah";15;0;100
0;56;"desmarie";56;0;100
156;0;"desmen";156;100;0
10;0;"desmend";10;100;0
165;5;"desmin";170;97.0588235294118;2.94117647058824
38;0;"desmine";38;100;0
1188;0;"desmon";1188;100;0
0;27;"desmona";27;0;100
31850;233;"desmond";32083;99.273758688402;0.726241311598043
41;6;"desmone";47;87.2340425531915;12.7659574468085
0;22;"desmonique";22;0;100
125;0;"desmund";125;100;0
0;7;"desnee";7;0;100
0;5;"despena";5;0;100
0;1410;"despina";1410;0;100
0;56;"desra";56;0;100
0;36;"desrae";36;0;100
0;10;"desray";10;0;100
0;217;"desree";217;0;100
0;5;"desriee";5;0;100
0;1492;"dessa";1492;0;100
0;19;"dessarae";19;0;100
0;15;"dessel";15;0;100
0;21;"dessence";21;0;100
0;10;"desseray";10;0;100
0;11;"dessia";11;0;100
6;17;"dessiah";23;26.0869565217391;73.9130434782609
0;7;"dessica";7;0;100
311;9772;"dessie";10083;3.08439948428047;96.9156005157195
0;81;"dessirae";81;0;100
0;87;"dessire";87;0;100
0;137;"dessiree";137;0;100
0;355;"desta";355;0;100
0;5;"destainy";5;0;100
89;0;"destan";89;100;0
0;72;"destane";72;0;100
0;830;"destanee";830;0;100
0;317;"destaney";317;0;100
0;1137;"destani";1137;0;100
0;1663;"destanie";1663;0;100
0;20;"destannie";20;0;100
0;3355;"destany";3355;0;100
67;0;"desten";67;100;0
0;23;"destene";23;0;100
0;105;"destenee";105;0;100
0;46;"desteney";46;0;100
0;192;"desteni";192;0;100
0;207;"destenie";207;0;100
0;1541;"desteny";1541;0;100
12;16;"dester";28;42.8571428571429;57.1428571428571
11;0;"destery";11;100;0
0;5;"destiany";5;0;100
5039;649;"destin";5688;88.5900140646976;11.4099859353024
0;163;"destina";163;0;100
0;73;"destinae";73;0;100
0;17;"destinay";17;0;100
188;1207;"destine";1395;13.4767025089606;86.5232974910394
0;10;"destinea";10;0;100
15;0;"destined";15;100;0
0;15883;"destinee";15883;0;100
0;15;"destinei";15;0;100
0;7510;"destiney";7510;0;100
0;16;"desting";16;0;100
0;7468;"destini";7468;0;100
0;2771;"destinie";2771;0;100
0;38;"destinii";38;0;100
0;5;"destinique";5;0;100
0;10;"destinni";10;0;100
0;5;"destinnie";5;0;100
0;30;"destinny";30;0;100
482;143614;"destiny";144096;0.334499222740395;99.6655007772596
0;5;"destinyann";5;0;100
0;37;"destinye";37;0;100
0;21;"destinymarie";21;0;100
0;14;"destinyrose";14;0;100
0;15;"destney";15;0;100
405;0;"deston";405;100;0
0;38;"destoni";38;0;100
0;80;"destony";80;0;100
5;26;"destri";31;16.1290322580645;83.8709677419355
1426;145;"destry";1571;90.7702100572884;9.22978994271165
340;113;"destyn";453;75.0551876379691;24.9448123620309
0;433;"destyne";433;0;100
0;771;"destynee";771;0;100
0;1027;"destyni";1027;0;100
0;297;"destynie";297;0;100
0;12;"destyny";12;0;100
5;0;"desuan";5;100;0
0;18;"desyrae";18;0;100
0;126;"desyre";126;0;100
0;32;"desyree";32;0;100
0;22;"deta";22;0;100
19;0;"detarius";19;100;0
35;0;"detavion";35;100;0
88;0;"detavious";88;100;0
32;0;"detavius";32;100;0
5;0;"deterrio";5;100;0
16;0;"deterrion";16;100;0
23;0;"deterrius";23;100;0
0;5;"detisha";5;0;100
0;11;"detoya";11;0;100
0;2048;"detra";2048;0;100
6;0;"detrail";6;100;0
72;0;"detravion";72;100;0
24;0;"detravious";24;100;0
95;0;"detrell";95;100;0
11;0;"detrevion";11;100;0
5;0;"detrez";5;100;0
0;5;"detri";5;0;100
0;287;"detria";287;0;100
420;5;"detric";425;98.8235294117647;1.17647058823529
0;5;"detrica";5;0;100
0;304;"detrice";304;0;100
117;11;"detrich";128;91.40625;8.59375
0;8;"detricia";8;0;100
1468;25;"detrick";1493;98.3255190890824;1.67448091091762
0;12;"detrina";12;0;100
129;0;"detroit";129;100;0
146;0;"detron";146;100;0
44;0;"detroy";44;100;0
0;203;"detta";203;0;100
0;36;"dette";36;0;100
5;0;"dettrick";5;100;0
26;0;"detwan";26;100;0
0;11;"detzani";11;0;100
7;0;"deucalion";7;100;0
73;0;"deuce";73;100;0
13;0;"deuel";13;100;0
163;102;"deundra";265;61.5094339622641;38.4905660377359
6;0;"deundrae";6;100;0
8;0;"deundray";8;100;0
280;0;"deundre";280;100;0
7;0;"deundrea";7;100;0
0;5;"deundria";5;0;100
136;0;"deunta";136;100;0
116;0;"deuntae";116;100;0
22;0;"deuntay";22;100;0
125;0;"deunte";125;100;0
6;0;"deuntray";6;100;0
11;0;"deus";11;100;0
2089;0;"dev";2089;100;0
16;905;"deva";921;1.73724212812161;98.2627578718784
24;0;"devaansh";24;100;0
0;82;"devaeh";82;0;100
17;0;"devahn";17;100;0
21;0;"devaj";21;100;0
0;10;"devaki";10;0;100
72;0;"deval";72;100;0
15;0;"devale";15;100;0
18;0;"devam";18;100;0
13022;5063;"devan";18085;72.0044235554327;27.9955764445673
0;24;"devana";24;0;100
0;5;"devanae";5;0;100
13;0;"devanand";13;100;0
5;0;"devance";5;100;0
53;0;"devane";53;100;0
0;159;"devanee";159;0;100
0;161;"devaney";161;0;100
36;0;"devang";36;100;0
0;5;"devanhi";5;0;100
0;337;"devani";337;0;100
0;387;"devanie";387;0;100
8;148;"devann";156;5.12820512820513;94.8717948717949
0;37;"devanna";37;0;100
0;30;"devanne";30;0;100
0;5;"devannie";5;0;100
0;170;"devanny";170;0;100
326;0;"devansh";326;100;0
0;124;"devanshi";124;0;100
224;0;"devanta";224;100;0
160;0;"devantae";160;100;0
7716;57;"devante";7773;99.266692396758;0.733307603241992
5;0;"devanti";5;100;0
10;0;"devantre";10;100;0
0;866;"devany";866;0;100
20;0;"devar";20;100;0
0;7;"devara";7;0;100
29;0;"devari";29;100;0
10;0;"devarian";10;100;0
123;0;"devario";123;100;0
63;0;"devarion";63;100;0
70;0;"devarious";70;100;0
127;0;"devaris";127;100;0
197;0;"devarius";197;100;0
11;0;"devaron";11;100;0
18;0;"devarsh";18;100;0
36;0;"devarus";36;100;0
5;0;"devaugh";5;100;0
2348;0;"devaughn";2348;100;0
10;0;"devaughnte";10;100;0
378;0;"devaun";378;100;0
125;0;"devaunte";125;100;0
0;19;"devaya";19;0;100
0;10;"devayah";10;0;100
0;29;"deveah";29;0;100
198;0;"devean";198;100;0
0;32;"deveda";32;0;100
76;0;"deveion";76;100;0
5;0;"devel";5;100;0
181;0;"devell";181;100;0
60;0;"develle";60;100;0
0;54;"develyn";54;0;100
10160;1303;"deven";11463;88.6329931082614;11.3670068917386
0;28;"devena";28;0;100
12;0;"devendra";12;100;0
0;102;"deveney";102;0;100
0;5;"deveni";5;0;100
12;0;"devente";12;100;0
0;55;"deveny";55;0;100
628;0;"deveon";628;100;0
15;0;"dever";15;100;0
0;449;"devera";449;0;100
6;0;"deveraux";6;100;0
695;0;"devere";695;100;0
127;6;"devereaux";133;95.4887218045113;4.51127819548872
11;0;"devereux";11;100;0
98;0;"deverick";98;100;0
0;5;"deverie";5;0;100
15;0;"deverl";15;100;0
0;5;"deverly";5;0;100
44;0;"devern";44;100;0
29;0;"deverne";29;100;0
165;0;"deveron";165;100;0
265;82;"devery";347;76.3688760806916;23.6311239193084
227;0;"devesh";227;100;0
0;5;"deveshi";5;0;100
0;5;"deveta";5;0;100
0;74;"devetta";74;0;100
0;55;"devette";55;0;100
23;0;"deveyon";23;100;0
0;704;"devi";704;0;100
0;10;"devia";10;0;100
257;22;"devian";279;92.1146953405018;7.88530465949821
0;14;"deviana";14;0;100
0;43;"devida";43;0;100
0;35;"devie";35;0;100
17;0;"devien";17;100;0
0;516;"devika";516;0;100
16;0;"deville";16;100;0
148986;16760;"devin";165746;89.8881420969435;10.1118579030565
0;1116;"devina";1116;0;100
23;0;"devindra";23;100;0
709;655;"devine";1364;51.9794721407625;48.0205278592375
0;29;"devinee";29;0;100
0;25;"devinity";25;0;100
5;0;"devinlee";5;100;0
271;100;"devinn";371;73.0458221024259;26.9541778975741
0;174;"devinne";174;0;100
0;13;"deviny";13;0;100
1701;26;"devion";1727;98.4944991314418;1.50550086855819
11;0;"devione";11;100;0
0;7;"devionna";7;0;100
18;0;"devionne";18;100;0
5;0;"deviontae";5;100;0
7;0;"devionte";7;100;0
0;241;"devita";241;0;100
5;0;"devito";5;100;0
5;0;"deviyon";5;100;0
0;13;"devki";13;0;100
29;0;"devlan";29;100;0
23;0;"devlen";23;100;0
3018;164;"devlin";3182;94.8460087994972;5.15399120050283
93;0;"devlon";93;100;0
309;200;"devlyn";509;60.7072691552063;39.2927308447937
0;61;"devlynn";61;0;100
5;0;"devn";5;100;0
59;0;"devoe";59;100;0
46;0;"devohn";46;100;0
0;49;"devoiry";49;0;100
0;11;"devola";11;0;100
69758;19832;"devon";89590;77.863600848309;22.136399151691
0;2704;"devona";2704;0;100
0;5;"devonae";5;0;100
24;0;"devonaire";24;100;0
0;231;"devonda";231;0;100
0;35;"devondra";35;0;100
264;0;"devondre";264;100;0
11;0;"devondrick";11;100;0
715;122;"devone";837;85.4241338112306;14.5758661887694
0;17;"devonee";17;0;100
0;18;"devoney";18;0;100
0;5;"devoni";5;0;100
0;220;"devonia";220;0;100
0;24;"devonie";24;0;100
415;23;"devonn";438;94.7488584474886;5.25114155251141
0;1704;"devonna";1704;0;100
665;958;"devonne";1623;40.973505853358;59.026494146642
5;0;"devonnte";5;100;0
2916;36;"devonta";2952;98.780487804878;1.21951219512195
2605;0;"devontae";2605;100;0
35;0;"devontai";35;100;0
5;0;"devontavius";5;100;0
804;0;"devontay";804;100;0
64;0;"devontaye";64;100;0
10739;32;"devonte";10771;99.7029059511652;0.297094048834834
47;0;"devontea";47;100;0
20;0;"devontee";20;100;0
39;0;"devontez";39;100;0
18;0;"devonti";18;100;0
12;0;"devontia";12;100;0
5;0;"devontra";5;100;0
5;0;"devontrae";5;100;0
18;0;"devontray";18;100;0
166;0;"devontre";166;100;0
5;0;"devontrey";5;100;0
0;123;"devony";123;0;100
0;41;"devonya";41;0;100
0;2232;"devora";2232;0;100
0;3547;"devorah";3547;0;100
0;50;"devoria";50;0;100
41;0;"devoris";41;100;0
0;55;"devory";55;0;100
0;200;"devota";200;0;100
0;781;"devra";781;0;100
17;0;"devraj";17;100;0
0;15;"devree";15;0;100
22;0;"devren";22;100;0
0;96;"devri";96;0;100
25;0;"devrick";25;100;0
0;11;"devrie";11;0;100
18;0;"devrim";18;100;0
87;0;"devrin";87;100;0
867;0;"devron";867;100;0
27;11;"devry";38;71.0526315789474;28.9473684210526
69;0;"devun";69;100;0
6;0;"devunta";6;100;0
5;0;"devunte";5;100;0
5;0;"devven";5;100;0
50;0;"devvin";50;100;0
59;5;"devvon";64;92.1875;7.8125
0;27;"devy";27;0;100
0;24;"devyani";24;0;100
6212;7527;"devyn";13739;45.2143533008225;54.7856466991775
55;116;"devyne";171;32.1637426900585;67.8362573099415
190;922;"devynn";1112;17.0863309352518;82.9136690647482
0;110;"devynne";110;0;100
83;0;"devyon";83;100;0
800;0;"dewain";800;100;0
576;0;"dewaine";576;100;0
619;16;"dewan";635;97.4803149606299;2.51968503937008
0;551;"dewana";551;0;100
29;0;"dewand";29;100;0
0;694;"dewanda";694;0;100
508;0;"dewane";508;100;0
17;0;"dewann";17;100;0
0;727;"dewanna";727;0;100
1392;0;"deward";1392;100;0
97;0;"dewarren";97;100;0
140;0;"dewaun";140;100;0
0;21;"dewayna";21;0;100
25936;111;"dewayne";26047;99.5738472760779;0.426152723922141
65;0;"dewel";65;100;0
206;0;"dewell";206;100;0
0;5;"dewetta";5;0;100
32173;406;"dewey";32579;98.7537984591301;1.24620154086989
0;5;"dewi";5;0;100
238;5;"dewie";243;97.9423868312757;2.05761316872428
528;0;"dewight";528;100;0
0;14;"dewilla";14;0;100
22;0;"dewin";22;100;0
5;0;"dewit";5;100;0
6550;0;"dewitt";6550;100;0
63;0;"dewitte";63;100;0
401;0;"dewon";401;100;0
44;0;"dewone";44;100;0
7;0;"dewuan";7;100;0
15;0;"dewy";15;100;0
21;0;"dewyane";21;100;0
5;0;"dewyne";5;100;0
384;0;"dex";384;100;0
0;10;"dexiree";10;0;100
14;0;"dexten";14;100;0
31915;217;"dexter";32132;99.324660774306;0.675339225694012
27;0;"dextin";27;100;0
280;0;"dexton";280;100;0
11;0;"dextyn";11;100;0
6;0;"dexx";6;100;0
0;80;"deya";80;0;100
0;6;"deyadira";6;0;100
0;5;"deyala";5;0;100
31;0;"deyan";31;100;0
0;287;"deyana";287;0;100
0;34;"deyanara";34;0;100
0;52;"deyaneira";52;0;100
0;87;"deyani";87;0;100
0;1879;"deyanira";1879;0;100
0;310;"deyanna";310;0;100
0;5;"deyannah";5;0;100
0;20;"deyanne";20;0;100
5;0;"deyante";5;100;0
15;0;"deybi";15;100;0
0;69;"deyci";69;0;100
0;6;"deycy";6;0;100
0;63;"deyja";63;0;100
0;64;"deyjah";64;0;100
0;35;"deyla";35;0;100
70;0;"deylan";70;100;0
0;31;"deylani";31;0;100
7;0;"deylen";7;100;0
0;15;"deyli";15;0;100
20;40;"deylin";60;33.3333333333333;66.6666666666667
18;0;"deylon";18;100;0
19;0;"deymar";19;100;0
0;12;"deymi";12;0;100
5;0;"deymian";5;100;0
0;139;"deyna";139;0;100
488;11;"deyon";499;97.7955911823647;2.20440881763527
0;100;"deyona";100;0;100
7;58;"deyonce";65;10.7692307692308;89.2307692307692
0;381;"deyonna";381;0;100
0;5;"deyonne";5;0;100
42;0;"deyonta";42;100;0
16;0;"deyontae";16;100;0
132;0;"deyonte";132;100;0
0;65;"deyra";65;0;100
10;0;"deyren";10;100;0
0;107;"deysha";107;0;100
10;0;"deyshaun";10;100;0
46;0;"deyshawn";46;100;0
0;1365;"deysi";1365;0;100
0;10;"deysia";10;0;100
0;7;"deyssi";7;0;100
0;238;"deysy";238;0;100
243;0;"deyton";243;100;0
74;0;"deyvi";74;100;0
13;0;"deyvid";13;100;0
5;0;"deyvin";5;100;0
24;0;"deyvion";24;100;0
51;0;"deyvon";51;100;0
211;0;"dez";211;100;0
0;6;"deza";6;0;100
0;5;"dezani";5;0;100
0;1393;"dezarae";1393;0;100
0;93;"dezarai";93;0;100
0;900;"dezaray";900;0;100
0;11;"dezaraye";11;0;100
0;42;"dezare";42;0;100
0;27;"dezarea";27;0;100
0;166;"dezaree";166;0;100
0;27;"dezarey";27;0;100
0;86;"dezaria";86;0;100
0;43;"dezariah";43;0;100
0;11;"dezariyah";11;0;100
5;0;"dezavion";5;100;0
5;0;"dezden";5;100;0
0;34;"dezera";34;0;100
0;447;"dezerae";447;0;100
0;6;"dezerai";6;0;100
0;404;"dezeray";404;0;100
0;5;"dezere";5;0;100
0;30;"dezerea";30;0;100
0;54;"dezeree";54;0;100
0;6;"dezerey";6;0;100
0;41;"dezha";41;0;100
5;0;"dezhan";5;100;0
0;7;"dezhanae";7;0;100
0;110;"dezhane";110;0;100
5;0;"dezhaun";5;100;0
21;0;"dezhon";21;100;0
225;156;"dezi";381;59.0551181102362;40.9448818897638
0;14;"dezia";14;0;100
5;188;"deziah";193;2.59067357512953;97.4093264248705
35;0;"dezion";35;100;0
0;8;"dezira";8;0;100
0;1858;"dezirae";1858;0;100
0;463;"deziray";463;0;100
0;10;"deziraye";10;0;100
0;708;"dezire";708;0;100
0;68;"dezirea";68;0;100
0;1356;"deziree";1356;0;100
0;7;"dezirey";7;0;100
0;66;"deziya";66;0;100
0;231;"deziyah";231;0;100
0;11;"dezja";11;0;100
22;0;"dezjuan";22;100;0
0;38;"dezlyn";38;0;100
0;36;"dezlynn";36;0;100
154;0;"dezman";154;100;0
5;0;"dezmand";5;100;0
0;52;"dezmariah";52;0;100
0;36;"dezmarie";36;0;100
336;0;"dezmen";336;100;0
27;0;"dezmend";27;100;0
221;0;"dezmin";221;100;0
778;0;"dezmon";778;100;0
2749;0;"dezmond";2749;100;0
44;0;"dezmund";44;100;0
16;5;"dezmyn";21;76.1904761904762;23.8095238095238
10;0;"dezon";10;100;0
0;62;"dezra";62;0;100
0;45;"dezrae";45;0;100
0;7;"dezree";7;0;100
0;7;"dezstany";7;0;100
0;5;"deztany";5;0;100
0;75;"deztinee";75;0;100
0;5;"deztiney";5;0;100
0;26;"deztini";26;0;100
0;241;"deztiny";241;0;100
0;16;"deztyni";16;0;100
0;10;"dezya";10;0;100
0;6;"dezyah";6;0;100
0;69;"dezyrae";69;0;100
0;135;"dezyre";135;0;100
0;5;"dezzarae";5;0;100
5;205;"dezzie";210;2.38095238095238;97.6190476190476
9;0;"dhahran";9;100;0
71;0;"dhairya";71;100;0
0;5;"dhakirah";5;0;100
0;206;"dhalia";206;0;100
5;0;"dhamani";5;100;0
0;71;"dhamar";71;0;100
10;0;"dhameer";10;100;0
0;110;"dhana";110;0;100
5;0;"dhananjay";5;100;0
12;0;"dhane";12;100;0
6;0;"dhanesh";6;100;0
209;79;"dhani";288;72.5694444444444;27.4305555555556
0;11;"dhanna";11;0;100
97;0;"dhanush";97;100;0
0;114;"dhanvi";114;0;100
57;0;"dhanvin";57;100;0
0;187;"dhanya";187;0;100
0;450;"dhara";450;0;100
39;0;"dharius";39;100;0
7;567;"dharma";574;1.21951219512195;98.780487804878
8;0;"dharmesh";8;100;0
12;0;"dharmik";12;100;0
0;5;"dharshini";5;0;100
0;12;"dharti";12;0;100
5;0;"dhati";5;100;0
0;17;"dhatri";17;0;100
94;0;"dhaval";94;100;0
0;6;"dheeksha";6;0;100
8;0;"dheer";8;100;0
10;0;"dheera";10;100;0
70;0;"dheeraj";70;100;0
10;0;"dheeran";10;100;0
5;0;"dhiago";5;100;0
287;0;"dhilan";287;100;0
61;0;"dhillon";61;100;0
21;0;"dhir";21;100;0
20;0;"dhiraj";20;100;0
85;0;"dhiren";85;100;0
0;10;"dhivya";10;0;100
0;118;"dhiya";118;0;100
8;0;"dhrish";8;100;0
0;47;"dhrithi";47;0;100
0;318;"dhriti";318;0;100
11;0;"dhru";11;100;0
0;21;"dhruthi";21;0;100
0;71;"dhruti";71;0;100
2756;0;"dhruv";2756;100;0
298;0;"dhruva";298;100;0
37;0;"dhruvan";37;100;0
0;199;"dhruvi";199;0;100
20;0;"dhruvin";20;100;0
0;25;"dhvani";25;0;100
0;78;"dhwani";78;0;100
11;0;"dhyaan";11;100;0
186;0;"dhyan";186;100;0
0;69;"dhyana";69;0;100
0;28;"dhyani";28;0;100
26;0;"dhyey";26;100;0
35;0;"dhylan";35;100;0
13;57;"di";70;18.5714285714286;81.4285714285714
107;1862;"dia";1969;5.43423057389538;94.5657694261046
5;0;"diab";5;100;0
5;0;"diablo";5;100;0
7;14;"diabolique";21;33.3333333333333;66.6666666666667
0;6;"diadra";6;0;100
201;0;"diago";201;100;0
0;358;"diahann";358;0;100
0;32;"diahanna";32;0;100
0;65;"diahn";65;0;100
0;52;"diaja";52;0;100
0;29;"diajah";29;0;100
10;0;"dial";10;100;0
0;129;"diala";129;0;100
744;5;"diallo";749;99.3324432576769;0.667556742323097
10;0;"dialo";10;100;0
0;21;"diamani";21;0;100
572;252;"diamante";824;69.4174757281553;30.5825242718447
0;654;"diamantina";654;0;100
25;507;"diamon";532;4.69924812030075;95.3007518796992
2200;32260;"diamond";34460;6.38421358096344;93.6157864190366
0;37;"diamonde";37;0;100
0;10;"diamondique";10;0;100
0;34;"diamondnique";34;0;100
0;108;"diamonds";108;0;100
0;96;"diamone";96;0;100
0;5;"diamoni";5;0;100
0;976;"diamonique";976;0;100
5;0;"diamonta";5;100;0
23;0;"diamontae";23;100;0
454;32;"diamonte";486;93.4156378600823;6.5843621399177
0;13;"diamyn";13;0;100
98;5369;"dian";5467;1.79257362355954;98.2074263764405
1285;355876;"diana";357161;0.359781723088467;99.6402182769115
0;449;"dianah";449;0;100
0;10;"dianalaura";10;0;100
0;5;"dianalee";5;0;100
0;18;"dianaliz";18;0;100
0;10;"dianalynn";10;0;100
0;5;"dianalys";5;0;100
0;5;"dianamarie";5;0;100
0;72;"dianara";72;0;100
0;110;"dianca";110;0;100
0;1928;"diandra";1928;0;100
551;15;"diandre";566;97.3498233215548;2.65017667844523
0;30;"diandrea";30;0;100
0;31;"diandria";31;0;100
1386;517900;"diane";519286;0.26690494255574;99.7330950574443
0;10;"dianela";10;0;100
0;5;"dianeli";5;0;100
0;44;"dianelis";44;0;100
0;10;"dianeliz";10;0;100
0;78;"dianelly";78;0;100
0;97;"dianely";97;0;100
0;119;"dianelys";119;0;100
0;5;"dianet";5;0;100
0;11;"dianetta";11;0;100
0;33;"dianette";33;0;100
0;188;"dianey";188;0;100
0;6;"diangela";6;0;100
570;0;"diangelo";570;100;0
0;141;"diani";141;0;100
0;624;"diania";624;0;100
0;11;"dianie";11;0;100
0;44;"dianira";44;0;100
0;5;"dianita";5;0;100
0;12252;"diann";12252;0;100
64;55522;"dianna";55586;0.115136904976073;99.8848630950239
0;86;"diannah";86;0;100
186;95103;"dianne";95289;0.195195667915499;99.8048043320845
0;13;"dianney";13;0;100
0;5;"dianni";5;0;100
0;426;"diannia";426;0;100
0;91;"diannie";91;0;100
0;28;"dianny";28;0;100
1297;20;"diante";1317;98.4813971146545;1.51860288534548
0;715;"diantha";715;0;100
0;13;"dianthe";13;0;100
0;5;"dianthia";5;0;100
0;66;"diany";66;0;100
5;0;"diaquan";5;100;0
49;0;"diar";49;100;0
0;606;"diara";606;0;100
11;0;"diarmuid";11;100;0
78;292;"diarra";370;21.0810810810811;78.9189189189189
0;15;"diary";15;0;100
0;78;"diasha";78;0;100
0;178;"diasia";178;0;100
0;24;"diasy";24;0;100
0;5;"diaundra";5;0;100
5;175;"diavian";180;2.77777777777778;97.2222222222222
15;99;"diavion";114;13.1578947368421;86.8421052631579
0;12;"diavione";12;0;100
0;16;"diavionne";16;0;100
19;0;"diavonte";19;100;0
75;0;"diaz";75;100;0
0;16;"diba";16;0;100
0;18;"dibanhi";18;0;100
0;43;"dibbie";43;0;100
0;32;"dicey";32;0;100
0;18;"dichelle";18;0;100
0;933;"dicie";933;0;100
28776;48;"dick";28824;99.8334721065778;0.166527893422148
917;0;"dickey";917;100;0
0;5;"dicki";5;0;100
4459;260;"dickie";4719;94.4903581267218;5.50964187327824
0;57;"dicksie";57;0;100
606;0;"dickson";606;100;0
975;0;"dicky";975;100;0
0;247;"dicy";247;0;100
0;187;"didi";187;0;100
781;0;"didier";781;100;0
0;5;"didra";5;0;100
0;5;"dieatra";5;0;100
0;1917;"diedra";1917;0;100
0;1794;"diedre";1794;0;100
0;10;"diedri";10;0;100
32;0;"diedrich";32;100;0
10;0;"diedrick";10;100;0
100681;216;"diego";100897;99.7859202949543;0.21407970504574
0;68;"diella";68;0;100
0;11;"diellza";11;0;100
51;518;"diem";569;8.96309314586995;91.0369068541301
0;10;"diena";10;0;100
0;16;"dienna";16;0;100
0;5;"dienne";5;0;100
51;0;"dieon";51;100;0
6;21;"diep";27;22.2222222222222;77.7777777777778
0;88;"diera";88;0;100
0;214;"dierdra";214;0;100
0;1116;"dierdre";1116;0;100
6;0;"dierick";6;100;0
22;0;"dierk";22;100;0
163;0;"dierks";163;100;0
0;421;"dierra";421;0;100
155;0;"dierre";155;100;0
1414;0;"diesel";1414;100;0
0;178;"diesha";178;0;100
880;0;"dieter";880;100;0
11;0;"dietmar";11;100;0
0;675;"dietra";675;0;100
1755;149;"dietrich";1904;92.1743697478991;7.82563025210084
189;0;"dietrick";189;100;0
0;10;"dietta";10;0;100
0;22;"dieu";22;0;100
0;5;"dieudonne";5;0;100
0;13;"dieynaba";13;0;100
243;0;"diezel";243;100;0
11;0;"digby";11;100;0
0;478;"digna";478;0;100
0;10;"dihanna";10;0;100
0;7;"dija";7;0;100
0;41;"dijana";41;0;100
35;0;"dijion";35;100;0
25;0;"dijohn";25;100;0
1339;69;"dijon";1408;95.0994318181818;4.90056818181818
0;24;"dijonae";24;0;100
0;35;"dijonay";35;0;100
0;6;"dijone";6;0;100
0;24;"dijonna";24;0;100
0;19;"dijonnae";19;0;100
0;28;"dijonnaise";28;0;100
6;0;"dijoun";6;100;0
66;0;"dijuan";66;100;0
31;0;"dikembe";31;100;0
10;0;"dikran";10;100;0
0;50;"diksha";50;0;100
0;17;"dila";17;0;100
3507;86;"dilan";3593;97.6064569997217;2.39354300027832
0;70;"dilana";70;0;100
23;0;"diland";23;100;0
13;0;"dilanjan";13;100;0
5;0;"dilann";5;100;0
0;16;"dilany";16;0;100
0;321;"dilara";321;0;100
0;16;"dilayla";16;0;100
18;0;"dilbert";18;100;0
0;197;"dilcia";197;0;100
0;5;"dilek";5;0;100
40;0;"dilen";40;100;0
0;6;"dilenny";6;0;100
0;6;"dileydi";6;0;100
0;225;"dilia";225;0;100
0;8;"diliana";8;0;100
0;6;"dililah";6;0;100
24;0;"dilin";24;100;0
5;0;"dill";5;100;0
0;15;"dilla";15;0;100
6514;287;"dillan";6801;95.7800323481841;4.21996765181591
3569;0;"dillard";3569;100;0
663;55;"dillen";718;92.3398328690808;7.66016713091922
579;0;"dillian";579;100;0
0;358;"dillie";358;0;100
540;0;"dillin";540;100;0
314;0;"dillinger";314;100;0
3456;0;"dillion";3456;100;0
61720;596;"dillon";62316;99.0435843122152;0.956415687784839
5;0;"dillonger";5;100;0
393;164;"dillyn";557;70.556552962298;29.443447037702
0;37;"dillynn";37;0;100
0;15;"dilma";15;0;100
6;0;"dilmon";6;100;0
401;0;"dilon";401;100;0
38;37;"dilpreet";75;50.6666666666667;49.3333333333333
62;0;"dilraj";62;100;0
0;6;"dilreet";6;0;100
6;0;"dilshaan";6;100;0
10;0;"dilshan";10;100;0
21;0;"dilson";21;100;0
5;0;"dilver";5;100;0
5;0;"dilworth";5;100;0
0;6;"dilyla";6;0;100
0;10;"dilylah";10;0;100
304;179;"dilyn";483;62.9399585921325;37.0600414078675
40;351;"dilynn";391;10.230179028133;89.769820971867
0;20;"dilys";20;0;100
0;68;"dim";68;0;100
60;266;"dima";326;18.4049079754601;81.5950920245399
56;0;"dimaggio";56;100;0
11;0;"dimani";11;100;0
10;0;"dimante";10;100;0
6;0;"dimar";6;100;0
83;0;"dimarco";83;100;0
7;0;"dimarcus";7;100;0
41;0;"dimari";41;100;0
32;0;"dimario";32;100;0
5;0;"dimarion";5;100;0
1591;0;"dimas";1591;100;0
0;12;"dimesha";12;0;100
0;20;"dimetra";20;0;100
114;0;"dimetri";114;100;0
156;0;"dimetrius";156;100;0
0;5;"dimia";5;0;100
5;0;"diminic";5;100;0
27;0;"dimitar";27;100;0
0;810;"dimitra";810;0;100
18;0;"dimitre";18;100;0
7689;99;"dimitri";7788;98.728813559322;1.27118644067797
0;239;"dimitria";239;0;100
24;0;"dimitric";24;100;0
18;0;"dimitrie";18;100;0
2387;0;"dimitrios";2387;100;0
63;0;"dimitrious";63;100;0
454;0;"dimitris";454;100;0
877;0;"dimitrius";877;100;0
77;0;"dimitriy";77;100;0
471;0;"dimitry";471;100;0
10;49;"dimon";59;16.9491525423729;83.0508474576271
0;230;"dimond";230;0;100
0;68;"dimonique";68;0;100
10;0;"dimonte";10;100;0
0;2416;"dimple";2416;0;100
0;66;"dimples";66;0;100
0;13;"dimya";13;0;100
63;0;"din";63;100;0
76;30295;"dina";30371;0.250238714563235;99.7497612854368
0;15;"dinae";15;0;100
0;9940;"dinah";9940;0;100
0;20;"dinahlee";20;0;100
0;6;"dinalee";6;0;100
0;56;"dinamarie";56;0;100
0;60;"dinara";60;0;100
141;0;"dinari";141;100;0
0;24;"dinasia";24;0;100
0;6;"dinasti";6;0;100
0;12;"dinasty";12;0;100
0;5;"dindi";5;0;100
0;5;"dinean";5;0;100
0;430;"dineen";430;0;100
0;10;"dineisha";10;0;100
0;24;"dinelle";24;0;100
0;7;"dinene";7;0;100
143;0;"dinero";143;100;0
0;16;"dinese";16;0;100
167;0;"dinesh";167;100;0
0;243;"dinesha";243;0;100
0;10;"dineshia";10;0;100
0;34;"dinetta";34;0;100
65;0;"dinh";65;100;0
0;79;"dinia";79;0;100
0;5;"dinise";5;0;100
0;125;"dinisha";125;0;100
0;76;"dinita";76;0;100
86;0;"dink";86;100;0
0;170;"dinna";170;0;100
0;5;"dinnah";5;0;100
0;5;"dinneen";5;0;100
0;10;"dinnia";10;0;100
27;5;"dinnie";32;84.375;15.625
86;0;"dinnis";86;100;0
8832;0;"dino";8832;100;0
0;752;"dinora";752;0;100
0;564;"dinorah";564;0;100
5;0;"dinos";5;100;0
0;5;"diny";5;0;100
60;0;"dio";60;100;0
0;10;"diocelina";10;0;100
153;0;"diogenes";153;100;0
383;0;"diogo";383;100;0
0;17;"diolinda";17;0;100
46;0;"diomar";46;100;0
21;0;"diomedes";21;100;0
17237;1160;"dion";18397;93.6946241234984;6.3053758765016
0;1487;"diona";1487;0;100
0;5;"dionah";5;0;100
0;16;"dionca";16;0;100
5;688;"diondra";693;0.721500721500722;99.2784992784993
6;0;"diondray";6;100;0
1318;0;"diondre";1318;100;0
0;43;"diondria";43;0;100
548;2333;"dione";2881;19.0211732037487;80.9788267962513
91;0;"dionel";91;100;0
16;20;"dioni";36;44.4444444444444;55.5555555555556
0;321;"dionicia";321;0;100
1963;0;"dionicio";1963;100;0
95;0;"dionis";95;100;0
0;233;"dionisia";233;0;100
1104;0;"dionisio";1104;100;0
81;0;"dionisios";81;100;0
5;0;"dionn";5;100;0
5;3642;"dionna";3647;0.137098985467508;99.8629010145325
0;5;"dionnah";5;0;100
419;9702;"dionne";10121;4.139907123802;95.860092876198
0;24;"dionni";24;0;100
0;18;"dionnie";18;0;100
359;0;"dionta";359;100;0
629;0;"diontae";629;100;0
152;0;"diontay";152;100;0
5;0;"diontaye";5;100;0
2938;26;"dionte";2964;99.1228070175439;0.87719298245614
5;0;"diontray";5;100;0
157;0;"diontre";157;100;0
24;0;"diony";24;100;0
0;38;"dionysia";38;0;100
59;0;"dionysios";59;100;0
27;0;"dionysius";27;100;0
32;0;"dionysus";32;100;0
0;11;"dionza";11;0;100
6;0;"diop";6;100;0
668;1750;"dior";2418;27.6261373035567;72.3738626964433
0;111;"diora";111;0;100
0;39;"diore";39;0;100
0;31;"dioselin";31;0;100
0;75;"dioselina";75;0;100
0;5;"dioseline";5;0;100
0;23;"dioselyn";23;0;100
54;0;"diovanni";54;100;0
0;18;"dipa";18;0;100
5;0;"dipak";5;100;0
0;16;"dipali";16;0;100
19;0;"dipesh";19;100;0
14;0;"dipson";14;100;0
0;11;"dipti";11;0;100
372;0;"diquan";372;100;0
5;0;"diquon";5;100;0
5;0;"diran";5;100;0
102;0;"dirck";102;100;0
0;14;"diretha";14;0;100
0;7;"dirinda";7;0;100
10752;0;"dirk";10752;100;0
12;0;"dirl";12;100;0
174;0;"diron";174;100;0
40;0;"dirrick";40;100;0
0;280;"disa";280;0;100
0;67;"disaya";67;0;100
0;10;"diseree";10;0;100
0;638;"disha";638;0;100
12;0;"dishan";12;100;0
5;0;"dishaun";5;100;0
201;0;"dishawn";201;100;0
0;5;"disheka";5;0;100
0;11;"dishita";11;0;100
323;0;"dishon";323;100;0
0;27;"disiree";27;0;100
5;130;"disney";135;3.7037037037037;96.2962962962963
11;0;"dison";11;100;0
0;11;"dissie";11;0;100
5;0;"distin";5;100;0
0;23;"distiny";23;0;100
0;24;"dita";24;0;100
0;7;"diti";7;0;100
0;20;"ditya";20;0;100
0;527;"diva";527;0;100
8;0;"divam";8;100;0
10;0;"divan";10;100;0
159;0;"divante";159;100;0
0;18;"divany";18;0;100
5;0;"diven";5;100;0
6;0;"divesh";6;100;0
0;16;"divia";16;0;100
0;5;"diviana";5;0;100
5;0;"divid";5;100;0
10;0;"divij";10;100;0
0;17;"divija";17;0;100
5;0;"divin";5;100;0
0;1005;"divina";1005;0;100
1153;1554;"divine";2707;42.5932766900628;57.4067233099372
0;651;"divinity";651;0;100
8;0;"divion";8;100;0
0;21;"divisha";21;0;100
72;0;"divit";72;100;0
5;0;"divith";5;100;0
0;6;"divleen";6;0;100
64;0;"divon";64;100;0
5;0;"divontae";5;100;0
84;0;"divonte";84;100;0
16;2336;"divya";2352;0.680272108843537;99.3197278911565
14;0;"divyam";14;100;0
30;0;"divyansh";30;100;0
0;13;"divyanshi";13;0;100
33;0;"divyesh";33;100;0
0;6;"divyne";6;0;100
40;0;"dix";40;100;0
0;15;"dixee";15;0;100
0;54;"dixi";54;0;100
0;12;"dixiana";12;0;100
0;7;"dixianna";7;0;100
721;42114;"dixie";42835;1.68320298821058;98.3167970117894
0;36;"dixielee";36;0;100
0;13;"dixielynn";13;0;100
2634;5;"dixon";2639;99.8105342932929;0.189465706707086
0;5;"dixy";5;0;100
12;3709;"diya";3721;0.322493953238377;99.6775060467616
0;10;"diyaa";10;0;100
0;17;"diyala";17;0;100
33;0;"diyan";33;100;0
0;81;"diyana";81;0;100
0;10;"diyanna";10;0;100
18;0;"diyar";18;100;0
64;0;"diyari";64;100;0
5;0;"diyon";5;100;0
0;5;"diyonna";5;0;100
20;0;"diyor";20;100;0
0;35;"diyora";35;0;100
19;0;"dizzy";19;100;0
683;13;"dj";696;98.132183908046;1.86781609195402
0;5;"djamila";5;0;100
0;9;"djana";9;0;100
0;5;"djanae";5;0;100
243;0;"django";243;100;0
6;0;"djaun";6;100;0
20;0;"djavan";20;100;0
5;0;"djavon";5;100;0
39;0;"djay";39;100;0
0;7;"djellza";7;0;100
0;29;"djenaba";29;0;100
0;19;"djenabou";19;0;100
0;5;"djene";5;0;100
0;105;"djeneba";105;0;100
0;18;"djenne";18;0;100
212;0;"djibril";212;100;0
232;11;"djimon";243;95.4732510288066;4.52674897119342
99;0;"djon";99;100;0
6;0;"djordje";6;100;0
1443;7;"djuan";1450;99.5172413793103;0.482758620689655
0;669;"djuana";669;0;100
0;12;"djuanna";12;0;100
0;358;"djuna";358;0;100
6;0;"dkaiden";6;100;0
38;0;"dkari";38;100;0
0;54;"dkayla";54;0;100
12;0;"dkhari";12;100;0
5;0;"dkota";5;100;0
6;0;"dkwon";6;100;0
0;5;"dlana";5;0;100
0;6;"dlaney";6;0;100
0;5;"dlayna";5;0;100
0;24;"dlila";24;0;100
0;16;"dlilah";16;0;100
0;5;"dlinda";5;0;100
0;69;"dlisa";69;0;100
0;6;"dliyah";6;0;100
0;34;"dlorah";34;0;100
16;0;"dlyan";16;100;0
0;31;"dlyla";31;0;100
0;14;"dlylah";14;0;100
0;66;"dlynn";66;0;100
67;25;"dmani";92;72.8260869565217;27.1739130434783
5;0;"dmar";5;100;0
443;0;"dmarco";443;100;0
843;0;"dmarcus";843;100;0
5;0;"dmareon";5;100;0
424;0;"dmari";424;100;0
0;6;"dmaria";6;0;100
5;0;"dmarian";5;100;0
420;0;"dmario";420;100;0
537;0;"dmarion";537;100;0
60;0;"dmarius";60;100;0
5;0;"dmarko";5;100;0
54;0;"dmarkus";54;100;0
5;0;"dmarquis";5;100;0
13;0;"dmarrion";13;100;0
67;0;"dmauri";67;100;0
5;0;"dmaurion";5;100;0
0;35;"dmaya";35;0;100
22;0;"dmetri";22;100;0
70;0;"dmetrius";70;100;0
0;57;"dmia";57;0;100
49;0;"dmichael";49;100;0
11;0;"dmir";11;100;0
0;5;"dmiracle";5;0;100
1950;0;"dmitri";1950;100;0
5;0;"dmitris";5;100;0
34;0;"dmitrius";34;100;0
460;0;"dmitriy";460;100;0
449;0;"dmitry";449;100;0
0;78;"dmiya";78;0;100
0;76;"dmiyah";76;0;100
21;0;"dmon";21;100;0
61;0;"dmoni";61;100;0
28;0;"dmontae";28;100;0
136;0;"dmonte";136;100;0
30;0;"dmorea";30;100;0
0;297;"dmya";297;0;100
0;10;"dmyah";10;0;100
0;57;"dnae";57;0;100
48;0;"dnaiel";48;100;0
0;10;"dnaielle";10;0;100
0;22;"dnaja";22;0;100
0;6;"dnajah";6;0;100
0;95;"dnasia";95;0;100
0;25;"dnaya";25;0;100
0;5;"dneisha";5;0;100
0;5;"dnesha";5;0;100
0;34;"dnia";34;0;100
0;5;"dniah";5;0;100
22;0;"dniel";22;100;0
0;5;"dnielle";5;0;100
0;7;"dnijah";7;0;100
0;10;"dnisha";10;0;100
0;129;"dniya";129;0;100
0;147;"dniyah";147;0;100
0;70;"dnya";70;0;100
0;20;"dnyah";20;0;100
0;5;"dnyia";5;0;100
0;78;"dnyla";78;0;100
0;30;"dnylah";30;0;100
5;0;"do";5;100;0
0;87;"doaa";87;0;100
178;0;"doak";178;100;0
37;17;"doan";54;68.5185185185185;31.4814814814815
51;0;"doane";51;100;0
41;0;"doanld";41;100;0
11;5;"dobbie";16;68.75;31.25
5;0;"dobby";5;100;0
32;0;"dobie";32;100;0
0;11;"doborah";11;0;100
944;0;"doc";944;100;0
0;721;"docia";721;0;100
0;52;"docie";52;0;100
4200;0;"dock";4200;100;0
6;0;"dockie";6;100;0
249;0;"doctor";249;100;0
306;0;"dodd";306;100;0
0;57;"doddie";57;0;100
505;0;"dodge";505;100;0
81;0;"dodger";81;100;0
5;458;"dodi";463;1.07991360691145;98.9200863930886
0;1258;"dodie";1258;0;100
16;0;"dodson";16;100;0
0;338;"dody";338;0;100
0;27;"doe";27;0;100
25;0;"doel";25;100;0
0;122;"doha";122;0;100
98;0;"dohn";98;100;0
38;0;"dohnovan";38;100;0
267;0;"doil";267;100;0
96;59;"dois";155;61.9354838709677;38.0645161290323
5;0;"dokken";5;100;0
55;0;"dokota";55;100;0
0;910;"dola";910;0;100
1622;0;"dolan";1622;100;0
0;133;"dolce";133;0;100
20;0;"dolen";20;100;0
0;10;"dolena";10;0;100
0;5;"dolene";5;0;100
0;6;"doletha";6;0;100
19;347;"doll";366;5.19125683060109;94.8087431693989
0;5;"dolleen";5;0;100
0;10;"dollena";10;0;100
0;98;"dollene";98;0;100
0;5;"dolley";5;0;100
0;5;"dolli";5;0;100
0;24;"dollicia";24;0;100
61;16533;"dollie";16594;0.367602747981198;99.6323972520188
0;30;"dollinda";30;0;100
0;53;"dolline";53;0;100
44;18799;"dolly";18843;0.233508464681845;99.7664915353182
0;246;"dollye";246;0;100
0;87;"dolora";87;0;100
0;191;"doloras";191;0;100
1336;210373;"dolores";211709;0.631054891383928;99.3689451086161
0;9;"dolorese";9;0;100
0;94;"dolorez";94;0;100
0;5;"doloria";5;0;100
0;51;"dolories";51;0;100
0;1884;"doloris";1884;0;100
0;11;"dolorita";11;0;100
0;82;"doloros";82;0;100
0;5;"dolorosa";5;0;100
0;5;"dolorous";5;0;100
0;6;"dolorse";6;0;100
566;0;"dolph";566;100;0
0;26;"dolphine";26;0;100
5;0;"dolphis";5;100;0
1125;0;"dolphus";1125;100;0
0;5;"dolres";5;0;100
450;0;"dolton";450;100;0
255;0;"dom";255;100;0
321;5;"domani";326;98.4662576687116;1.53374233128834
1129;11;"domanic";1140;99.0350877192982;0.964912280701754
749;0;"domanick";749;100;0
279;0;"domanik";279;100;0
146;375;"domanique";521;28.0230326295585;71.9769673704415
5;0;"domari";5;100;0
13;0;"domarion";13;100;0
0;6;"domeeka";6;0;100
10378;0;"domenic";10378;100;0
0;3285;"domenica";3285;0;100
5032;0;"domenick";5032;100;0
3294;0;"domenico";3294;100;0
215;5;"domenik";220;97.7272727272727;2.27272727272727
187;539;"domenique";726;25.7575757575758;74.2424242424242
36;0;"domer";36;100;0
22;0;"dometrius";22;100;0
5;0;"domian";5;100;0
10;0;"domiano";10;100;0
0;5;"domica";5;0;100
0;10;"domicella";10;0;100
6;0;"domico";6;100;0
0;10;"domie";10;0;100
0;12;"domina";12;0;100
11;0;"dominador";11;100;0
0;15;"dominae";15;0;100
5;0;"dominant";5;100;0
15;0;"dominck";15;100;0
6;0;"domineck";6;100;0
0;5;"dominee";5;0;100
7;0;"domineek";7;100;0
17;5;"dominek";22;77.2727272727273;22.7272727272727
14;0;"domineke";14;100;0
15;26;"domineque";41;36.5853658536585;63.4146341463415
0;16;"dominesha";16;0;100
10;3802;"dominga";3812;0.262329485834208;99.7376705141658
13619;26;"domingo";13645;99.8094540124588;0.190545987541224
71;0;"domingos";71;100;0
19;68;"domingue";87;21.8390804597701;78.1609195402299
0;157;"domini";157;0;100
157414;1179;"dominic";158593;99.2565876173602;0.743412382639839
0;2230;"dominica";2230;0;100
12;0;"dominicc";12;100;0
0;7;"dominice";7;0;100
0;6;"dominicia";6;0;100
61142;267;"dominick";61409;99.5652103111922;0.434789688807829
0;5;"dominicka";5;0;100
354;0;"dominico";354;100;0
137;6;"dominie";143;95.8041958041958;4.1958041958042
46;165;"dominigue";211;21.8009478672986;78.1990521327014
8044;95;"dominik";8139;98.8327804398575;1.16721956014252
0;571;"dominika";571;0;100
15;0;"dominike";15;100;0
5;0;"dominio";5;100;0
45;0;"dominion";45;100;0
277;5;"dominiq";282;98.2269503546099;1.77304964539007
0;15;"dominiqu";15;0;100
0;80;"dominiqua";80;0;100
22119;49958;"dominique";72077;30.6880142070286;69.3119857929714
0;58;"dominisha";58;0;100
5;91;"domino";96;5.20833333333333;94.7916666666667
0;5;"dominoe";5;0;100
2370;3871;"dominque";6241;37.9746835443038;62.0253164556962
5;5;"dominquie";10;50;50
17;0;"dominus";17;100;0
23;0;"dominyc";23;100;0
79;0;"dominyck";79;100;0
152;0;"dominyk";152;100;0
7;0;"dominykas";7;100;0
68;139;"domique";207;32.8502415458937;67.1497584541063
0;38;"domita";38;0;100
0;345;"domitila";345;0;100
10;0;"domitilo";10;100;0
33;0;"domminic";33;100;0
17;0;"domminick";17;100;0
0;5;"dommonique";5;0;100
100;0;"domnic";100;100;0
422;0;"domnick";422;100;0
19;0;"domnik";19;100;0
71;138;"domnique";209;33.9712918660287;66.0287081339713
10;0;"domoni";10;100;0
2754;67;"domonic";2821;97.6249556894718;2.37504431052818
0;10;"domonica";10;0;100
1065;0;"domonick";1065;100;0
0;8;"domonigue";8;0;100
106;0;"domonik";106;100;0
1770;5138;"domonique";6908;25.6224667052693;74.3775332947308
0;5;"domonque";5;0;100
5;0;"domunique";5;100;0
37;0;"domynic";37;100;0
5;0;"domynick";5;100;0
11;0;"domynik";11;100;0
0;6;"domynique";6;0;100
165653;1207;"don";166860;99.2766390986456;0.723360901354429
175;18036;"dona";18211;0.960957662950964;99.039042337049
0;61;"donabelle";61;0;100
0;10;"donaciana";10;0;100
539;0;"donaciano";539;100;0
6;197;"donae";203;2.95566502463054;97.0443349753695
0;5;"donagene";5;0;100
0;29;"donah";29;0;100
64;0;"donahue";64;100;0
5;0;"donail";5;100;0
0;5;"donajean";5;0;100
0;18;"donaji";18;0;100
3676;5;"donal";3681;99.8641673458299;0.135832654170062
1408039;5560;"donald";1413599;99.6066777070442;0.393322292955782
0;618;"donalda";618;0;100
0;41;"donaldeen";41;0;100
0;12;"donaldine";12;0;100
307;0;"donaldo";307;100;0
122;0;"donaldson";122;100;0
0;406;"donalee";406;0;100
0;10;"donaleen";10;0;100
0;29;"donalene";29;0;100
5;0;"donall";5;100;0
0;296;"donalyn";296;0;100
0;5;"donalynn";5;0;100
0;5;"donamarie";5;0;100
11;0;"donard";11;100;0
0;5;"donashia";5;0;100
0;189;"donasia";189;0;100
345;0;"donat";345;100;0
0;550;"donata";550;0;100
15;0;"donate";15;100;0
0;216;"donatella";216;0;100
193;0;"donatello";193;100;0
465;0;"donathan";465;100;0
15;0;"donathon";15;100;0
2911;0;"donato";2911;100;0
7793;5;"donavan";7798;99.935880995127;0.0641190048730444
1116;0;"donaven";1116;100;0
2178;0;"donavin";2178;100;0
5159;0;"donavon";5159;100;0
490;0;"donavyn";490;100;0
0;36;"doncella";36;0;100
6;0;"donchevell";6;100;0
0;164;"donda";164;0;100
0;20;"dondee";20;0;100
764;375;"dondi";1139;67.0763827919227;32.9236172080773
0;5;"dondie";5;0;100
20;489;"dondra";509;3.92927308447937;96.0707269155206
16;0;"dondrae";16;100;0
11;0;"dondray";11;100;0
1533;0;"dondre";1533;100;0
17;76;"dondrea";93;18.2795698924731;81.7204301075269
107;0;"dondrell";107;100;0
5;0;"dondrey";5;100;0
0;35;"dondria";35;0;100
20;0;"dondrick";20;100;0
6;0;"doneal";6;100;0
0;40;"donecia";40;0;100
0;66;"doneen";66;0;100
0;365;"doneisha";365;0;100
0;11;"doneka";11;0;100
691;30;"donel";721;95.8391123439667;4.16088765603329
5;0;"doneld";5;100;0
0;549;"donelda";549;0;100
0;5;"donelia";5;0;100
4713;591;"donell";5304;88.8574660633484;11.1425339366516
0;1812;"donella";1812;0;100
316;1127;"donelle";1443;21.8988218988219;78.1011781011781
0;39;"donene";39;0;100
0;11;"donese";11;0;100
0;652;"donesha";652;0;100
0;201;"doneshia";201;0;100
0;21;"donesia";21;0;100
0;144;"doneta";144;0;100
0;1994;"donetta";1994;0;100
0;1091;"donette";1091;0;100
0;35;"doneva";35;0;100
174;0;"donevan";174;100;0
81;0;"donevin";81;100;0
5;5;"doney";10;50;50
316;0;"dong";316;100;0
134;678;"doni";812;16.5024630541872;83.4975369458128
0;1114;"donia";1114;0;100
0;802;"donica";802;0;100
0;567;"donice";567;0;100
0;56;"donicia";56;0;100
17;0;"donicio";17;100;0
131;616;"donie";747;17.5368139223561;82.4631860776439
0;44;"doniece";44;0;100
376;7;"doniel";383;98.1723237597911;1.82767624020888
0;5;"doniell";5;0;100
91;1950;"donielle";2041;4.45859872611465;95.5414012738854
0;160;"doniesha";160;0;100
0;402;"donika";402;0;100
12;0;"doninic";12;100;0
19;73;"doninique";92;20.6521739130435;79.3478260869565
0;78;"doniqua";78;0;100
36;122;"donique";158;22.7848101265823;77.2151898734177
109;565;"donis";674;16.1721068249258;83.8278931750742
0;338;"donise";338;0;100
0;1276;"donisha";1276;0;100
0;20;"donishia";20;0;100
0;5189;"donita";5189;0;100
0;6;"donitra";6;0;100
0;16;"donitta";16;0;100
1106;0;"donivan";1106;100;0
0;5;"donivee";5;0;100
111;0;"doniven";111;100;0
77;0;"donivin";77;100;0
28;0;"donivon";28;100;0
0;13;"doniya";13;0;100
0;16;"doniyah";16;0;100
0;102;"donja";102;0;100
10;0;"donjae";10;100;0
0;5;"donjanae";5;0;100
6;0;"donjay";6;100;0
6;0;"donje";6;100;0
71;0;"donjuan";71;100;0
5;0;"donlad";5;100;0
23;0;"donld";23;100;0
564;0;"donley";564;100;0
5;0;"donminique";5;100;0
0;13;"donmonique";13;0;100
6534;62;"donn";6596;99.0600363856883;0.939963614311704
2232;829864;"donna";832096;0.268238280198439;99.7317617198016
0;15;"donnabel";15;0;100
0;24;"donnabell";24;0;100
0;436;"donnabelle";436;0;100
0;85;"donnae";85;0;100
0;73;"donnah";73;0;100
0;307;"donnajean";307;0;100
0;27;"donnajo";27;0;100
49;0;"donnal";49;100;0
386;0;"donnald";386;100;0
0;966;"donnalee";966;0;100
0;7;"donnalou";7;0;100
0;82;"donnalyn";82;0;100
0;75;"donnalynn";75;0;100
0;351;"donnamae";351;0;100
0;76;"donnamaria";76;0;100
0;1124;"donnamarie";1124;0;100
0;78;"donnarae";78;0;100
0;5;"donnas";5;0;100
0;17;"donnasia";17;0;100
152;0;"donnavan";152;100;0
16;0;"donnaven";16;100;0
73;0;"donnavin";73;100;0
45;0;"donnavon";45;100;0
0;6;"donnay";6;0;100
80;117;"donne";197;40.6091370558376;59.3908629441624
0;83;"donneisha";83;0;100
770;47;"donnel";817;94.2472460220318;5.75275397796818
13954;1026;"donnell";14980;93.150867823765;6.84913217623498
0;344;"donnella";344;0;100
236;318;"donnelle";554;42.5992779783394;57.4007220216607
38;0;"donnelly";38;100;0
5;0;"donner";5;100;0
0;273;"donnesha";273;0;100
0;34;"donneshia";34;0;100
0;5;"donneta";5;0;100
0;26;"donnett";26;0;100
0;1521;"donnetta";1521;0;100
0;1209;"donnette";1209;0;100
106;0;"donney";106;100;0
6;179;"donni";185;3.24324324324324;96.7567567567568
0;394;"donnia";394;0;100
0;93;"donnica";93;0;100
0;158;"donnice";158;0;100
60043;6633;"donnie";66676;90.0518927350171;9.9481072649829
0;10;"donniece";10;0;100
0;96;"donnielle";96;0;100
0;34;"donniesha";34;0;100
0;80;"donnika";80;0;100
456;1046;"donnis";1502;30.3595206391478;69.6404793608522
0;44;"donnise";44;0;100
0;445;"donnisha";445;0;100
0;855;"donnita";855;0;100
0;6;"donnitta";6;0;100
66;0;"donnivan";66;100;0
26;0;"donnivin";26;100;0
521;0;"donnovan";521;100;0
8;0;"donnovin";8;100;0
12621;40;"donny";12661;99.6840691888476;0.315930811152358
5;0;"donnye";5;100;0
5;0;"donoban";5;100;0
830;0;"donold";830;100;0
54477;210;"donovan";54687;99.6159964891108;0.384003510889242
24;0;"donovann";24;100;0
376;0;"donoven";376;100;0
720;0;"donovin";720;100;0
639;0;"donovon";639;100;0
215;0;"donovyn";215;100;0
39;0;"donquarius";39;100;0
5;0;"donquavious";5;100;0
11;0;"donquell";11;100;0
27;0;"donquez";27;100;0
10;0;"donrico";10;100;0
25;26;"donsha";51;49.0196078431373;50.9803921568627
13;27;"donshae";40;32.5;67.5
64;28;"donshay";92;69.5652173913043;30.4347826086957
3714;91;"donta";3805;97.6084099868594;2.3915900131406
5408;17;"dontae";5425;99.6866359447005;0.313364055299539
173;0;"dontai";173;100;0
0;5;"dontajah";5;0;100
66;0;"dontario";66;100;0
102;0;"dontarious";102;100;0
346;0;"dontarius";346;100;0
5;0;"dontarrius";5;100;0
0;127;"dontasia";127;0;100
17;0;"dontate";17;100;0
11;108;"dontavia";119;9.2436974789916;90.7563025210084
70;0;"dontavian";70;100;0
5;0;"dontavias";5;100;0
101;0;"dontavion";101;100;0
1749;0;"dontavious";1749;100;0
359;0;"dontavis";359;100;0
961;0;"dontavius";961;100;0
2256;0;"dontay";2256;100;0
382;0;"dontaye";382;100;0
0;5;"dontaysha";5;0;100
6;0;"dontaz";6;100;0
14785;137;"donte";14922;99.0818925077067;0.918107492293258
98;0;"dontea";98;100;0
94;0;"dontee";94;100;0
208;0;"dontel";208;100;0
188;0;"dontell";188;100;0
26;0;"donterio";26;100;0
45;0;"donterious";45;100;0
99;0;"donterius";99;100;0
28;0;"donterrio";28;100;0
33;0;"donterrious";33;100;0
114;0;"donterrius";114;100;0
5;0;"dontevion";5;100;0
11;0;"dontevious";11;100;0
7;0;"dontevius";7;100;0
16;0;"dontey";16;100;0
942;0;"dontez";942;100;0
13;0;"donti";13;100;0
13;36;"dontia";49;26.530612244898;73.469387755102
11;0;"dontonio";11;100;0
46;0;"dontra";46;100;0
122;0;"dontrae";122;100;0
141;0;"dontrail";141;100;0
101;0;"dontravious";101;100;0
20;0;"dontravius";20;100;0
304;0;"dontray";304;100;0
469;0;"dontre";469;100;0
5;0;"dontrea";5;100;0
74;0;"dontreal";74;100;0
247;0;"dontrel";247;100;0
2570;16;"dontrell";2586;99.3812838360402;0.618716163959783
72;0;"dontrelle";72;100;0
82;0;"dontrey";82;100;0
125;0;"dontrez";125;100;0
0;6;"dontrice";6;0;100
12;0;"donvan";12;100;0
22;0;"dony";22;100;0
265;2220;"donya";2485;10.6639839034205;89.3360160965795
301;212;"donyae";513;58.6744639376218;41.3255360623782
5;0;"donyai";5;100;0
79;354;"donyale";433;18.2448036951501;81.7551963048499
257;86;"donye";343;74.9271137026239;25.0728862973761
171;92;"donyea";263;65.0190114068441;34.9809885931559
79;96;"donyel";175;45.1428571428571;54.8571428571429
504;398;"donyell";902;55.8758314855876;44.1241685144124
15;373;"donyelle";388;3.8659793814433;96.1340206185567
0;103;"donyetta";103;0;100
0;26;"donza";26;0;100
0;9;"donzaleigh";9;0;100
236;0;"donzel";236;100;0
1007;23;"donzell";1030;97.7669902912621;2.23300970873786
0;375;"donzella";375;0;100
0;40;"donzetta";40;0;100
5;0;"dooley";5;100;0
11;5;"dor";16;68.75;31.25
450;89192;"dora";89642;0.501996831842217;99.4980031681578
0;6;"dorabelle";6;0;100
0;33;"dorace";33;0;100
0;5;"dorae";5;0;100
0;7;"doraelia";7;0;100
0;6;"dorah";6;0;100
40;7;"dorain";47;85.1063829787234;14.8936170212766
0;237;"doraine";237;0;100
216;86;"doral";302;71.523178807947;28.476821192053
0;510;"doralee";510;0;100
0;98;"doralene";98;0;100
0;5;"doraline";5;0;100
0;5;"doraliz";5;0;100
0;12;"doraly";12;0;100
0;92;"doralyn";92;0;100
0;6;"doralynn";6;0;100
0;34;"doramae";34;0;100
2585;55;"doran";2640;97.9166666666667;2.08333333333333
177;0;"dorance";177;100;0
0;5;"doranda";5;0;100
0;5;"dorane";5;0;100
0;170;"dorann";170;0;100
0;28;"doranna";28;0;100
0;110;"doranne";110;0;100
0;51;"doras";51;0;100
0;93;"doratha";93;0;100
0;590;"dorathea";590;0;100
0;1920;"dorathy";1920;0;100
0;5;"doray";5;0;100
0;30;"dorca";30;0;100
0;6768;"dorcas";6768;0;100
6;0;"dorce";6;100;0
0;23;"dorcia";23;0;100
10;42;"dorcie";52;19.2307692307692;80.7692307692308
5;282;"dorcus";287;1.74216027874564;98.2578397212544
6;0;"dorcy";6;100;0
20;193;"dore";213;9.38967136150235;90.6103286384976
0;66;"dorea";66;0;100
90;251;"dorean";341;26.3929618768328;73.6070381231672
0;1238;"doreatha";1238;0;100
0;21;"doreathea";21;0;100
0;61;"doreather";61;0;100
0;528;"doree";528;0;100
58;46239;"doreen";46297;0.125278095772944;99.8747219042271
0;259;"doreena";259;0;100
0;399;"doreene";399;0;100
5;0;"dorel";5;100;0
0;6;"dorelia";6;0;100
136;0;"dorell";136;100;0
0;84;"dorella";84;0;100
0;15;"dorelle";15;0;100
10;0;"doremus";10;100;0
321;36;"doren";357;89.9159663865546;10.0840336134454
0;702;"dorena";702;0;100
0;483;"dorenda";483;0;100
0;7921;"dorene";7921;0;100
22;0;"doreon";22;100;0
5;18;"dores";23;21.7391304347826;78.2608695652174
0;37;"doresa";37;0;100
0;12;"dorese";12;0;100
0;10;"doresha";10;0;100
0;8556;"doretha";8556;0;100
0;1033;"dorethea";1033;0;100
0;19;"dorether";19;0;100
0;114;"dorethia";114;0;100
0;98;"dorethy";98;0;100
0;2522;"doretta";2522;0;100
0;273;"dorette";273;0;100
7;48;"dorey";55;12.7272727272727;87.2727272727273
0;4854;"dori";4854;0;100
0;1263;"doria";1263;0;100
19374;4419;"dorian";23793;81.4273105535242;18.5726894464759
0;160;"doriana";160;0;100
0;39;"doriane";39;0;100
0;339;"doriann";339;0;100
0;104;"dorianna";104;0;100
0;490;"dorianne";490;0;100
0;5;"dorica";5;0;100
0;703;"dorice";703;0;100
36;1723;"dorie";1759;2.04661739624787;97.9533826037521
6;0;"doriel";6;100;0
0;5;"dorielle";5;0;100
1089;69;"dorien";1158;94.0414507772021;5.95854922279793
0;5;"doriene";5;0;100
0;12;"dorienne";12;0;100
0;46;"dories";46;0;100
144;21;"dorin";165;87.2727272727273;12.7272727272727
0;934;"dorina";934;0;100
0;4794;"dorinda";4794;0;100
0;2862;"dorine";2862;0;100
0;6;"dorinna";6;0;100
0;116;"dorinne";116;0;100
550;0;"dorion";550;100;0
3220;459091;"doris";462311;0.696500840343405;99.3034991596566
0;49;"dorisa";49;0;100
0;60;"dorisann";60;0;100
0;460;"dorise";460;0;100
0;11;"dorisha";11;0;100
0;6;"dorislee";6;0;100
0;58;"dorismae";58;0;100
0;175;"dorismar";175;0;100
0;64;"dorissa";64;0;100
0;11;"doristeen";11;0;100
0;7;"doristene";7;0;100
0;140;"doristine";140;0;100
0;40;"dorit";40;0;100
0;688;"dorita";688;0;100
0;47;"doritha";47;0;100
0;5;"dorithy";5;0;100
15;0;"dorjan";15;100;0
0;1089;"dorla";1089;0;100
30;0;"dorlan";30;100;0
43;0;"dorland";43;100;0
0;15;"dorlas";15;0;100
0;5;"dorlean";5;0;100
0;5;"dorlee";5;0;100
0;151;"dorleen";151;0;100
0;546;"dorlene";546;0;100
0;15;"dorles";15;0;100
0;19;"dorline";19;0;100
0;108;"dorlis";108;0;100
0;146;"dorlisa";146;0;100
0;690;"dorma";690;0;100
0;5;"dormalee";5;0;100
1898;0;"dorman";1898;100;0
0;6;"dormilee";6;0;100
7;0;"dormon";7;100;0
225;12;"dorn";237;94.9367088607595;5.06329113924051
0;119;"dorna";119;0;100
18;0;"dorne";18;100;0
294;0;"dornell";294;100;0
0;10;"dornisha";10;0;100
5;0;"doro";5;100;0
0;6;"dorohty";6;0;100
603;0;"doron";603;100;0
0;49;"dorota";49;0;100
0;125;"dorotea";125;0;100
676;0;"doroteo";676;100;0
0;4743;"dorotha";4743;0;100
0;644;"dorothe";644;0;100
6;32643;"dorothea";32649;0.0183772856749058;99.9816227143251
0;289;"dorothee";289;0;100
0;5;"dorothene";5;0;100
0;1147;"dorothey";1147;0;100
0;132;"dorothia";132;0;100
0;520;"dorothie";520;0;100
3651;1093641;"dorothy";1097292;0.332728207259326;99.6672717927407
0;152;"dorothyann";152;0;100
0;317;"dorothye";317;0;100
0;77;"dorothymae";77;0;100
0;6;"doroty";6;0;100
0;5;"dorpha";5;0;100
119;0;"dorr";119;100;0
0;5;"dorra";5;0;100
0;40;"dorrace";40;0;100
0;354;"dorraine";354;0;100
284;0;"dorrance";284;100;0
0;164;"dorreen";164;0;100
5;0;"dorrel";5;100;0
358;0;"dorrell";358;100;0
5;10;"dorren";15;33.3333333333333;66.6666666666667
6;0;"dorrence";6;100;0
0;90;"dorrene";90;0;100
0;5;"dorretta";5;0;100
0;155;"dorri";155;0;100
431;31;"dorrian";462;93.2900432900433;6.70995670995671
0;889;"dorrie";889;0;100
106;0;"dorrien";106;100;0
0;308;"dorrine";308;0;100
22;0;"dorrion";22;100;0
1664;7270;"dorris";8934;18.6254757107679;81.3745242892321
0;13;"dorrit";13;0;100
5;0;"dorron";5;100;0
0;16;"dorry";16;0;100
0;51;"dorsa";51;0;100
254;0;"dorse";254;100;0
71;0;"dorsel";71;100;0
29;0;"dorsett";29;100;0
5096;817;"dorsey";5913;86.1829866396076;13.8170133603924
0;5;"dorsha";5;0;100
0;5;"dorsi";5;0;100
254;391;"dorsie";645;39.3798449612403;60.6201550387597
0;5;"dorth";5;0;100
0;6748;"dortha";6748;0;100
0;20;"dorthay";20;0;100
0;36;"dorthe";36;0;100
0;2383;"dorthea";2383;0;100
0;31;"dorthella";31;0;100
0;1559;"dorthey";1559;0;100
0;152;"dorthia";152;0;100
0;239;"dorthie";239;0;100
0;63;"dorthula";63;0;100
79;20172;"dorthy";20251;0.390104192385561;99.6098958076144
33;0;"doruk";33;100;0
24;0;"dorus";24;100;0
43;0;"dorvin";43;100;0
432;0;"dorwin";432;100;0
124;919;"dory";1043;11.888782358581;88.111217641419
98;0;"doryan";98;100;0
0;172;"doryce";172;0;100
0;7;"dorylee";7;0;100
0;51;"dorys";51;0;100
0;280;"dosha";280;0;100
0;626;"doshia";626;0;100
0;601;"doshie";601;0;100
0;45;"dosia";45;0;100
12;28;"dosie";40;30;70
325;0;"doss";325;100;0
450;503;"dossie";953;47.2193074501574;52.7806925498426
22;1210;"dot";1232;1.78571428571429;98.2142857142857
0;14;"dotha";14;0;100
0;118;"dotsie";118;0;100
32;0;"dotson";32;100;0
0;51;"dotsy";51;0;100
0;44;"dott";44;0;100
0;188;"dotti";188;0;100
0;8770;"dottie";8770;0;100
0;1663;"dotty";1663;0;100
0;33;"dottye";33;0;100
0;7;"doty";7;0;100
39;28;"doua";67;58.2089552238806;41.7910447761194
0;5;"douaa";5;0;100
0;6;"douachee";6;0;100
22458;5;"doug";22463;99.9777411743757;0.0222588256243601
5;0;"dougal";5;100;0
15;0;"dougald";15;100;0
47;0;"dougals";47;100;0
556008;2077;"douglas";558085;99.6278344696596;0.37216553034036
5720;26;"douglass";5746;99.5475113122172;0.452488687782805
300;0;"dougles";300;100;0
5;0;"douglus";5;100;0
47;0;"doulgas";47;100;0
0;43;"dounia";43;0;100
2414;0;"dov";2414;100;0
0;50;"dova";50;0;100
6;0;"dovan";6;100;0
98;0;"dovber";98;100;0
22;627;"dove";649;3.38983050847458;96.6101694915254
135;0;"dover";135;100;0
0;16;"dovetta";16;0;100
0;87;"dovey";87;0;100
10;0;"dovi";10;100;0
2111;0;"dovid";2111;100;0
10;7510;"dovie";7520;0.132978723404255;99.8670212765958
0;6;"dovion";6;0;100
13;0;"dovon";13;100;0
12;0;"dovonte";12;100;0
1008;0;"dow";1008;100;0
40;0;"doward";40;100;0
6;0;"dowd";6;100;0
5;0;"dowe";5;100;0
211;0;"dowell";211;100;0
5;0;"dowl";5;100;0
0;17;"down";17;0;100
6;0;"downey";6;100;0
13;0;"downing";13;100;0
0;60;"doxie";60;0;100
731;34;"doy";765;95.5555555555556;4.44444444444444
1149;0;"doyal";1149;100;0
946;172;"doyce";1118;84.6153846153846;15.3846153846154
106;20;"doye";126;84.1269841269841;15.8730158730159
93;0;"doyel";93;100;0
210;0;"doyl";210;100;0
0;21;"doyla";21;0;100
30193;252;"doyle";30445;99.1722778781409;0.82772212185909
0;258;"doylene";258;0;100
449;63;"doyne";512;87.6953125;12.3046875
66;0;"doyt";66;100;0
5;0;"dozie";5;100;0
338;0;"dozier";338;100;0
219;0;"dquan";219;100;0
5;0;"dquarious";5;100;0
10;0;"dquarius";10;100;0
5;0;"dquavion";5;100;0
46;0;"drace";46;100;0
166;0;"dracen";166;100;0
470;0;"draco";470;100;0
10;0;"draconis";10;100;0
17;0;"dracy";17;100;0
212;0;"draden";212;100;0
20;0;"dradyn";20;100;0
101;0;"drae";101;100;0
114;0;"draeden";114;100;0
6;0;"draedon";6;100;0
62;0;"draedyn";62;100;0
42;0;"draegan";42;100;0
22;0;"draelyn";22;100;0
18;0;"draeson";18;100;0
6;0;"draevyn";6;100;0
246;0;"dragan";246;100;0
5;0;"dragen";5;100;0
56;0;"drago";56;100;0
122;0;"dragon";122;100;0
215;0;"draiden";215;100;0
6;0;"draidyn";6;100;0
5;0;"draike";5;100;0
11;0;"draiman";11;100;0
16;0;"draiven";16;100;0
0;29;"draizy";29;0;100
6;0;"drakar";6;100;0
32348;78;"drake";32426;99.7594522913711;0.240547708628878
154;0;"draken";154;100;0
142;0;"drakkar";142;100;0
112;0;"drako";112;100;0
372;0;"draper";372;100;0
5;0;"drapper";5;100;0
5;0;"draquan";5;100;0
13;0;"drashawn";13;100;0
0;6;"drashti";6;0;100
15;0;"drason";15;100;0
5975;219;"draven";6194;96.4643203099774;3.5356796900226
5;0;"dravid";5;100;0
430;0;"dravin";430;100;0
5;0;"dravion";5;100;0
109;0;"dravon";109;100;0
212;0;"dravyn";212;100;0
6;0;"drax";6;100;0
0;47;"draxie";47;0;100
29;0;"draxton";29;100;0
263;0;"dray";263;100;0
0;402;"draya";402;0;100
0;40;"drayah";40;0;100
86;0;"drayce";86;100;0
52;0;"draycen";52;100;0
1496;0;"drayden";1496;100;0
13;0;"draydin";13;100;0
89;0;"draydon";89;100;0
87;0;"drayk";87;100;0
301;0;"drayke";301;100;0
11;0;"draylan";11;100;0
0;5;"draylee";5;0;100
96;0;"draylen";96;100;0
7;0;"draylin";7;100;0
169;0;"draylon";169;100;0
14;0;"draymond";14;100;0
11;0;"drayon";11;100;0
57;0;"draysen";57;100;0
331;0;"drayson";331;100;0
6;0;"drayten";6;100;0
1733;0;"drayton";1733;100;0
302;0;"drayven";302;100;0
51;0;"drayvin";51;100;0
13;0;"drayvon";13;100;0
35;0;"drazen";35;100;0
598;0;"dre";598;100;0
0;619;"drea";619;0;100
0;31;"dreah";31;0;100
98;1257;"dream";1355;7.23247232472325;92.7675276752768
0;3043;"dreama";3043;0;100
5;81;"dreamer";86;5.81395348837209;94.1860465116279
21;0;"drean";21;100;0
0;132;"dreana";132;0;100
0;301;"dreanna";301;0;100
0;5;"dreauna";5;0;100
0;16;"dreda";16;0;100
35;0;"dredan";35;100;0
7;0;"dreddy";7;100;0
144;0;"dreden";144;100;0
40;0;"dredon";40;100;0
162;0;"dredyn";162;100;0
0;7;"dree";7;0;100
0;6;"dreema";6;0;100
0;56;"dreena";56;0;100
27;0;"dregan";27;100;0
5;0;"dreighton";5;100;0
5;0;"dreion";5;100;0
10;0;"drekwon";10;100;0
22;0;"drelan";22;100;0
5;0;"drelen";5;100;0
16;0;"drelin";16;100;0
37;0;"drelon";37;100;0
177;0;"drelyn";177;100;0
19;12;"drelynn";31;61.2903225806452;38.7096774193548
0;2464;"drema";2464;0;100
5;0;"dremon";5;100;0
5;0;"dremond";5;100;0
10;0;"dren";10;100;0
0;618;"drena";618;0;100
0;565;"drenda";565;0;100
0;6;"drene";6;0;100
0;6;"drenisha";6;0;100
0;5;"dreniyah";5;0;100
0;26;"drenna";26;0;100
28;0;"drennan";28;100;0
5;0;"drennen";5;100;0
5;0;"drennon";5;100;0
138;0;"dreon";138;100;0
0;10;"dreona";10;0;100
0;86;"dreonna";86;0;100
459;0;"drequan";459;100;0
695;170;"dresden";865;80.3468208092486;19.6531791907514
5;0;"dresdyn";5;100;0
147;0;"dresean";147;100;0
0;5;"dresha";5;0;100
9;0;"dreshan";9;100;0
222;0;"dreshaun";222;100;0
631;0;"dreshawn";631;100;0
100;0;"dreshon";100;100;0
33;0;"dreshun";33;100;0
24;0;"dreson";24;100;0
5;0;"dresyn";5;100;0
0;5;"dretha";5;0;100
20;5;"dreu";25;80;20
119;0;"dreux";119;100;0
41;0;"drevan";41;100;0
7;0;"drevaughn";7;100;0
22;0;"dreven";22;100;0
42;0;"dreveon";42;100;0
5;0;"drevian";5;100;0
103;0;"drevin";103;100;0
193;0;"drevion";193;100;0
639;0;"drevon";639;100;0
6;0;"drevonn";6;100;0
7;0;"drevonte";7;100;0
24;0;"drevyn";24;100;0
73282;6809;"drew";80091;91.4984205466282;8.50157945337179
0;7;"drewann";7;0;100
0;20;"drewcilla";20;0;100
90;0;"drewey";90;100;0
11;0;"drewry";11;100;0
19;0;"drex";19;100;0
6;0;"drexal";6;100;0
1295;40;"drexel";1335;97.0037453183521;2.99625468164794
16;0;"drexell";16;100;0
58;0;"drexler";58;100;0
8;0;"drexton";8;100;0
373;0;"drey";373;100;0
0;182;"dreya";182;0;100
0;49;"dreyah";49;0;100
0;7;"dreyanna";7;0;100
49;0;"dreydan";49;100;0
424;0;"dreyden";424;100;0
6;0;"dreydin";6;100;0
92;0;"dreydon";92;100;0
10;0;"dreyken";10;100;0
10;0;"dreylan";10;100;0
5;0;"dreylin";5;100;0
16;0;"dreylon";16;100;0
40;0;"dreyon";40;100;0
18;0;"dreysen";18;100;0
237;0;"dreyson";237;100;0
5;0;"dreyten";5;100;0
267;0;"dreyton";267;100;0
5;0;"dreyven";5;100;0
5;0;"dreyvin";5;100;0
101;0;"drezden";101;100;0
11;0;"drian";11;100;0
0;88;"driana";88;0;100
0;135;"drianna";135;0;100
6;0;"driggs";6;100;0
22;0;"drilon";22;100;0
29;0;"drin";29;100;0
0;246;"drina";246;0;100
0;187;"drinda";187;0;100
0;63;"drisana";63;0;100
0;5;"driscilla";5;0;100
5;0;"driscoll";5;100;0
7;0;"drish";7;100;0
0;5;"drisha";5;0;100
0;78;"drishti";78;0;100
0;29;"drishya";29;0;100
17;0;"driss";17;100;0
8;0;"dristan";8;100;0
44;5;"dristen";49;89.7959183673469;10.2040816326531
0;13;"dristi";13;0;100
33;12;"dristin";45;73.3333333333333;26.6666666666667
24;0;"driston";24;100;0
0;6;"dristy";6;0;100
0;41;"drita";41;0;100
5;0;"dritan";5;100;0
16;0;"driton";16;100;0
10;0;"driver";10;100;0
0;10;"driyah";10;0;100
5;0;"drizzt";5;100;0
10;0;"dron";10;100;0
2248;1513;"dru";3761;59.7713374102632;40.2286625897368
0;37;"druann";37;0;100
0;63;"druanne";63;0;100
5;0;"druce";5;100;0
0;171;"drucella";171;0;100
0;25;"drucie";25;0;100
0;3350;"drucilla";3350;0;100
1054;804;"drue";1858;56.7276641550054;43.2723358449946
0;15;"druecilla";15;0;100
5;0;"druey";5;100;0
20;0;"drummond";20;100;0
209;0;"drury";209;100;0
0;427;"druscilla";427;0;100
0;10;"drusella";10;0;100
0;5;"drusie";5;0;100
0;2746;"drusilla";2746;0;100
0;17;"druzella";17;0;100
406;0;"dryden";406;100;0
0;24;"drystal";24;0;100
72;0;"drystan";72;100;0
7;0;"dryver";7;100;0
320;0;"dsean";320;100;0
0;5;"dshae";5;0;100
0;31;"dshanti";31;0;100
284;0;"dshaun";284;100;0
579;0;"dshawn";579;100;0
0;5;"dshayla";5;0;100
44;0;"dshon";44;100;0
5;0;"dshun";5;100;0
22;0;"du";22;100;0
0;411;"dua";411;0;100
0;470;"duaa";470;0;100
50;0;"duain";50;100;0
1052;0;"duaine";1052;100;0
18;0;"dual";18;100;0
565;0;"duan";565;100;0
0;564;"duana";564;0;100
114703;1015;"duane";115718;99.122867661038;0.877132338961959
0;10;"duann";10;0;100
0;68;"duanna";68;0;100
109;54;"duanne";163;66.8711656441718;33.1288343558282
135;0;"duante";135;100;0
632;0;"duard";632;100;0
15;0;"duarte";15;100;0
279;0;"duayne";279;100;0
127;0;"dub";127;100;0
11;0;"duban";11;100;0
251;76;"dublin";327;76.7584097859327;23.2415902140673
0;5;"dublyn";5;0;100
29;0;"dubois";29;100;0
0;7;"dubraska";7;0;100
416;0;"duc";416;100;0
5;0;"ducati";5;100;0
10;0;"duce";10;100;0
7;0;"duchein";7;100;0
0;131;"duchess";131;0;100
17;0;"dud";17;100;0
45;0;"dude";45;100;0
11267;120;"dudley";11387;98.9461666813032;1.05383331869676
280;0;"duel";280;100;0
110;0;"duell";110;100;0
0;15;"duella";15;0;100
0;7;"duewa";7;0;100
75;0;"duey";75;100;0
431;0;"duff";431;100;0
34;6;"duffie";40;85;15
627;16;"duffy";643;97.5116640746501;2.48833592534992
16;0;"dugald";16;100;0
492;0;"dugan";492;100;0
203;0;"duglas";203;100;0
0;112;"duha";112;0;100
0;5;"duice";5;0;100
5;0;"duie";5;100;0
85;0;"duilio";85;100;0
5;0;"dujon";5;100;0
1146;0;"dujuan";1146;100;0
0;25;"dujuana";25;0;100
7502;0;"duke";7502;100;0
5;0;"dukens";5;100;0
0;149;"dula";149;0;100
5;0;"dulan";5;100;0
0;13;"dulaney";13;0;100
11;0;"dulani";11;100;0
49;17122;"dulce";17171;0.285364859355891;99.7146351406441
0;594;"dulcemaria";594;0;100
0;105;"dulcey";105;0;100
0;14;"dulcia";14;0;100
0;1417;"dulcie";1417;0;100
0;292;"dulcinea";292;0;100
0;100;"dulcy";100;0;100
5;0;"dulio";5;100;0
0;253;"dulse";253;0;100
5;0;"dulton";5;100;0
5;0;"dumaka";5;100;0
5;0;"dumar";5;100;0
29;0;"dumas";29;100;0
21;0;"dumont";21;100;0
0;8;"duna";8;0;100
76;0;"dunbar";76;100;0
18960;11;"duncan";18971;99.9420167624269;0.0579832375731379
5;0;"dundre";5;100;0
6;0;"dune";6;100;0
469;287;"dung";756;62.037037037037;37.962962962963
0;524;"dunia";524;0;100
0;5;"duniya";5;0;100
5;0;"dunk";5;100;0
5;0;"dunn";5;100;0
5;0;"dunstan";5;100;0
10;0;"dunta";10;100;0
5;0;"duntae";5;100;0
23;0;"dunte";23;100;0
0;317;"dunya";317;0;100
164;0;"duong";164;100;0
16;0;"dupre";16;100;0
804;0;"dupree";804;100;0
26;0;"dupri";26;100;0
87;0;"duquan";87;100;0
0;227;"dura";227;0;100
0;6;"durah";6;0;100
7;0;"dural";7;100;0
1453;0;"duran";1453;100;0
1060;0;"durand";1060;100;0
6;0;"durane";6;100;0
5;0;"durango";5;100;0
331;0;"durant";331;100;0
116;0;"durante";116;100;0
5;0;"durbin";5;100;0
0;20;"dureen";20;0;100
31;0;"durel";31;100;0
1704;0;"durell";1704;100;0
96;23;"durelle";119;80.672268907563;19.327731092437
0;107;"durenda";107;0;100
0;92;"durene";92;0;100
0;11;"duretta";11;0;100
0;44;"durga";44;0;100
237;0;"durham";237;100;0
5;0;"durie";5;100;0
253;0;"duriel";253;100;0
0;244;"durinda";244;0;100
0;5;"duriyah";5;0;100
88;0;"durk";88;100;0
10;0;"durke";10;100;0
35;0;"durl";35;100;0
5;0;"durland";5;100;0
0;5;"durlene";5;0;100
576;0;"duron";576;100;0
0;8;"durrani";8;0;100
55;0;"durrel";55;100;0
1833;0;"durrell";1833;100;0
0;12;"durriyah";12;0;100
40;0;"durron";40;100;0
0;86;"duru";86;0;100
0;5;"durva";5;0;100
5;0;"durville";5;100;0
2829;0;"durward";2829;100;0
632;0;"durwin";632;100;0
2688;0;"durwood";2688;100;0
5;0;"duryea";5;100;0
109;0;"dusan";109;100;0
12;0;"dusean";12;100;0
23;0;"dushan";23;100;0
5;0;"dushane";5;100;0
0;5;"dusharme";5;0;100
72;0;"dushaun";72;100;0
435;11;"dushawn";446;97.5336322869955;2.46636771300448
34;6;"dushon";40;85;15
5;0;"dusin";5;100;0
16;0;"dusitn";16;100;0
0;36;"duska";36;0;100
5;0;"duskin";5;100;0
1694;0;"dustan";1694;100;0
0;79;"dustee";79;0;100
1359;0;"dusten";1359;100;0
9;1751;"dusti";1760;0.511363636363636;99.4886363636364
11;897;"dustie";908;1.21145374449339;98.7885462555066
204301;1381;"dustin";205682;99.3285751791601;0.671424820839937
0;169;"dustina";169;0;100
96;146;"dustine";242;39.6694214876033;60.3305785123967
5;0;"dustinjames";5;100;0
5;0;"dustion";5;100;0
21;0;"dustn";21;100;0
1165;0;"duston";1165;100;0
15;0;"dustun";15;100;0
10352;4340;"dusty";14692;70.4601143479445;29.5398856520555
2530;60;"dustyn";2590;97.6833976833977;2.31660231660232
5;0;"dut";5;100;0
1051;0;"dutch";1051;100;0
0;110;"dutchess";110;0;100
0;6;"duuana";6;0;100
0;9;"duuna";9;0;100
527;0;"duval";527;100;0
77;0;"duvall";77;100;0
74;0;"duvan";74;100;0
0;5;"duveen";5;0;100
157;0;"duvid";157;100;0
7;0;"duvier";7;100;0
31;0;"duvon";31;100;0
25;0;"duwaine";25;100;0
205;0;"duwan";205;100;0
0;15;"duwana";15;0;100
106;0;"duwane";106;100;0
0;11;"duwanna";11;0;100
305;0;"duward";305;100;0
3595;0;"duwayne";3595;100;0
802;0;"duy";802;100;0
0;184;"duyen";184;0;100
201;0;"dvante";201;100;0
86;0;"dvaughn";86;100;0
288;0;"dvid";288;100;0
16;0;"dvir";16;100;0
256;0;"dvon";256;100;0
48;0;"dvonta";48;100;0
106;0;"dvontae";106;100;0
423;0;"dvonte";423;100;0
0;106;"dvora";106;0;100
0;12;"dvyne";12;0;100
7526;0;"dwain";7526;100;0
0;5;"dwaina";5;0;100
4320;0;"dwaine";4320;100;0
0;26;"dwala";26;0;100
1211;910;"dwan";2121;57.0957095709571;42.9042904290429
0;988;"dwana";988;0;100
0;249;"dwanda";249;0;100
3165;0;"dwane";3165;100;0
0;5;"dwania";5;0;100
20;5;"dwann";25;80;20
0;444;"dwanna";444;0;100
42;0;"dwanye";42;100;0
6;0;"dward";6;100;0
48;0;"dwaun";48;100;0
20;0;"dwaylon";20;100;0
72;0;"dwayn";72;100;0
0;70;"dwayna";70;0;100
75183;458;"dwayne";75641;99.3945082693248;0.605491730675163
5;0;"dwen";5;100;0
0;6;"dwendolyn";6;0;100
77484;325;"dwight";77809;99.5823105296302;0.417689470369752
18;0;"dwij";18;100;0
0;5;"dwija";5;0;100
160;0;"dwon";160;100;0
16;0;"dwone";16;100;0
29;0;"dwright";29;100;0
22;0;"dwuan";22;100;0
1149;0;"dwyane";1149;100;0
5;0;"dwyer";5;100;0
0;11;"dwyla";11;0;100
0;5;"dwyn";5;0;100
85;0;"dwyne";85;100;0
0;5;"dyala";5;0;100
296;5;"dyami";301;98.3388704318937;1.66112956810631
0;64;"dyamon";64;0;100
10;1161;"dyamond";1171;0.85397096498719;99.1460290350128
71;1804;"dyan";1875;3.78666666666667;96.2133333333333
0;1800;"dyana";1800;0;100
0;75;"dyanara";75;0;100
0;30;"dyandra";30;0;100
0;387;"dyane";387;0;100
10;1086;"dyani";1096;0.912408759124087;99.0875912408759
0;5;"dyanira";5;0;100
0;994;"dyann";994;0;100
0;1601;"dyanna";1601;0;100
0;991;"dyanne";991;0;100
0;24;"dyanni";24;0;100
15;0;"dyante";15;100;0
0;172;"dyasia";172;0;100
19;0;"dyce";19;100;0
8;0;"dycen";8;100;0
6;0;"dyego";6;100;0
0;26;"dyeisha";26;0;100
0;50;"dyemond";50;0;100
79;0;"dyer";79;100;0
0;104;"dyesha";104;0;100
8;0;"dyian";8;100;0
0;5;"dyisha";5;0;100
250;0;"dyke";250;100;0
0;5;"dykeria";5;0;100
12;0;"dylahn";12;100;0
15;0;"dylam";15;100;0
351788;10982;"dylan";362770;96.9727375472062;3.02726245279378
0;241;"dylana";241;0;100
699;0;"dyland";699;100;0
0;5;"dylane";5;0;100
0;21;"dylaney";21;0;100
26;0;"dylanger";26;100;0
0;82;"dylanie";82;0;100
5;0;"dylanjacob";5;100;0
27;0;"dylanjames";27;100;0
10;0;"dylanmichael";10;100;0
268;649;"dylann";917;29.2257360959651;70.7742639040349
0;27;"dylanne";27;0;100
5;0;"dylanthomas";5;100;0
27;0;"dyle";27;100;0
930;22;"dylen";952;97.6890756302521;2.3109243697479
5;0;"dylenn";5;100;0
7;0;"dylhan";7;100;0
10;0;"dylian";10;100;0
0;33;"dylilah";33;0;100
592;122;"dylin";714;82.9131652661064;17.0868347338936
3097;422;"dyllan";3519;88.0079568059108;11.9920431940892
180;0;"dyllen";180;100;0
5;0;"dyllian";5;100;0
146;0;"dyllin";146;100;0
1226;0;"dyllon";1226;100;0
6;0;"dyllyn";6;100;0
4314;0;"dylon";4314;100;0
90;25;"dylyn";115;78.2608695652174;21.7391304347826
0;105;"dylynn";105;0;100
0;16;"dyman";16;0;100
50;0;"dymere";50;100;0
0;73;"dymin";73;0;100
104;0;"dymir";104;100;0
22;369;"dymon";391;5.62659846547315;94.3734015345269
76;1806;"dymond";1882;4.03825717321998;95.96174282678
0;38;"dymone";38;0;100
0;25;"dymonique";25;0;100
0;93;"dymphna";93;0;100
0;40;"dymple";40;0;100
0;219;"dyna";219;0;100
0;41;"dynah";41;0;100
0;5;"dynalee";5;0;100
0;5;"dynasha";5;0;100
0;190;"dynasia";190;0;100
0;95;"dynastee";95;0;100
0;367;"dynasti";367;0;100
0;66;"dynastie";66;0;100
0;2011;"dynasty";2011;0;100
0;70;"dyneisha";70;0;100
58;6;"dynell";64;90.625;9.375
0;6;"dynelle";6;0;100
0;257;"dynesha";257;0;100
0;75;"dyneshia";75;0;100
0;5;"dynesti";5;0;100
0;37;"dynesty";37;0;100
0;22;"dynetta";22;0;100
0;40;"dynette";40;0;100
0;180;"dynisha";180;0;100
0;40;"dynisty";40;0;100
0;5;"dynita";5;0;100
0;62;"dynver";62;0;100
174;5;"dyon";179;97.2067039106145;2.79329608938547
0;10;"dyona";10;0;100
5;0;"dyondre";5;100;0
0;7;"dyoni";7;0;100
0;134;"dyonna";134;0;100
0;26;"dyonne";26;0;100
5;0;"dyontae";5;100;0
30;0;"dyonte";30;100;0
186;0;"dyquan";186;100;0
18;0;"dyral";18;100;0
15;0;"dyran";15;100;0
171;0;"dyrell";171;100;0
10;0;"dyrk";10;100;0
533;0;"dyron";533;100;0
5;0;"dysan";5;100;0
5;0;"dysean";5;100;0
83;0;"dysen";83;100;0
0;6;"dysha";6;0;100
68;0;"dyshaun";68;100;0
287;0;"dyshawn";287;100;0
0;6;"dysheka";6;0;100
102;0;"dyshon";102;100;0
1287;5;"dyson";1292;99.6130030959752;0.386996904024768
0;15;"dystanie";15;0;100
0;94;"dystany";94;0;100
0;17;"dystinee";17;0;100
0;5;"dystini";5;0;100
0;59;"dystiny";59;0;100
0;26;"dyuthi";26;0;100
0;5;"dyuti";5;0;100
5;0;"dyvion";5;100;0
40;0;"dyvon";40;100;0
0;5;"dyvonne";5;0;100
25;0;"dywan";25;100;0
0;12;"dywana";12;0;100
261;0;"dywane";261;100;0
0;6;"dywanna";6;0;100
37;0;"dywayne";37;100;0
0;23;"dzaria";23;0;100
0;5;"dzejla";5;0;100
19;0;"dzenan";19;100;0
0;5;"dzeneta";5;0;100
0;5;"dzenita";5;0;100
0;5;"dziah";5;0;100
6;0;"dzion";6;100;0
0;17;"dzire";17;0;100
0;41;"dziyah";41;0;100
10;0;"dzung";10;100;0
6;0;"dzuy";6;100;0
0;5;"dzya";5;0;100
0;55;"dzyre";55;0;100
0;11;"ea";11;0;100
0;21;"eabha";21;0;100
94;51;"eaden";145;64.8275862068965;35.1724137931034
0;28;"eadie";28;0;100
6;0;"eadon";6;100;0
11;0;"eadric";11;100;0
0;5;"eadyn";5;0;100
5;0;"eaen";5;100;0
279;0;"eagan";279;100;0
64;0;"eagle";64;100;0
76;0;"eain";76;100;0
5;0;"ealon";5;100;0
0;12;"ealyn";12;0;100
67;0;"eames";67;100;0
11;0;"eammon";11;100;0
3569;0;"eamon";3569;100;0
1105;0;"eamonn";1105;100;0
5255;0;"ean";5255;100;0
90;0;"eann";90;100;0
0;41;"eanna";41;0;100
0;83;"eara";83;0;100
0;5;"eardie";5;0;100
11;0;"earic";11;100;0
0;37;"earica";37;0;100
0;45;"earie";45;0;100
5;0;"earin";5;100;0
275258;2143;"earl";277401;99.2274721432151;0.772527856784943
0;742;"earla";742;0;100
86;0;"earland";86;100;0
0;36;"earldean";36;0;100
0;5;"earldene";5;0;100
0;57;"earldine";57;0;100
10690;257;"earle";10947;97.6523248378551;2.34767516214488
0;2585;"earlean";2585;0;100
0;20;"earleane";20;0;100
44;134;"earlee";178;24.7191011235955;75.2808988764045
0;1480;"earleen";1480;0;100
0;5;"earleene";5;0;100
0;36;"earlen";36;0;100
0;178;"earlena";178;0;100
5;14165;"earlene";14170;0.0352858151023289;99.9647141848977
0;5;"earlesha";5;0;100
0;11;"earletta";11;0;100
0;7;"earlette";7;0;100
529;0;"earley";529;100;0
2213;1275;"earlie";3488;63.4461009174312;36.5538990825688
83;0;"earlin";83;100;0
0;11;"earlina";11;0;100
59;16456;"earline";16515;0.357250983953981;99.642749016046
10;0;"earling";10;100;0
55;0;"earlis";55;100;0
0;5;"earlisa";5;0;100
0;98;"earlisha";98;0;100
18;0;"earlon";18;100;0
3588;362;"early";3950;90.8354430379747;9.16455696202532
0;85;"earlyn";85;0;100
0;300;"earlyne";300;0;100
0;10;"earlynn";10;0;100
0;601;"earma";601;0;100
5;0;"earman";5;100;0
5;0;"earmel";5;100;0
0;20;"earmer";20;0;100
0;10;"earmie";10;0;100
138;0;"earmon";138;100;0
5;0;"earn";5;100;0
0;21;"earna";21;0;100
0;6;"earnease";6;0;100
17;5;"earnell";22;77.2727272727273;22.7272727272727
55709;721;"earnest";56430;98.722310827574;1.27768917242601
0;5;"earnestean";5;0;100
0;396;"earnesteen";396;0;100
0;127;"earnestene";127;0;100
61;16028;"earnestine";16089;0.379141028031574;99.6208589719684
49;0;"earney";49;100;0
0;17;"earnice";17;0;100
1179;326;"earnie";1505;78.3388704318937;21.6611295681063
0;6;"earnistine";6;0;100
25;0;"earnst";25;100;0
0;153;"earnstine";153;0;100
167;5;"earon";172;97.0930232558139;2.90697674418605
11;0;"earron";11;100;0
145;13;"earsel";158;91.7721518987342;8.22784810126582
0;5;"earsell";5;0;100
5;163;"earsie";168;2.97619047619048;97.0238095238095
12;0;"earskin";12;100;0
0;5;"earsley";5;0;100
0;11;"earstine";11;0;100
0;18;"earth";18;0;100
32;2914;"eartha";2946;1.08621860149355;98.9137813985064
0;11;"earthalee";11;0;100
0;5;"earthel";5;0;100
0;39;"earther";39;0;100
5;0;"earthy";5;100;0
5;0;"earven";5;100;0
5;0;"earvie";5;100;0
1193;0;"earvin";1193;100;0
0;5;"eary";5;0;100
0;10;"easha";10;0;100
5;0;"eashaan";5;100;0
186;0;"eashan";186;100;0
18;0;"easley";18;100;0
1427;0;"eason";1427;100;0
38;0;"eastan";38;100;0
369;0;"easten";369;100;0
66;5059;"easter";5125;1.28780487804878;98.7121951219512
0;42;"easther";42;0;100
356;10;"eastin";366;97.2677595628415;2.73224043715847
0;8;"eastlyn";8;0;100
0;5;"eastlynn";5;0;100
12;0;"eastman";12;100;0
39845;630;"easton";40475;98.4434836318715;1.55651636812847
511;350;"eastyn";861;59.349593495935;40.650406504065
0;26;"eastynn";26;0;100
1120;0;"eathan";1120;100;0
21;683;"eathel";704;2.98295454545455;97.0170454545455
351;0;"eathen";351;100;0
6;527;"eather";533;1.12570356472795;98.874296435272
23;0;"eathin";23;100;0
76;0;"eathon";76;100;0
23;0;"eathyn";23;100;0
88;0;"eaton";88;100;0
0;5;"eava";5;0;100
6;155;"eavan";161;3.72670807453416;96.2732919254658
98;0;"eaven";98;100;0
0;6;"eavie";6;0;100
5;0;"eb";5;100;0
5;0;"ebaad";5;100;0
236;0;"eban";236;100;0
0;11;"ebanie";11;0;100
0;122;"ebany";122;0;100
5;0;"ebaristo";5;100;0
12;0;"ebay";12;100;0
188;0;"ebb";188;100;0
5;584;"ebba";589;0.848896434634975;99.151103565365
5;0;"ebbe";5;100;0
5;0;"ebben";5;100;0
300;308;"ebbie";608;49.3421052631579;50.6578947368421
5;0;"ebbin";5;100;0
0;18;"ebbony";18;0;100
5;22;"ebby";27;18.5185185185185;81.4814814814815
0;5;"ebe";5;0;100
0;38;"ebecca";38;0;100
0;53;"ebelia";53;0;100
0;364;"ebelin";364;0;100
0;11;"ebelina";11;0;100
0;89;"ebelyn";89;0;100
3100;6;"eben";3106;99.8068254990341;0.193174500965873
788;22;"ebenezer";810;97.2839506172839;2.71604938271605
1094;0;"eber";1094;100;0
430;0;"eberardo";430;100;0
0;6;"ebere";6;0;100
6;0;"eberhard";6;100;0
293;0;"ebert";293;100;0
300;0;"ebin";300;100;0
0;5;"ebna";5;0;100
259;0;"ebon";259;100;0
0;1181;"ebone";1181;0;100
0;1662;"ebonee";1662;0;100
0;747;"eboney";747;0;100
5;6471;"eboni";6476;0.0772081531809759;99.922791846819
0;2637;"ebonie";2637;0;100
0;11;"ebonii";11;0;100
0;299;"ebonique";299;0;100
0;41;"ebonne";41;0;100
0;28;"ebonnie";28;0;100
455;38707;"ebony";39162;1.16184055972627;98.8381594402737
0;106;"ebonye";106;0;100
27;0;"ebraheem";27;100;0
393;0;"ebrahim";393;100;0
5;0;"ebrahima";5;100;0
210;0;"ebrima";210;100;0
0;22;"ebru";22;0;100
80;0;"ebubechukwu";80;100;0
0;78;"ebunoluwa";78;0;100
5;0;"ebward";5;100;0
0;10;"ecaterina";10;0;100
0;68;"ece";68;0;100
5;0;"ecequiel";5;100;0
0;20;"echelle";20;0;100
104;3787;"echo";3891;2.67283474685171;97.3271652531483
0;16;"echoe";16;0;100
5;0;"echol";5;100;0
25;0;"ecker";25;100;0
11;94;"ecko";105;10.4761904761905;89.5238095238095
0;33;"ecrin";33;0;100
0;10;"ecstasy";10;0;100
770;0;"ector";770;100;0
20855;155;"ed";21010;99.2622560685388;0.737743931461209
0;3343;"eda";3343;0;100
72;0;"edahi";72;100;0
0;5;"edalia";5;0;100
0;6;"edaline";6;0;100
0;8;"edalyn";8;0;100
1150;163;"edan";1313;87.5856816450876;12.4143183549124
0;224;"edana";224;0;100
5;0;"edawrd";5;100;0
6;0;"edberg";6;100;0
31;0;"edbert";31;100;0
4386;13;"edd";4399;99.7044782905206;0.295521709479427
0;630;"edda";630;0;100
38;6;"edden";44;86.3636363636364;13.6363636363636
304;0;"edder";304;100;0
119;6;"eddi";125;95.2;4.8
0;5;"eddica";5;0;100
205189;15015;"eddie";220204;93.1813227734283;6.81867722657173
43;0;"eddieberto";43;100;0
29;0;"eddiel";29;100;0
6;0;"eddin";6;100;0
16;117;"eddis";133;12.0300751879699;87.9699248120301
311;5;"eddison";316;98.4177215189873;1.58227848101266
0;146;"eddith";146;0;100
321;0;"eddrick";321;100;0
13;0;"eddward";13;100;0
13017;326;"eddy";13343;97.5567713407779;2.44322865922206
6;294;"eddye";300;2;98
5;0;"eddyson";5;100;0
0;5;"eddythe";5;0;100
0;17;"ede";17;0;100
0;102;"edee";102;0;100
390;47;"edel";437;89.2448512585812;10.7551487414188
0;50;"edelia";50;0;100
0;73;"edelin";73;0;100
0;15;"edelina";15;0;100
0;159;"edeline";159;0;100
45;249;"edell";294;15.3061224489796;84.6938775510204
0;35;"edelle";35;0;100
0;654;"edelmira";654;0;100
465;0;"edelmiro";465;100;0
0;14;"edelweiss";14;0;100
0;269;"edelyn";269;0;100
0;38;"edelynn";38;0;100
68;0;"edem";68;100;0
5231;30183;"eden";35414;14.7709945219405;85.2290054780595
0;44;"edena";44;0;100
0;5;"edengrace";5;0;100
122;0;"edenilson";122;100;0
0;5;"edenrose";5;0;100
2460;0;"eder";2460;100;0
5;0;"ederick";5;100;0
40;0;"ederson";40;100;0
0;53;"edessa";53;0;100
17;0;"edford";17;100;0
144174;690;"edgar";144864;99.523691186216;0.476308813783963
1316;0;"edgard";1316;100;0
5668;0;"edgardo";5668;100;0
5;0;"edgareduardo";5;100;0
5;0;"edgbert";5;100;0
58;0;"edge";58;100;0
121;0;"edgel";121;100;0
420;0;"edger";420;100;0
6;0;"edgerin";6;100;0
65;0;"edgerrin";65;100;0
6;0;"edguin";6;100;0
32;0;"edher";32;100;0
324;24;"edi";348;93.1034482758621;6.89655172413793
0;73;"edia";73;0;100
336;0;"ediberto";336;100;0
0;5;"edica";5;0;100
0;5;"edice";5;0;100
0;24;"edid";24;0;100
70;4575;"edie";4645;1.50699677072121;98.4930032292788
274;0;"ediel";274;100;0
5;0;"edier";5;100;0
0;11;"edieth";11;0;100
0;5;"edika";5;0;100
26;5;"edil";31;83.8709677419355;16.1290322580645
732;0;"edilberto";732;100;0
0;124;"edilia";124;0;100
121;0;"edilson";121;100;0
951;59;"edin";1010;94.1584158415842;5.84158415841584
0;475;"edina";475;0;100
143;0;"edinson";143;100;0
5;0;"edir";5;100;0
117;41;"edis";158;74.0506329113924;25.9493670886076
0;11;"edisa";11;0;100
0;5;"edisha";5;0;100
8842;86;"edison";8928;99.0367383512545;0.96326164874552
38;0;"edisson";38;100;0
0;178;"edit";178;0;100
0;77;"edita";77;0;100
713;236727;"edith";237440;0.300286388140162;99.6997136118598
0;284;"editha";284;0;100
0;257;"edithe";257;0;100
0;10;"edithmae";10;0;100
22;0;"ediz";22;100;0
20;0;"edjuan";20;100;0
109;0;"edker";109;100;0
0;242;"edla";242;0;100
38;0;"edley";38;100;0
14;284;"edlin";298;4.69798657718121;95.3020134228188
7;0;"edlow";7;100;0
0;426;"edlyn";426;0;100
0;11;"edlynn";11;0;100
0;6;"edma";6;0;100
0;22;"edmae";22;0;100
164;0;"edman";164;100;0
17;0;"edmanuel";17;100;0
149;0;"edmar";149;100;0
0;5;"edmay";5;0;100
0;47;"edmee";47;0;100
0;5;"edmere";5;0;100
6;0;"edmilson";6;100;0
1148;0;"edmon";1148;100;0
0;5;"edmona";5;0;100
23373;7;"edmond";23380;99.9700598802395;0.029940119760479
5;0;"edmondo";5;100;0
0;732;"edmonia";732;0;100
5;0;"edmont";5;100;0
5;0;"edmound";5;100;0
48983;60;"edmund";49043;99.8776583814204;0.122341618579614
3169;0;"edmundo";3169;100;0
920;259048;"edna";259968;0.353889709502708;99.6461102904973
0;30;"ednah";30;0;100
0;336;"ednamae";336;0;100
0;11;"ednamay";11;0;100
0;12;"ednar";12;0;100
7;33;"edner";40;17.5;82.5
0;6;"ednesha";6;0;100
5;0;"edney";5;100;0
0;31;"ednita";31;0;100
36;0;"edo";36;100;0
187;0;"edoardo";187;100;0
0;20;"edolia";20;0;100
0;57;"edom";57;0;100
176;0;"edon";176;100;0
0;80;"edona";80;0;100
5;0;"edonis";5;100;0
0;5;"edony";5;0;100
0;6;"edora";6;0;100
583;0;"edouard";583;100;0
0;1431;"edra";1431;0;100
60;0;"edras";60;100;0
65;0;"edrees";65;100;0
78;0;"edrei";78;100;0
0;51;"edrena";51;0;100
13;0;"edrey";13;100;0
0;15;"edria";15;0;100
215;0;"edrian";215;100;0
0;36;"edriana";36;0;100
0;6;"edrianna";6;0;100
1138;0;"edric";1138;100;0
0;11;"edrica";11;0;100
1392;0;"edrick";1392;100;0
0;11;"edricka";11;0;100
0;745;"edrie";745;0;100
31;0;"edriel";31;100;0
59;0;"edrik";59;100;0
23;0;"edrin";23;100;0
0;42;"edrina";42;0;100
232;704;"edris";936;24.7863247863248;75.2136752136752
11;0;"edro";11;100;0
5;0;"edroy";5;100;0
3892;0;"edsel";3892;100;0
23;0;"edsell";23;100;0
25;0;"edsil";25;100;0
8;0;"edsol";8;100;0
3721;0;"edson";3721;100;0
5;0;"edsson";5;100;0
67;0;"edu";67;100;0
5;0;"eduan";5;100;0
143;0;"eduar";143;100;0
1575;0;"eduard";1575;100;0
0;156;"eduarda";156;0;100
101261;433;"eduardo";101694;99.5742128345822;0.425787165417822
9;0;"eduardoluis";9;100;0
154;0;"eduin";154;100;0
6;0;"edurdo";6;100;0
0;5;"eduvigen";5;0;100
0;11;"eduviges";11;0;100
0;5;"eduvijes";5;0;100
0;19;"eduvina";19;0;100
5;0;"edvard";5;100;0
310;0;"edvardo";310;100;0
798;0;"edvin";798;100;0
0;5;"edwa";5;0;100
11;0;"edwad";11;100;0
0;12;"edwana";12;0;100
243;0;"edwar";243;100;0
1241257;5193;"edward";1246450;99.5833767900838;0.416623209916162
0;40;"edwarda";40;0;100
5;0;"edwardd";5;100;0
0;88;"edwardine";88;0;100
6;0;"edwardjames";6;100;0
6671;0;"edwardo";6671;100;0
403;0;"edwards";403;100;0
0;5;"edweina";5;0;100
5;0;"edwell";5;100;0
80;0;"edwen";80;100;0
0;301;"edwena";301;0;100
5;6;"edwidge";11;45.4545454545455;54.5454545454545
6;0;"edwill";6;100;0
232695;1175;"edwin";233870;99.4975841279343;0.502415872065678
0;15148;"edwina";15148;0;100
5;0;"edwind";5;100;0
157;0;"edwing";157;100;0
11;0;"edwinn";11;100;0
0;362;"edwinna";362;0;100
5;0;"edwon";5;100;0
5;0;"edwood";5;100;0
82;0;"edword";82;100;0
15;0;"edwrd";15;100;0
18;0;"edwuin";18;100;0
599;0;"edwyn";599;100;0
0;152;"edwyna";152;0;100
18;0;"edwynn";18;100;0
520;180;"edy";700;74.2857142857143;25.7142857142857
0;5;"edyce";5;0;100
0;173;"edye";173;0;100
79;749;"edyn";828;9.54106280193237;90.4589371980676
0;92;"edynn";92;0;100
39;0;"edyson";39;100;0
0;10;"edyta";10;0;100
0;1945;"edyth";1945;0;100
0;25;"edytha";25;0;100
0;12654;"edythe";12654;0;100
5;0;"edzel";5;100;0
5;0;"edzon";5;100;0
68;0;"eean";68;100;0
12;0;"eelijah";12;100;0
5;0;"eelis";5;100;0
0;5;"eeliyah";5;0;100
0;6;"eelyn";6;0;100
0;6;"eeman";6;0;100
0;13;"eera";13;0;100
188;0;"eero";188;100;0
300;0;"eesa";300;100;0
0;718;"eesha";718;0;100
133;0;"eeshan";133;100;0
0;107;"eeva";107;0;100
0;103;"eevee";103;0;100
0;28;"eevie";28;0;100
5;0;"eeyan";5;100;0
246;0;"efe";246;100;0
0;126;"effa";126;0;100
176;30757;"effie";30933;0.568971648401384;99.4310283515986
25;0;"efford";25;100;0
24;0;"effrem";24;100;0
5;0;"effren";5;100;0
57;0;"effrey";57;100;0
0;37;"effy";37;0;100
0;20;"efia";20;0;100
0;10;"efigenia";10;0;100
54;0;"efosa";54;100;0
1365;0;"efraim";1365;100;0
17223;29;"efrain";17252;99.8319035474148;0.168096452585208
41;0;"efram";41;100;0
33;0;"efran";33;100;0
0;53;"efrat";53;0;100
0;88;"efrata";88;0;100
33;0;"efrayim";33;100;0
1538;0;"efrem";1538;100;0
7524;0;"efren";7524;100;0
5;0;"efrian";5;100;0
38;0;"efrin";38;100;0
0;6;"efrosini";6;0;100
0;23;"efstathia";23;0;100
47;0;"efstathios";47;100;0
12;0;"efstratios";12;100;0
0;35;"efthimia";35;0;100
21;0;"efthimios";21;100;0
0;5;"efthymia";5;0;100
0;12;"eftihia";12;0;100
74;0;"efton";74;100;0
0;11;"efua";11;0;100
934;49;"egan";983;95.0152594099695;4.98474059003052
1082;0;"egbert";1082;100;0
126;0;"ege";126;100;0
28;0;"eghosa";28;100;0
164;0;"egidio";164;100;0
0;5;"egina";5;0;100
0;6;"egla";6;0;100
114;0;"egon";114;100;0
70;0;"egor";70;100;0
271;2442;"egypt";2713;9.98894213048286;90.0110578695171
16;0;"egzon";16;100;0
251;182;"eh";433;57.9676674364896;42.0323325635104
31;0;"ehaan";31;100;0
397;0;"ehab";397;100;0
233;0;"ehan";233;100;0
5;0;"ehitan";5;100;0
0;51;"ehlana";51;0;100
0;5;"ehlena";5;0;100
5;0;"ehlijah";5;100;0
1123;17;"ehren";1140;98.5087719298246;1.49122807017544
22;33;"ehrin";55;40;60
13;0;"ehron";13;100;0
341;0;"ehsan";341;100;0
142;0;"ehtan";142;100;0
5;0;"ehud";5;100;0
5;0;"ehvan";5;100;0
11;0;"eiad";11;100;0
1726;0;"eian";1726;100;0
0;17;"eibhleann";17;0;100
0;51;"eibhlin";51;0;100
6;0;"eichael";6;100;0
8;0;"eichi";8;100;0
10;0;"eid";10;100;0
233;0;"eidan";233;100;0
0;5;"eidel";5;0;100
410;0;"eiden";410;100;0
0;7;"eider";7;0;100
0;6;"eidy";6;0;100
11;0;"eiichi";11;100;0
5;0;"eijah";5;100;0
43;0;"eiji";43;100;0
21;0;"eiker";21;100;0
0;188;"eiko";188;0;100
0;842;"eila";842;0;100
0;45;"eilah";45;0;100
54;0;"eilam";54;100;0
58;0;"eilan";58;100;0
0;6;"eilani";6;0;100
0;5;"eilany";5;0;100
0;24;"eilean";24;0;100
0;136;"eilee";136;0;100
407;185092;"eileen";185499;0.219408190879735;99.7805918091203
0;36;"eileena";36;0;100
0;548;"eileene";548;0;100
0;10;"eileigh";10;0;100
0;10;"eilen";10;0;100
0;2042;"eilene";2042;0;100
5;0;"eiler";5;100;0
26;0;"eilert";26;100;0
0;255;"eiley";255;0;100
0;49;"eiliana";49;0;100
0;146;"eilidh";146;0;100
5;0;"eilijah";5;100;0
0;6;"eilin";6;0;100
0;170;"eilis";170;0;100
0;5;"eilise";5;0;100
0;258;"eilish";258;0;100
0;169;"eiliyah";169;0;100
16;0;"eiljah";16;100;0
0;497;"eilleen";497;0;100
0;28;"eillen";28;0;100
0;57;"eilley";57;0;100
0;5;"eillie";5;0;100
5;0;"eilon";5;100;0
0;15;"eilonwy";15;0;100
0;267;"eily";267;0;100
0;130;"eilyn";130;0;100
0;6;"eilynn";6;0;100
0;30;"eilzabeth";30;0;100
0;25;"eimaan";25;0;100
6;0;"eimaj";6;100;0
0;91;"eiman";91;0;100
0;5;"eimear";5;0;100
0;108;"eimi";108;0;100
0;28;"eimile";28;0;100
0;5;"eimly";5;0;100
0;22;"eimmy";22;0;100
0;450;"eimy";450;0;100
217;0;"ein";217;100;0
0;7;"eina";7;0;100
1265;0;"einar";1265;100;0
5;0;"einard";5;100;0
0;5;"einav";5;0;100
154;0;"einer";154;100;0
0;6;"einin";6;0;100
814;0;"eino";814;100;0
5;0;"einstein";5;100;0
451;0;"eion";451;100;0
0;243;"eira";243;0;100
17;0;"eirc";17;100;0
0;18;"eire";18;0;100
0;33;"eireann";33;0;100
0;5;"eireen";5;0;100
7;0;"eiren";7;100;0
0;134;"eirene";134;0;100
0;5;"eirian";5;0;100
263;0;"eirik";263;100;0
0;28;"eirini";28;0;100
0;19;"eirinn";19;0;100
5;0;"eirnin";5;100;0
185;66;"eisa";251;73.7051792828685;26.2948207171315
0;19;"eisele";19;0;100
115;0;"eisen";115;100;0
5;0;"eisenhower";5;100;0
0;266;"eisha";266;0;100
0;29;"eislee";29;0;100
0;13;"eisleigh";13;0;100
15;1187;"eisley";1202;1.24792013311148;98.7520798668885
30;0;"eissa";30;100;0
44;0;"eita";44;100;0
1596;0;"eitan";1596;100;0
19;0;"eitel";19;100;0
11;0;"eith";11;100;0
914;0;"eithan";914;100;0
0;165;"eithel";165;0;100
157;0;"eithen";157;100;0
0;5;"eithne";5;0;100
11;0;"eithyn";11;100;0
32;0;"eito";32;100;0
0;5;"eiva";5;0;100
57;0;"eivan";57;100;0
23;0;"eiven";23;100;0
195;0;"eivin";195;100;0
0;5;"eiyanna";5;0;100
0;615;"eiza";615;0;100
0;11;"eizabella";11;0;100
0;44;"eizabeth";44;0;100
12;0;"eizan";12;100;0
0;10;"eizley";10;0;100
214;0;"ej";214;100;0
0;45;"eja";45;0;100
116;0;"ejay";116;100;0
15;0;"ejaz";15;100;0
6;0;"ekaansh";6;100;0
209;119;"ekam";328;63.719512195122;36.280487804878
5;0;"ekambir";5;100;0
5;0;"ekamjeet";5;100;0
5;0;"ekamjit";5;100;0
38;11;"ekamjot";49;77.5510204081633;22.4489795918367
28;0;"ekamveer";28;100;0
70;0;"ekansh";70;100;0
0;803;"ekaterina";803;0;100
0;197;"ekaterini";197;0;100
0;8;"ekco";8;0;100
19;16;"ekene";35;54.2857142857143;45.7142857142857
23;0;"eker";23;100;0
139;6;"ekin";145;95.8620689655172;4.13793103448276
0;17;"ekko";17;0;100
11;91;"eknoor";102;10.7843137254902;89.2156862745098
5;0;"eko";5;100;0
5;0;"ekow";5;100;0
0;37;"ekram";37;0;100
29;0;"ekrem";29;100;0
0;112;"ekta";112;0;100
241;38;"el";279;86.3799283154122;13.6200716845878
0;1673;"ela";1673;0;100
5;5;"elaan";10;50;50
216;0;"elad";216;100;0
0;94;"eladia";94;0;100
1679;0;"eladio";1679;100;0
0;45;"elaena";45;0;100
0;56;"elaf";56;0;100
0;218;"elah";218;0;100
0;5;"elaheh";5;0;100
0;5;"elahna";5;0;100
0;11;"elahni";11;0;100
125;0;"elai";125;100;0
0;20;"elaia";20;0;100
0;5;"elaida";5;0;100
5;136;"elaijah";141;3.54609929078014;96.4539007092199
0;240;"elain";240;0;100
0;21455;"elaina";21455;0;100
0;120;"elainah";120;0;100
654;256470;"elaine";257124;0.254351985812293;99.7456480141877
0;32;"elainea";32;0;100
0;36;"elainey";36;0;100
0;28;"elaini";28;0;100
0;34;"elainie";34;0;100
0;200;"elainna";200;0;100
0;20;"elainy";20;0;100
0;6;"elaisa";6;0;100
0;6;"elaise";6;0;100
0;90;"elaisha";90;0;100
0;5;"elaiya";5;0;100
0;87;"elaiza";87;0;100
0;147;"elajah";147;0;100
6;0;"elajuwon";6;100;0
2095;0;"elam";2095;100;0
2746;713;"elan";3459;79.3871061000289;20.6128938999711
0;7871;"elana";7871;0;100
0;82;"elanah";82;0;100
62;0;"eland";62;100;0
0;276;"elanda";276;0;100
0;5;"elander";5;0;100
0;66;"elandra";66;0;100
0;795;"elane";795;0;100
0;24;"elaney";24;0;100
0;845;"elani";845;0;100
0;124;"elania";124;0;100
0;424;"elanie";424;0;100
0;438;"elanna";438;0;100
0;11;"elannah";11;0;100
0;12;"elanni";12;0;100
0;5;"elannie";5;0;100
0;5;"elanny";5;0;100
0;1113;"elanor";1113;0;100
0;83;"elanora";83;0;100
0;117;"elanore";117;0;100
35;0;"elante";35;100;0
0;123;"elantra";123;0;100
0;5;"elanur";5;0;100
0;143;"elany";143;0;100
0;224;"elara";224;0;100
0;108;"elaria";108;0;100
15;0;"elario";15;100;0
0;62;"elasha";62;0;100
0;149;"elasia";149;0;100
0;5;"elauna";5;0;100
0;80;"elaura";80;0;100
22;0;"elay";22;100;0
0;110;"elaya";110;0;100
0;148;"elayah";148;0;100
0;5;"elayiah";5;0;100
0;92;"elayjah";92;0;100
0;5;"elayla";5;0;100
0;3595;"elayna";3595;0;100
0;73;"elaynah";73;0;100
0;3834;"elayne";3834;0;100
0;156;"elaysha";156;0;100
0;11;"elayshia";11;0;100
0;256;"elaysia";256;0;100
422;0;"elazar";422;100;0
0;5;"elazia";5;0;100
308;3228;"elba";3536;8.710407239819;91.289592760181
107;0;"elber";107;100;0
15;0;"elbern";15;100;0
31608;97;"elbert";31705;99.6940545655259;0.305945434474058
0;1689;"elberta";1689;0;100
0;17;"elbertha";17;0;100
0;63;"elbia";63;0;100
81;5;"elbie";86;94.1860465116279;5.81395348837209
53;0;"elbin";53;100;0
0;18;"elbira";18;0;100
5;0;"elbis";5;100;0
0;5;"elbonie";5;0;100
0;189;"elbony";189;0;100
618;0;"elbridge";618;100;0
40;0;"elburn";40;100;0
250;0;"elby";250;100;0
51;0;"elchanan";51;100;0
230;0;"elchonon";230;100;0
5;0;"elcid";5;100;0
0;294;"elcie";294;0;100
17;0;"elco";17;100;0
0;5;"elcy";5;0;100
42;8309;"elda";8351;0.502933780385583;99.4970662196144
10;0;"eldad";10;100;0
0;5;"eldamae";5;0;100
8;0;"eldan";8;100;0
0;284;"eldana";284;0;100
132;0;"eldar";132;100;0
143;223;"eldean";366;39.0710382513661;60.9289617486339
6;5;"eldee";11;54.5454545454545;45.4545454545455
0;39;"eldeen";39;0;100
5505;11;"elden";5516;99.8005801305294;0.199419869470631
0;145;"eldena";145;0;100
0;129;"eldene";129;0;100
1783;52;"elder";1835;97.16621253406;2.83378746594005
0;5;"elderine";5;0;100
31;17;"eldie";48;64.5833333333333;35.4166666666667
577;0;"eldin";577;100;0
0;24;"eldina";24;0;100
0;157;"eldine";157;0;100
5;0;"eldion";5;100;0
424;0;"eldo";424;100;0
25344;55;"eldon";25399;99.7834560415764;0.21654395842356
0;46;"eldona";46;0;100
0;263;"eldonna";263;0;100
367;0;"eldor";367;100;0
0;3837;"eldora";3837;0;100
0;119;"eldoris";119;0;100
47;26;"eldra";73;64.3835616438356;35.6164383561644
3689;294;"eldred";3983;92.6186291739894;7.38137082601054
192;0;"eldredge";192;100;0
6;0;"eldren";6;100;0
29;0;"eldric";29;100;0
5;0;"eldrich";5;100;0
377;0;"eldrick";377;100;0
23;5;"eldrid";28;82.1428571428571;17.8571428571429
4970;0;"eldridge";4970;100;0
132;0;"eldrige";132;100;0
15;0;"eldrin";15;100;0
70;0;"eldwin";70;100;0
0;5;"ele";5;0;100
0;182;"elea";182;0;100
0;216;"eleah";216;0;100
25;55;"elean";80;31.25;68.75
0;1292;"eleana";1292;0;100
0;5;"eleanar";5;0;100
0;5;"eleane";5;0;100
0;154;"eleaner";154;0;100
0;191;"eleanna";191;0;100
601;270233;"eleanor";270834;0.221907146074717;99.7780928539253
0;5553;"eleanora";5553;0;100
0;17296;"eleanore";17296;0;100
0;11;"eleany";11;0;100
0;5;"eleasa";5;0;100
0;5;"eleasah";5;0;100
32;0;"eleasar";32;100;0
0;3030;"elease";3030;0;100
0;77;"eleasha";77;0;100
4612;7;"eleazar";4619;99.8484520458974;0.15154795410262
54;0;"eleazer";54;100;0
6;0;"elec";6;100;0
0;520;"elecia";520;0;100
5;0;"eleck";5;100;0
0;5;"elecktra";5;0;100
0;978;"electa";978;0;100
0;1021;"electra";1021;0;100
0;31;"eleda";31;0;100
0;16;"elee";16;0;100
0;5;"eleecia";5;0;100
0;394;"eleen";394;0;100
0;323;"eleena";323;0;100
0;49;"eleene";49;0;100
0;23;"eleesa";23;0;100
0;7;"eleese";7;0;100
0;66;"eleesha";66;0;100
0;11;"eleesia";11;0;100
0;6;"eleeza";6;0;100
0;10;"elefteria";10;0;100
6;0;"elefterios";6;100;0
0;211;"eleftheria";211;0;100
162;0;"eleftherios";162;100;0
0;5;"eleigh";5;0;100
0;10;"eleigha";10;0;100
0;212;"eleina";212;0;100
0;6;"eleisa";6;0;100
0;10;"eleise";10;0;100
0;162;"eleisha";162;0;100
162;0;"elek";162;100;0
0;640;"elektra";640;0;100
42;0;"elemer";42;100;0
0;322;"elen";322;0;100
93;69829;"elena";69922;0.133005348817254;99.8669946511828
0;16;"elenah";16;0;100
0;16;"elenamarie";16;0;100
6;0;"elend";6;100;0
0;46;"elender";46;0;100
0;1181;"elene";1181;0;100
0;106;"elener";106;0;100
0;5171;"eleni";5171;0;100
0;7;"elenia";7;0;100
0;94;"elenie";94;0;100
0;6;"elenis";6;0;100
0;34;"elenita";34;0;100
0;180;"elenna";180;0;100
0;17;"elenny";17;0;100
456;0;"eleno";456;100;0
0;16;"elenoa";16;0;100
0;1939;"elenor";1939;0;100
0;2965;"elenora";2965;0;100
0;1564;"elenore";1564;0;100
0;247;"eleny";247;0;100
11;0;"eleodoro";11;100;0
0;485;"eleonor";485;0;100
0;1013;"eleonora";1013;0;100
0;820;"eleonore";820;0;100
0;279;"eleora";279;0;100
0;161;"eleri";161;0;100
318;0;"elery";318;100;0
5;0;"eles";5;100;0
0;211;"elesa";211;0;100
0;511;"elese";511;0;100
0;612;"elesha";612;0;100
0;160;"eleshia";160;0;100
0;323;"elesia";323;0;100
0;7;"elessa";7;0;100
310;12;"elester";322;96.2732919254658;3.72670807453416
0;10;"elestine";10;0;100
6;0;"elet";6;100;0
0;34;"eleta";34;0;100
0;270;"eletha";270;0;100
0;15;"elethia";15;0;100
5;0;"eletise";5;100;0
0;6;"eleuteria";6;0;100
751;0;"eleuterio";751;100;0
694;0;"elex";694;100;0
0;572;"elexa";572;0;100
15;0;"elexander";15;100;0
0;16;"elexas";16;0;100
0;30;"elexcia";30;0;100
0;5;"elexes";5;0;100
0;5;"elexi";5;0;100
0;558;"elexia";558;0;100
0;2763;"elexis";2763;0;100
0;71;"elexius";71;0;100
0;24;"elexsis";24;0;100
0;1265;"elexus";1265;0;100
0;58;"elexys";58;0;100
12;0;"eley";12;100;0
0;11;"eleya";11;0;100
0;17;"eleyah";17;0;100
0;5;"eleyana";5;0;100
0;328;"eleyna";328;0;100
0;21;"elezabeth";21;0;100
0;70;"elfa";70;0;100
5;0;"elfago";5;100;0
93;0;"elfego";93;100;0
0;155;"elfida";155;0;100
0;232;"elfie";232;0;100
104;0;"elford";104;100;0
5;0;"elfred";5;100;0
0;865;"elfreda";865;0;100
0;29;"elfredia";29;0;100
0;63;"elfreida";63;0;100
0;53;"elfrida";53;0;100
0;1252;"elfrieda";1252;0;100
0;291;"elfriede";291;0;100
10;115;"elga";125;8;92
12;0;"elgan";12;100;0
63;0;"elgar";63;100;0
48;70;"elgene";118;40.6779661016949;59.3220338983051
28;0;"elger";28;100;0
11;23;"elgia";34;32.3529411764706;67.6470588235294
792;468;"elgie";1260;62.8571428571429;37.1428571428571
3795;43;"elgin";3838;98.8796248045857;1.12037519541428
0;5;"elgina";5;0;100
142;0;"elhadj";142;100;0
119;0;"elhadji";119;100;0
19;244;"elham";263;7.22433460076046;92.7756653992395
0;5;"elhana";5;0;100
107313;709;"eli";108022;99.3436522189924;0.656347781007573
822;6593;"elia";7415;11.0856372218476;88.9143627781524
432;0;"eliab";432;100;0
0;247;"eliabeth";247;0;100
775;318;"eliah";1093;70.9057639524245;29.0942360475755
0;30;"eliahna";30;0;100
51;0;"eliahs";51;100;0
16;0;"eliahu";16;100;0
52;0;"eliajah";52;100;0
81;0;"eliakim";81;100;0
665;0;"eliam";665;100;0
4810;44;"elian";4854;99.0935311083642;0.906468891635764
27;32087;"eliana";32114;0.0840754810985863;99.9159245189014
0;5;"elianagrace";5;0;100
0;399;"elianah";399;0;100
0;10;"eliandra";10;0;100
0;429;"eliane";429;0;100
0;182;"eliani";182;0;100
0;48;"elianie";48;0;100
0;73;"elianis";73;0;100
0;5259;"elianna";5259;0;100
0;151;"eliannah";151;0;100
0;119;"elianne";119;0;100
0;21;"elianni";21;0;100
0;15;"eliannie";15;0;100
0;315;"elianny";315;0;100
19;0;"eliano";19;100;0
0;288;"eliany";288;0;100
0;67;"elianys";67;0;100
0;5;"eliara";5;0;100
69797;170;"elias";69967;99.7570283133477;0.242971686652279
270;0;"eliasar";270;100;0
5;0;"eliase";5;100;0
5;0;"eliasib";5;100;0
16;0;"eliason";16;100;0
14;0;"eliasz";14;100;0
85;0;"eliav";85;100;0
267;0;"eliaz";267;100;0
1758;0;"eliazar";1758;100;0
0;15;"eliazbeth";15;0;100
85;0;"eliazer";85;100;0
360;0;"eliberto";360;100;0
0;47;"elibeth";47;0;100
5;0;"eliborio";5;100;0
70;0;"elic";70;100;0
0;62;"elica";62;0;100
7;237;"elice";244;2.86885245901639;97.1311475409836
314;0;"eliceo";314;100;0
0;3994;"elicia";3994;0;100
0;5;"eliciana";5;0;100
28;0;"elicio";28;100;0
97;0;"elick";97;100;0
0;7370;"elida";7370;0;100
0;119;"elide";119;0;100
0;6;"elided";6;0;100
0;5;"elidet";5;0;100
0;46;"elideth";46;0;100
0;922;"elidia";922;0;100
10;0;"elidio";10;100;0
2551;278;"elie";2829;90.1732060798869;9.82679392011311
0;5;"elieana";5;0;100
28;0;"eliecer";28;100;0
0;6;"elieen";6;0;100
15;0;"eliejah";15;100;0
2045;0;"eliel";2045;100;0
0;5;"elien";5;0;100
6;224;"elienai";230;2.60869565217391;97.3913043478261
0;58;"eliene";58;0;100
360;0;"elier";360;100;0
0;79;"eliese";79;0;100
237;0;"elieser";237;100;0
0;11;"eliesha";11;0;100
0;131;"eliette";131;0;100
23;0;"eliezar";23;100;0
11;0;"eliezel";11;100;0
6195;0;"eliezer";6195;100;0
0;770;"elif";770;0;100
351;0;"eliga";351;100;0
1634;0;"eligah";1634;100;0
439;0;"elige";439;100;0
5;0;"eliger";5;100;0
831;0;"eligh";831;100;0
349;0;"eligha";349;100;0
17;0;"elight";17;100;0
1465;0;"eligio";1465;100;0
92;0;"elih";92;100;0
1049;0;"elihu";1049;100;0
208;0;"elihue";208;100;0
32;0;"elii";32;100;0
37;0;"eliijah";37;100;0
965;0;"elija";965;100;0
34;0;"elijaah";34;100;0
266316;1069;"elijah";267385;99.6002019559811;0.399798044018924
38;0;"elijaha";38;100;0
10;0;"elijahh";10;100;0
84;0;"elijahjames";84;100;0
11;0;"elijahjohn";11;100;0
27;0;"elijahjuan";27;100;0
6;0;"elijahpaul";6;100;0
10;0;"elijahray";10;100;0
6;0;"elijahwan";6;100;0
18;0;"elijahwon";18;100;0
5;0;"elijames";5;100;0
109;0;"elijan";109;100;0
5;0;"elijawon";5;100;0
5;0;"elijay";5;100;0
699;0;"elijha";699;100;0
5;0;"elijhah";5;100;0
8;0;"elijia";8;100;0
995;0;"elijiah";995;100;0
525;0;"elijio";525;100;0
37;0;"elijsha";37;100;0
45;0;"elijuah";45;100;0
6;0;"elik";6;100;0
0;354;"elika";354;0;100
10;0;"elikai";10;100;0
5;0;"elikem";5;100;0
0;18;"elilah";18;0;100
0;10;"elilta";10;0;100
164;113;"elim";277;59.2057761732852;40.7942238267148
0;7;"elimar";7;0;100
8;0;"elimelec";8;100;0
802;0;"elimelech";802;100;0
104;3873;"elin";3977;2.61503645964295;97.384963540357
0;3536;"elina";3536;0;100
0;15;"elinah";15;0;100
0;8;"elinam";8;0;100
0;5;"elinar";5;0;100
0;273;"elinda";273;0;100
0;227;"eline";227;0;100
0;10;"eliner";10;0;100
0;5;"elinn";5;0;100
0;19796;"elinor";19796;0;100
0;252;"elinora";252;0;100
0;2201;"elinore";2201;0;100
2230;0;"elio";2230;100;0
232;0;"eliodoro";232;100;0
32;0;"elioenai";32;100;0
64;0;"elion";64;100;0
0;30;"eliona";30;0;100
11;0;"elionaid";11;100;0
0;11;"elionna";11;0;100
49;0;"elior";49;100;0
0;542;"eliora";542;0;100
0;5;"eliorah";5;0;100
0;5;"eliose";5;0;100
6513;396;"eliot";6909;94.2683456361268;5.73165436387321
5;0;"elioth";5;100;0
1452;0;"eliott";1452;100;0
0;31;"eliotte";31;0;100
0;42;"elira";42;0;100
34;0;"eliran";34;100;0
160;170;"elis";330;48.4848484848485;51.5151515151515
137;41157;"elisa";41294;0.331767326972442;99.6682326730276
0;112;"elisabel";112;0;100
0;68;"elisabella";68;0;100
0;1374;"elisabet";1374;0;100
0;5;"elisabeta";5;0;100
27;44538;"elisabeth";44565;0.0605856613934702;99.9394143386065
0;5;"elisabethe";5;0;100
0;251;"elisabetta";251;0;100
102;37;"elisah";139;73.3812949640288;26.6187050359712
0;61;"elisama";61;0;100
0;171;"elisandra";171;0;100
302;0;"elisandro";302;100;0
23;0;"elisaul";23;100;0
0;51;"elisavet";51;0;100
0;5;"elisbeth";5;0;100
0;17;"eliscia";17;0;100
61;61937;"elise";61998;0.0983902706538921;99.9016097293461
0;193;"elisea";193;0;100
0;46;"elisebeth";46;0;100
19;0;"elisee";19;100;0
5;0;"elisei";5;100;0
8822;0;"eliseo";8822;100;0
0;18;"eliset";18;0;100
36;0;"elisey";36;100;0
10;0;"elish";10;100;0
12451;13459;"elisha";25910;48.0548050945581;51.9451949054419
214;27;"elishah";241;88.7966804979253;11.2033195020747
0;10;"elishea";10;0;100
0;155;"elisheba";155;0;100
0;1797;"elisheva";1797;0;100
0;587;"elishia";587;0;100
0;10;"elishka";10;0;100
78;0;"elishua";78;100;0
0;1679;"elisia";1679;0;100
27;0;"elisiah";27;100;0
0;21;"elisiana";21;0;100
0;5;"elisianna";5;0;100
32;0;"elisio";32;100;0
5;0;"elisjah";5;100;0
0;181;"eliska";181;0;100
50;11;"elison";61;81.9672131147541;18.0327868852459
0;16580;"elissa";16580;0;100
0;6;"elissabeth";6;0;100
0;5;"elissar";5;0;100
0;395;"elisse";395;0;100
0;5;"elissha";5;0;100
0;261;"elissia";261;0;100
0;5;"elisya";5;0;100
0;497;"elita";497;0;100
0;10;"elitania";10;0;100
12;0;"elite";12;100;0
0;22;"elitha";22;0;100
0;5;"elithia";5;0;100
454;0;"eliu";454;100;0
1338;0;"eliud";1338;100;0
42;0;"elius";42;100;0
41;0;"eliut";41;100;0
16;0;"eliuth";16;100;0
5;0;"eliverto";5;100;0
0;269;"elivia";269;0;100
25;0;"elix";25;100;0
0;11;"elixabeth";11;0;100
5;0;"elixander";5;100;0
0;5;"elixis";5;0;100
86;532;"eliya";618;13.915857605178;86.084142394822
456;834;"eliyah";1290;35.3488372093023;64.6511627906977
0;5;"eliyahna";5;0;100
2475;0;"eliyahu";2475;100;0
0;257;"eliyana";257;0;100
0;87;"eliyanah";87;0;100
0;62;"eliyanna";62;0;100
182;0;"eliyas";182;100;0
6;0;"eliyjah";6;100;0
90;0;"eliyohu";90;100;0
0;206;"eliz";206;0;100
173;43913;"eliza";44086;0.392414825568208;99.6075851744318
0;21;"elizabath";21;0;100
0;25;"elizabe";25;0;100
0;11;"elizabeath";11;0;100
0;53;"elizabeht";53;0;100
0;15;"elizabel";15;0;100
0;316;"elizabella";316;0;100
0;72;"elizabelle";72;0;100
0;5;"elizaberh";5;0;100
0;1712;"elizabet";1712;0;100
0;20;"elizabeta";20;0;100
0;10;"elizabete";10;0;100
4949;1561726;"elizabeth";1566675;0.315891936745017;99.684108063255
0;5;"elizabetha";5;0;100
0;490;"elizabethann";490;0;100
0;86;"elizabethanne";86;0;100
0;15;"elizabethe";15;0;100
0;5;"elizabethgrace";5;0;100
0;34;"elizabethmarie";34;0;100
0;10;"elizabethrose";10;0;100
0;5;"elizabith";5;0;100
0;123;"elizabth";123;0;100
0;22;"elizadeth";22;0;100
0;28;"elizaeth";28;0;100
510;439;"elizah";949;53.740779768177;46.259220231823
0;6;"elizaida";6;0;100
0;5;"elizajane";5;0;100
0;6;"elizama";6;0;100
0;15;"elizamarie";15;0;100
5;0;"elizander";5;100;0
0;41;"elizandra";41;0;100
237;0;"elizandro";237;100;0
77;0;"elizar";77;100;0
83;0;"elizardo";83;100;0
0;309;"elizaveta";309;0;100
0;8;"elizbeath";8;0;100
0;1220;"elizbeth";1220;0;100
16;270;"elize";286;5.59440559440559;94.4055944055944
0;22;"elizeabeth";22;0;100
0;204;"elizebath";204;0;100
0;4211;"elizebeth";4211;0;100
0;12;"elizebth";12;0;100
73;0;"elizeo";73;100;0
92;0;"elizer";92;100;0
0;77;"elizet";77;0;100
0;168;"elizeth";168;0;100
0;58;"elizette";58;0;100
8;0;"elizha";8;100;0
0;24;"elizia";24;0;100
24;0;"eliziah";24;100;0
0;226;"elizibeth";226;0;100
82;0;"elizjah";82;100;0
0;28;"elizza";28;0;100
0;7;"elizzabeth";7;0;100
0;58;"elizzie";58;0;100
81;0;"eljay";81;100;0
0;10;"eljean";10;0;100
10;0;"eljin";10;100;0
0;585;"elka";585;0;100
24;0;"elkan";24;100;0
20;0;"elkanah";20;100;0
0;1045;"elke";1045;0;100
235;0;"elkin";235;100;0
5;0;"elkins";5;100;0
0;134;"elky";134;0;100
139;10;"ell";149;93.2885906040269;6.71140939597315
793;257677;"ella";258470;0.306805431965025;99.693194568035
0;34;"ellabelle";34;0;100
0;7;"ellaclaire";7;0;100
0;5;"elladean";5;0;100
0;265;"ellagrace";265;0;100
0;692;"ellah";692;0;100
0;458;"ellaina";458;0;100
0;48;"ellaine";48;0;100
0;55;"ellajane";55;0;100
0;18;"ellajean";18;0;100
0;5;"ellajo";5;0;100
0;82;"ellakate";82;0;100
0;5;"ellalee";5;0;100
0;6;"ellalynn";6;0;100
0;1736;"ellamae";1736;0;100
0;5;"ellamaria";5;0;100
0;243;"ellamarie";243;0;100
0;142;"ellamay";142;0;100
0;378;"ellan";378;0;100
0;428;"ellana";428;0;100
0;5;"ellanah";5;0;100
0;26;"ellani";26;0;100
0;83;"ellanie";83;0;100
0;398;"ellanor";398;0;100
0;331;"ellanora";331;0;100
0;167;"ellanore";167;0;100
0;23;"ellany";23;0;100
0;419;"ellar";419;0;100
0;114;"ellarae";114;0;100
174;0;"ellard";174;100;0
0;179;"ellaree";179;0;100
0;6;"ellarene";6;0;100
0;8;"ellaria";8;0;100
0;119;"ellarie";119;0;100
0;5;"ellarine";5;0;100
0;309;"ellarose";309;0;100
0;205;"ellary";205;0;100
0;22;"ellasandra";22;0;100
0;5;"ellasia";5;0;100
0;111;"ellason";111;0;100
0;5;"ellasophia";5;0;100
0;337;"ellasyn";337;0;100
0;5;"ellawease";5;0;100
0;6;"ellawee";6;0;100
0;10;"ellawese";10;0;100
0;34;"ellawyn";34;0;100
0;5;"ellaya";5;0;100
0;5;"ellayah";5;0;100
0;170;"ellayna";170;0;100
0;12161;"elle";12161;0;100
0;43;"ellea";43;0;100
0;91;"elleah";91;0;100
0;94;"ellean";94;0;100
0;315;"elleana";315;0;100
0;282;"elleanna";282;0;100
0;322;"elleanor";322;0;100
0;10;"elleanora";10;0;100
0;5;"ellease";5;0;100
0;5;"ellece";5;0;100
0;956;"ellee";956;0;100
0;290;"elleen";290;0;100
0;346;"elleigh";346;0;100
710;259716;"ellen";260426;0.272630228932595;99.7273697710674
0;1968;"ellena";1968;0;100
0;5;"ellenah";5;0;100
0;30;"ellender";30;0;100
0;870;"ellene";870;0;100
0;47;"elleni";47;0;100
0;52;"ellenie";52;0;100
0;33;"ellenmarie";33;0;100
0;498;"ellenor";498;0;100
0;163;"ellenora";163;0;100
0;181;"ellenore";181;0;100
0;10;"elleny";10;0;100
0;6;"elleona";6;0;100
0;5;"elleora";5;0;100
0;370;"eller";370;0;100
0;23;"elleri";23;0;100
0;216;"ellerie";216;0;100
2140;2978;"ellery";5118;41.8132082844861;58.1867917155139
5;0;"elles";5;100;0
0;79;"ellese";79;0;100
0;5;"ellesha";5;0;100
0;28;"elleson";28;0;100
0;111;"ellesse";111;0;100
0;32;"ellesyn";32;0;100
5;0;"ellet";5;100;0
0;5;"ellette";5;0;100
0;9;"ellexa";9;0;100
0;54;"ellexis";54;0;100
0;17;"ellexus";17;0;100
0;249;"elley";249;0;100
29;2156;"elli";2185;1.32723112128146;98.6727688787185
0;896;"ellia";896;0;100
0;39;"elliah";39;0;100
0;53;"elliahna";53;0;100
46;0;"ellian";46;100;0
0;10282;"elliana";10282;0;100
0;137;"ellianah";137;0;100
0;5;"elliani";5;0;100
0;12;"elliann";12;0;100
0;2580;"ellianna";2580;0;100
0;76;"elliannah";76;0;100
0;70;"ellianne";70;0;100
232;0;"ellias";232;100;0
0;24;"elliauna";24;0;100
0;389;"ellice";389;0;100
0;91;"ellicia";91;0;100
1022;53427;"ellie";54449;1.87698580322871;98.1230141967713
0;210;"ellieana";210;0;100
0;31;"ellieann";31;0;100
0;209;"ellieanna";209;0;100
0;5;"ellieanne";5;0;100
0;5;"elliegrace";5;0;100
0;19;"elliekate";19;0;100
0;153;"elliemae";153;0;100
0;8;"elliemarie";8;0;100
0;37;"elliemay";37;0;100
0;5;"elliena";5;0;100
0;21;"ellierose";21;0;100
0;106;"elliet";106;0;100
0;43;"elliett";43;0;100
0;835;"elliette";835;0;100
452;0;"ellijah";452;100;0
0;8;"ellika";8;0;100
0;561;"ellin";561;0;100
0;133;"ellina";133;0;100
0;29;"elline";29;0;100
410;428;"ellington";838;48.9260143198091;51.0739856801909
0;388;"ellinor";388;0;100
0;63;"ellinore";63;0;100
0;76;"elliona";76;0;100
0;85;"ellionna";85;0;100
0;21;"elliora";21;0;100
37272;3468;"elliot";40740;91.4874815905744;8.51251840942563
41344;3240;"elliott";44584;92.7328189485017;7.26718105149829
47;407;"elliotte";454;10.352422907489;89.647577092511
38584;3553;"ellis";42137;91.5679806345967;8.43201936540333
0;824;"ellisa";824;0;100
0;656;"ellise";656;0;100
0;49;"ellisen";49;0;100
0;303;"ellisha";303;0;100
0;17;"ellisia";17;0;100
2143;3278;"ellison";5421;39.5314517616676;60.4685482383324
0;481;"ellissa";481;0;100
0;10;"ellissia";10;0;100
7;6;"elliston";13;53.8461538461538;46.1538461538462
0;379;"ellisyn";379;0;100
0;16;"ellivia";16;0;100
0;20;"elliya";20;0;100
0;121;"elliyah";121;0;100
0;33;"elliyana";33;0;100
0;16;"elliyanna";16;0;100
0;21;"elliza";21;0;100
0;103;"ellizabeth";103;0;100
0;41;"ellnora";41;0;100
0;20;"ellodie";20;0;100
0;29;"ellody";29;0;100
0;332;"elloise";332;0;100
0;213;"ellon";213;0;100
0;503;"ellora";503;0;100
0;41;"elloree";41;0;100
0;72;"ellorie";72;0;100
0;390;"ellory";390;0;100
0;870;"ellouise";870;0;100
0;5;"elloween";5;0;100
0;150;"ellowyn";150;0;100
0;21;"ellsa";21;0;100
0;152;"ellsie";152;0;100
6869;0;"ellsworth";6869;100;0
1892;0;"ellwood";1892;100;0
82;0;"ellwyn";82;100;0
10;3404;"elly";3414;0.292911540714704;99.7070884592853
0;5;"ellya";5;0;100
0;895;"ellyana";895;0;100
0;11;"ellyanah";11;0;100
0;384;"ellyanna";384;0;100
0;132;"ellyce";132;0;100
0;5;"ellycia";5;0;100
0;17;"ellye";17;0;100
0;23;"ellyette";23;0;100
0;5;"ellymae";5;0;100
0;3720;"ellyn";3720;0;100
0;18;"ellyne";18;0;100
0;12;"ellynn";12;0;100
0;11;"ellynor";11;0;100
0;10;"ellyona";10;0;100
0;17;"ellyonna";17;0;100
0;5;"ellyot";5;0;100
0;31;"ellyott";31;0;100
0;27;"ellys";27;0;100
0;184;"ellysa";184;0;100
0;683;"ellyse";683;0;100
0;7;"ellysen";7;0;100
0;58;"ellysia";58;0;100
0;336;"ellyson";336;0;100
0;298;"ellyssa";298;0;100
0;10;"ellyza";10;0;100
477;19439;"elma";19916;2.39505924884515;97.6049407511548
0;5;"elmae";5;0;100
176;0;"elman";176;100;0
287;20;"elmar";307;93.485342019544;6.51465798045603
0;272;"elmarie";272;0;100
0;59;"elmeda";59;0;100
7;0;"elmedin";7;100;0
0;10;"elmedina";10;0;100
5;0;"elmen";5;100;0
117797;1644;"elmer";119441;98.623588215102;1.37641178489798
0;8;"elmerine";8;0;100
0;16;"elmeta";16;0;100
10;5;"elmi";15;66.6666666666667;33.3333333333333
78;0;"elmin";78;100;0
0;635;"elmina";635;0;100
11;0;"elmir";11;100;0
0;3753;"elmira";3753;0;100
0;155;"elmire";155;0;100
9753;247;"elmo";10000;97.53;2.47
591;0;"elmon";591;100;0
182;0;"elmond";182;100;0
10;0;"elmont";10;100;0
64;0;"elmor";64;100;0
3681;10;"elmore";3691;99.729070712544;0.270929287455974
228;0;"elmus";228;100;0
0;501;"elmyra";501;0;100
0;4202;"elna";4202;0;100
0;5;"elnara";5;0;100
28;0;"elnatan";28;100;0
239;0;"elnathan";239;100;0
0;6;"elnaz";6;0;100
0;5;"elneda";5;0;100
5;393;"elner";398;1.25628140703518;98.7437185929648
0;21;"elneta";21;0;100
0;154;"elnita";154;0;100
5;0;"elno";5;100;0
0;843;"elnor";843;0;100
27;19672;"elnora";19699;0.137062795065739;99.8629372049343
0;6;"elnorah";6;0;100
0;400;"elnore";400;0;100
0;199;"elnoria";199;0;100
80;0;"elo";80;100;0
0;56;"eloda";56;0;100
0;5;"elodee";5;0;100
0;1783;"elodia";1783;0;100
0;2226;"elodie";2226;0;100
0;73;"elody";73;0;100
6;0;"elof";6;100;0
93;0;"elohim";93;100;0
22;0;"eloi";22;100;0
0;5;"eloida";5;0;100
0;72;"eloina";72;0;100
0;18;"eloine";18;0;100
10;2636;"elois";2646;0.377928949357521;99.6220710506425
0;6092;"eloisa";6092;0;100
111;48470;"eloise";48581;0.228484386900228;99.7715156130998
0;42;"eloiza";42;0;100
17;0;"elom";17;100;0
1531;487;"elon";2018;75.8671952428147;24.1328047571853
0;1005;"elona";1005;0;100
0;575;"elonda";575;0;100
0;9;"elondra";9;0;100
0;62;"eloni";62;0;100
0;7;"elonie";7;0;100
0;68;"elonna";68;0;100
11;0;"elonte";11;100;0
161;0;"elonzo";161;100;0
0;3634;"elora";3634;0;100
0;96;"elorah";96;0;100
0;7;"eloria";7;0;100
0;12;"eloris";12;0;100
0;11;"elosia";11;0;100
0;5;"elosie";5;0;100
5;9383;"elouise";9388;0.0532594801874734;99.9467405198125
0;13;"elovie";13;0;100
0;194;"elowen";194;0;100
0;5;"elowese";5;0;100
0;18;"elowise";18;0;100
0;230;"elowyn";230;0;100
0;5;"elowynn";5;0;100
7897;0;"eloy";7897;100;0
0;218;"eloyce";218;0;100
10;0;"eloyd";10;100;0
0;92;"eloyse";92;0;100
0;32;"elpha";32;0;100
37;0;"elphege";37;100;0
0;5;"elphie";5;0;100
0;22;"elpida";22;0;100
0;74;"elpidia";74;0;100
773;0;"elpidio";773;100;0
51;0;"elra";51;100;0
326;0;"elray";326;100;0
34;14;"elree";48;70.8333333333333;29.1666666666667
0;18;"elrena";18;0;100
0;26;"elrene";26;0;100
0;5;"elreta";5;0;100
30;0;"elrey";30;100;0
352;0;"elric";352;100;0
30;0;"elrick";30;100;0
38;0;"elrico";38;100;0
440;0;"elridge";440;100;0
0;28;"elrita";28;0;100
6;0;"elrod";6;100;0
14;0;"elroi";14;100;0
5;0;"elron";5;100;0
0;37;"elrose";37;0;100
7190;6;"elroy";7196;99.9166203446359;0.0833796553640912
22;0;"elry";22;100;0
21;26305;"elsa";26326;0.0797690496087518;99.9202309503913
0;5;"elsabeth";5;0;100
0;12;"elsah";12;0;100
0;691;"elsbeth";691;0;100
0;400;"else";400;0;100
0;21;"elsee";21;0;100
0;64;"elsey";64;0;100
0;35;"elsha";35;0;100
6;8;"elshaddai";14;42.8571428571429;57.1428571428571
0;284;"elsi";284;0;100
0;407;"elsia";407;0;100
777;153345;"elsie";154122;0.504146066103476;99.4958539338965
0;15;"elsiemae";15;0;100
6;0;"elsmer";6;100;0
6;0;"elso";6;100;0
1194;0;"elson";1194;100;0
0;757;"elspeth";757;0;100
0;10;"elssa";10;0;100
139;0;"elster";139;100;0
1056;5;"elston";1061;99.5287464655985;0.471253534401508
802;0;"elsworth";802;100;0
0;1070;"elsy";1070;0;100
0;186;"elsye";186;0;100
0;1166;"elta";1166;0;100
0;131;"eltha";131;0;100
0;20;"elthea";20;0;100
0;14;"eltis";14;0;100
20361;188;"elton";20549;99.0851136308336;0.914886369166383
0;10;"eltra";10;0;100
0;5;"elua";5;0;100
10;0;"eluid";10;100;0
6;0;"eluster";6;100;0
0;45;"eluteria";45;0;100
394;0;"eluterio";394;100;0
177;0;"eluzer";177;100;0
762;28496;"elva";29258;2.60441588625333;97.3955841137467
0;15;"elvada";15;0;100
150;0;"elvan";150;100;0
16;28;"elve";44;36.3636363636364;63.6363636363636
0;51;"elveda";51;0;100
12;0;"elvedin";12;100;0
464;0;"elven";464;100;0
0;378;"elvena";378;0;100
0;115;"elvenia";115;0;100
278;49;"elver";327;85.0152905198777;14.9847094801223
0;5071;"elvera";5071;0;100
0;119;"elverda";119;0;100
0;74;"elveria";74;0;100
22;0;"elvern";22;100;0
0;288;"elverna";288;0;100
276;0;"elvert";276;100;0
0;141;"elverta";141;0;100
14;0;"elves";14;100;0
12;0;"elvester";12;100;0
0;107;"elveta";107;0;100
16;103;"elvi";119;13.4453781512605;86.5546218487395
31;7303;"elvia";7334;0.422688846468503;99.5773111535315
0;45;"elvida";45;0;100
713;2262;"elvie";2975;23.9663865546218;76.0336134453782
19607;234;"elvin";19841;98.8206239604859;1.17937603951414
0;2250;"elvina";2250;0;100
0;20;"elvine";20;0;100
6;0;"elvio";6;100;0
38;0;"elvir";38;100;0
44;25242;"elvira";25286;0.174009333227873;99.8259906667721
0;20;"elvire";20;0;100
0;5;"elviria";5;0;100
16532;152;"elvis";16684;99.0889474946056;0.91105250539439
0;31;"elvita";31;0;100
6;0;"elviz";6;100;0
23;0;"elvon";23;100;0
57;86;"elvy";143;39.8601398601399;60.1398601398601
83;11;"elvyn";94;88.2978723404255;11.7021276595745
0;1272;"elwanda";1272;0;100
306;0;"elward";306;100;0
25;0;"elway";25;100;0
22;0;"elwell";22;100;0
0;27;"elwillie";27;0;100
4942;5;"elwin";4947;99.8989286436224;0.101071356377603
19706;53;"elwood";19759;99.7317678020143;0.268232197985728
26;0;"elworth";26;100;0
3091;76;"elwyn";3167;97.600252604989;2.39974739501105
3890;392;"ely";4282;90.8453993461;9.15460065390005
214;163;"elya";377;56.763925729443;43.236074270557
5;5;"elyah";10;50;50
0;5;"elyahna";5;0;100
141;0;"elyan";141;100;0
0;1022;"elyana";1022;0;100
0;65;"elyanah";65;0;100
0;6;"elyane";6;0;100
0;495;"elyanna";495;0;100
0;14;"elyannah";14;0;100
895;0;"elyas";895;100;0
0;780;"elyce";780;0;100
0;417;"elycia";417;0;100
0;5;"elyda";5;0;100
0;15;"elydia";15;0;100
163;0;"elye";163;100;0
26;0;"elyes";26;100;0
6;0;"elyh";6;100;0
5;0;"elyijah";5;100;0
6;0;"elyis";6;100;0
17;0;"elyja";17;100;0
1408;0;"elyjah";1408;100;0
29;0;"elyjiah";29;100;0
11;447;"elyn";458;2.40174672489083;97.5982532751092
0;98;"elyna";98;0;100
0;5;"elyne";5;0;100
0;283;"elynn";283;0;100
0;5;"elynna";5;0;100
0;6;"elynne";6;0;100
0;459;"elynor";459;0;100
0;144;"elynore";144;0;100
94;0;"elyon";94;100;0
5;0;"elyott";5;100;0
0;1402;"elysa";1402;0;100
0;180;"elysabeth";180;0;100
19;17942;"elyse";17961;0.105784755859919;99.8942152441401
26;669;"elysha";695;3.7410071942446;96.2589928057554
0;74;"elyshia";74;0;100
7;3588;"elysia";3595;0.19471488178025;99.8052851182197
0;5;"elysian";5;0;100
0;10;"elysiana";10;0;100
5;47;"elysium";52;9.61538461538462;90.3846153846154
0;6730;"elyssa";6730;0;100
0;682;"elysse";682;0;100
0;453;"elyssia";453;0;100
11;0;"elyus";11;100;0
0;11;"elyvia";11;0;100
0;765;"elyza";765;0;100
0;447;"elyzabeth";447;0;100
0;32;"elyzah";32;0;100
0;10;"elyze";10;0;100
0;5;"elyzza";5;0;100
1778;675;"elza";2453;72.4826742763963;27.5173257236038
0;73;"elzabeth";73;0;100
0;212;"elzada";212;0;100
0;19;"elzadie";19;0;100
0;26;"elzbieta";26;0;100
6;0;"elze";6;100;0
11;0;"elzear";11;100;0
0;149;"elzena";149;0;100
0;5;"elzenia";5;0;100
151;20;"elzia";171;88.3040935672515;11.6959064327485
0;12;"elziabeth";12;0;100
3547;529;"elzie";4076;87.0215897939156;12.9784102060844
0;166;"elzina";166;0;100
0;5;"elzira";5;0;100
36;0;"elzo";36;100;0
0;543;"elzora";543;0;100
365;0;"elzy";365;100;0
0;3524;"ema";3524;0;100
89;0;"emaad";89;100;0
27;781;"emaan";808;3.34158415841584;96.6584158415842
607;0;"emad";607;100;0
0;206;"emagene";206;0;100
0;5;"emagin";5;0;100
0;7;"emagine";7;0;100
0;53;"emah";53;0;100
0;45;"emahni";45;0;100
5;0;"emaje";5;100;0
0;21;"emajean";21;0;100
0;117;"emalea";117;0;100
0;19;"emaleah";19;0;100
0;3490;"emalee";3490;0;100
0;5;"emalei";5;0;100
0;964;"emaleigh";964;0;100
0;5;"emalena";5;0;100
0;75;"emalene";75;0;100
0;67;"emaley";67;0;100
0;98;"emali";98;0;100
0;162;"emalia";162;0;100
0;5;"emaliah";5;0;100
0;1080;"emalie";1080;0;100
0;44;"emalin";44;0;100
0;95;"emalina";95;0;100
0;1434;"emaline";1434;0;100
0;17;"emalise";17;0;100
0;5;"emaliya";5;0;100
0;453;"emaly";453;0;100
0;1275;"emalyn";1275;0;100
0;21;"emalyne";21;0;100
0;494;"emalynn";494;0;100
0;11;"emalynne";11;0;100
173;1732;"eman";1905;9.08136482939632;90.9186351706037
0;41;"emanda";41;0;100
0;5;"emane";5;0;100
0;26;"emanee";26;0;100
299;4422;"emani";4721;6.33340393984325;93.6665960601567
0;178;"emanie";178;0;100
0;53;"emanii";53;0;100
0;15;"emanni";15;0;100
61;0;"emannuel";61;100;0
539;0;"emanual";539;100;0
47827;93;"emanuel";47920;99.8059265442404;0.194073455759599
0;487;"emanuela";487;0;100
295;0;"emanuele";295;100;0
65;0;"emanuell";65;100;0
0;190;"emanuella";190;0;100
196;157;"emanuelle";353;55.5240793201133;44.4759206798867
0;36;"emanuelly";36;0;100
12;0;"emar";12;100;0
0;55;"emara";55;0;100
13;0;"emare";13;100;0
0;132;"emaree";132;0;100
5;0;"emareon";5;100;0
676;797;"emari";1473;45.8927359131025;54.1072640868975
0;35;"emaria";35;0;100
0;34;"emariah";34;0;100
0;794;"emarie";794;0;100
5;0;"emarii";5;100;0
392;0;"emarion";392;100;0
0;6;"emariya";6;0;100
0;26;"emarosa";26;0;100
6;0;"emarri";6;100;0
13;105;"emary";118;11.0169491525424;88.9830508474576
0;17;"emauni";17;0;100
96;23;"emauri";119;80.672268907563;19.327731092437
0;234;"emaya";234;0;100
0;10;"emayah";10;0;100
104;7486;"ember";7590;1.37022397891963;98.6297760210804
0;371;"emberlee";371;0;100
0;155;"emberleigh";155;0;100
0;70;"emberley";70;0;100
0;95;"emberli";95;0;100
0;52;"emberlie";52;0;100
0;58;"emberlin";58;0;100
0;1002;"emberly";1002;0;100
0;623;"emberlyn";623;0;100
0;721;"emberlynn";721;0;100
0;6;"emberlynne";6;0;100
29;0;"embert";29;100;0
0;6;"embra";6;0;100
10;223;"embree";233;4.29184549356223;95.7081545064378
0;39;"embrey";39;0;100
0;19;"embri";19;0;100
0;104;"embrie";104;0;100
313;350;"embry";663;47.209653092006;52.790346907994
0;11;"embrya";11;0;100
0;33;"embyr";33;0;100
0;40;"eme";40;0;100
26;0;"emeal";26;100;0
11;0;"emedio";11;100;0
0;15;"emee";15;0;100
0;11;"emeilia";11;0;100
411;17;"emeka";428;96.0280373831776;3.97196261682243
6;11;"emel";17;35.2941176470588;64.7058823529412
0;1391;"emelda";1391;0;100
0;6;"emele";6;0;100
0;76;"emelee";76;0;100
0;31;"emelene";31;0;100
0;1162;"emeli";1162;0;100
0;8079;"emelia";8079;0;100
0;11;"emeliah";11;0;100
0;13;"emeliana";13;0;100
0;2095;"emelie";2095;0;100
0;737;"emelin";737;0;100
0;488;"emelina";488;0;100
0;38;"emelinda";38;0;100
0;2655;"emeline";2655;0;100
419;0;"emelio";419;100;0
0;10;"emelita";10;0;100
0;6;"emellia";6;0;100
0;20;"emellie";20;0;100
0;351;"emelly";351;0;100
16;17817;"emely";17833;0.089721303201929;99.9102786967981
0;11;"emelya";11;0;100
0;5;"emelye";5;0;100
0;1988;"emelyn";1988;0;100
0;21;"emelyne";21;0;100
0;80;"emelynn";80;0;100
0;5;"emem";5;0;100
25;61;"emer";86;29.0697674418605;70.9302325581395
0;77;"emera";77;0;100
10;53;"emeral";63;15.8730158730159;84.1269841269841
366;6632;"emerald";6998;5.23006573306659;94.7699342669334
0;5;"emeralda";5;0;100
0;46;"emeraude";46;0;100
0;44;"emercyn";44;0;100
6;0;"emere";6;100;0
0;129;"emeree";129;0;100
0;18;"emerey";18;0;100
53;1146;"emeri";1199;4.42035029190992;95.5796497080901
0;5;"emeria";5;0;100
232;0;"emeric";232;100;0
16;0;"emerich";16;100;0
395;0;"emerick";395;100;0
10;2425;"emerie";2435;0.410677618069815;99.5893223819302
0;17;"emerii";17;0;100
21;0;"emerik";21;100;0
63;16;"emeril";79;79.746835443038;20.253164556962
0;11;"emerine";11;0;100
5;0;"emeris";5;100;0
0;142;"emerita";142;0;100
11;0;"emerito";11;100;0
0;29;"emerlee";29;0;100
0;11;"emerleigh";11;0;100
0;12;"emerline";12;0;100
0;62;"emerly";62;0;100
0;38;"emerlyn";38;0;100
0;18;"emerlynn";18;0;100
53;700;"emersen";753;7.03851261620186;92.9614873837981
21519;16975;"emerson";38494;55.9022185275627;44.0977814724373
77;5376;"emersyn";5453;1.41206675224647;98.5879332477535
0;102;"emersynn";102;0;100
35;0;"emert";35;100;0
16602;16672;"emery";33274;49.8948127667248;50.1051872332752
10;0;"emeryk";10;100;0
0;15;"emeryn";15;0;100
23;0;"emerzon";23;100;0
0;37;"emese";37;0;100
156;0;"emet";156;100;0
372;0;"emeterio";372;100;0
6;0;"emeth";6;100;0
232;0;"emett";232;100;0
0;2596;"emi";2596;0;100
0;53;"emia";53;0;100
0;175;"emiah";175;0;100
394;0;"emidio";394;100;0
0;151;"emie";151;0;100
93;0;"emiel";93;100;0
5;0;"emier";5;100;0
314;0;"emigdio";314;100;0
0;13;"emijah";13;0;100
0;59;"emika";59;0;100
5;1352;"emiko";1357;0.368459837877671;99.6315401621223
28794;129;"emil";28923;99.5539881755005;0.446011824499533
0;74;"emila";74;0;100
0;59;"emilce";59;0;100
0;22;"emilda";22;0;100
7524;636;"emile";8160;92.2058823529412;7.79411764705882
0;419;"emilea";419;0;100
0;55;"emileah";55;0;100
8;22092;"emilee";22100;0.0361990950226244;99.9638009049774
0;1200;"emileigh";1200;0;100
0;88;"emilene";88;0;100
86;0;"emileo";86;100;0
0;1701;"emiley";1701;0;100
0;1751;"emili";1751;0;100
0;27907;"emilia";27907;0;100
0;29;"emiliah";29;0;100
80;0;"emilian";80;100;0
0;1371;"emiliana";1371;0;100
0;5;"emiliann";5;0;100
0;111;"emilianna";111;0;100
0;10;"emilianne";10;0;100
20035;5;"emiliano";20040;99.9750499001996;0.0249500998003992
7;23487;"emilie";23494;0.0297948412360603;99.9702051587639
0;5;"emiliee";5;0;100
21;0;"emilien";21;100;0
0;13;"emilienne";13;0;100
0;187;"emilija";187;0;100
0;23;"emilin";23;0;100
0;59;"emilina";59;0;100
0;290;"emiline";290;0;100
37332;57;"emilio";37389;99.8475487442831;0.152451255716922
0;62;"emiliya";62;0;100
0;5;"emille";5;0;100
0;89;"emillee";89;0;100
0;180;"emillia";180;0;100
0;11;"emilliana";11;0;100
0;7;"emillianna";7;0;100
111;0;"emilliano";111;100;0
0;460;"emillie";460;0;100
394;0;"emillio";394;100;0
0;1209;"emilly";1209;0;100
151;0;"emilo";151;100;0
0;35;"emilse";35;0;100
25;0;"emilson";25;100;0
1734;822815;"emily";824549;0.210296780421782;99.7897032195782
0;118;"emilya";118;0;100
0;17;"emilyah";17;0;100
0;572;"emilyann";572;0;100
0;258;"emilyanne";258;0;100
0;39;"emilye";39;0;100
0;41;"emilyelizabeth";41;0;100
0;84;"emilygrace";84;0;100
0;5;"emilyjane";5;0;100
0;22;"emilyjo";22;0;100
0;5;"emilymae";5;0;100
0;47;"emilymarie";47;0;100
0;1133;"emilyn";1133;0;100
0;5;"emilyna";5;0;100
0;12;"emilyne";12;0;100
0;389;"emilynn";389;0;100
0;219;"emilyrose";219;0;100
333;0;"emin";333;100;0
0;547;"emina";547;0;100
0;109;"emine";109;0;100
2164;0;"emir";2164;100;0
0;154;"emira";154;0;100
0;23;"emirah";23;0;100
0;30;"emiree";30;0;100
0;139;"emireth";139;0;100
29;0;"emirhan";29;100;0
0;30;"emiri";30;0;100
0;5;"emirra";5;0;100
0;5;"emiry";5;0;100
0;6;"emisha";6;0;100
304;0;"emit";304;100;0
21;0;"emiterio";21;100;0
520;0;"emitt";520;100;0
5;0;"emitte";5;100;0
0;269;"emiya";269;0;100
0;386;"emiyah";386;0;100
28;37;"emjay";65;43.0769230769231;56.9230769230769
0;6;"emlee";6;0;100
0;11;"emley";11;0;100
0;20;"emly";20;0;100
5;293;"emlyn";298;1.67785234899329;98.3221476510067
0;27;"emlynn";27;0;100
1384;580027;"emma";581411;0.238041591920345;99.7619584080796
0;5;"emmabella";5;0;100
0;62;"emmabelle";62;0;100
0;5;"emmabeth";5;0;100
0;108;"emmaclaire";108;0;100
0;5;"emmadell";5;0;100
0;210;"emmagene";210;0;100
0;514;"emmagrace";514;0;100
0;827;"emmah";827;0;100
0;146;"emmajane";146;0;100
0;561;"emmajean";561;0;100
0;135;"emmajo";135;0;100
0;165;"emmakate";165;0;100
0;11;"emmakay";11;0;100
0;11;"emmalani";11;0;100
0;423;"emmalea";423;0;100
0;111;"emmaleah";111;0;100
0;7875;"emmalee";7875;0;100
0;6;"emmaleen";6;0;100
0;47;"emmalei";47;0;100
0;2041;"emmaleigh";2041;0;100
0;88;"emmalena";88;0;100
0;343;"emmalene";343;0;100
0;35;"emmaley";35;0;100
0;117;"emmali";117;0;100
0;205;"emmalia";205;0;100
0;669;"emmalie";669;0;100
0;519;"emmalin";519;0;100
0;415;"emmalina";415;0;100
0;5078;"emmaline";5078;0;100
0;17;"emmalinn";17;0;100
0;6;"emmalisa";6;0;100
0;152;"emmalise";152;0;100
0;199;"emmalou";199;0;100
0;6;"emmalouise";6;0;100
0;538;"emmaly";538;0;100
0;5283;"emmalyn";5283;0;100
0;241;"emmalyne";241;0;100
0;2740;"emmalynn";2740;0;100
0;204;"emmalynne";204;0;100
0;24;"emmalyse";24;0;100
0;104;"emmamae";104;0;100
0;161;"emmamarie";161;0;100
0;10;"emman";10;0;100
5;0;"emmanel";5;100;0
5;0;"emmaneul";5;100;0
0;99;"emmani";99;0;100
6;0;"emmanouel";6;100;0
437;0;"emmanual";437;100;0
70742;350;"emmanuel";71092;99.5076801890508;0.492319810949193
0;579;"emmanuela";579;0;100
107;0;"emmanuell";107;100;0
0;888;"emmanuella";888;0;100
267;1064;"emmanuelle";1331;20.0601051840721;79.9398948159279
5;0;"emmanul";5;100;0
0;296;"emmarae";296;0;100
0;46;"emmaree";46;0;100
0;20;"emmari";20;0;100
0;15;"emmariah";15;0;100
0;958;"emmarie";958;0;100
0;555;"emmarose";555;0;100
0;182;"emmary";182;0;100
0;16;"emmasofia";16;0;100
0;31;"emmasophia";31;0;100
0;5;"emmasue";5;0;100
60;0;"emmauel";60;100;0
78;5;"emmaus";83;93.9759036144578;6.02409638554217
0;2589;"emme";2589;0;100
0;44;"emmee";44;0;100
0;5;"emmelee";5;0;100
0;5;"emmelene";5;0;100
0;325;"emmelia";325;0;100
0;24;"emmelie";24;0;100
0;19;"emmelin";19;0;100
0;48;"emmelina";48;0;100
0;3329;"emmeline";3329;0;100
0;396;"emmely";396;0;100
0;335;"emmelyn";335;0;100
0;11;"emmelyne";11;0;100
0;34;"emmelynn";34;0;100
11;1835;"emmer";1846;0.595882990249187;99.4041170097508
0;26;"emmeri";26;0;100
5;0;"emmeric";5;100;0
101;0;"emmerich";101;100;0
13;0;"emmerick";13;100;0
0;154;"emmerie";154;0;100
0;6;"emmerly";6;0;100
0;145;"emmersen";145;0;100
384;1684;"emmerson";2068;18.568665377176;81.431334622824
0;575;"emmersyn";575;0;100
201;0;"emmert";201;100;0
24;619;"emmery";643;3.73250388802488;96.2674961119751
0;11;"emmeryn";11;0;100
5207;0;"emmet";5207;100;0
46899;129;"emmett";47028;99.7256953304414;0.274304669558561
774;0;"emmette";774;100;0
0;5;"emmey";5;0;100
0;1317;"emmi";1317;0;100
0;5940;"emmie";5940;0;100
0;11;"emmielou";11;0;100
0;146;"emmilee";146;0;100
0;76;"emmilia";76;0;100
10;0;"emmiliano";10;100;0
0;13;"emmilie";13;0;100
0;28;"emmiline";28;0;100
0;16;"emmilou";16;0;100
0;856;"emmily";856;0;100
0;164;"emmilyn";164;0;100
0;56;"emmilynn";56;0;100
3529;0;"emmit";3529;100;0
9634;0;"emmitt";9634;100;0
67;0;"emmitte";67;100;0
0;12;"emmo";12;0;100
0;107;"emmogene";107;0;100
5;0;"emmon";5;100;0
0;10;"emmoni";10;0;100
111;0;"emmons";111;100;0
0;6;"emmori";6;0;100
0;5;"emmorie";5;0;100
5;98;"emmory";103;4.85436893203883;95.1456310679612
0;31;"emmrie";31;0;100
0;105;"emmry";105;0;100
0;7412;"emmy";7412;0;100
0;5;"emmye";5;0;100
0;598;"emmylou";598;0;100
19;0;"emmytt";19;100;0
0;16;"emna";16;0;100
0;93;"emnet";93;0;100
15;12;"emo";27;55.5555555555556;44.4444444444444
0;49;"emogean";49;0;100
0;4793;"emogene";4793;0;100
0;5;"emogine";5;0;100
0;90;"emojean";90;0;100
0;5;"emolene";5;0;100
406;90;"emon";496;81.8548387096774;18.1451612903226
16;0;"emond";16;100;0
5;55;"emone";60;8.33333333333333;91.6666666666667
0;171;"emonee";171;0;100
0;6;"emoney";6;0;100
112;2084;"emoni";2196;5.10018214936248;94.8998178506375
14;900;"emonie";914;1.53172866520788;98.4682713347921
0;67;"emonii";67;0;100
0;95;"emonni";95;0;100
0;140;"emonnie";140;0;100
30;0;"emontae";30;100;0
133;0;"emonte";133;100;0
0;120;"emony";120;0;100
0;12;"emora";12;0;100
0;146;"emoree";146;0;100
59;409;"emori";468;12.6068376068376;87.3931623931624
0;447;"emorie";447;0;100
15676;4300;"emory";19976;78.4741690028034;21.5258309971966
0;26;"emperatriz";26;0;100
0;5;"emperess";5;0;100
26;0;"emperor";26;100;0
0;705;"empress";705;0;100
0;6;"empris";6;0;100
0;32;"empriss";32;0;100
0;5;"empryss";5;0;100
6;16;"emra";22;27.2727272727273;72.7272727272727
18;0;"emraan";18;100;0
100;0;"emrah";100;100;0
265;0;"emran";265;100;0
673;0;"emre";673;100;0
9;566;"emree";575;1.56521739130435;98.4347826086956
0;5;"emreigh";5;0;100
34;147;"emrey";181;18.7845303867403;81.2154696132597
20;284;"emri";304;6.57894736842105;93.4210526315789
30;0;"emric";30;100;0
167;0;"emrick";167;100;0
5;752;"emrie";757;0.660501981505945;99.3394980184941
57;0;"emrik";57;100;0
26;0;"emron";26;100;0
5;0;"emroy";5;100;0
538;1132;"emry";1670;32.2155688622755;67.7844311377246
5;0;"emryck";5;100;0
11;0;"emryk";11;100;0
0;13;"emryn";13;0;100
319;82;"emrys";401;79.5511221945137;20.4488778054863
0;41;"emslee";41;0;100
10;420;"emsley";430;2.32558139534884;97.6744186046512
0;10;"emslie";10;0;100
12;0;"emuel";12;100;0
0;35;"emuna";35;0;100
0;137;"emunah";137;0;100
0;1053;"emy";1053;0;100
0;441;"emya";441;0;100
0;129;"emyah";129;0;100
0;31;"emyia";31;0;100
0;37;"emyiah";37;0;100
0;15;"emyla";15;0;100
0;6;"emylah";6;0;100
0;29;"emyle";29;0;100
0;624;"emylee";624;0;100
0;6;"emyleigh";6;0;100
0;55;"emyli";55;0;100
0;163;"emylia";163;0;100
0;172;"emylie";172;0;100
0;40;"emyly";40;0;100
22;0;"emyr";22;100;0
0;8;"emyree";8;0;100
0;5;"emyri";5;0;100
0;5;"emyrie";5;0;100
0;29;"emyrson";29;0;100
10;0;"emytt";10;100;0
21;0;"emzie";21;100;0
0;5;"emzley";5;0;100
6;0;"emzy";6;100;0
17;0;"en";17;100;0
0;3054;"ena";3054;0;100
0;13;"enaiya";13;0;100
0;5;"enaja";5;0;100
0;22;"enajah";22;0;100
0;8;"enajiah";8;0;100
0;16;"enalina";16;0;100
11;0;"enam";11;100;0
42;0;"enan";42;100;0
0;13;"enara";13;0;100
0;5;"enari";5;0;100
0;131;"enas";131;0;100
0;11;"enasia";11;0;100
0;212;"enaya";212;0;100
0;27;"enayah";27;0;100
0;5;"enaysia";5;0;100
832;132;"encarnacion";964;86.3070539419087;13.6929460580913
0;6;"enchante";6;0;100
0;9;"enchantee";9;0;100
0;8;"enchantra";8;0;100
15;0;"encil";15;100;0
0;238;"enda";238;0;100
0;30;"endea";30;0;100
828;0;"ender";828;100;0
18;0;"enderson";18;100;0
0;12;"endesha";12;0;100
96;0;"endi";96;100;0
0;1157;"endia";1157;0;100
0;15;"endiah";15;0;100
0;11;"endie";11;0;100
0;69;"endiya";69;0;100
0;36;"endiyah";36;0;100
0;109;"endora";109;0;100
0;5;"endra";5;0;100
56;0;"endre";56;100;0
5;0;"endrew";5;100;0
6;0;"endri";6;100;0
6;0;"endrick";6;100;0
78;0;"endrit";78;100;0
0;10;"endsley";10;0;100
461;15;"endy";476;96.8487394957983;3.15126050420168
0;266;"endya";266;0;100
0;5;"endyah";5;0;100
0;5;"endyia";5;0;100
5;0;"enea";5;100;0
13;0;"eneas";13;100;0
0;688;"enedelia";688;0;100
0;2740;"enedina";2740;0;100
39;0;"enedino";39;100;0
0;870;"eneida";870;0;100
0;6;"enely";6;0;100
10;0;"enemencio";10;100;0
5;0;"ener";5;100;0
0;7;"eneri";7;0;100
208;393;"enes";601;34.6089850249584;65.3910149750416
0;5;"enesa";5;0;100
0;5;"enesha";5;0;100
0;41;"enessa";41;0;100
0;5;"enette";5;0;100
0;23;"eneyda";23;0;100
0;98;"enez";98;0;100
0;6;"enfinity";6;0;100
0;24;"enga";24;0;100
17;0;"engel";17;100;0
150;0;"engelbert";150;100;0
5;0;"engelberto";5;100;0
5;0;"engels";5;100;0
0;6;"enger";6;0;100
0;31;"engie";31;0;100
22;160;"england";182;12.0879120879121;87.9120879120879
181;265;"english";446;40.5829596412556;59.4170403587444
0;53;"engracia";53;0;100
0;21;"engrid";21;0;100
0;5;"eni";5;0;100
0;51;"enia";51;0;100
0;35;"eniah";35;0;100
0;12;"enice";12;0;100
6;8687;"enid";8693;0.0690210514206833;99.9309789485793
0;13;"enija";13;0;100
0;163;"enijah";163;0;100
0;5;"enika";5;0;100
0;6;"enilda";6;0;100
84;0;"enio";84;100;0
25;198;"eniola";223;11.2107623318386;88.7892376681614
264;293;"enis";557;47.3967684021544;52.6032315978456
0;89;"enisa";89;0;100
0;15;"enise";15;0;100
0;40;"enisha";40;0;100
0;5;"enissa";5;0;100
0;10;"enita";10;0;100
0;17;"enith";17;0;100
0;425;"eniya";425;0;100
0;673;"eniyah";673;0;100
0;5;"eniylah";5;0;100
16;0;"enjamin";16;100;0
0;859;"enjoli";859;0;100
0;28;"enjolie";28;0;100
12;0;"enki";12;100;0
6;0;"enloe";6;100;0
0;98;"enma";98;0;100
940;0;"enmanuel";940;100;0
0;461;"enna";461;0;100
9;0;"enner";9;100;0
24;0;"enneth";24;100;0
0;5;"ennette";5;0;100
0;7;"ennice";7;0;100
0;10;"ennie";10;0;100
0;208;"ennifer";208;0;100
66;0;"ennio";66;100;0
2962;309;"ennis";3271;90.5533476001223;9.44665239987771
17;0;"enno";17;100;0
0;12;"enny";12;0;100
25;0;"eno";25;100;0
885;0;"enoc";885;100;0
9419;0;"enoch";9419;100;0
45;0;"enock";45;100;0
5;0;"enoe";5;100;0
6;0;"enok";6;100;0
0;2558;"enola";2558;0;100
0;62;"enolia";62;0;100
0;50;"enora";50;0;100
3286;0;"enos";3286;100;0
12;0;"enosh";12;100;0
17;0;"enri";17;100;0
5;0;"enric";5;100;0
0;126;"enrica";126;0;100
5;0;"enrick";5;100;0
4530;0;"enrico";4530;100;0
760;0;"enrigue";760;100;0
0;71;"enrika";71;0;100
38;0;"enrike";38;100;0
56044;260;"enrique";56304;99.5382210855357;0.461778914464336
0;1847;"enriqueta";1847;0;100
0;5;"enriquetta";5;0;100
32;0;"enriquez";32;100;0
603;0;"enrrique";603;100;0
0;5;"enrriqueta";5;0;100
17;0;"enry";17;100;0
36;0;"ensar";36;100;0
5;0;"ensign";5;100;0
0;52;"enslee";52;0;100
0;5;"ensleigh";5;0;100
16;536;"ensley";552;2.89855072463768;97.1014492753623
0;43;"enslie";43;0;100
14;0;"enso";14;100;0
44;0;"enson";44;100;0
0;16;"envee";16;0;100
36;0;"enver";36;100;0
0;64;"envi";64;0;100
0;7;"envie";7;0;100
5;454;"envy";459;1.08932461873638;98.9106753812636
0;6;"envyi";6;0;100
0;966;"enya";966;0;100
0;70;"enyah";70;0;100
0;18;"enyce";18;0;100
0;25;"enyia";25;0;100
0;69;"enyla";69;0;100
0;7;"enylah";7;0;100
0;5;"enyssa";5;0;100
0;398;"enza";398;0;100
37;0;"enzi";37;100;0
65;0;"enzio";65;100;0
0;18;"enzlee";18;0;100
0;20;"enzley";20;0;100
0;6;"enzlie";6;0;100
9160;0;"enzo";9160;100;0
5;0;"enzogabriel";5;100;0
6;0;"enzzo";6;100;0
328;0;"eoghan";328;100;0
1126;0;"eoin";1126;100;0
0;660;"eola";660;0;100
0;5;"eolia";5;0;100
0;11;"eoline";11;0;100
286;0;"eon";286;100;0
0;5;"eona";5;0;100
0;957;"eowyn";957;0;100
5;0;"eph";5;100;0
5963;0;"ephraim";5963;100;0
11;0;"ephrain";11;100;0
346;0;"ephram";346;100;0
0;50;"ephrata";50;0;100
0;6;"ephratah";6;0;100
145;0;"ephrem";145;100;0
801;0;"ephriam";801;100;0
10;0;"ephrim";10;100;0
5;0;"ephron";5;100;0
74;19;"epic";93;79.5698924731183;20.4301075268817
0;479;"epifania";479;0;100
1925;0;"epifanio";1925;100;0
33;0;"epigmenio";33;100;0
0;23;"epimenia";23;0;100
184;0;"epimenio";184;100;0
0;677;"epiphany";677;0;100
11;0;"epitacio";11;100;0
5;0;"epolito";5;100;0
0;31;"eponine";31;0;100
44;204;"eppie";248;17.741935483871;82.258064516129
0;175;"epsie";175;0;100
164;0;"equan";164;100;0
0;5;"equasha";5;0;100
0;5;"equasia";5;0;100
0;580;"equilla";580;0;100
34;4851;"era";4885;0.696008188331627;99.3039918116684
0;139;"erabella";139;0;100
59;0;"eraclio";59;100;0
63;0;"eragon";63;100;0
0;10;"erah";10;0;100
0;298;"eraina";298;0;100
0;5;"eraine";5;0;100
6;0;"eraldo";6;100;0
0;5;"eralia";5;0;100
0;17;"eralyn";17;0;100
0;46;"eralynn";46;0;100
565;87;"eran";652;86.6564417177914;13.3435582822086
0;279;"erandi";279;0;100
0;340;"erandy";340;0;100
3766;0;"erasmo";3766;100;0
89;0;"erasmus";89;100;0
145;0;"erasto";145;100;0
270;0;"erastus";270;100;0
24;0;"eray";24;100;0
10;0;"erbey";10;100;0
188;10;"erbie";198;94.9494949494949;5.05050505050505
15;0;"erbin";15;100;0
5;0;"erblin";5;100;0
472;0;"erby";472;100;0
156;187;"ercel";343;45.4810495626822;54.5189504373178
125;252;"ercell";377;33.1564986737401;66.8435013262599
0;84;"ercelle";84;0;100
0;80;"ercia";80;0;100
0;108;"ercie";108;0;100
76;6;"ercil";82;92.6829268292683;7.31707317073171
0;172;"ercilia";172;0;100
65;0;"ercole";65;100;0
0;15;"erda";15;0;100
0;5;"erdell";5;0;100
52;0;"erdem";52;100;0
0;23;"erdene";23;0;100
25;0;"erdi";25;100;0
0;248;"erdine";248;0;100
26;0;"erdman";26;100;0
6;0;"erec";6;100;0
0;5;"ereca";5;0;100
665;0;"erek";665;100;0
0;203;"ereka";203;0;100
0;11;"erelene";11;0;100
0;5;"ereline";5;0;100
12;0;"eremy";12;100;0
750;151;"eren";901;83.2408435072142;16.7591564927858
0;20;"erena";20;0;100
0;223;"erendida";223;0;100
0;786;"erendira";786;0;100
0;30;"erene";30;0;100
15;0;"erenest";15;100;0
5;0;"erenst";5;100;0
0;6;"ereny";6;0;100
0;15;"eres";15;0;100
0;5;"eresmia";5;0;100
0;17;"eretria";17;0;100
0;10;"eretta";10;0;100
177;0;"erez";177;100;0
16;0;"erfan";16;100;0
12;0;"erford";12;100;0
5;0;"erhan";5;100;0
110;0;"erhard";110;100;0
92;0;"erhardt";92;100;0
19;0;"erhart";19;100;0
338;291;"eri";629;53.7360890302067;46.2639109697933
0;198;"eria";198;0;100
0;30;"eriah";30;0;100
0;196;"erial";196;0;100
111;132;"erian";243;45.679012345679;54.320987654321
0;1005;"eriana";1005;0;100
0;16;"erianah";16;0;100
0;48;"eriane";48;0;100
0;5;"eriani";5;0;100
0;5;"eriann";5;0;100
0;996;"erianna";996;0;100
0;5;"eriannah";5;0;100
0;28;"erianne";28;0;100
0;24;"erianny";24;0;100
0;10;"eribella";10;0;100
2335;0;"eriberto";2335;100;0
871649;4293;"eric";875942;99.5098990572435;0.490100942756484
1025;229608;"erica";230633;0.444429027936158;99.5555709720638
0;84;"ericah";84;0;100
0;13;"erical";13;0;100
0;7;"ericalynn";7;0;100
0;5;"ericamarie";5;0;100
0;5;"ericanicole";5;0;100
5;0;"ericanthony";5;100;0
79;0;"ericberto";79;100;0
10;0;"ericc";10;100;0
0;580;"ericca";580;0;100
5;0;"ericdaniel";5;100;0
234;30;"erice";264;88.6363636363636;11.3636363636364
11479;32;"erich";11511;99.7220050386587;0.277994961341326
0;258;"ericha";258;0;100
0;449;"ericia";449;0;100
5;0;"ericjames";5;100;0
69151;412;"erick";69563;99.4077311214295;0.592268878570504
46;22951;"ericka";22997;0.200026090359612;99.7999739096404
0;10;"erickah";10;0;100
0;5;"erickia";5;0;100
920;0;"erickson";920;100;0
10;0;"ericlee";10;100;0
11;0;"ericmichael";11;100;0
77;0;"erico";77;100;0
610;0;"ericson";610;100;0
32;0;"ericsson";32;100;0
0;5;"eridani";5;0;100
1932;1199;"erie";3131;61.7055253912488;38.2944746087512
0;15;"erieanna";15;0;100
68;533;"eriel";601;11.3144758735441;88.6855241264559
0;17;"eriella";17;0;100
0;405;"erielle";405;0;100
0;5;"erien";5;0;100
0;133;"erienne";133;0;100
0;5;"erieonna";5;0;100
5;0;"eries";5;100;0
0;5;"erihanna";5;0;100
150831;666;"erik";151497;99.5603873344027;0.439612665597339
548;123327;"erika";123875;0.442381432896065;99.5576185671039
0;306;"erikah";306;0;100
10;0;"erikc";10;100;0
11;17;"erike";28;39.2857142857143;60.7142857142857
0;10;"erikia";10;0;100
12;0;"erikk";12;100;0
0;981;"erikka";981;0;100
0;78;"eriko";78;0;100
41;0;"eriks";41;100;0
6;0;"eriksen";6;100;0
266;0;"erikson";266;100;0
15;0;"eriksson";15;100;0
34;0;"eril";34;100;0
0;120;"erilyn";120;0;100
0;39;"erilynn";39;0;100
0;5;"erim";5;0;100
9170;311663;"erin";320833;2.85818478772446;97.1418152122755
0;813;"erina";813;0;100
12;88;"erine";100;12;88
33;0;"erineo";33;100;0
0;20;"erini";20;0;100
0;6;"erinique";6;0;100
0;5;"erinisha";5;0;100
0;15;"erinmarie";15;0;100
143;3368;"erinn";3511;4.07291369980063;95.9270863001994
0;243;"erinne";243;0;100
0;11;"eriny";11;0;100
23;25;"erioluwa";48;47.9166666666667;52.0833333333333
449;113;"erion";562;79.8932384341637;20.1067615658363
0;190;"eriona";190;0;100
0;370;"erionna";370;0;100
0;5;"erionne";5;0;100
717;0;"eriq";717;100;0
0;24;"eriqa";24;0;100
0;10;"eriqua";10;0;100
259;0;"erique";259;100;0
378;1762;"eris";2140;17.6635514018692;82.3364485981308
0;63;"erisa";63;0;100
0;33;"erisha";33;0;100
5;0;"erison";5;100;0
0;6;"eriss";6;0;100
0;19;"erissa";19;0;100
0;5;"eritrea";5;0;100
5;0;"erivan";5;100;0
61;0;"eriverto";61;100;0
12;0;"erix";12;100;0
0;65;"eriyah";65;0;100
0;9;"eriyan";9;0;100
0;171;"eriyana";171;0;100
0;160;"eriyanna";160;0;100
11;10;"eriyon";21;52.3809523809524;47.6190476190476
0;11;"eriyona";11;0;100
0;81;"eriyonna";81;0;100
28;0;"erjon";28;100;0
0;6;"erka";6;0;100
5;0;"erkan";5;100;0
0;907;"erla";907;0;100
5;0;"erlan";5;100;0
478;0;"erland";478;100;0
827;0;"erle";827;100;0
0;68;"erlean";68;0;100
0;280;"erleen";280;0;100
0;2332;"erlene";2332;0;100
206;11;"erlin";217;94.9308755760369;5.06912442396313
0;4616;"erlinda";4616;0;100
0;1626;"erline";1626;0;100
1233;0;"erling";1233;100;0
31;0;"erlon";31;100;0
0;26;"erlyne";26;0;100
0;5;"erlys";5;0;100
238;52309;"erma";52547;0.452927855063086;99.5470721449369
0;17;"ermadean";17;0;100
0;6;"ermadine";6;0;100
0;73;"ermagene";73;0;100
0;10;"ermajean";10;0;100
261;336;"ermal";597;43.7185929648241;56.2814070351759
0;5;"ermalea";5;0;100
0;106;"ermalee";106;0;100
0;39;"ermalene";39;0;100
0;331;"ermalinda";331;0;100
0;36;"ermaline";36;0;100
647;0;"erman";647;100;0
53;61;"ermel";114;46.4912280701754;53.5087719298246
0;1367;"ermelinda";1367;0;100
0;5;"ermenia";5;0;100
0;30;"ermer";30;0;100
0;5;"ermia";5;0;100
75;0;"ermias";75;100;0
5;131;"ermie";136;3.67647058823529;96.3235294117647
48;0;"ermil";48;100;0
0;36;"ermila";36;0;100
11;0;"ermilo";11;100;0
157;0;"ermin";157;100;0
0;278;"ermina";278;0;100
0;28;"erminda";28;0;100
67;444;"ermine";511;13.1115459882583;86.8884540117417
0;1489;"erminia";1489;0;100
0;63;"erminie";63;0;100
307;0;"erminio";307;100;0
5;0;"ermis";5;100;0
0;5;"ermma";5;0;100
368;30;"ermon";398;92.462311557789;7.53768844221105
5;0;"ermond";5;100;0
11;7968;"erna";7979;0.137861887454568;99.8621381125454
12;0;"ernad";12;100;0
5;0;"ernal";5;100;0
312;0;"ernan";312;100;0
10;0;"ernel";10;100;0
0;38;"ernell";38;0;100
0;64;"ernesha";64;0;100
0;17;"erneshia";17;0;100
286023;1786;"ernest";287809;99.3794495655105;0.62055043448954
0;243;"ernesta";243;0;100
0;249;"ernesteen";249;0;100
0;197;"ernestene";197;0;100
0;5247;"ernestina";5247;0;100
159;43000;"ernestine";43159;0.36840519937904;99.631594800621
42037;121;"ernesto";42158;99.7129844869301;0.28701551306988
5;0;"ernestor";5;100;0
0;78;"ernestyne";78;0;100
0;7;"ernetta";7;0;100
0;11;"ernette";11;0;100
10;0;"erney";10;100;0
0;12;"ernice";12;0;100
16191;689;"ernie";16880;95.9182464454976;4.08175355450237
5;0;"erniest";5;100;0
0;62;"ernisha";62;0;100
10;0;"ernist";10;100;0
0;10;"ernistine";10;0;100
5;0;"erno";5;100;0
2158;0;"ernst";2158;100;0
0;15;"ernstine";15;0;100
6;0;"erny";6;100;0
20;0;"ero";20;100;0
449;0;"erol";449;100;0
1256;187;"eron";1443;87.040887040887;12.959112959113
0;11;"eronda";11;0;100
990;0;"eros";990;100;0
6;0;"eroz";6;100;0
6;0;"erran";6;100;0
23;0;"errett";23;100;0
336;0;"erric";336;100;0
0;368;"errica";368;0;100
1298;0;"errick";1298;100;0
0;154;"erricka";154;0;100
70;0;"errik";70;100;0
0;122;"errika";122;0;100
271;842;"errin";1113;24.3486073674753;75.6513926325247
12;0;"errion";12;100;0
5;0;"erris";5;100;0
8450;0;"errol";8450;100;0
5;0;"errold";5;100;0
822;0;"erroll";822;100;0
792;15;"erron";807;98.1412639405204;1.85873605947955
0;105;"erryn";105;0;100
0;69;"ersa";69;0;100
264;88;"ersel";352;75;25
0;11;"ersell";11;0;100
0;6;"erselle";6;0;100
0;7;"ersheen";7;0;100
10;0;"ershel";10;100;0
5;398;"ersie";403;1.24069478908189;98.7593052109181
0;82;"ersilia";82;0;100
464;0;"erskin";464;100;0
1990;0;"erskine";1990;100;0
0;30;"ersula";30;0;100
0;241;"ertha";241;0;100
0;5;"ertie";5;0;100
5;10;"ertis";15;33.3333333333333;66.6666666666667
50;0;"erubey";50;100;0
201;0;"erubiel";201;100;0
0;114;"erum";114;0;100
0;611;"erva";611;0;100
237;0;"ervan";237;100;0
445;0;"erven";445;100;0
0;5;"ervena";5;0;100
0;6;"ervene";6;0;100
221;0;"ervey";221;100;0
193;36;"ervie";229;84.2794759825327;15.7205240174673
58;0;"ervil";58;100;0
11;0;"erville";11;100;0
37087;138;"ervin";37225;99.6292813969107;0.370718603089322
0;27;"ervina";27;0;100
167;0;"ervine";167;100;0
917;0;"erving";917;100;0
5;0;"ervy";5;100;0
5;0;"erwan";5;100;0
20108;49;"erwin";20157;99.7569082700799;0.243091729920127
6;0;"ery";6;100;0
0;39;"eryana";39;0;100
0;59;"eryanna";59;0;100
67;0;"eryc";67;100;0
0;161;"eryca";161;0;100
164;0;"eryck";164;100;0
0;13;"erycka";13;0;100
925;0;"eryk";925;100;0
0;1140;"eryka";1140;0;100
0;1395;"erykah";1395;0;100
146;6696;"eryn";6842;2.13387898275358;97.8661210172464
0;16;"eryne";16;0;100
0;1585;"erynn";1585;0;100
0;179;"erynne";179;0;100
0;6;"eryonna";6;0;100
0;10;"eryss";10;0;100
70;0;"eryx";70;100;0
30;81;"erza";111;27.027027027027;72.972972972973
0;5;"erzsebet";5;0;100
278;51;"esa";329;84.4984802431611;15.5015197568389
0;23;"esabel";23;0;100
0;528;"esabella";528;0;100
0;30;"esabelle";30;0;100
9;0;"esad";9;100;0
1721;0;"esai";1721;100;0
88;0;"esaiah";88;100;0
425;0;"esaias";425;100;0
12;0;"esaie";12;100;0
5;0;"esain";5;100;0
58;0;"esam";58;100;0
5;0;"esat";5;100;0
2616;0;"esau";2616;100;0
138;0;"esaul";138;100;0
383;0;"esaw";383;100;0
0;20;"esbeidi";20;0;100
0;255;"esbeidy";255;0;100
39;0;"esben";39;100;0
0;86;"esbeydi";86;0;100
0;13;"esbeydy";13;0;100
30;0;"escar";30;100;0
0;86;"escarlet";86;0;100
0;29;"escarleth";29;0;100
0;22;"escarlett";22;0;100
0;5;"eschelle";5;0;100
199;0;"escher";199;100;0
80;0;"eschol";80;100;0
299;0;"esco";299;100;0
0;12;"escolastica";12;0;100
997;0;"esdras";997;100;0
6;0;"esean";6;100;0
5;0;"esekiel";5;100;0
0;5;"esenia";5;0;100
0;17;"eseosa";17;0;100
2785;0;"esequiel";2785;100;0
0;12;"eseta";12;0;100
12;0;"esey";12;100;0
553;0;"esgar";553;100;0
39;0;"esgardo";39;100;0
0;1642;"esha";1642;0;100
0;372;"eshaal";372;0;100
754;0;"eshaan";754;100;0
0;611;"eshal";611;0;100
959;0;"eshan";959;100;0
0;51;"eshana";51;0;100
0;110;"eshani";110;0;100
0;27;"eshanti";27;0;100
21;0;"eshaun";21;100;0
152;0;"eshawn";152;100;0
0;5;"eshawna";5;0;100
0;56;"eshe";56;0;100
0;5;"eshell";5;0;100
5;0;"esher";5;100;0
0;47;"eshika";47;0;100
5;0;"eshin";5;100;0
0;22;"eshita";22;0;100
10;0;"eshon";10;100;0
0;5;"eshter";5;0;100
10;0;"eshton";10;100;0
60;0;"eshwar";60;100;0
0;18;"esi";18;0;100
183;0;"esiah";183;100;0
128;0;"esias";128;100;0
10;0;"esiquiel";10;100;0
106;0;"esiquio";106;100;0
34;0;"eskel";34;100;0
313;0;"esker";313;100;0
14;0;"eskil";14;100;0
15;0;"esko";15;100;0
0;5;"eslem";5;0;100
257;11;"esley";268;95.8955223880597;4.1044776119403
104;358;"esli";462;22.5108225108225;77.4891774891775
60;36;"eslie";96;62.5;37.5
6;295;"esly";301;1.99335548172757;98.0066445182724
0;6;"eslyn";6;0;100
0;628;"esma";628;0;100
0;354;"esmae";354;0;100
38;0;"esmael";38;100;0
6;0;"esmail";6;100;0
0;11;"esmaralda";11;0;100
0;25;"esmarie";25;0;100
0;89;"esmay";89;0;100
0;3526;"esme";3526;0;100
0;388;"esmee";388;0;100
0;26;"esmer";26;0;100
0;10;"esmerai";10;0;100
0;5;"esmeraida";5;0;100
0;11;"esmerald";11;0;100
180;44102;"esmeralda";44282;0.406485705252699;99.5935142947473
0;46;"esmeraldo";46;0;100
0;536;"esmerelda";536;0;100
0;11;"esmerie";11;0;100
0;6;"esmerlda";6;0;100
0;36;"esmi";36;0;100
0;5;"esmia";5;0;100
0;38;"esmie";38;0;100
0;64;"esmirna";64;0;100
429;0;"esmond";429;100;0
5;0;"esnaider";5;100;0
15;0;"esneider";15;100;0
6;0;"esneyder";6;100;0
0;5;"esohe";5;0;100
10;31;"esosa";41;24.390243902439;75.609756097561
0;6;"espanola";6;0;100
0;72;"esparanza";72;0;100
465;31;"espen";496;93.75;6.25
33;5;"esper";38;86.8421052631579;13.1578947368421
0;10;"esperance";10;0;100
0;499;"esperansa";499;0;100
35;18565;"esperanza";18600;0.188172043010753;99.8118279569892
17;7;"espie";24;70.8333333333333;29.1666666666667
168;0;"espiridion";168;100;0
153;17;"espn";170;90;10
0;10;"esprit";10;0;100
19;0;"espy";19;100;0
7;38;"espyn";45;15.5555555555556;84.4444444444444
11;0;"esque";11;100;0
6;0;"esquiel";6;100;0
15;0;"esquire";15;100;0
0;315;"esra";315;0;100
0;89;"esraa";89;0;100
8;0;"esrael";8;100;0
29;0;"esrom";29;100;0
362;96;"essa";458;79.0393013100437;20.9606986899563
88;0;"essam";88;100;0
0;169;"essance";169;0;100
0;9017;"essence";9017;0;100
0;81;"essense";81;0;100
318;0;"essex";318;100;0
25;0;"essey";25;100;0
0;6;"essfa";6;0;100
36;0;"essiah";36;100;0
0;189;"essica";189;0;100
1093;34640;"essie";35733;3.0587971902723;96.9412028097277
0;23;"essiemae";23;0;100
40;0;"essien";40;100;0
0;5;"essined";5;0;100
5;0;"essix";5;100;0
0;5;"essye";5;0;100
0;199;"essynce";199;0;100
22;3837;"esta";3859;0.570095879761596;99.4299041202384
222;0;"estaban";222;100;0
0;17;"estacia";17;0;100
0;45;"estafani";45;0;100
0;12;"estafania";12;0;100
60;0;"estal";60;100;0
0;86;"estalee";86;0;100
0;5;"estaleen";5;0;100
0;179;"estalene";179;0;100
0;56;"estaline";56;0;100
0;28;"estanislada";28;0;100
275;0;"estanislado";275;100;0
199;0;"estanislao";199;100;0
5;0;"estarlin";5;100;0
10;0;"estavan";10;100;0
5;0;"estavon";5;100;0
29343;31;"esteban";29374;99.8944644924082;0.105535507591748
43;704;"estee";747;5.75635876840696;94.243641231593
0;88;"esteen";88;0;100
271;0;"estefan";271;100;0
0;982;"estefana";982;0;100
16;4089;"estefani";4105;0.389768574908648;99.6102314250914
5;6071;"estefania";6076;0.0822909809084924;99.9177090190915
0;511;"estefanie";511;0;100
0;24;"estefanita";24;0;100
0;176;"estefanny";176;0;100
153;0;"estefano";153;100;0
5;4610;"estefany";4615;0.108342361863489;99.8916576381365
0;5;"estefanya";5;0;100
0;46;"esteffany";46;0;100
0;7;"estefhany";7;0;100
2336;446;"estel";2782;83.9683680805176;16.0316319194824
0;8115;"estela";8115;0;100
0;16;"estele";16;0;100
0;10;"estelee";10;0;100
0;186;"estelene";186;0;100
0;5;"esteline";5;0;100
0;69;"estelita";69;0;100
531;3867;"estell";4398;12.0736698499318;87.9263301500682
50;33196;"estella";33246;0.150394032364796;99.8496059676352
0;170;"estellar";170;0;100
154;47545;"estelle";47699;0.322857921549718;99.6771420784503
0;27;"estellene";27;0;100
0;40;"esteller";40;0;100
0;22;"estelline";22;0;100
0;5;"estellise";5;0;100
177;0;"esten";177;100;0
116;0;"estephan";116;100;0
0;174;"estephani";174;0;100
0;451;"estephania";451;0;100
0;1755;"estephanie";1755;0;100
0;795;"estephany";795;0;100
30;0;"estephen";30;100;0
856;14534;"ester";15390;5.56205328135153;94.4379467186485
0;84;"estera";84;0;100
0;13;"esterine";13;0;100
0;73;"esterlene";73;0;100
0;17;"esterline";17;0;100
493;16;"estes";509;96.8565815324165;3.1434184675835
8288;10;"estevan";8298;99.879489033502;0.120510966497951
28;0;"esteve";28;100;0
715;0;"esteven";715;100;0
94;0;"estevon";94;100;0
0;5;"esteysi";5;0;100
0;76;"estha";76;0;100
0;28;"esthefani";28;0;100
0;17;"esthefania";17;0;100
0;186;"esthefany";186;0;100
0;12;"esthel";12;0;100
0;327;"esthela";327;0;100
903;234994;"esther";235897;0.382794185597952;99.617205814402
0;13;"estherlene";13;0;100
0;6;"esthermae";6;0;100
0;79;"esti";79;0;100
0;6;"estibaliz";6;0;100
79;0;"estiben";79;100;0
0;227;"estie";227;0;100
908;0;"estil";908;100;0
1230;7;"estill";1237;99.4341147938561;0.565885206143896
0;7;"estilla";7;0;100
34;0;"estin";34;100;0
0;43;"estine";43;0;100
5;0;"estis";5;100;0
0;5;"estivalis";5;0;100
196;0;"estiven";196;100;0
670;75;"estle";745;89.9328859060403;10.0671140939597
60;0;"estol";60;100;0
1841;0;"eston";1841;100;0
0;74;"estoria";74;0;100
5;0;"estrada";5;100;0
0;16;"estralita";16;0;100
0;24;"estrelita";24;0;100
0;13262;"estrella";13262;0;100
0;1037;"estrellita";1037;0;100
0;185;"estreya";185;0;100
368;0;"estuardo";368;100;0
188;0;"estus";188;100;0
0;395;"esty";395;0;100
0;53;"esveidy";53;0;100
5;0;"esven";5;100;0
269;0;"esvin";269;100;0
75;0;"eswin";75;100;0
0;5;"eszter";5;0;100
0;5;"eta";5;0;100
173;0;"etai";173;100;0
5;0;"etalo";5;100;0
291;0;"etan";291;100;0
0;103;"etana";103;0;100
5;0;"etash";5;100;0
0;6;"etasha";6;0;100
0;20;"etelvina";20;0;100
5;0;"eternal";5;100;0
0;12;"eterniti";12;0;100
0;1520;"eternity";1520;0;100
0;1492;"etha";1492;0;100
5;0;"ethaen";5;100;0
0;70;"ethal";70;0;100
5;0;"etham";5;100;0
400622;667;"ethan";401289;99.8337856258208;0.166214374179208
95;0;"ethanael";95;100;0
30;0;"ethanalexander";30;100;0
6;0;"ethanandrew";6;100;0
23;0;"ethane";23;100;0
5;0;"ethaneal";5;100;0
13;0;"ethangabriel";13;100;0
16;0;"ethanial";16;100;0
794;0;"ethaniel";794;100;0
43;0;"ethanjacob";43;100;0
140;0;"ethanjames";140;100;0
5;0;"ethanjay";5;100;0
15;0;"ethanjohn";15;100;0
9;0;"ethanjoseph";9;100;0
18;0;"ethanmatthew";18;100;0
37;0;"ethanmichael";37;100;0
49;0;"ethann";49;100;0
6;0;"ethanpaul";6;100;0
0;14;"ethany";14;0;100
13;0;"ethean";13;100;0
1277;232350;"ethel";233627;0.546597781934451;99.4534022180655
0;10;"ethelann";10;0;100
167;5;"ethelbert";172;97.0930232558139;2.90697674418605
0;396;"ethelda";396;0;100
0;5;"etheldra";5;0;100
0;5;"etheldreda";5;0;100
0;10;"ethele";10;0;100
0;64;"ethelean";64;0;100
0;34;"ethelee";34;0;100
0;584;"etheleen";584;0;100
0;6;"ethelen";6;0;100
0;1837;"ethelene";1837;0;100
0;15;"ethelind";15;0;100
0;473;"etheline";473;0;100
0;115;"ethell";115;0;100
0;60;"ethelle";60;0;100
0;5;"ethellee";5;0;100
0;314;"ethelmae";314;0;100
0;5;"ethelmay";5;0;100
0;69;"ethelreda";69;0;100
0;10;"ethelrene";10;0;100
0;10;"ethelrine";10;0;100
0;69;"ethelwyn";69;0;100
0;4067;"ethelyn";4067;0;100
0;292;"ethelyne";292;0;100
0;18;"ethelynn";18;0;100
3550;0;"ethen";3550;100;0
66;1111;"ether";1177;5.60747663551402;94.392523364486
105;0;"etheridge";105;100;0
0;60;"etherine";60;0;100
30;0;"ethian";30;100;0
0;40;"ethie";40;0;100
0;5;"ethil";5;0;100
287;0;"ethin";287;100;0
0;59;"ethleen";59;0;100
0;652;"ethlyn";652;0;100
0;33;"ethna";33;0;100
0;95;"ethne";95;0;100
0;5;"ethny";5;0;100
267;0;"ethon";267;100;0
5;0;"ethredge";5;100;0
256;0;"ethridge";256;100;0
0;1900;"ethyl";1900;0;100
0;380;"ethyle";380;0;100
0;12;"ethyleen";12;0;100
0;62;"ethylene";62;0;100
1311;0;"ethyn";1311;100;0
5;0;"ethynn";5;100;0
1372;81;"etienne";1453;94.4253269098417;5.57467309015829
5;0;"etinosa";5;100;0
0;487;"etna";487;0;100
0;5;"etnie";5;0;100
0;201;"etoile";201;0;100
0;62;"etola";62;0;100
0;43;"etolia";43;0;100
27;0;"eton";27;100;0
0;5;"etonya";5;0;100
0;77;"etosha";77;0;100
0;7;"etoshia";7;0;100
0;132;"etoy";132;0;100
0;31;"etoya";31;0;100
7;0;"etoyi";7;100;0
0;14;"etoyle";14;0;100
0;104;"etrulia";104;0;100
23;0;"etsel";23;100;0
0;5;"etsub";5;0;100
0;69;"etsuko";69;0;100
5;0;"etsuo";5;100;0
23;32177;"etta";32200;0.0714285714285714;99.9285714285714
0;5;"ettalyn";5;0;100
0;95;"ettamae";95;0;100
0;99;"ettel";99;0;100
0;380;"etter";380;0;100
0;5;"etti";5;0;100
0;1165;"ettie";1165;0;100
375;0;"ettore";375;100;0
0;469;"etty";469;0;100
31;0;"etzio";31;100;0
0;23;"eua";23;0;100
393;0;"eual";393;100;0
321;0;"euan";321;100;0
0;5;"euba";5;0;100
12;0;"eubert";12;100;0
218;0;"euclid";218;100;0
64;0;"euclide";64;100;0
20;0;"euclides";20;100;0
0;38;"euda";38;0;100
0;10;"eudean";10;0;100
0;382;"eudelia";382;0;100
132;241;"eudell";373;35.3887399463807;64.6112600536193
0;5;"eudella";5;0;100
0;5;"eudena";5;0;100
0;19;"eudene";19;0;100
0;5;"eudice";5;0;100
0;16;"eudine";16;0;100
10;0;"eudon";10;100;0
0;1867;"eudora";1867;0;100
5;0;"eudy";5;100;0
692;0;"euel";692;100;0
511;0;"euell";511;100;0
0;23;"euella";23;0;100
0;5;"eufaula";5;0;100
0;65;"eufelia";65;0;100
0;675;"eufemia";675;0;100
63;0;"eufemio";63;100;0
0;23;"eufracia";23;0;100
11;0;"eufracio";11;100;0
0;5;"eufrasia";5;0;100
178;0;"eugean";178;100;0
226;0;"eugen";226;100;0
0;1151;"eugena";1151;0;100
370525;2533;"eugene";373058;99.3210171072595;0.678982892740539
15;27969;"eugenia";27984;0.0536020583190395;99.946397941681
0;2957;"eugenie";2957;0;100
4588;0;"eugenio";4588;100;0
0;6;"eugie";6;0;100
0;360;"eugina";360;0;100
297;0;"eugine";297;100;0
0;5;"euginia";5;0;100
5;0;"eugne";5;100;0
0;5;"eugonda";5;0;100
5;0;"euguene";5;100;0
351;0;"eugune";351;100;0
6;0;"euin";6;100;0
0;10;"eujin";10;0;100
320;42392;"eula";42712;0.749203970781045;99.250796029219
0;1622;"eulah";1622;0;100
0;386;"eulala";386;0;100
0;74;"eulalah";74;0;100
0;27;"eulalee";27;0;100
0;4026;"eulalia";4026;0;100
0;572;"eulalie";572;0;100
1500;0;"eulalio";1500;100;0
0;121;"eulamae";121;0;100
92;0;"eulan";92;100;0
0;136;"eulanda";136;0;100
0;6;"eulane";6;0;100
0;323;"eular";323;0;100
517;0;"eulas";517;100;0
0;18;"eulean";18;0;100
0;16;"eulee";16;0;100
0;5;"eulema";5;0;100
0;593;"eulene";593;0;100
38;0;"eules";38;100;0
12;0;"euless";12;100;0
0;97;"euleta";97;0;100
0;65;"eulia";65;0;100
234;5;"eulice";239;97.907949790795;2.09205020920502
36;0;"eulices";36;100;0
55;0;"eulie";55;100;0
0;5;"eulina";5;0;100
0;5;"eulinda";5;0;100
0;153;"euline";153;0;100
597;0;"eulis";597;100;0
296;0;"eulises";296;100;0
0;113;"eulla";113;0;100
0;82;"eulogia";82;0;100
738;0;"eulogio";738;100;0
0;15;"eulojia";15;0;100
32;0;"eulojio";32;100;0
67;0;"eulon";67;100;0
0;78;"eulonda";78;0;100
10;0;"eulos";10;100;0
22;0;"eulus";22;100;0
6;0;"eulys";6;100;0
0;9;"eumeka";9;0;100
5;285;"eun";290;1.72413793103448;98.2758620689655
0;1948;"euna";1948;0;100
0;6;"eunetta";6;0;100
0;10;"eunia";10;0;100
1145;74901;"eunice";76046;1.50566762222865;98.4943323777714
0;98;"eunie";98;0;100
0;6;"euniece";6;0;100
0;10;"eunika";10;0;100
0;22;"euniqua";22;0;100
10;580;"eunique";590;1.69491525423729;98.3050847457627
0;34;"eunise";34;0;100
0;24;"eunita";24;0;100
0;5;"eunji";5;0;100
0;144;"eupha";144;0;100
0;514;"euphemia";514;0;100
0;6;"euphoria";6;0;100
0;20;"euple";20;0;100
84;1254;"eura";1338;6.2780269058296;93.7219730941704
0;5;"euradell";5;0;100
273;0;"eural";273;100;0
0;5;"eurania";5;0;100
0;5;"eurasia";5;0;100
0;5;"euree";5;0;100
0;5;"eureeka";5;0;100
5;835;"eureka";840;0.595238095238095;99.4047619047619
5;0;"eurel";5;100;0
0;101;"euretha";101;0;100
0;58;"euretta";58;0;100
7;6;"euri";13;53.8461538461538;46.1538461538462
60;5;"euriah";65;92.3076923076923;7.69230769230769
0;16;"eurica";16;0;100
0;5;"euricka";5;0;100
10;5;"eurie";15;66.6666666666667;33.3333333333333
5;0;"euriel";5;100;0
6;0;"eurijah";6;100;0
0;81;"eurika";81;0;100
10;0;"euris";10;100;0
0;14;"eurith";14;0;100
0;17;"eurma";17;0;100
11;0;"eury";11;100;0
0;67;"eurydice";67;0;100
0;333;"eusebia";333;0;100
2954;0;"eusebio";2954;100;0
0;11;"eusevia";11;0;100
73;0;"eusevio";73;100;0
642;0;"eustace";642;100;0
0;156;"eustacia";156;0;100
291;0;"eustacio";291;100;0
52;0;"eustaquio";52;100;0
19;0;"eustice";19;100;0
5;0;"eustis";5;100;0
0;316;"eustolia";316;0;100
17;0;"eustolio";17;100;0
0;248;"eutha";248;0;100
0;10;"eutimia";10;0;100
225;0;"eutimio";225;100;0
10;0;"eutiquio";10;100;0
0;107;"euva";107;0;100
0;12;"euzelia";12;0;100
930;232817;"eva";233747;0.397866068869333;99.6021339311307
73;0;"evaan";73;100;0
0;15;"evabelle";15;0;100
0;5;"evada";5;0;100
0;93;"evadean";93;0;100
0;20;"evadell";20;0;100
0;72;"evadene";72;0;100
0;20;"evadine";20;0;100
0;101;"evadna";101;0;100
0;85;"evadne";85;0;100
0;5;"evaeh";5;0;100
0;99;"evagelia";99;0;100
30;0;"evagelos";30;100;0
0;38;"evagene";38;0;100
0;10;"evaggelia";10;0;100
0;6;"evagrace";6;0;100
0;577;"evah";577;0;100
0;11;"evaine";11;0;100
0;6;"evajane";6;0;100
0;45;"evajean";45;0;100
0;5;"evajo";5;0;100
0;13;"evalani";13;0;100
49;0;"evald";49;100;0
0;5;"evalean";5;0;100
0;868;"evalee";868;0;100
0;176;"evaleen";176;0;100
0;12;"evaleena";12;0;100
0;5;"evalei";5;0;100
0;112;"evaleigh";112;0;100
0;5;"evalen";5;0;100
0;1080;"evalena";1080;0;100
0;385;"evalene";385;0;100
0;24;"evalet";24;0;100
0;13;"evalett";13;0;100
0;89;"evalette";89;0;100
0;11;"evalia";11;0;100
0;86;"evalie";86;0;100
0;125;"evalin";125;0;100
0;1304;"evalina";1304;0;100
0;10;"evalinda";10;0;100
0;1355;"evaline";1355;0;100
0;5;"evalisa";5;0;100
0;116;"evalise";116;0;100
0;54;"evalisse";54;0;100
0;7;"evaliz";7;0;100
0;16;"evalou";16;0;100
0;88;"evaluna";88;0;100
0;29;"evaly";29;0;100
0;7269;"evalyn";7269;0;100
0;32;"evalyna";32;0;100
0;198;"evalyne";198;0;100
0;1951;"evalynn";1951;0;100
0;155;"evalynne";155;0;100
0;63;"evalyse";63;0;100
0;192;"evamae";192;0;100
0;132;"evamaria";132;0;100
0;835;"evamarie";835;0;100
257088;4035;"evan";261123;98.4547512092003;1.54524879079974
0;557;"evana";557;0;100
1779;0;"evander";1779;100;0
0;90;"evanee";90;0;100
0;132;"evanell";132;0;100
0;10;"evanelle";10;0;100
0;10;"evaney";10;0;100
0;5;"evangalene";5;0;100
0;107;"evangaline";107;0;100
12;0;"evangel";12;100;0
0;310;"evangela";310;0;100
0;18;"evangeleen";18;0;100
0;5;"evangelena";5;0;100
0;159;"evangelene";159;0;100
0;995;"evangelia";995;0;100
0;43;"evangelin";43;0;100
0;8899;"evangelina";8899;0;100
0;23897;"evangeline";23897;0;100
0;5;"evangelita";5;0;100
11;0;"evangelo";11;100;0
1020;0;"evangelos";1020;100;0
0;11;"evangely";11;0;100
0;293;"evangelyn";293;0;100
0;68;"evangelyne";68;0;100
0;57;"evangelynn";57;0;100
0;37;"evangline";37;0;100
0;159;"evani";159;0;100
0;147;"evania";147;0;100
0;243;"evanie";243;0;100
5;0;"evanjames";5;100;0
0;56;"evanjelina";56;0;100
382;308;"evann";690;55.3623188405797;44.6376811594203
0;647;"evanna";647;0;100
0;11;"evannah";11;0;100
0;173;"evanne";173;0;100
0;5;"evanni";5;0;100
0;53;"evannie";53;0;100
0;115;"evanny";115;0;100
0;6;"evanora";6;0;100
4644;43;"evans";4687;99.0825688073395;0.917431192660551
10;0;"evanston";10;100;0
12;0;"evante";12;100;0
0;45;"evanthia";45;0;100
0;496;"evany";496;0;100
0;5;"evanyelin";5;0;100
5;0;"evar";5;100;0
16;0;"evard";16;100;0
0;27;"evarista";27;0;100
1806;0;"evaristo";1806;100;0
0;47;"evarose";47;0;100
120;0;"evart";120;100;0
0;10;"evaughn";10;0;100
6;0;"evay";6;100;0
0;25;"evaya";25;0;100
0;10;"evdokia";10;0;100
0;5;"evdoxia";5;0;100
0;23619;"eve";23619;0;100
0;180;"evea";180;0;100
0;11;"eveah";11;0;100
0;5;"eveana";5;0;100
0;11;"eveanna";11;0;100
0;321;"evee";321;0;100
15;0;"evel";15;100;0
0;155;"evelean";155;0;100
0;5;"evelee";5;0;100
0;322;"eveleen";322;0;100
0;39;"eveleigh";39;0;100
0;60;"evelen";60;0;100
0;1261;"evelena";1261;0;100
0;742;"evelene";742;0;100
0;9;"evelet";9;0;100
0;38;"evelett";38;0;100
0;104;"evelette";104;0;100
0;7;"eveli";7;0;100
0;1379;"evelia";1379;0;100
0;10;"evelie";10;0;100
0;5;"evelien";5;0;100
5;6640;"evelin";6645;0.0752445447705041;99.9247554552295
0;4213;"evelina";4213;0;100
0;15;"evelinda";15;0;100
0;2864;"eveline";2864;0;100
0;10;"evelinn";10;0;100
580;0;"evelio";580;100;0
0;10;"evelis";10;0;100
0;59;"evelise";59;0;100
0;56;"evelisse";56;0;100
0;11;"eveliz";11;0;100
8;0;"evell";8;100;0
0;146;"evella";146;0;100
0;115;"evellyn";115;0;100
0;200;"evely";200;0;100
1830;544746;"evelyn";546576;0.334811627294283;99.6651883727057
0;230;"evelyna";230;0;100
0;3839;"evelyne";3839;0;100
0;7186;"evelynn";7186;0;100
0;1029;"evelynne";1029;0;100
0;28;"evelynrose";28;0;100
0;5;"evelyon";5;0;100
0;12;"evelyse";12;0;100
0;11;"evemarie";11;0;100
462;0;"even";462;100;0
0;23;"evenie";23;0;100
0;16;"evening";16;0;100
0;5;"evennie";5;0;100
0;6;"evenny";6;0;100
222;0;"evens";222;100;0
0;157;"eveny";157;0;100
2976;1865;"ever";4841;61.4749018797769;38.5250981202231
0;5;"evera";5;0;100
121;0;"everado";121;100;0
5;5;"everal";10;50;50
250;0;"everard";250;100;0
4324;0;"everardo";4324;100;0
0;8;"everdeen";8;0;100
0;5;"everee";5;0;100
889;119;"everest";1008;88.1944444444444;11.8055555555556
650;0;"everet";650;100;0
96211;575;"everett";96786;99.4059058128242;0.594094187175831
0;28;"everetta";28;0;100
10019;155;"everette";10174;98.4765087477885;1.52349125221152
0;55;"evergreen";55;0;100
124;0;"everhett";124;100;0
46;0;"everick";46;100;0
430;0;"everitt";430;100;0
0;29;"everlea";29;0;100
0;513;"everlean";513;0;100
0;53;"everleaner";53;0;100
0;1039;"everlee";1039;0;100
0;11;"everleen";11;0;100
0;17;"everlei";17;0;100
0;2262;"everleigh";2262;0;100
0;1093;"everlena";1093;0;100
0;313;"everlene";313;0;100
0;5;"everlener";5;0;100
0;569;"everley";569;0;100
0;41;"everli";41;0;100
0;195;"everlie";195;0;100
0;5;"everliegh";5;0;100
0;10;"everlin";10;0;100
0;217;"everlina";217;0;100
0;336;"everline";336;0;100
11;8855;"everly";8866;0.124069478908189;99.8759305210918
0;745;"everlyn";745;0;100
0;75;"everlynn";75;0;100
0;13;"everlyse";13;0;100
36;17;"evern";53;67.9245283018868;32.0754716981132
225;0;"everrett";225;100;0
5;0;"everrette";5;100;0
307;0;"everson";307;100;0
0;5;"eversyn";5;0;100
3032;0;"evert";3032;100;0
33;0;"everth";33;100;0
489;0;"everton";489;100;0
930;0;"evertt";930;100;0
82;0;"evertte";82;100;0
10;10;"every";20;50;50
15;0;"evester";15;100;0
0;20;"evet";20;0;100
0;309;"evett";309;0;100
0;334;"evetta";334;0;100
0;5739;"evette";5739;0;100
0;616;"evey";616;0;100
0;11;"eveyln";11;0;100
0;65;"evgenia";65;0;100
0;269;"evi";269;0;100
0;837;"evia";837;0;100
221;236;"evian";457;48.3588621444201;51.6411378555799
0;439;"eviana";439;0;100
0;355;"evianna";355;0;100
87;11232;"evie";11319;0.768619135966075;99.2313808640339
0;27;"evienne";27;0;100
0;5;"evila";5;0;100
0;5;"evilin";5;0;100
0;5;"evilo";5;0;100
0;27;"evilyn";27;0;100
0;5;"evilynn";5;0;100
2856;478;"evin";3334;85.6628674265147;14.3371325734853
0;11;"evina";11;0;100
16;0;"evins";16;100;0
17;0;"evion";17;100;0
0;5;"evionna";5;0;100
0;1165;"evita";1165;0;100
0;8;"evleen";8;0;100
0;5;"evleyn";5;0;100
0;23;"evlin";23;0;100
0;6;"evline";6;0;100
0;898;"evlyn";898;0;100
0;38;"evlynn";38;0;100
0;5;"evnika";5;0;100
187;0;"evo";187;100;0
18;0;"evodio";18;100;0
0;85;"evola";85;0;100
0;69;"evoleht";69;0;100
0;975;"evolet";975;0;100
0;137;"evoleth";137;0;100
0;120;"evolett";120;0;100
0;150;"evolette";150;0;100
715;3697;"evon";4412;16.2058023572076;83.7941976427924
0;104;"evona";104;0;100
0;193;"evonda";193;0;100
5;410;"evone";415;1.20481927710843;98.7951807228916
0;39;"evoni";39;0;100
0;12;"evonia";12;0;100
0;10;"evonie";10;0;100
0;5;"evonn";5;0;100
0;320;"evonna";320;0;100
0;4969;"evonne";4969;0;100
0;12;"evonnie";12;0;100
0;17;"evonny";17;0;100
5;0;"evontae";5;100;0
63;0;"evonte";63;100;0
0;486;"evony";486;0;100
0;240;"evora";240;0;100
0;5;"evorn";5;0;100
0;10;"evra";10;0;100
5;0;"evran";5;100;0
299;14;"evren";313;95.5271565495208;4.47284345047923
133;0;"evrett";133;100;0
7;0;"evrhett";7;100;0
13;0;"evrin";13;100;0
0;329;"evva";329;0;100
0;103;"evvie";103;0;100
0;23;"evvy";23;0;100
0;934;"evy";934;0;100
0;5;"evyan";5;0;100
0;5;"evyana";5;0;100
0;17;"evyanna";17;0;100
0;28;"evyenia";28;0;100
0;10;"evylen";10;0;100
0;5;"evylene";5;0;100
0;10;"evylin";10;0;100
630;783;"evyn";1413;44.5859872611465;55.4140127388535
5;226;"evynn";231;2.16450216450216;97.8354978354978
0;48;"evynne";48;0;100
0;11;"evyonne";11;0;100
0;279;"ewa";279;0;100
865;0;"ewald";865;100;0
5;0;"ewalt";5;100;0
2154;0;"ewan";2154;100;0
0;5;"ewanda";5;0;100
0;24;"ewaoluwa";24;0;100
297;0;"eward";297;100;0
122;0;"ewart";122;100;0
68;0;"ewel";68;100;0
0;113;"ewelina";113;0;100
1958;7;"ewell";1965;99.6437659033079;0.356234096692112
108;0;"ewen";108;100;0
105;0;"ewin";105;100;0
1120;0;"ewing";1120;100;0
0;364;"exa";364;0;100
6;0;"exael";6;100;0
71;0;"exander";71;100;0
5;0;"exar";5;100;0
1092;0;"exavier";1092;100;0
10;0;"exavion";10;100;0
69;0;"exavior";69;100;0
11;19;"excel";30;36.6666666666667;63.3333333333333
412;5;"excell";417;98.8009592326139;1.19904076738609
5;0;"exel";5;100;0
15;0;"exell";15;100;0
29;0;"exequiel";29;100;0
0;36;"exer";36;0;100
0;8;"exia";8;0;100
6;1815;"exie";1821;0.329489291598023;99.670510708402
0;46;"exilda";46;0;100
15;0;"exiquio";15;100;0
253;43;"exodus";296;85.472972972973;14.527027027027
47;0;"exton";47;100;0
11;0;"exum";11;100;0
5;0;"exzander";5;100;0
286;0;"exzavier";286;100;0
32;0;"exzavion";32;100;0
29;0;"exzavior";29;100;0
0;6;"eya";6;0;100
776;0;"eyad";776;100;0
346;0;"eyal";346;100;0
1154;0;"eyan";1154;100;0
0;215;"eyana";215;0;100
0;10;"eyani";10;0;100
0;187;"eyanna";187;0;100
20;0;"eyas";20;100;0
50;0;"eyasu";50;100;0
101;0;"eydan";101;100;0
207;5;"eyden";212;97.6415094339623;2.35849056603774
0;5;"eydi";5;0;100
0;478;"eydie";478;0;100
7;0;"eyen";7;100;0
0;5;"eygpt";5;0;100
13;0;"eyian";13;100;0
0;79;"eyla";79;0;100
0;11;"eylah";11;0;100
22;0;"eylan";22;100;0
0;206;"eyleen";206;0;100
0;135;"eylin";135;0;100
0;12;"eylul";12;0;100
44;0;"eymen";44;100;0
0;181;"eymi";181;0;100
0;11;"eymy";11;0;100
8;0;"eyoab";8;100;0
170;0;"eyob";170;100;0
147;0;"eyoel";147;100;0
48;0;"eyon";48;100;0
0;16;"eyona";16;0;100
0;84;"eyonna";84;0;100
39;0;"eyosias";39;100;0
0;18;"eyra";18;0;100
5;11;"eyram";16;31.25;68.75
314;0;"eytan";314;100;0
445;0;"eythan";445;100;0
0;28;"eythel";28;0;100
5;0;"eythen";5;100;0
28;0;"eyuel";28;100;0
0;58;"eyva";58;0;100
5;0;"eyvan";5;100;0
0;228;"eyvette";228;0;100
5;0;"eyvin";5;100;0
0;18;"eyvone";18;0;100
0;771;"eyvonne";771;0;100
6;0;"ezaan";6;100;0
0;5;"ezabel";5;0;100
0;306;"ezabella";306;0;100
0;10;"ezabelle";10;0;100
11;0;"ezael";11;100;0
5;0;"ezai";5;100;0
43;0;"ezaiah";43;100;0
322;0;"ezana";322;100;0
0;11;"ezara";11;0;100
0;32;"ezaria";32;0;100
92;40;"ezariah";132;69.6969696969697;30.3030303030303
0;15;"ezariyah";15;0;100
14;0;"ezavier";14;100;0
10;0;"ezayah";10;100;0
13;0;"eze";13;100;0
106;0;"ezechiel";106;100;0
5;0;"ezekeal";5;100;0
12;0;"ezekeial";12;100;0
109;0;"ezekeil";109;100;0
49;0;"ezekiah";49;100;0
1132;0;"ezekial";1132;100;0
12;0;"ezekias";12;100;0
35975;13;"ezekiel";35988;99.9638768478382;0.0361231521618317
13;0;"ezekio";13;100;0
11;0;"ezekyel";11;100;0
208;0;"ezel";208;100;0
3192;411;"ezell";3603;88.5928393005829;11.4071606994172
0;180;"ezella";180;0;100
40;74;"ezelle";114;35.0877192982456;64.9122807017544
23;0;"ezequel";23;100;0
95;0;"ezequias";95;100;0
12777;0;"ezequiel";12777;100;0
5;0;"ezequil";5;100;0
12;0;"ezera";12;100;0
54;0;"ezeriah";54;100;0
0;25;"ezgi";25;0;100
205;5;"eziah";210;97.6190476190476;2.38095238095238
13;0;"ezias";13;100;0
0;5;"ezichi";5;0;100
29;0;"eziel";29;100;0
37;0;"ezikiel";37;100;0
0;154;"ezinne";154;0;100
579;0;"ezio";579;100;0
12;0;"ezion";12;100;0
5;0;"eziquel";5;100;0
5;0;"eziquiel";5;100;0
5;0;"eziquio";5;100;0
0;5;"eziya";5;0;100
0;10;"eziyah";10;0;100
24;0;"ezkiel";24;100;0
0;11;"ezlynn";11;0;100
0;123;"ezma";123;0;100
0;109;"ezmae";109;0;100
0;16;"ezmariah";16;0;100
0;21;"ezmay";21;0;100
0;47;"ezme";47;0;100
0;329;"ezmeralda";329;0;100
0;44;"ezmerelda";44;0;100
0;6;"ezmie";6;0;100
0;59;"ezola";59;0;100
0;22;"ezora";22;0;100
0;7;"ezoza";7;0;100
0;19;"ezperanza";19;0;100
5;0;"ezquiel";5;100;0
40153;1842;"ezra";41995;95.613763543279;4.38623645672104
106;0;"ezrael";106;100;0
735;209;"ezrah";944;77.8601694915254;22.1398305084746
53;0;"ezreal";53;100;0
7;0;"ezren";7;100;0
96;544;"ezri";640;15;85
0;8;"ezria";8;0;100
7;0;"ezriah";7;100;0
0;61;"ezrie";61;0;100
446;0;"ezriel";446;100;0
0;28;"eztli";28;0;100
23;0;"ezykiel";23;100;0
0;13;"ezzah";13;0;100
498;0;"ezzard";498;100;0
19;118;"ezzie";137;13.8686131386861;86.1313868613139
26;0;"faaiz";26;100;0
0;11;"faaizah";11;0;100
62;0;"faaris";62;100;0
0;67;"faatima";67;0;100
0;125;"faatimah";125;0;100
11;0;"faaz";11;100;0
49;0;"fabain";49;100;0
60;0;"faber";60;100;0
0;21;"fabia";21;0;100
37683;327;"fabian";38010;99.1397000789266;0.860299921073402
0;1416;"fabiana";1416;0;100
0;158;"fabianna";158;0;100
67;0;"fabiano";67;100;0
616;0;"fabien";616;100;0
0;5;"fabiene";5;0;100
0;486;"fabienne";486;0;100
0;58;"fabiha";58;0;100
15;0;"fabin";15;100;0
2401;0;"fabio";2401;100;0
53;8749;"fabiola";8802;0.602135878209498;99.3978641217905
185;0;"fabion";185;100;0
6;0;"fabius";6;100;0
5;96;"fable";101;4.95049504950495;95.049504950495
0;5;"fabriana";5;0;100
453;0;"fabrice";453;100;0
939;0;"fabricio";939;100;0
0;42;"fabrienne";42;0;100
10;0;"fabrisio";10;100;0
1073;0;"fabrizio";1073;100;0
118;0;"fabrizzio";118;100;0
0;5;"faby";5;0;100
81;0;"fabyan";81;100;0
0;6;"fachon";6;0;100
163;0;"facundo";163;100;0
0;5;"fada";5;0;100
0;7;"fadak";7;0;100
0;10;"fadeelah";10;0;100
141;0;"fadel";141;100;0
716;0;"fadi";716;100;0
0;75;"fadia";75;0;100
98;0;"fadil";98;100;0
0;6;"fadila";6;0;100
0;19;"fadima";19;0;100
0;26;"fadra";26;0;100
0;203;"faduma";203;0;100
0;262;"fadumo";262;0;100
0;17;"fadwa";17;0;100
229;0;"fady";229;100;0
0;2238;"fae";2238;0;100
0;7;"faedra";7;0;100
25;5;"faelan";30;83.3333333333333;16.6666666666667
0;100;"faelyn";100;0;100
0;69;"faelynn";69;0;100
0;15;"faeryn";15;0;100
1094;0;"fahad";1094;100;0
240;0;"fahd";240;100;0
80;0;"fahed";80;100;0
689;0;"faheem";689;100;0
0;12;"faheemah";12;0;100
409;0;"fahim";409;100;0
0;140;"fahima";140;0;100
0;5;"fahm";5;0;100
10;0;"fahmi";10;100;0
0;74;"fahmida";74;0;100
0;23;"fahren";23;0;100
0;6;"fahtima";6;0;100
0;5;"faida";5;0;100
0;906;"faiga";906;0;100
0;191;"faige";191;0;100
0;2342;"faigy";2342;0;100
0;12;"faiha";12;0;100
71;6;"fain";77;92.2077922077922;7.79220779220779
0;40;"faina";40;0;100
5;0;"faiq";5;100;0
5;41;"fair";46;10.8695652173913;89.1304347826087
0;6;"faira";6;0;100
0;6;"fairah";6;0;100
11;0;"fairbanks";11;100;0
0;20;"fairen";20;0;100
0;55;"fairie";55;0;100
121;0;"fairley";121;100;0
0;2141;"fairy";2141;0;100
0;5;"fairyn";5;0;100
0;30;"faisa";30;0;100
1712;0;"faisal";1712;100;0
44;0;"faison";44;100;0
229;130767;"faith";130996;0.174814498152615;99.8251855018474
0;251;"faithann";251;0;100
0;63;"faithanne";63;0;100
0;666;"faithe";666;0;100
0;38;"faithful";38;0;100
0;301;"faithlyn";301;0;100
0;346;"faithlynn";346;0;100
0;39;"faithmarie";39;0;100
20;0;"faiyaz";20;100;0
444;0;"faiz";444;100;0
0;739;"faiza";739;0;100
135;0;"faizaan";135;100;0
0;251;"faizah";251;0;100
5;0;"faizal";5;100;0
528;0;"faizan";528;100;0
234;0;"faizon";234;100;0
0;10;"fajar";10;0;100
0;169;"fajr";169;0;100
0;45;"falak";45;0;100
0;137;"falan";137;0;100
0;124;"falana";124;0;100
0;11;"falanda";11;0;100
12;0;"falando";12;100;0
0;15;"falba";15;0;100
12;0;"falco";12;100;0
323;23;"falcon";346;93.3526011560694;6.64739884393064
0;218;"falecia";218;0;100
0;5;"faleisha";5;0;100
0;192;"falen";192;0;100
0;16;"falena";16;0;100
0;11;"falencia";11;0;100
0;165;"falesha";165;0;100
0;20;"faleshia";20;0;100
0;651;"falicia";651;0;100
0;157;"falicity";157;0;100
0;48;"falin";48;0;100
0;50;"falina";50;0;100
0;98;"faline";98;0;100
0;82;"falisa";82;0;100
0;905;"falisha";905;0;100
0;13;"falishia";13;0;100
0;137;"fallan";137;0;100
0;64;"fallen";64;0;100
0;5;"fallie";5;0;100
0;15;"fallin";15;0;100
388;8633;"fallon";9021;4.3010752688172;95.6989247311828
94;0;"fallou";94;100;0
0;1106;"fallyn";1106;0;100
0;50;"fallynn";50;0;100
83;1857;"falon";1940;4.27835051546392;95.7216494845361
0;19;"falona";19;0;100
0;25;"falonda";25;0;100
0;6;"falone";6;0;100
0;907;"falyn";907;0;100
0;486;"falynn";486;0;100
0;5;"falynne";5;0;100
0;6;"falysha";6;0;100
0;61;"fama";61;0;100
0;7;"fame";7;0;100
0;44;"famie";44;0;100
136;0;"famous";136;100;0
0;12;"fan";12;0;100
0;12;"fana";12;0;100
0;508;"fanchon";508;0;100
0;15;"fanci";15;0;100
0;11;"fancie";11;0;100
0;479;"fancy";479;0;100
0;5;"faneisha";5;0;100
0;12;"fanessa";12;0;100
0;64;"fani";64;0;100
0;37;"fania";37;0;100
0;30;"fanie";30;0;100
0;39;"fanisha";39;0;100
0;33;"fanita";33;0;100
0;5;"fanna";5;0;100
0;5;"fannette";5;0;100
329;67436;"fannie";67765;0.485501365011437;99.5144986349886
0;10;"fanniemae";10;0;100
0;7892;"fanny";7892;0;100
0;411;"fannye";411;0;100
5;0;"fanon";5;100;0
0;927;"fanta";927;0;100
0;5;"fantaisa";5;0;100
0;64;"fantasha";64;0;100
0;120;"fantashia";120;0;100
0;1789;"fantasia";1789;0;100
0;107;"fantasy";107;0;100
0;5;"fantaysia";5;0;100
0;29;"fantazia";29;0;100
29;0;"fanuel";29;100;0
0;90;"fany";90;0;100
0;30;"fanya";30;0;100
97;0;"faolan";97;100;0
0;5;"faora";5;0;100
0;1024;"fara";1024;0;100
66;0;"faraaz";66;100;0
14;0;"farad";14;100;0
0;21;"faraday";21;0;100
90;4855;"farah";4945;1.82002022244692;98.1799797775531
6;0;"farai";6;100;0
24;0;"faraj";24;100;0
45;0;"faraji";45;100;0
6;24;"faran";30;20;80
571;0;"faraz";571;100;0
12;0;"farbod";12;100;0
106;0;"fard";106;100;0
109;0;"fardeen";109;100;0
7;0;"fardi";7;100;0
46;0;"fardin";46;100;0
0;16;"fardosa";16;0;100
0;83;"fardowsa";83;0;100
13;0;"fardy";13;100;0
585;0;"fareed";585;100;0
0;95;"fareeda";95;0;100
0;94;"fareedah";94;0;100
0;94;"fareeha";94;0;100
0;273;"faren";273;0;100
671;0;"fares";671;100;0
0;116;"farha";116;0;100
71;0;"farhaan";71;100;0
250;0;"farhad";250;100;0
1282;0;"farhan";1282;100;0
0;236;"farhana";236;0;100
0;129;"farheen";129;0;100
0;81;"farhiya";81;0;100
0;13;"farhiyo";13;0;100
0;5;"fari";5;0;100
0;162;"faria";162;0;100
0;17;"fariah";17;0;100
0;12;"fariba";12;0;100
0;5;"farica";5;0;100
0;5;"farice";5;0;100
817;0;"farid";817;100;0
0;533;"farida";533;0;100
0;18;"faridah";18;0;100
0;393;"fariha";393;0;100
0;11;"farihah";11;0;100
17;97;"farin";114;14.9122807017544;85.0877192982456
0;21;"farina";21;0;100
2168;20;"faris";2188;99.0859232175503;0.914076782449726
0;11;"farisa";11;0;100
10;0;"fariz";10;100;0
0;29;"fariza";29;0;100
0;6;"farjana";6;0;100
1053;10;"farley";1063;99.0592662276576;0.940733772342427
0;34;"farm";34;0;100
139;0;"farmer";139;100;0
0;54;"farnaz";54;0;100
6;0;"farnum";6;100;0
0;15;"farol";15;0;100
2319;52;"faron";2371;97.8068325601012;2.19316743989878
68;0;"farooq";68;100;0
202;0;"farouk";202;100;0
11;0;"farouq";11;100;0
0;113;"farra";113;0;100
7;0;"farrad";7;100;0
7;10284;"farrah";10291;0.0680206005247304;99.9319793994753
11;0;"farrakhan";11;100;0
0;74;"farran";74;0;100
0;10;"farrar";10;0;100
831;38;"farrel";869;95.6271576524741;4.37284234752589
4298;472;"farrell";4770;90.104821802935;9.89517819706499
264;609;"farren";873;30.2405498281787;69.7594501718213
0;62;"farrie";62;0;100
15;115;"farrin";130;11.5384615384615;88.4615384615385
2872;508;"farris";3380;84.9704142011834;15.0295857988166
573;114;"farron";687;83.4061135371179;16.5938864628821
5;0;"farrow";5;100;0
5;0;"farrukh";5;100;0
0;155;"farryn";155;0;100
17;0;"farshad";17;100;0
5;0;"farshid";5;100;0
0;145;"fartun";145;0;100
41;0;"faruk";41;100;0
75;0;"faruq";75;100;0
0;6;"farwa";6;0;100
0;89;"faryal";89;0;100
0;5;"faryl";5;0;100
0;363;"faryn";363;0;100
0;5;"farynn";5;0;100
99;0;"farzad";99;100;0
25;0;"farzan";25;100;0
0;198;"farzana";198;0;100
0;7;"farzeen";7;0;100
5;0;"farzin";5;100;0
0;31;"farzona";31;0;100
0;11;"fasha";11;0;100
0;28;"fashionette";28;0;100
5;0;"fatai";5;100;0
951;119;"fate";1070;88.8785046728972;11.1214953271028
0;25;"fateema";25;0;100
0;5;"fateemah";5;0;100
15;0;"fateen";15;100;0
149;0;"fateh";149;100;0
0;6;"fateha";6;0;100
0;725;"fatema";725;0;100
0;157;"fatemah";157;0;100
0;38;"fatemeh";38;0;100
0;174;"faten";174;0;100
30;7;"fathi";37;81.0810810810811;18.9189189189189
0;35;"fathia";35;0;100
0;206;"fathima";206;0;100
0;5;"fathma";5;0;100
0;7;"fatia";7;0;100
75;0;"fatih";75;100;0
0;85;"fatiha";85;0;100
0;86;"fatim";86;0;100
46;30542;"fatima";30588;0.150385772198248;99.8496142278018
0;2742;"fatimah";2742;0;100
0;5;"fatimat";5;0;100
0;224;"fatimata";224;0;100
0;32;"fatimatou";32;0;100
0;49;"fatimazahra";49;0;100
0;81;"fatime";81;0;100
0;6;"fatimetou";6;0;100
10;59;"fatin";69;14.4927536231884;85.5072463768116
0;334;"fatina";334;0;100
0;62;"fatisha";62;0;100
0;701;"fatma";701;0;100
0;22;"fatmah";22;0;100
0;237;"fatmata";237;0;100
0;36;"fatme";36;0;100
0;21;"fatmeh";21;0;100
18;0;"fatmir";18;100;0
0;5;"fatmire";5;0;100
0;849;"fatou";849;0;100
0;22;"fatouma";22;0;100
0;1728;"fatoumata";1728;0;100
0;41;"fatoumatta";41;0;100
0;5;"fattima";5;0;100
0;12;"fatu";12;0;100
0;394;"fatuma";394;0;100
0;168;"fatumata";168;0;100
0;5;"fatumo";5;0;100
0;10;"fatyma";10;0;100
0;222;"faun";222;0;100
0;123;"fauna";123;0;100
0;5;"faune";5;0;100
0;5;"fauniel";5;0;100
71;0;"faust";71;100;0
0;10;"fausta";10;0;100
53;0;"faustin";53;100;0
0;1530;"faustina";1530;0;100
0;362;"faustine";362;0;100
3632;0;"faustino";3632;100;0
2644;0;"fausto";2644;100;0
0;11;"fauzia";11;0;100
0;56;"faven";56;0;100
2548;0;"favian";2548;100;0
0;35;"faviana";35;0;100
525;0;"favio";525;100;0
0;1956;"faviola";1956;0;100
22;0;"favion";22;100;0
62;290;"favor";352;17.6136363636364;82.3863636363636
37;317;"favour";354;10.4519774011299;89.5480225988701
11;0;"fawad";11;100;0
236;0;"fawaz";236;100;0
19;0;"fawkes";19;100;0
0;5450;"fawn";5450;0;100
0;168;"fawna";168;0;100
0;70;"fawnda";70;0;100
0;71;"fawne";71;0;100
0;17;"fawnia";17;0;100
0;5;"fawnna";5;0;100
28;0;"fawwaz";28;100;0
5;0;"fawzan";5;100;0
53;0;"fawzi";53;100;0
0;6;"fawzia";6;0;100
3704;30128;"fay";33832;10.9482147079688;89.0517852920312
0;6;"faya";6;0;100
0;10;"fayann";10;0;100
10;0;"fayaz";10;100;0
16;0;"faybian";16;100;0
0;5;"faydean";5;0;100
0;6;"faydell";6;0;100
5;0;"fayden";5;100;0
0;6;"faydene";6;0;100
0;169;"faydra";169;0;100
518;66265;"faye";66783;0.775646496862974;99.224353503137
0;6;"fayelyn";6;0;100
0;60;"fayelynn";60;0;100
0;5;"fayerene";5;0;100
0;23;"fayeth";23;0;100
0;1061;"fayetta";1061;0;100
368;573;"fayette";941;39.1073326248672;60.8926673751328
151;0;"fayez";151;100;0
0;10;"fayga";10;0;100
0;10;"fayha";10;0;100
0;10;"fayla";10;0;100
0;16;"faylee";16;0;100
0;5;"fayleen";5;0;100
0;297;"faylene";297;0;100
0;12;"faylin";12;0;100
0;57;"faylinn";57;0;100
0;10;"faylyn";10;0;100
0;55;"faylynn";55;0;100
0;47;"fayma";47;0;100
54;99;"fayne";153;35.2941176470588;64.7058823529412
0;40;"faynell";40;0;100
0;70;"fayola";70;0;100
0;584;"fayrene";584;0;100
0;10;"fayrouz";10;0;100
182;0;"faysal";182;100;0
14;0;"fayt";14;100;0
0;11;"fayte";11;0;100
0;1795;"fayth";1795;0;100
0;953;"faythe";953;0;100
0;17;"fayza";17;0;100
17;0;"fazal";17;100;0
11;0;"fazon";11;100;0
0;78;"fe";78;0;100
0;521;"feather";521;0;100
0;26;"febbie";26;0;100
0;231;"febe";231;0;100
0;12;"feben";12;0;100
0;5;"febie";5;0;100
0;6;"febra";6;0;100
66;0;"fed";66;100;0
0;5;"feda";5;0;100
0;6;"fedaa";6;0;100
0;7;"feddie";7;0;100
5;0;"fedel";5;100;0
21;0;"fedele";21;100;0
0;5;"fedelia";5;0;100
0;46;"fedelina";46;0;100
0;189;"federica";189;0;100
75;0;"federick";75;100;0
8317;5;"federico";8322;99.9399182888729;0.0600817111271329
80;0;"fedor";80;100;0
0;212;"fedora";212;0;100
0;65;"fedra";65;0;100
72;0;"fedrick";72;100;0
6;0;"feffrey";6;100;0
0;64;"feiga";64;0;100
0;186;"feige";186;0;100
0;43;"feigy";43;0;100
6;0;"feish";6;100;0
5;34;"fela";39;12.8205128205128;87.1794871794872
6;0;"felando";6;100;0
0;130;"felcia";130;0;100
124;0;"felder";124;100;0
0;30;"felechia";30;0;100
0;10267;"felecia";10267;0;100
0;5;"felecie";5;0;100
0;84;"felecity";84;0;100
0;68;"feleica";68;0;100
0;10;"feleicia";10;0;100
0;5;"feleisha";5;0;100
0;6;"felena";6;0;100
0;177;"felesha";177;0;100
0;128;"feleshia";128;0;100
0;87;"felesia";87;0;100
174;0;"feliberto";174;100;0
0;2086;"felica";2086;0;100
694;4151;"felice";4845;14.3240454076367;85.6759545923633
0;17;"felicea";17;0;100
0;226;"felicha";226;0;100
0;35;"felichia";35;0;100
279;90547;"felicia";90826;0.307180763217581;99.6928192367824
0;528;"feliciana";528;0;100
2167;0;"feliciano";2167;100;0
0;131;"felicidad";131;0;100
0;129;"felicie";129;0;100
0;1840;"felicita";1840;0;100
0;1936;"felicitas";1936;0;100
0;106;"felicite";106;0;100
0;58;"feliciti";58;0;100
6;11650;"felicity";11656;0.0514756348661634;99.9485243651338
33;0;"feliks";33;100;0
60;0;"felimon";60;100;0
0;358;"felina";358;0;100
0;5;"felinda";5;0;100
0;2196;"felipa";2196;0;100
29242;133;"felipe";29375;99.5472340425532;0.452765957446808
19;0;"felipedejesus";19;100;0
0;5;"felipita";5;0;100
62;42;"felis";104;59.6153846153846;40.3846153846154
0;1991;"felisa";1991;0;100
0;6;"feliscia";6;0;100
0;63;"felise";63;0;100
0;5886;"felisha";5886;0;100
0;331;"felishia";331;0;100
0;258;"felisia";258;0;100
6;0;"felisiano";6;100;0
0;42;"felisita";42;0;100
0;57;"felisitas";57;0;100
0;18;"felisity";18;0;100
0;282;"felissa";282;0;100
0;5;"felissia";5;0;100
0;783;"felita";783;0;100
65176;569;"felix";65745;99.1345349456232;0.865465054376759
290;379;"feliz";669;43.3482810164424;56.6517189835576
0;133;"feliza";133;0;100
5;0;"felizardo";5;100;0
0;6;"felizia";6;0;100
0;5;"fellicia";5;0;100
5;0;"fellipe";5;100;0
0;113;"felma";113;0;100
0;8;"feloniz";8;0;100
6483;5;"felton";6488;99.922934648582;0.0770653514180025
25;0;"feltus";25;100;0
5;0;"felty";5;100;0
0;19;"felycia";19;0;100
12;0;"felyx";12;100;0
5;1292;"female";1297;0.38550501156515;99.6144949884349
27;24;"femi";51;52.9411764705882;47.0588235294118
0;5;"femke";5;0;100
50;0;"fender";50;100;0
0;108;"fendi";108;0;100
0;23;"fenet";23;0;100
25;0;"feng";25;100;0
0;12;"fenisha";12;0;100
476;142;"fenix";618;77.0226537216828;22.9773462783171
0;5;"fenley";5;0;100
17;0;"fenn";17;100;0
0;40;"fenna";40;0;100
10;0;"fennec";10;100;0
5;0;"fennell";5;100;0
41;0;"fenner";41;100;0
0;25;"fennie";25;0;100
5;0;"fenrir";5;100;0
42;0;"fenris";42;100;0
1859;0;"fenton";1859;100;0
21;0;"fentress";21;100;0
34;0;"fenway";34;100;0
38;0;"fenwick";38;100;0
5;0;"feodor";5;100;0
0;10;"feodora";10;0;100
0;39;"feona";39;0;100
29;0;"ferando";29;100;0
402;0;"feras";402;100;0
569;0;"ferd";569;100;0
228;0;"ferdie";228;100;0
5;0;"ferdinan";5;100;0
7965;0;"ferdinand";7965;100;0
294;0;"ferdinando";294;100;0
17;0;"ferdy";17;100;0
5;0;"ferdynand";5;100;0
37;0;"ferenc";37;100;0
0;125;"fergie";125;0;100
400;0;"fergus";400;100;0
88;0;"ferguson";88;100;0
5;0;"ferid";5;100;0
0;5;"feride";5;0;100
0;10;"ferin";10;0;100
91;0;"ferlando";91;100;0
257;0;"ferlin";257;100;0
0;7;"ferma";7;0;100
1331;0;"ferman";1331;100;0
5;0;"fermen";5;100;0
4544;0;"fermin";4544;100;0
0;200;"fermina";200;0;100
253;0;"fermon";253;100;0
472;34016;"fern";34488;1.36859197401995;98.6314080259801
0;44;"ferna";44;0;100
145;0;"fernado";145;100;0
7;0;"fernan";7;100;0
1470;0;"fernand";1470;100;0
26;14580;"fernanda";14606;0.178009037381898;99.8219909626181
0;521;"fernande";521;0;100
5;0;"fernandeo";5;100;0
384;0;"fernandez";384;100;0
94123;585;"fernando";94708;99.3823119483043;0.617688051695738
0;4337;"ferne";4337;0;100
6;5;"fernell";11;54.5454545454545;45.4545454545455
0;15;"fernetta";15;0;100
14;0;"ferney";14;100;0
344;11;"fernie";355;96.9014084507042;3.09859154929577
5;0;"fernley";5;100;0
10;544;"ferol";554;1.80505415162455;98.1949458483755
10;0;"feroz";10;100;0
0;5;"ferra";5;0;100
0;76;"ferrah";76;0;100
18;18;"ferran";36;50;50
5;0;"ferrante";5;100;0
7;45;"ferrari";52;13.4615384615385;86.5384615384615
5;0;"ferras";5;100;0
377;22;"ferrel";399;94.4862155388471;5.51378446115288
1906;162;"ferrell";2068;92.1663442940039;7.83365570599613
0;5;"ferren";5;0;100
0;6;"ferrie";6;0;100
5;0;"ferril";5;100;0
10;0;"ferrill";10;100;0
27;90;"ferrin";117;23.0769230769231;76.9230769230769
2443;252;"ferris";2695;90.6493506493507;9.35064935064935
15;22;"ferrol";37;40.5405405405405;59.4594594594595
101;12;"ferron";113;89.3805309734513;10.6194690265487
60;10;"ferry";70;85.7142857142857;14.2857142857143
0;15;"ferryn";15;0;100
0;11;"feryal";11;0;100
0;6;"feryl";6;0;100
5;0;"fess";5;100;0
5;0;"fester";5;100;0
325;0;"festus";325;100;0
0;5;"fetina";5;0;100
0;149;"feven";149;0;100
0;100;"fey";100;0;100
0;5;"feyisayo";5;0;100
41;0;"feynman";41;100;0
5;0;"feysal";5;100;0
0;25;"feyza";25;0;100
56;0;"fher";56;100;0
5;0;"fhernando";5;100;0
0;195;"fia";195;0;100
0;10;"fiala";10;0;100
0;11;"fiama";11;0;100
0;23;"fiamma";23;0;100
0;68;"fiana";68;0;100
0;188;"fianna";188;0;100
0;5;"fibbie";5;0;100
10538;0;"fidel";10538;100;0
0;410;"fidela";410;0;100
0;635;"fidelia";635;0;100
0;11;"fidelina";11;0;100
6;0;"fidelio";6;100;0
49;114;"fidelis";163;30.0613496932515;69.9386503067485
0;5;"fidella";5;0;100
10;0;"fidelmar";10;100;0
0;60;"fidencia";60;0;100
2158;0;"fidencio";2158;100;0
6;0;"fidensio";6;100;0
99;0;"field";99;100;0
34;0;"fielden";34;100;0
20;0;"fielder";20;100;0
500;0;"fielding";500;100;0
6;0;"fieldon";6;100;0
68;0;"fields";68;100;0
0;28;"fiera";28;0;100
0;45;"fierra";45;0;100
0;6;"fiesta";6;0;100
0;6;"fiffany";6;0;100
0;141;"fifi";141;0;100
5;0;"fiifi";5;100;0
0;5;"fikir";5;0;100
0;45;"fikisha";45;0;100
36;0;"filadelfio";36;100;0
0;12;"filamena";12;0;100
452;0;"filbert";452;100;0
34;0;"filberto";34;100;0
513;0;"filemon";513;100;0
10;0;"filex";10;100;0
5;0;"fili";5;100;0
2400;0;"filiberto";2400;100;0
0;83;"filicia";83;0;100
0;5;"filicity";5;0;100
244;0;"filimon";244;100;0
1803;0;"filip";1803;100;0
0;5;"filipa";5;0;100
391;0;"filipe";391;100;0
0;91;"filippa";91;0;100
567;0;"filippo";567;100;0
6;0;"filippos";6;100;0
0;5;"filisha";5;0;100
0;5;"filiz";5;0;100
22;0;"fillip";22;100;0
234;0;"fillmore";234;100;0
17;0;"filmon";17;100;0
268;0;"filmore";268;100;0
0;5124;"filomena";5124;0;100
175;0;"filomeno";175;100;0
0;5;"filomina";5;0;100
0;19;"filsan";19;0;100
0;31;"filza";31;0;100
123;0;"fin";123;100;0
0;252;"fina";252;0;100
78;0;"finas";78;100;0
6;5;"finau";11;54.5454545454545;45.4545454545455
123;0;"finbar";123;100;0
11;0;"finbarr";11;100;0
60;0;"finch";60;100;0
158;25;"findlay";183;86.3387978142077;13.6612021857924
167;66;"findley";233;71.6738197424893;28.3261802575107
44;0;"fineas";44;100;0
0;6;"finely";6;0;100
81;0;"fines";81;100;0
0;5;"finessa";5;0;100
17;195;"finesse";212;8.0188679245283;91.9811320754717
16;0;"finest";16;100;0
448;0;"finian";448;100;0
2029;5;"finis";2034;99.7541789577188;0.245821042281219
5;0;"finland";5;100;0
643;131;"finlay";774;83.0749354005168;16.9250645994832
0;5;"finlea";5;0;100
49;420;"finlee";469;10.4477611940298;89.5522388059701
0;457;"finleigh";457;0;100
8468;10750;"finley";19218;44.0628577375377;55.9371422624623
5;0;"finly";5;100;0
16129;247;"finn";16376;98.4916951636541;1.50830483634587
0;20;"finna";20;0;100
52;0;"finnan";52;100;0
70;0;"finnbar";70;100;0
73;0;"finnean";73;100;0
377;0;"finneas";377;100;0
6669;45;"finnegan";6714;99.3297587131367;0.670241286863271
91;0;"finneus";91;100;0
1998;0;"finnian";1998;100;0
267;0;"finnick";267;100;0
25;5;"finnie";30;83.3333333333333;16.6666666666667
754;0;"finnigan";754;100;0
61;0;"finnis";61;100;0
5;0;"finnlay";5;100;0
52;41;"finnlee";93;55.9139784946236;44.0860215053763
0;79;"finnleigh";79;0;100
1817;1007;"finnley";2824;64.3413597733711;35.6586402266289
31;15;"finnly";46;67.3913043478261;32.6086956521739
0;144;"finola";144;0;100
279;0;"fintan";279;100;0
41;0;"finton";41;100;0
21;0;"finus";21;100;0
0;37;"fion";37;0;100
5;24321;"fiona";24326;0.0205541396037162;99.9794458603963
415;0;"fionn";415;100;0
0;606;"fionna";606;0;100
6;0;"fionnlagh";6;100;0
0;112;"fionnuala";112;0;100
0;5;"fionnula";5;0;100
0;122;"fiora";122;0;100
465;11;"fiore";476;97.6890756302521;2.3109243697479
0;153;"fiorela";153;0;100
0;1062;"fiorella";1062;0;100
0;5;"fiorenza";5;0;100
6;11;"fiori";17;35.2941176470588;64.7058823529412
0;5;"fira";5;0;100
386;0;"firas";386;100;0
0;36;"firdaus";36;0;100
8;0;"firdavs";8;100;0
0;22;"firdaws";22;0;100
0;5;"firdous";5;0;100
188;0;"firman";188;100;0
97;0;"firmin";97;100;0
0;5;"firyal";5;0;100
1442;8;"fischer";1450;99.448275862069;0.551724137931034
157;0;"fishel";157;100;0
4050;22;"fisher";4072;99.4597249508841;0.540275049115914
10;0;"fisnik";10;100;0
0;16;"fitima";16;0;100
223;0;"fitz";223;100;0
1236;0;"fitzgerald";1236;100;0
320;0;"fitzhugh";320;100;0
61;0;"fitzpatrick";61;100;0
163;0;"fitzroy";163;100;0
22;0;"fitzwilliam";22;100;0
18;39;"fiyinfoluwa";57;31.5789473684211;68.4210526315789
0;354;"fiza";354;0;100
0;111;"fizza";111;0;100
0;5;"fjolla";5;0;100
31;0;"flabio";31;100;0
45;0;"flake";45;100;0
0;5;"flame";5;0;100
24;0;"flamur";24;100;0
0;500;"flannery";500;0;100
0;115;"flara";115;0;100
0;36;"flarence";36;0;100
0;5;"flarrie";5;0;100
15;0;"flash";15;100;0
0;15;"flaura";15;0;100
0;5;"flava";5;0;100
22;0;"flavel";22;100;0
0;1614;"flavia";1614;0;100
25;0;"flavian";25;100;0
36;0;"flavil";36;100;0
2837;0;"flavio";2837;100;0
11;0;"flavious";11;100;0
10;0;"flavis";10;100;0
76;0;"flavius";76;100;0
80;5;"flay";85;94.1176470588235;5.88235294117647
0;5;"flechia";5;0;100
0;221;"flecia";221;0;100
0;380;"fleda";380;0;100
155;0;"fleet";155;100;0
0;649;"fleeta";649;0;100
96;0;"fleetwood";96;100;0
203;0;"flem";203;100;0
932;0;"fleming";932;100;0
0;5;"flemmie";5;0;100
35;0;"flemming";35;100;0
102;0;"flemon";102;100;0
0;5;"flerida";5;0;100
0;7;"flesha";7;0;100
0;24;"fleshia";24;0;100
0;1171;"fleta";1171;0;100
12776;128;"fletcher";12904;99.008059516429;0.991940483570986
0;172;"fleur";172;0;100
0;322;"fleurette";322;0;100
5;0;"flex";5;100;0
0;5;"flicia";5;0;100
1946;0;"flint";1946;100;0
5;0;"flip";5;100;0
0;1849;"flo";1849;0;100
0;35;"floda";35;0;100
0;5;"flodie";5;0;100
0;37;"floe";37;0;100
0;212;"floella";212;0;100
0;65;"floetta";65;0;100
0;10;"floice";10;0;100
42;0;"floid";42;100;0
0;5;"floie";5;0;100
0;72;"flois";72;0;100
0;10;"flona";10;0;100
0;988;"flonnie";988;0;100
92;6788;"flor";6880;1.33720930232558;98.6627906976744
167;58059;"flora";58226;0.28681345103562;99.7131865489644
0;68;"florabel";68;0;100
0;55;"florabell";55;0;100
0;296;"florabelle";296;0;100
0;5;"floraida";5;0;100
0;95;"floraine";95;0;100
0;10;"floral";10;0;100
0;21;"floralee";21;0;100
0;41;"floramae";41;0;100
12;0;"floran";12;100;0
0;1506;"florance";1506;0;100
0;15;"florann";15;0;100
0;6;"floranne";6;0;100
0;22;"florastine";22;0;100
18;0;"flord";18;100;0
0;5;"flordemaria";5;0;100
0;353;"flordia";353;0;100
0;58;"flore";58;0;100
0;92;"florean";92;0;100
0;30;"florece";30;0;100
0;14;"florecita";14;0;100
0;15;"floreda";15;0;100
0;372;"floree";372;0;100
0;167;"floreen";167;0;100
0;287;"floreine";287;0;100
0;212;"florella";212;0;100
28;0;"floren";28;100;0
0;187;"florena";187;0;100
1162;285877;"florence";287039;0.404823037984385;99.5951769620156
0;1374;"florencia";1374;0;100
2963;0;"florencio";2963;100;0
0;121;"florenda";121;0;100
0;4563;"florene";4563;0;100
50;0;"florent";50;100;0
0;991;"florentina";991;0;100
12;614;"florentine";626;1.91693290734824;98.0830670926518
3014;0;"florentino";3014;100;0
23;9;"florenz";32;71.875;28.125
6;0;"florenzo";6;100;0
19;11;"flores";30;63.3333333333333;36.6666666666667
0;19;"floresita";19;0;100
0;21;"florestela";21;0;100
0;170;"florestine";170;0;100
0;6;"floreta";6;0;100
0;20;"floretha";20;0;100
0;2035;"floretta";2035;0;100
0;358;"florette";358;0;100
0;17;"flori";17;0;100
0;1564;"floria";1564;0;100
3385;55;"florian";3440;98.4011627906977;1.59883720930233
0;22;"floriana";22;0;100
0;5;"floribel";5;0;100
5;0;"floriberto";5;100;0
0;526;"florice";526;0;100
5;3009;"florida";3014;0.165892501658925;99.8341074983411
0;39;"floridalma";39;0;100
0;75;"floride";75;0;100
0;791;"florie";791;0;100
0;6;"florien";6;0;100
0;270;"floriene";270;0;100
34;0;"florin";34;100;0
0;394;"florina";394;0;100
0;10;"florince";10;0;100
0;1830;"florinda";1830;0;100
48;0;"florindo";48;100;0
5;10939;"florine";10944;0.045687134502924;99.9543128654971
5;0;"florio";5;100;0
22;669;"floris";691;3.18379160636758;96.8162083936324
0;5;"florisa";5;0;100
0;5;"florisel";5;0;100
0;492;"florita";492;0;100
0;24;"flormaria";24;0;100
0;141;"flornce";141;0;100
0;1283;"florrie";1283;0;100
0;5;"florrine";5;0;100
31;17;"flory";48;64.5833333333333;35.4166666666667
20;0;"floryan";20;100;0
0;5;"flosie";5;0;100
37;17979;"flossie";18016;0.205373001776199;99.7946269982238
0;39;"flossy";39;0;100
0;5;"flourish";5;0;100
26;0;"flournoy";26;100;0
0;79;"flower";79;0;100
304;5517;"floy";5821;5.22247036591651;94.7775296340835
0;5;"floya";5;0;100
12;512;"floyce";524;2.29007633587786;97.7099236641221
147247;1268;"floyd";148515;99.1462141871191;0.853785812880854
0;20;"floyda";20;0;100
310;0;"floyde";310;100;0
0;5;"floydell";5;0;100
0;33;"floydene";33;0;100
0;6;"floydia";6;0;100
0;660;"floye";660;0;100
117;0;"floyed";117;100;0
21;0;"flozell";21;100;0
3567;316;"flynn";3883;91.861962400206;8.13803759979397
53;0;"flynt";53;100;0
67;0;"foch";67;100;0
74;0;"foday";74;100;0
27;0;"fode";27;100;0
5;0;"foister";5;100;0
0;13;"fola";13;0;100
0;10;"folami";10;0;100
6;0;"folarin";6;100;0
0;355;"folasade";355;0;100
0;174;"folashade";174;0;100
32;0;"foley";32;100;0
0;5;"folia";5;0;100
5;0;"folke";5;100;0
0;5;"foluke";5;0;100
29;0;"fon";29;100;0
0;4112;"fonda";4112;0;100
301;5;"fong";306;98.3660130718954;1.63398692810458
0;11;"fonisha";11;0;100
39;147;"fonnie";186;20.9677419354839;79.0322580645161
11;12;"fonta";23;47.8260869565217;52.1739130434783
193;137;"fontaine";330;58.4848484848485;41.5151515151515
0;10;"fontana";10;0;100
5;0;"fontane";5;100;0
0;589;"fontella";589;0;100
0;6;"fontelle";6;0;100
0;5;"fontilla";5;0;100
5;0;"fonza";5;100;0
56;0;"fonzie";56;100;0
35;0;"fonzo";35;100;0
6;0;"forace";6;100;0
0;5;"foram";5;0;100
198;0;"forbes";198;100;0
5;0;"forbus";5;100;0
5827;5;"ford";5832;99.9142661179698;0.0857338820301783
5;0;"forde";5;100;0
13;0;"fordham";13;100;0
0;5;"fordie";5;0;100
95;0;"fordyce";95;100;0
14268;391;"forest";14659;97.3326966368784;2.66730336312163
34;0;"forester";34;100;0
0;310;"forestine";310;0;100
5;0;"forestt";5;100;0
11;286;"forever";297;3.7037037037037;96.2962962962963
26;0;"forman";26;100;0
0;37;"formeka";37;0;100
127;0;"forney";127;100;0
46393;869;"forrest";47262;98.1613135288392;1.83868647116076
98;0;"forrester";98;100;0
0;128;"forrestine";128;0;100
13;0;"forrestt";13;100;0
10;0;"forris";10;100;0
38;0;"forster";38;100;0
5;0;"fort";5;100;0
761;0;"fortino";761;100;0
0;59;"fortuna";59;0;100
0;253;"fortunata";253;0;100
0;5;"fortunate";5;0;100
895;0;"fortunato";895;100;0
128;214;"fortune";342;37.4269005847953;62.5730994152047
0;5;"forum";5;0;100
0;16;"fosteen";16;0;100
10536;129;"foster";10665;98.7904360056259;1.20956399437412
0;5;"fostina";5;0;100
0;21;"fostine";21;0;100
0;12;"fotima";12;0;100
0;368;"fotini";368;0;100
82;0;"fotios";82;100;0
17;0;"fotis";17;100;0
0;24;"foua";24;0;100
347;0;"fouad";347;100;0
113;0;"fount";113;100;0
129;0;"fountain";129;100;0
0;5;"fouzia";5;0;100
186;0;"fowler";186;100;0
1830;25;"fox";1855;98.6522911051213;1.34770889487871
183;0;"foxx";183;100;0
0;5;"foxy";5;0;100
2087;421;"foy";2508;83.213716108453;16.7862838915471
119;254;"foye";373;31.9034852546917;68.0965147453083
5;0;"foyster";5;100;0
0;5;"fozie";5;0;100
6;0;"fraak";6;100;0
0;5;"fraces";5;0;100
0;5;"fracine";5;0;100
7;0;"fracisco";7;100;0
0;378;"fradel";378;0;100
0;241;"frady";241;0;100
5;0;"frager";5;100;0
0;354;"fraida";354;0;100
0;5;"fraidel";5;0;100
0;735;"fraidy";735;0;100
46;0;"frak";46;100;0
5;0;"frampton";5;100;0
361;4969;"fran";5330;6.77298311444653;93.2270168855535
16;0;"franc";16;100;0
0;364;"franca";364;0;100
0;11;"franccesca";11;0;100
374;1152;"france";1526;24.5085190039318;75.4914809960681
0;87;"francee";87;0;100
0;179;"franceen";179;0;100
0;5;"francel";5;0;100
0;329;"francelia";329;0;100
0;17;"francelina";17;0;100
5;10;"francell";15;33.3333333333333;66.6666666666667
0;350;"francella";350;0;100
0;28;"francelle";28;0;100
0;8;"francellia";8;0;100
0;69;"francely";69;0;100
0;623;"francena";623;0;100
0;1724;"francene";1724;0;100
0;212;"francenia";212;0;100
4682;561328;"frances";566010;0.827193865832759;99.1728061341672
0;62;"francesa";62;0;100
10;19;"francesc";29;34.4827586206897;65.5172413793103
33;28163;"francesca";28196;0.117037877713151;99.8829621222868
7171;0;"francesco";7171;100;0
0;22;"francese";22;0;100
0;319;"franceska";319;0;100
0;172;"francess";172;0;100
0;74;"francessca";74;0;100
0;161;"francetta";161;0;100
0;17;"francey";17;0;100
0;16;"franchell";16;0;100
0;102;"franchelle";102;0;100
0;4162;"franchesca";4162;0;100
39;0;"franchesco";39;100;0
0;1836;"francheska";1836;0;100
0;8;"franchessca";8;0;100
0;18;"franchesska";18;0;100
0;37;"franchester";37;0;100
0;10;"franchetta";10;0;100
0;12;"franchette";12;0;100
0;6;"franchezca";6;0;100
0;91;"franchon";91;0;100
223;0;"franchot";223;100;0
0;230;"franci";230;0;100
0;776;"francia";776;0;100
25;0;"francico";25;100;0
6;1831;"francie";1837;0.326619488296135;99.6733805117039
0;15;"franciene";15;0;100
13;889;"francies";902;1.44124168514412;98.5587583148559
0;100;"francile";100;0;100
0;148;"francille";148;0;100
0;1620;"francina";1620;0;100
11;35747;"francine";35758;0.0307623468874098;99.9692376531126
276749;27280;"francis";304029;91.0271717500633;8.97282824993668
8;0;"francisc";8;100;0
61;11843;"francisca";11904;0.512432795698925;99.4875672043011
130990;954;"francisco";131944;99.2769659855696;0.723034014430364
123;0;"franciscojavier";123;100;0
5;0;"franciscojr";5;100;0
5;0;"franciscus";5;100;0
0;17;"francise";17;0;100
0;16;"franciska";16;0;100
459;0;"franciso";459;100;0
67;0;"franciszek";67;100;0
0;5;"franciszka";5;0;100
0;6;"francita";6;0;100
142;0;"franck";142;100;0
5;0;"franclin";5;100;0
6402;0;"franco";6402;100;0
1677;5;"francois";1682;99.7027348394768;0.297265160523187
0;607;"francoise";607;0;100
5;0;"francsico";5;100;0
0;159;"francy";159;0;100
0;121;"francyne";121;0;100
0;124;"francys";124;0;100
0;5;"franda";5;0;100
138;0;"frandy";138;100;0
0;5;"franes";5;0;100
0;16;"franey";16;0;100
0;36;"frani";36;0;100
0;19;"frania";19;0;100
7;0;"franics";7;100;0
5;0;"franis";5;100;0
26;0;"franisco";26;100;0
849745;4221;"frank";853966;99.5057180262446;0.494281973755395
0;17;"franka";17;0;100
67;0;"franke";67;100;0
0;193;"frankee";193;0;100
6;0;"frankel";6;100;0
139;5;"frankey";144;96.5277777777778;3.47222222222222
73;917;"franki";990;7.37373737373737;92.6262626262626
40303;31792;"frankie";72095;55.902628476316;44.097371523684
28;0;"frankin";28;100;0
58;0;"franklen";58;100;0
132623;708;"franklin";133331;99.4689907073374;0.531009292662622
5;0;"frankline";5;100;0
5;0;"frankly";5;100;0
5844;20;"franklyn";5864;99.6589358799454;0.34106412005457
0;5;"franklynn";5;0;100
236;0;"franko";236;100;0
2765;45;"franky";2810;98.3985765124555;1.60142348754448
6;266;"frankye";272;2.20588235294118;97.7941176470588
0;45;"frann";45;0;100
0;5;"franne";5;0;100
0;188;"frannie";188;0;100
0;90;"franny";90;0;100
149;0;"frans";149;100;0
0;73;"franshesca";73;0;100
0;195;"fransheska";195;0;100
0;10;"fransica";10;0;100
825;0;"fransico";825;100;0
0;406;"fransisca";406;0;100
2967;0;"fransisco";2967;100;0
0;47;"frantasia";47;0;100
5;0;"frantisek";5;100;0
1023;0;"frantz";1023;100;0
16;0;"frantzy";16;100;0
0;5;"franyelis";5;0;100
2720;0;"franz";2720;100;0
0;15;"franzetta";15;0;100
0;186;"franziska";186;0;100
446;0;"fraser";446;100;0
36;0;"frasier";36;100;0
11;0;"fray";11;100;0
0;59;"fraya";59;0;100
0;8;"frayah";8;0;100
0;61;"frayda";61;0;100
110;0;"frazer";110;100;0
1977;0;"frazier";1977;100;0
328;0;"fread";328;100;0
0;124;"freada";124;0;100
312898;1800;"fred";314698;99.4280230570261;0.571976942973899
26;39481;"freda";39507;0.0658111220796315;99.9341888779204
8;0;"fredarius";8;100;0
0;6;"fredasia";6;0;100
0;1457;"fredda";1457;0;100
134;0;"fredderick";134;100;0
70;63;"freddi";133;52.6315789473684;47.3684210526316
0;6;"freddia";6;0;100
21;0;"freddick";21;100;0
72241;10024;"freddie";82265;87.8149881480581;12.1850118519419
1160;0;"freddrick";1160;100;0
25452;172;"freddy";25624;99.3287542928504;0.671245707149547
0;99;"freddye";99;0;100
0;5;"fredeline";5;0;100
15;0;"frederi";15;100;0
13686;0;"frederic";13686;100;0
0;2188;"frederica";2188;0;100
621;0;"frederich";621;100;0
251693;1105;"frederick";252798;99.5628921114882;0.437107888511776
0;1820;"fredericka";1820;0;100
1031;0;"frederico";1031;100;0
477;0;"frederik";477;100;0
0;73;"frederika";73;0;100
0;11;"frederique";11;0;100
830;86;"fredi";916;90.6113537117904;9.38864628820961
0;2307;"fredia";2307;0;100
303;0;"fredick";303;100;0
1189;40;"fredie";1229;96.7453213995118;3.2546786004882
0;10;"fredina";10;0;100
0;18;"fredine";18;0;100
35;0;"fredirick";35;100;0
176;0;"fredis";176;100;0
0;5;"fredith";5;0;100
0;5;"fredlyn";5;0;100
0;488;"fredna";488;0;100
5;0;"fredo";5;100;0
0;364;"fredonia";364;0;100
6;0;"fredreck";6;100;0
22;0;"fredreick";22;100;0
0;6;"fredreka";6;0;100
8228;0;"fredric";8228;100;0
0;890;"fredrica";890;0;100
424;0;"fredrich";424;100;0
62030;259;"fredrick";62289;99.5841962465283;0.415803753471721
0;1316;"fredricka";1316;0;100
10;0;"fredricks";10;100;0
196;0;"fredrico";196;100;0
347;0;"fredrik";347;100;0
0;286;"fredrika";286;0;100
4068;0;"fredy";4068;100;0
26;0;"fredys";26;100;0
46;50;"free";96;47.9166666666667;52.0833333333333
0;2941;"freeda";2941;0;100
0;20;"freedia";20;0;100
551;1034;"freedom";1585;34.7634069400631;65.2365930599369
300;0;"freeland";300;100;0
5;0;"freelin";5;100;0
5;0;"freelon";5;100;0
10144;5;"freeman";10149;99.9507340624692;0.0492659375307912
280;0;"freemon";280;100;0
27;0;"freemont";27;100;0
0;7;"freesia";7;0;100
0;10304;"freida";10304;0;100
0;15;"freidy";15;0;100
0;237;"freja";237;0;100
5;0;"freland";5;100;0
81;0;"freman";81;100;0
78;0;"fremon";78;100;0
466;0;"fremont";466;100;0
1003;10;"french";1013;99.0128331688055;0.987166831194472
68;292;"frenchie";360;18.8888888888889;81.1111111111111
0;10;"frenda";10;0;100
0;8;"frenesi";8;0;100
0;30;"freta";30;0;100
16;0;"frey";16;100;0
0;4611;"freya";4611;0;100
0;32;"freyah";32;0;100
0;30;"freyda";30;0;100
0;795;"freyja";795;0;100
5;0;"freylin";5;100;0
5;0;"frezell";5;100;0
0;16;"frica";16;0;100
0;5916;"frida";5916;0;100
0;23;"friday";23;0;100
0;5;"fridda";5;0;100
49;0;"friddie";49;100;0
0;21518;"frieda";21518;0;100
460;0;"friedrich";460;100;0
5;0;"friel";5;100;0
68;0;"friend";68;100;0
0;5;"frika";5;0;100
0;429;"frimet";429;0;100
0;20;"frimmy";20;0;100
0;61;"frimy";61;0;100
11;0;"frink";11;100;0
174;0;"frisco";174;100;0
0;5;"frita";5;0;100
0;5;"fritha";5;0;100
5876;0;"fritz";5876;100;0
43;0;"fritzgerald";43;100;0
0;285;"fritzi";285;0;100
0;69;"fritzie";69;0;100
0;10;"fritzy";10;0;100
5;0;"frizell";5;100;0
497;0;"froilan";497;100;0
0;618;"frona";618;0;100
0;5;"froney";5;0;100
0;380;"fronia";380;0;100
0;566;"fronie";566;0;100
0;180;"fronnie";180;0;100
5;0;"frontis";5;100;0
18;0;"frost";18;100;0
6;0;"frosty";6;100;0
6;0;"froy";6;100;0
596;0;"froylan";596;100;0
0;5;"frozine";5;0;100
0;135;"fruma";135;0;100
5;0;"frumencio";5;100;0
0;11;"frumie";11;0;100
112;0;"frutoso";112;100;0
0;124;"fryda";124;0;100
10;0;"fu";10;100;0
418;0;"fuad";418;100;0
272;0;"fue";272;100;0
0;91;"fujie";91;0;100
0;118;"fujiko";118;0;100
14;0;"fujio";14;100;0
0;12;"fujiye";12;0;100
0;5;"fuka";5;0;100
7;0;"fukuichi";7;100;0
27;0;"fulgencio";27;100;0
390;0;"fuller";390;100;0
2305;0;"fulton";2305;100;0
25;0;"fulvio";25;100;0
0;154;"fumi";154;0;100
0;195;"fumie";195;0;100
0;721;"fumiko";721;0;100
129;0;"fumio";129;100;0
0;72;"fumiye";72;0;100
0;33;"fumiyo";33;0;100
0;6;"funda";6;0;100
0;10;"funmilayo";10;0;100
6;0;"funston";6;100;0
224;0;"fuquan";224;100;0
0;5;"furaha";5;0;100
0;7;"furiosa";7;0;100
102;0;"furious";102;100;0
120;0;"furkan";120;100;0
6;0;"furlon";6;100;0
2649;0;"furman";2649;100;0
27;0;"furnell";27;100;0
15;0;"furney";15;100;0
100;0;"furqan";100;100;0
0;5;"fury";5;0;100
0;194;"fusae";194;0;100
0;193;"fusako";193;0;100
0;71;"fusaye";71;0;100
0;6;"fushia";6;0;100
104;31;"future";135;77.037037037037;22.962962962963
5;0;"fuzail";5;100;0
0;172;"fynlee";172;0;100
0;39;"fynleigh";39;0;100
0;44;"fynley";44;0;100
0;13;"fynlie";13;0;100
721;54;"fynn";775;93.0322580645161;6.96774193548387
5;0;"fynnegan";5;100;0
10;0;"fynnigan";10;100;0
0;18;"fynnlee";18;0;100
0;5;"fynnleigh";5;0;100
6;26;"fynnley";32;18.75;81.25
49;0;"fyodor";49;100;0
0;7;"fyrn";7;0;100
5;0;"fysher";5;100;0
0;17;"gaal";17;0;100
0;29;"gabbanelli";29;0;100
0;77;"gabbi";77;0;100
0;154;"gabbie";154;0;100
0;33;"gabbriel";33;0;100
0;280;"gabbriella";280;0;100
0;213;"gabbrielle";213;0;100
16;749;"gabby";765;2.09150326797386;97.9084967320261
3601;0;"gabe";3601;100;0
22;0;"gabel";22;100;0
5;0;"gaber";5;100;0
436;16;"gaberial";452;96.4601769911504;3.53982300884956
537;0;"gaberiel";537;100;0
0;11;"gaberielle";11;0;100
0;5;"gaberille";5;0;100
0;183;"gabi";183;0;100
0;5;"gabie";5;0;100
23;0;"gabiel";23;100;0
0;6;"gabiela";6;0;100
0;33;"gabija";33;0;100
22;0;"gabin";22;100;0
0;41;"gabina";41;0;100
2266;0;"gabino";2266;100;0
25;0;"gabirel";25;100;0
0;5;"gabirelle";5;0;100
680;6;"gable";686;99.1253644314869;0.87463556851312
142;0;"gabor";142;100;0
46;0;"gabrael";46;100;0
5;0;"gabrail";5;100;0
143;41;"gabreal";184;77.7173913043478;22.2826086956522
0;5;"gabreella";5;0;100
0;5;"gabreial";5;0;100
230;22;"gabreil";252;91.2698412698413;8.73015873015873
0;56;"gabreilla";56;0;100
0;67;"gabreille";67;0;100
29;0;"gabrel";29;100;0
0;167;"gabrella";167;0;100
0;235;"gabrelle";235;0;100
0;5;"gabria";5;0;100
1566;264;"gabrial";1830;85.5737704918033;14.4262295081967
0;5;"gabriala";5;0;100
0;10;"gabrialla";10;0;100
0;28;"gabrialle";28;0;100
138;0;"gabrian";138;100;0
0;319;"gabriana";319;0;100
0;401;"gabrianna";401;0;100
21;18;"gabrieal";39;53.8461538461538;46.1538461538462
328095;6640;"gabriel";334735;98.016341284897;1.98365871510299
370;77073;"gabriela";77443;0.477770747517529;99.5222292524825
0;5;"gabrielah";5;0;100
6;0;"gabrielalexande";6;100;0
5;0;"gabrielangelo";5;100;0
748;2012;"gabriele";2760;27.1014492753623;72.8985507246377
5;0;"gabrieljohn";5;100;0
361;1281;"gabriell";1642;21.9853836784409;78.0146163215591
68;109201;"gabriella";109269;0.0622317400177543;99.9377682599822
0;73;"gabriellah";73;0;100
0;5;"gabriellamarie";5;0;100
733;131712;"gabrielle";132445;0.553437275850353;99.4465627241496
0;71;"gabriellia";71;0;100
0;126;"gabrielly";126;0;100
10;0;"gabrielmichael";10;100;0
0;10;"gabriely";10;0;100
130;0;"gabrien";130;100;0
11;0;"gabril";11;100;0
0;160;"gabrille";160;0;100
0;5;"gabrionna";5;0;100
11;13;"gabriyel";24;45.8333333333333;54.1666666666667
11;0;"gabryal";11;100;0
361;182;"gabryel";543;66.4825046040516;33.5174953959484
0;156;"gabryela";156;0;100
0;7;"gabryele";7;0;100
0;5;"gabryell";5;0;100
0;652;"gabryella";652;0;100
0;540;"gabryelle";540;0;100
30;0;"gabryl";30;100;0
44;0;"gabryle";44;100;0
0;5;"gabrylle";5;0;100
26;1125;"gaby";1151;2.25890529973936;97.7410947002606
77;0;"gad";77;100;0
160;0;"gaddiel";160;100;0
39;0;"gaddis";39;100;0
0;5;"gadeer";5;0;100
159;0;"gadge";159;100;0
5;0;"gadi";5;100;0
1110;0;"gadiel";1110;100;0
5;0;"gadriel";5;100;0
20;0;"gadsden";20;100;0
0;652;"gae";652;0;100
0;40;"gaea";40;0;100
20;0;"gaebriel";20;100;0
66;0;"gaege";66;100;0
19340;597;"gael";19937;97.0055675377439;2.99443246225611
0;5;"gaela";5;0;100
130;0;"gaelan";130;100;0
156;18;"gaelen";174;89.6551724137931;10.3448275862069
6;0;"gaell";6;100;0
0;369;"gaelle";369;0;100
0;6;"gaely";6;0;100
0;64;"gaelyn";64;0;100
113;0;"gaetan";113;100;0
0;674;"gaetana";674;0;100
3664;0;"gaetano";3664;100;0
28;0;"gaeton";28;100;0
42;6;"gagan";48;87.5;12.5
129;50;"gagandeep";179;72.0670391061452;27.9329608938547
55613;226;"gage";55839;99.5952649581833;0.404735041816651
8;0;"gagik";8;100;0
10;0;"gahan";10;100;0
81;0;"gahel";81;100;0
0;33;"gai";33;0;100
0;955;"gaia";955;0;100
6;0;"gaibriel";6;100;0
16;0;"gaiden";16;100;0
4120;115;"gaige";4235;97.28453364817;2.71546635182999
14;0;"gaije";14;100;0
8837;201200;"gail";210037;4.20735394240062;95.7926460575994
0;564;"gaila";564;0;100
11;0;"gailand";11;100;0
0;19;"gailann";19;0;100
0;5;"gailanne";5;0;100
24;0;"gailard";24;100;0
5;898;"gaile";903;0.553709856035437;99.4462901439646
0;5;"gaileen";5;0;100
250;6;"gailen";256;97.65625;2.34375
0;62;"gailene";62;0;100
6;0;"gaillard";6;100;0
15;0;"gailon";15;100;0
6;0;"gailord";6;100;0
0;196;"gailya";196;0;100
0;135;"gailyn";135;0;100
0;5;"gailynn";5;0;100
1490;0;"gaines";1490;100;0
23;0;"gains";23;100;0
630;6;"gaither";636;99.0566037735849;0.943396226415094
0;28;"gaitlin";28;0;100
306;0;"gaius";306;100;0
137;0;"gaje";137;100;0
21;0;"gajuan";21;100;0
142;153;"gal";295;48.135593220339;51.864406779661
0;1670;"gala";1670;0;100
0;179;"galadriel";179;0;100
76;0;"galan";76;100;0
0;11;"galatea";11;0;100
0;5;"galathia";5;0;100
0;5;"galatia";5;0;100
0;6;"galaxie";6;0;100
10;145;"galaxy";155;6.45161290322581;93.5483870967742
120;0;"galdino";120;100;0
12282;19871;"gale";32153;38.1986128821572;61.8013871178428
16052;560;"galen";16612;96.6289429328197;3.37105706718035
0;159;"galena";159;0;100
0;53;"galene";53;0;100
0;85;"gali";85;0;100
0;313;"galia";313;0;100
0;32;"galiana";32;0;100
0;5;"galicia";5;0;100
0;5413;"galilea";5413;0;100
0;123;"galileah";123;0;100
0;246;"galilee";246;0;100
249;0;"galileo";249;100;0
18;0;"galin";18;100;0
0;290;"galina";290;0;100
0;11;"galinda";11;0;100
0;18;"galisa";18;0;100
0;107;"galit";107;0;100
0;30;"galiyah";30;0;100
5;0;"gallagher";5;100;0
0;5;"gallie";5;0;100
10;0;"galloway";10;100;0
320;0;"galo";320;100;0
5;0;"galon";5;100;0
5;0;"galvester";5;100;0
5;0;"galveston";5;100;0
828;0;"galvin";828;100;0
0;66;"galya";66;0;100
0;39;"galylea";39;0;100
37;52;"galyn";89;41.5730337078652;58.4269662921348
0;10;"galynn";10;0;100
432;0;"gamal";432;100;0
1621;0;"gamaliel";1621;100;0
46;0;"gamalier";46;100;0
6;0;"gamari";6;100;0
43;0;"gambit";43;100;0
84;5;"gamble";89;94.3820224719101;5.61797752808989
15;0;"gamel";15;100;0
10;0;"games";10;100;0
0;16;"gamila";16;0;100
5;0;"gamir";5;100;0
0;5;"gamya";5;0;100
0;29;"gana";29;0;100
0;5;"ganae";5;0;100
0;14;"ganajah";14;0;100
5;0;"gandalf";5;100;0
5;0;"gandolfo";5;100;0
0;25;"ganell";25;0;100
0;21;"ganelle";21;0;100
0;16;"ganesa";16;0;100
273;0;"ganesh";273;100;0
0;12;"ganessa";12;0;100
5;0;"gani";5;100;0
0;6;"gania";6;0;100
0;25;"ganiya";25;0;100
0;56;"ganiyah";56;0;100
0;17;"ganna";17;0;100
19;0;"gannen";19;100;0
16;0;"gannicus";16;100;0
5139;0;"gannon";5139;100;0
7;0;"gannyn";7;100;0
18;0;"gano";18;100;0
169;0;"ganon";169;100;0
23;0;"gant";23;100;0
5;0;"gantt";5;100;0
7;0;"ganyn";7;100;0
6;0;"ganza";6;100;0
0;375;"gao";375;0;100
0;5;"gaolee";5;0;100
0;51;"gaonou";51;0;100
0;11;"gaosheng";11;0;100
5;0;"gaoussou";5;100;0
0;16;"gaozong";16;0;100
5;0;"gaquan";5;100;0
227;0;"gar";227;100;0
0;339;"gara";339;0;100
5;0;"garak";5;100;0
480;0;"garald";480;100;0
107;0;"garan";107;100;0
31;0;"garang";31;100;0
26;0;"garbiel";26;100;0
0;6;"garbielle";6;0;100
31;0;"garbriel";31;100;0
0;12;"garbrielle";12;0;100
0;28;"garcelle";28;0;100
423;36;"garcia";459;92.156862745098;7.84313725490196
15;0;"gard";15;100;0
0;51;"garda";51;0;100
47;0;"gardell";47;100;0
5;0;"garden";5;100;0
0;1280;"gardenia";1280;0;100
0;5;"gardina";5;0;100
195;0;"gardiner";195;100;0
2813;5;"gardner";2818;99.8225691980128;0.177430801987225
74;0;"gardy";74;100;0
222;0;"gared";222;100;0
117;0;"garek";117;100;0
243;0;"gareld";243;100;0
1033;12;"garen";1045;98.8516746411483;1.14832535885167
1463;0;"garet";1463;100;0
3883;5;"gareth";3888;99.8713991769547;0.128600823045267
4826;0;"garett";4826;100;0
38;0;"garette";38;100;0
1456;0;"garey";1456;100;0
4769;0;"garfield";4769;100;0
0;107;"gargi";107;0;100
100;0;"garhett";100;100;0
153;485;"gari";638;23.9811912225705;76.0188087774295
16;0;"garian";16;100;0
10;0;"garic";10;100;0
41;0;"garick";41;100;0
10;34;"garie";44;22.7272727272727;77.2727272727273
18;6;"gariel";24;75;25
0;12;"gariella";12;0;100
0;80;"garielle";80;0;100
90;0;"garik";90;100;0
0;78;"garima";78;0;100
1092;0;"garin";1092;100;0
0;5;"garine";5;0;100
447;0;"garion";447;100;0
124;0;"garison";124;100;0
19;0;"garit";19;100;0
5;0;"garitt";5;100;0
5;0;"garius";5;100;0
175;0;"garl";175;100;0
0;52;"garla";52;0;100
416;0;"garlan";416;100;0
23303;818;"garland";24121;96.6087641474234;3.39123585257659
133;0;"garlen";133;100;0
0;71;"garlene";71;0;100
422;0;"garlin";422;100;0
349;0;"garlon";349;100;0
5;0;"garlond";5;100;0
6;0;"garlund";6;100;0
11;5;"garlyn";16;68.75;31.25
12;0;"garman";12;100;0
86;0;"garmon";86;100;0
50;0;"garn";50;100;0
0;30;"garna";30;0;100
5;0;"garnel";5;100;0
406;99;"garnell";505;80.3960396039604;19.6039603960396
0;11;"garnelle";11;0;100
2084;23;"garner";2107;98.9084005695301;1.09159943046986
1933;6532;"garnet";8465;22.8352037802717;77.1647962197283
0;7;"garneta";7;0;100
3691;2644;"garnett";6335;58.2636148382005;41.7363851617995
0;884;"garnetta";884;0;100
0;911;"garnette";911;0;100
50;0;"garney";50;100;0
209;38;"garnie";247;84.6153846153846;15.3846153846154
0;8;"garnieta";8;0;100
0;30;"garnita";30;0;100
157;0;"garo";157;100;0
3050;0;"garold";3050;100;0
970;0;"garon";970;100;0
32;0;"garr";32;100;0
5;0;"garrad";5;100;0
11;0;"garran";11;100;0
5;0;"garrard";5;100;0
5;0;"garratt";5;100;0
38;0;"garred";38;100;0
5;0;"garrek";5;100;0
56;0;"garrel";56;100;0
163;0;"garrell";163;100;0
1738;17;"garren";1755;99.031339031339;0.968660968660969
12977;5;"garret";12982;99.9614851332614;0.0385148667385611
425;0;"garreth";425;100;0
128356;452;"garrett";128808;99.6490901186262;0.350909881373828
370;0;"garrette";370;100;0
22;0;"garrey";22;100;0
14;0;"garrhett";14;100;0
0;5;"garri";5;0;100
10;0;"garric";10;100;0
5257;0;"garrick";5257;100;0
341;74;"garrie";415;82.1686746987952;17.8313253012048
34;0;"garrik";34;100;0
412;0;"garrin";412;100;0
19;0;"garrion";19;100;0
87;0;"garris";87;100;0
7302;5;"garrison";7307;99.9315724647598;0.0684275352401807
184;0;"garrit";184;100;0
200;0;"garritt";200;100;0
45;0;"garrod";45;100;0
810;0;"garron";810;100;0
45;0;"garrus";45;100;0
47425;179;"garry";47604;99.6239811780523;0.376018821947736
0;5;"garryn";5;0;100
57;0;"garson";57;100;0
9523;0;"garth";9523;100;0
0;16;"gartha";16;0;100
15;0;"gartrell";15;100;0
90;0;"garv";90;100;0
11;0;"garvens";11;100;0
261;0;"garvey";261;100;0
33;0;"garvice";33;100;0
32;0;"garvie";32;100;0
2385;0;"garvin";2385;100;0
349;0;"garvis";349;100;0
22;0;"garwin";22;100;0
74;0;"garwood";74;100;0
899371;3288;"gary";902659;99.635742844197;0.364257155803022
5;0;"garyl";5;100;0
12;0;"garylee";12;100;0
224;73;"garyn";297;75.4208754208754;24.5791245791246
12;0;"garyon";12;100;0
49;0;"garyson";49;100;0
5;0;"garytt";5;100;0
0;5;"gasia";5;0;100
1843;0;"gaspar";1843;100;0
42;0;"gaspard";42;100;0
445;0;"gaspare";445;100;0
1463;0;"gasper";1463;100;0
3725;0;"gaston";3725;100;0
7;0;"gaten";7;100;0
292;44;"gates";336;86.9047619047619;13.0952380952381
0;583;"gatha";583;0;100
0;51;"gathel";51;0;100
16;0;"gather";16;100;0
12;0;"gatlen";12;100;0
1957;5;"gatlin";1962;99.7451580020387;0.254841997961264
119;5;"gatlyn";124;95.9677419354839;4.03225806451613
8;11;"gatlynn";19;42.1052631578947;57.8947368421053
10;0;"gator";10;100;0
53;5;"gatsby";58;91.3793103448276;8.62068965517241
5;0;"gattis";5;100;0
20;0;"gattlin";20;100;0
0;23;"gaudalupe";23;0;100
82;0;"gaudencio";82;100;0
0;20;"gaudy";20;0;100
4096;0;"gauge";4096;100;0
680;0;"gaurav";680;100;0
0;447;"gauri";447;0;100
0;5;"gaurika";5;0;100
612;0;"gautam";612;100;0
340;0;"gautham";340;100;0
950;0;"gavan";950;100;0
3665;0;"gaven";3665;100;0
0;11;"gavi";11;0;100
5;0;"gavian";5;100;0
5;0;"gavien";5;100;0
167861;369;"gavin";168230;99.7806574332759;0.219342566724128
0;80;"gavina";80;0;100
129;0;"gavinn";129;100;0
1575;0;"gavino";1575;100;0
0;6;"gaviota";6;0;100
415;0;"gavon";415;100;0
1279;5;"gavriel";1284;99.6105919003115;0.389408099688474
0;92;"gavriela";92;0;100
0;321;"gavriella";321;0;100
0;163;"gavrielle";163;0;100
28;0;"gavril";28;100;0
6;0;"gavvin";6;100;0
0;5;"gavy";5;0;100
4723;115;"gavyn";4838;97.6229847044233;2.37701529557668
5;0;"gavyne";5;100;0
217;0;"gavynn";217;100;0
79;0;"gawain";79;100;0
5;0;"gawaine";5;100;0
1317;17783;"gay";19100;6.89528795811518;93.1047120418848
0;57;"gaya";57;0;100
0;57;"gayane";57;0;100
0;35;"gayann";35;0;100
0;78;"gayanne";78;0;100
0;128;"gayathri";128;0;100
0;246;"gayatri";246;0;100
0;5747;"gaye";5747;0;100
0;6;"gayel";6;0;100
6;0;"gayge";6;100;0
15;607;"gayl";622;2.41157556270096;97.588424437299
6;10838;"gayla";10844;0.0553301364810033;99.944669863519
480;46;"gaylan";526;91.254752851711;8.74524714828897
1025;0;"gayland";1025;100;0
27;0;"gaylard";27;100;0
4943;61231;"gayle";66174;7.46970109106296;92.530298908937
0;57;"gaylee";57;0;100
0;565;"gayleen";565;0;100
2024;348;"gaylen";2372;85.3288364249578;14.6711635750422
0;2569;"gaylene";2569;0;100
0;218;"gaylia";218;0;100
110;81;"gaylin";191;57.5916230366492;42.4083769633508
3472;218;"gaylon";3690;94.0921409214092;5.90785907859079
23;0;"gaylor";23;100;0
6017;5;"gaylord";6022;99.9169711059449;0.0830288940551312
0;303;"gaylyn";303;0;100
0;415;"gaylynn";415;0;100
0;6;"gaylynne";6;0;100
0;106;"gayna";106;0;100
5;0;"gaynard";5;100;0
0;214;"gaynel";214;0;100
18;4180;"gaynell";4198;0.428775607432111;99.5712243925679
0;1536;"gaynelle";1536;0;100
0;5;"gaynol";5;0;100
95;105;"gaynor";200;47.5;52.5
0;5;"gayola";5;0;100
11;0;"gayron";11;100;0
0;160;"gaytha";160;0;100
0;10;"gaythel";10;0;100
5;0;"gayton";5;100;0
58;0;"gaza";58;100;0
0;6;"gazal";6;0;100
0;109;"gazella";109;0;100
0;58;"gazelle";58;0;100
51;5;"ge";56;91.0714285714286;8.92857142857143
0;26;"gea";26;0;100
554;670;"gean";1224;45.2614379084967;54.7385620915033
0;319;"geana";319;0;100
21;0;"geancarlo";21;100;0
0;7;"geane";7;0;100
0;116;"geanette";116;0;100
0;174;"geanie";174;0;100
0;146;"geanine";146;0;100
0;508;"geanna";508;0;100
0;26;"geanne";26;0;100
0;55;"geannie";55;0;100
0;21;"geannine";21;0;100
66;0;"gearald";66;100;0
0;6;"geargia";6;0;100
236;64;"gearl";300;78.6666666666667;21.3333333333333
4281;5;"gearld";4286;99.8833411105926;0.116658889407373
0;469;"gearldean";469;0;100
0;144;"gearldene";144;0;100
5;4685;"gearldine";4690;0.106609808102345;99.8933901918977
0;23;"gearlean";23;0;100
0;7;"gearleen";7;0;100
0;78;"gearlene";78;0;100
0;260;"gearline";260;0;100
186;0;"gearold";186;100;0
2455;0;"geary";2455;100;0
10;0;"geatano";10;100;0
0;5;"gecenia";5;0;100
79;0;"gedalia";79;100;0
10;0;"gedaliah";10;100;0
100;0;"gedalya";100;100;0
5;0;"geddes";5;100;0
175;0;"geddy";175;100;0
94;0;"gedeon";94;100;0
40;17;"gee";57;70.1754385964912;29.8245614035088
0;1546;"geena";1546;0;100
0;52;"geet";52;0;100
0;190;"geeta";190;0;100
0;10;"geetanjali";10;0;100
0;23;"geetha";23;0;100
0;37;"geethika";37;0;100
0;61;"geetika";61;0;100
0;10;"gefen";10;0;100
38;0;"geff";38;100;0
12;0;"geffen";12;100;0
16;0;"geffery";16;100;0
6;0;"geffory";6;100;0
221;0;"geffrey";221;100;0
58;0;"gegory";58;100;0
0;5;"gehad";5;0;100
5;0;"gehard";5;100;0
639;0;"gehrig";639;100;0
0;5;"geidi";5;0;100
0;18;"geidy";18;0;100
0;137;"geisha";137;0;100
0;19;"geissie";19;0;100
20;0;"gejuan";20;100;0
0;26;"gela";26;0;100
27;0;"gelacio";27;100;0
0;20;"geleah";20;0;100
0;5;"gelen";5;0;100
0;105;"gelena";105;0;100
0;136;"gelene";136;0;100
0;5;"gelia";5;0;100
0;216;"gelila";216;0;100
0;52;"gelina";52;0;100
0;35;"gelinda";35;0;100
0;5;"geline";5;0;100
0;129;"gelisa";129;0;100
0;6;"gelisha";6;0;100
0;30;"gelissa";30;0;100
0;10;"gella";10;0;100
0;225;"gelsey";225;0;100
0;15;"gelsomina";15;0;100
7;0;"gelson";7;100;0
0;133;"gem";133;0;100
0;2085;"gema";2085;0;100
5;0;"gemar";5;100;0
51;0;"gemari";51;100;0
6;0;"gemarion";6;100;0
72;0;"gemayel";72;100;0
0;5;"gemelli";5;0;100
0;10;"gemia";10;0;100
185;355;"gemini";540;34.2592592592593;65.7407407407407
0;6;"gemise";6;0;100
0;12417;"gemma";12417;0;100
0;6;"gemmalynn";6;0;100
62;12;"gen";74;83.7837837837838;16.2162162162162
0;12540;"gena";12540;0;100
0;298;"genae";298;0;100
0;10;"genai";10;0;100
0;29;"genara";29;0;100
49;0;"genard";49;100;0
7136;0;"genaro";7136;100;0
0;53;"genasis";53;0;100
0;5;"genavecia";5;0;100
0;27;"genavee";27;0;100
0;44;"genaveve";44;0;100
0;134;"genavie";134;0;100
0;707;"genavieve";707;0;100
0;84;"genavive";84;0;100
0;32;"genay";32;0;100
0;40;"genaya";40;0;100
0;5;"gencie";5;0;100
125809;6799;"gene";132608;94.8728583494209;5.12714165057915
0;600;"genea";600;0;100
0;101;"geneal";101;0;100
0;102;"genean";102;0;100
0;6;"geneane";6;0;100
0;23;"genece";23;0;100
0;179;"genecis";179;0;100
0;281;"genee";281;0;100
0;227;"geneen";227;0;100
0;40;"geneice";40;0;100
0;292;"geneieve";292;0;100
0;5;"geneil";5;0;100
0;5;"geneine";5;0;100
0;20;"geneiva";20;0;100
0;243;"geneive";243;0;100
0;33;"geneiveve";33;0;100
0;5;"geneivieve";5;0;100
0;24;"genel";24;0;100
0;91;"genelda";91;0;100
0;5;"genele";5;0;100
0;5;"genelia";5;0;100
0;1437;"genell";1437;0;100
0;232;"genella";232;0;100
0;1699;"genelle";1699;0;100
0;8;"genena";8;0;100
0;5;"genendy";5;0;100
0;512;"genene";512;0;100
0;60;"genera";60;0;100
3384;0;"general";3384;100;0
22;0;"genero";22;100;0
0;16;"generosa";16;0;100
0;32;"generose";32;0;100
64;0;"generoso";64;100;0
0;41;"generra";41;0;100
0;33;"genesa";33;0;100
0;381;"genese";381;0;100
0;219;"genesee";219;0;100
0;22;"geneses";22;0;100
0;26;"genesha";26;0;100
0;157;"genesi";157;0;100
0;78;"genesia";78;0;100
1844;59562;"genesis";61406;3.00296387975116;96.9970361202488
0;31;"genesiss";31;0;100
0;417;"genessa";417;0;100
0;11;"genesse";11;0;100
0;11;"genessee";11;0;100
0;5;"genessi";5;0;100
0;998;"genessis";998;0;100
0;45;"genessy";45;0;100
0;15;"genessys";15;0;100
0;40;"genesy";40;0;100
0;325;"genesys";325;0;100
0;44;"genet";44;0;100
0;38;"geneta";38;0;100
0;53;"genetha";53;0;100
0;13;"genett";13;0;100
0;568;"genetta";568;0;100
0;606;"genette";606;0;100
309;85096;"geneva";85405;0.361805514899596;99.6381944851004
0;475;"geneve";475;0;100
0;22;"genevea";22;0;100
0;20;"genevee";20;0;100
0;250;"geneveive";250;0;100
0;240;"genever";240;0;100
0;53;"geneveve";53;0;100
0;1376;"genevia";1376;0;100
0;1716;"genevie";1716;0;100
0;71;"geneviene";71;0;100
0;9;"geneviev";9;0;100
151;105102;"genevieve";105253;0.143463844260971;99.856536155739
0;1018;"genevive";1018;0;100
0;302;"genevra";302;0;100
0;35;"genevy";35;0;100
6;0;"genghis";6;100;0
0;340;"geni";340;0;100
0;1656;"genia";1656;0;100
0;55;"geniah";55;0;100
0;15;"genica";15;0;100
0;806;"genice";806;0;100
157;2470;"genie";2627;5.97639893414541;94.0236010658546
0;76;"geniece";76;0;100
0;59;"geniel";59;0;100
0;80;"geniene";80;0;100
0;48;"genieva";48;0;100
0;536;"genieve";536;0;100
0;5;"genievieve";5;0;100
0;185;"genifer";185;0;100
0;5;"geniffer";5;0;100
0;18;"genika";18;0;100
0;13;"genina";13;0;100
0;551;"genine";551;0;100
0;922;"genise";922;0;100
0;40;"genises";40;0;100
0;34;"genisha";34;0;100
0;655;"genisis";655;0;100
0;5;"genissa";5;0;100
0;7;"genisse";7;0;100
0;6;"genisus";6;0;100
0;21;"genisys";21;0;100
0;432;"genita";432;0;100
0;198;"geniva";198;0;100
0;20;"genive";20;0;100
0;35;"genivieve";35;0;100
0;6;"genivive";6;0;100
0;143;"geniya";143;0;100
0;120;"geniyah";120;0;100
5;0;"genki";5;100;0
0;2965;"genna";2965;0;100
17;0;"gennady";17;100;0
2333;0;"gennaro";2333;100;0
0;93;"gennavieve";93;0;100
0;6;"gennavive";6;0;100
0;179;"gennell";179;0;100
0;6;"gennelle";6;0;100
5;0;"genner";5;100;0
0;548;"gennesis";548;0;100
0;5;"gennessy";5;0;100
0;11;"gennesy";11;0;100
0;20;"gennesys";20;0;100
0;7;"genneth";7;0;100
0;83;"gennett";83;0;100
0;43;"gennetta";43;0;100
0;187;"gennette";187;0;100
0;10;"gennevieve";10;0;100
0;61;"genni";61;0;100
0;6;"gennia";6;0;100
199;2426;"gennie";2625;7.58095238095238;92.4190476190476
0;31;"gennieve";31;0;100
0;1166;"gennifer";1166;0;100
0;17;"gennine";17;0;100
0;1298;"genny";1298;0;100
3242;0;"geno";3242;100;0
0;213;"genoa";213;0;100
0;266;"genola";266;0;100
0;556;"genora";556;0;100
0;5;"genoria";5;0;100
0;183;"genova";183;0;100
0;2406;"genoveva";2406;0;100
50;0;"genovevo";50;100;0
0;16;"genovia";16;0;100
0;5;"genovieve";5;0;100
0;95;"genowefa";95;0;100
0;30;"genrose";30;0;100
5;0;"gensen";5;100;0
0;5;"gensie";5;0;100
0;23;"gensis";23;0;100
29;0;"gent";29;100;0
0;17;"gentiana";17;0;100
201;0;"gentle";201;100;0
0;87;"gentri";87;0;100
0;29;"gentrie";29;0;100
3126;1747;"gentry";4873;64.1493946234353;35.8506053765647
17;0;"genuine";17;100;0
0;5;"genva";5;0;100
0;5;"genvieve";5;0;100
0;20;"genya";20;0;100
0;32;"genysis";32;0;100
737;16;"geo";753;97.875166002656;2.12483399734396
10;0;"geobani";10;100;0
21;0;"geof";21;100;0
1551;0;"geoff";1551;100;0
1515;0;"geoffery";1515;100;0
6;0;"geoffory";6;100;0
53937;140;"geoffrey";54077;99.7411098988479;0.258890101152061
677;0;"geoffry";677;100;0
141;0;"geofrey";141;100;0
101;0;"geoge";101;100;0
33;0;"geoggrey";33;100;0
0;5;"geogia";5;0;100
10;0;"geogory";10;100;0
30;0;"geomar";30;100;0
20;0;"geon";20;100;0
0;5;"geona";5;0;100
0;181;"geonna";181;0;100
26;0;"geonni";26;100;0
6;0;"geontae";6;100;0
5;0;"geonte";5;100;0
543;55;"geordan";598;90.8026755852843;9.19732441471572
5;0;"georden";5;100;0
47;0;"geordi";47;100;0
71;0;"geordie";71;100;0
44;0;"geordon";44;100;0
27;0;"geordy";27;100;0
0;23;"geordyn";23;0;100
5;0;"geore";5;100;0
16;0;"georffrey";16;100;0
470;10;"georg";480;97.9166666666667;2.08333333333333
0;201;"georga";201;0;100
0;26;"georgan";26;0;100
0;277;"georgana";277;0;100
0;1723;"georgann";1723;0;100
0;1458;"georganna";1458;0;100
0;1257;"georganne";1257;0;100
1369991;9259;"george";1379250;99.3286931303245;0.671306869675548
0;24;"georgea";24;0;100
0;329;"georgean";329;0;100
0;82;"georgeana";82;0;100
0;2317;"georgeann";2317;0;100
0;1747;"georgeanna";1747;0;100
0;1119;"georgeanne";1119;0;100
6;0;"georgeanthony";6;100;0
0;48;"georgeen";48;0;100
0;10;"georgeina";10;0;100
0;5;"georgella";5;0;100
17;0;"georgemichael";17;100;0
0;838;"georgena";838;0;100
0;4343;"georgene";4343;0;100
0;118;"georgenia";118;0;100
0;5;"georgenna";5;0;100
0;6;"georgenne";6;0;100
797;0;"georges";797;100;0
0;26;"georgett";26;0;100
0;3525;"georgetta";3525;0;100
0;13116;"georgette";13116;0;100
58;393;"georgi";451;12.860310421286;87.139689578714
687;140628;"georgia";141315;0.48614796730708;99.5138520326929
0;11;"georgiaann";11;0;100
0;10;"georgialee";10;0;100
0;5;"georgiamae";5;0;100
0;419;"georgian";419;0;100
0;8306;"georgiana";8306;0;100
0;5;"georgiane";5;0;100
0;1963;"georgiann";1963;0;100
0;8481;"georgianna";8481;0;100
0;1339;"georgianne";1339;0;100
1526;10790;"georgie";12316;12.3903864891198;87.6096135108802
0;21;"georgieann";21;0;100
0;17;"georgieanna";17;0;100
0;5;"georgiena";5;0;100
0;10;"georgietta";10;0;100
0;14992;"georgina";14992;0;100
0;2781;"georgine";2781;0;100
0;45;"georginia";45;0;100
600;5;"georgio";605;99.1735537190083;0.826446280991736
866;0;"georgios";866;100;0
50;0;"georgiy";50;100;0
21;15;"georgy";36;58.3333333333333;41.6666666666667
0;127;"georjean";127;0;100
5;0;"geovan";5;100;0
0;220;"geovana";220;0;100
1254;0;"geovani";1254;100;0
84;0;"geovanie";84;100;0
0;683;"geovanna";683;0;100
11;0;"geovanne";11;100;0
3441;0;"geovanni";3441;100;0
142;0;"geovannie";142;100;0
2435;0;"geovanny";2435;100;0
1484;0;"geovany";1484;100;0
18;0;"geovoni";18;100;0
5;0;"geovonie";5;100;0
138;0;"geovonni";138;100;0
33;0;"geovonnie";33;100;0
10;0;"gequan";10;100;0
385;88;"ger";473;81.3953488372093;18.6046511627907
0;136;"gera";136;0;100
595;0;"gerad";595;100;0
0;16;"geradette";16;0;100
0;10;"geradine";10;0;100
169;0;"gerado";169;100;0
0;6;"geraine";6;0;100
224;148;"geral";372;60.2150537634409;39.7849462365591
445969;2385;"gerald";448354;99.4680542606958;0.531945739304211
0;66;"geralda";66;0;100
0;916;"geraldean";916;0;100
0;33;"geraldeen";33;0;100
0;765;"geraldene";765;0;100
0;10;"geraldi";10;0;100
0;118;"geraldin";118;0;100
0;85;"geraldina";85;0;100
748;209313;"geraldine";210061;0.356087041383217;99.6439129586168
0;5;"geraldinne";5;0;100
2325;0;"geraldo";2325;100;0
0;81;"geraldy";81;0;100
0;66;"geraldyn";66;0;100
0;486;"geraldyne";486;0;100
0;6;"geraleen";6;0;100
0;227;"geralene";227;0;100
0;675;"geraline";675;0;100
5;0;"gerall";5;100;0
0;4847;"geralyn";4847;0;100
0;455;"geralynn";455;0;100
5;0;"gerame";5;100;0
52;0;"geramiah";52;100;0
17;0;"geramie";17;100;0
57;0;"geramy";57;100;0
77;0;"geran";77;100;0
0;28;"gerane";28;0;100
57591;112;"gerard";57703;99.8059026393775;0.194097360622498
0;158;"gerarda";158;0;100
0;36;"gerardette";36;0;100
0;5;"gerardina";5;0;100
0;154;"gerardine";154;0;100
50508;239;"gerardo";50747;99.5290361991842;0.470963800815812
5;0;"gerardojr";5;100;0
195;0;"gerasimos";195;100;0
16;0;"geraud";16;100;0
10;0;"gerben";10;100;0
60;0;"gerber";60;100;0
16;17;"gerd";33;48.4848484848485;51.5151515151515
0;987;"gerda";987;0;100
0;16;"gerdie";16;0;100
11;22;"gere";33;33.3333333333333;66.6666666666667
39;0;"gered";39;100;0
15;0;"gerek";15;100;0
5;0;"gereld";5;100;0
0;23;"gereldine";23;0;100
0;22;"gerelene";22;0;100
0;5;"gereline";5;0;100
136;0;"gerell";136;100;0
10;0;"geremia";10;100;0
432;0;"geremiah";432;100;0
21;0;"geremias";21;100;0
5;0;"geremie";5;100;0
1190;0;"geremy";1190;100;0
15;0;"geren";15;100;0
0;159;"gerene";159;0;100
0;37;"geretha";37;0;100
0;10;"gerette";10;0;100
440;0;"gergory";440;100;0
2303;0;"gerhard";2303;100;0
858;0;"gerhardt";858;100;0
201;0;"gerhart";201;100;0
5;8013;"geri";8018;0.0623596906959342;99.9376403093041
0;21;"geriah";21;0;100
0;206;"geriann";206;0;100
0;511;"gerianne";511;0;100
17;0;"geric";17;100;0
0;132;"gerica";132;0;100
6;0;"gericho";6;100;0
11;0;"gerick";11;100;0
11;0;"gerid";11;100;0
0;22;"gerie";22;0;100
5;0;"geriel";5;100;0
110;0;"gerik";110;100;0
0;29;"gerika";29;0;100
0;689;"gerilyn";689;0;100
0;181;"gerilynn";181;0;100
15;0;"gerimiah";15;100;0
5;0;"gerin";5;100;0
0;17;"gerise";17;0;100
0;5;"gerita";5;0;100
0;23;"geriyah";23;0;100
85;0;"gerlad";85;100;0
0;10;"gerladine";10;0;100
16;0;"gerld";16;100;0
0;5;"gerldean";5;0;100
0;483;"gerldine";483;0;100
0;64;"gerlean";64;0;100
0;268;"gerlene";268;0;100
0;462;"gerline";462;0;100
0;5;"gerlisa";5;0;100
0;10;"gerlyn";10;0;100
951;42;"germain";993;95.7703927492447;4.22960725075529
2290;7862;"germaine";10152;22.5571315996848;77.4428684003152
9130;5;"german";9135;99.9452654625068;0.0547345374931582
12;0;"germane";12;100;0
0;133;"germani";133;0;100
0;6;"germanii";6;0;100
177;270;"germany";447;39.5973154362416;60.4026845637584
12;0;"germar";12;100;0
5;0;"germari";5;100;0
5;0;"germarion";5;100;0
5;0;"germayne";5;100;0
5;0;"germell";5;100;0
5;0;"germey";5;100;0
6;0;"germon";6;100;0
0;5;"germya";5;0;100
17;0;"gernard";17;100;0
5;0;"gernie";5;100;0
0;5;"gerniya";5;0;100
5;0;"gero";5;100;0
295;0;"gerod";295;100;0
915;0;"geroge";915;100;0
0;5;"gerogia";5;0;100
2962;0;"gerold";2962;100;0
0;79;"geroldine";79;0;100
0;5;"geroline";5;0;100
0;5;"gerolyn";5;0;100
1300;0;"gerome";1300;100;0
10;0;"geromy";10;100;0
377;0;"geron";377;100;0
49;0;"gerone";49;100;0
0;5;"geronima";5;0;100
2743;0;"geronimo";2743;100;0
321;0;"gerrad";321;100;0
168;0;"gerrald";168;100;0
11;0;"gerran";11;100;0
580;0;"gerrard";580;100;0
0;80;"gerre";80;0;100
43;0;"gerred";43;100;0
21;0;"gerrel";21;100;0
435;0;"gerrell";435;100;0
552;38;"gerren";590;93.5593220338983;6.44067796610169
5;0;"gerret";5;100;0
92;0;"gerrett";92;100;0
17;5446;"gerri";5463;0.311184330953688;99.6888156690463
0;57;"gerriann";57;0;100
0;111;"gerrianne";111;0;100
0;96;"gerrica";96;0;100
566;0;"gerrick";566;100;0
22;0;"gerrid";22;100;0
11;1367;"gerrie";1378;0.798258345428157;99.2017416545718
0;10;"gerrika";10;0;100
0;32;"gerrilyn";32;0;100
0;11;"gerrilynn";11;0;100
11;0;"gerrin";11;100;0
2743;0;"gerrit";2743;100;0
231;0;"gerritt";231;100;0
718;0;"gerrod";718;100;0
25;0;"gerrold";25;100;0
289;0;"gerron";289;100;0
14372;6656;"gerry";21028;68.3469659501617;31.6530340498383
0;6;"gerrye";6;0;100
0;5;"gerryn";5;0;100
6;0;"gersain";6;100;0
173;0;"gershom";173;100;0
707;0;"gershon";707;100;0
3424;0;"gerson";3424;100;0
0;17;"gerta";17;0;100
0;1685;"gertha";1685;0;100
0;11;"gerthie";11;0;100
0;6647;"gertie";6647;0;100
5;23;"gertis";28;17.8571428571429;82.1428571428571
0;28;"gertrud";28;0;100
454;145831;"gertrude";146285;0.310353077895888;99.6896469221041
0;6;"gertrudes";6;0;100
0;28;"gertrudis";28;0;100
0;222;"gertrue";222;0;100
0;238;"gertude";238;0;100
0;127;"gerturde";127;0;100
11;0;"gervais";11;100;0
0;54;"gervaise";54;0;100
197;5;"gervase";202;97.5247524752475;2.47524752475248
5;0;"gerver";5;100;0
5;0;"gervin";5;100;0
217;0;"gervis";217;100;0
21;0;"gervon";21;100;0
758;0;"gery";758;100;0
10;95;"geryl";105;9.52380952380952;90.4761904761905
12;0;"gerzon";12;100;0
0;5;"gesel";5;0;100
0;6;"gesele";6;0;100
0;6;"gesell";6;0;100
0;256;"geselle";256;0;100
0;160;"gesenia";160;0;100
0;5;"geshia";5;0;100
0;5;"gesica";5;0;100
0;5;"gesina";5;0;100
0;23;"gessel";23;0;100
0;5;"gessell";5;0;100
0;96;"gesselle";96;0;100
0;200;"gessica";200;0;100
5;0;"gesualdo";5;100;0
5;0;"geter";5;100;0
0;7;"getha";7;0;100
0;46;"gethsemane";46;0;100
0;18;"gethsemani";18;0;100
0;27;"getrude";27;0;100
0;5;"getrudes";5;0;100
12;476;"getsemani";488;2.45901639344262;97.5409836065574
0;5;"getsemany";5;0;100
0;15;"gettie";15;0;100
12;0;"gettis";12;100;0
10;0;"getty";10;100;0
5;0;"gettys";5;100;0
7;0;"getzel";7;100;0
0;23;"getzemani";23;0;100
0;11;"getzemany";11;0;100
0;5;"gevalia";5;0;100
12;0;"gevan";12;100;0
0;50;"gevena";50;0;100
96;0;"gevin";96;100;0
101;0;"gevon";101;100;0
20;0;"gevonte";20;100;0
65;0;"gevorg";65;100;0
205;0;"gevork";205;100;0
0;5;"gewel";5;0;100
0;8;"geysha";8;0;100
260;0;"geza";260;100;0
0;45;"gezelle";45;0;100
12;0;"ghabriel";12;100;0
0;108;"ghada";108;0;100
0;7;"ghadah";7;0;100
0;91;"ghadeer";91;0;100
14;0;"ghael";14;100;0
0;16;"ghaida";16;0;100
5;0;"ghais";5;100;0
34;0;"ghaith";34;100;0
0;33;"ghala";33;0;100
6;0;"ghaleb";6;100;0
62;0;"ghali";62;100;0
0;54;"ghalia";54;0;100
0;12;"ghana";12;0;100
5;0;"ghanem";5;100;0
288;0;"ghassan";288;100;0
5;0;"ghavin";5;100;0
0;124;"ghazal";124;0;100
143;0;"ghazi";143;100;0
0;10;"ghena";10;0;100
0;5;"ghenet";5;0;100
0;45;"ghia";45;0;100
5;0;"ghian";5;100;0
0;23;"ghianna";23;0;100
0;44;"ghina";44;0;100
0;175;"ghislaine";175;0;100
0;11;"ghislane";11;0;100
0;48;"ghita";48;0;100
0;7;"ghofran";7;0;100
10;0;"ghulam";10;100;0
0;5;"gi";5;0;100
5;13639;"gia";13644;0.0366461448255644;99.9633538551744
0;219;"giabella";219;0;100
5;0;"giacinto";5;100;0
16;0;"giacobbe";16;100;0
0;5;"giacomina";5;0;100
1571;0;"giacomo";1571;100;0
0;3302;"giada";3302;0;100
0;59;"giah";59;0;100
0;5;"giahan";5;0;100
0;32;"giahna";32;0;100
0;15;"giahnna";15;0;100
0;56;"giamarie";56;0;100
3147;0;"gian";3147;100;0
0;7593;"giana";7593;0;100
0;104;"gianah";104;0;100
7152;0;"giancarlo";7152;100;0
684;0;"giancarlos";684;100;0
0;581;"gianella";581;0;100
0;110;"gianelle";110;0;100
0;27;"gianelly";27;0;100
0;5;"gianessa";5;0;100
0;7;"gianetta";7;0;100
948;0;"gianfranco";948;100;0
63;12;"giang";75;84;16
244;178;"giani";422;57.8199052132701;42.1800947867299
0;568;"gianina";568;0;100
0;10;"gianinna";10;0;100
61;0;"giankarlo";61;100;0
2289;0;"gianluca";2289;100;0
78;0;"gianlucas";78;100;0
91;0;"gianlucca";91;100;0
35;0;"gianluigi";35;100;0
13;0;"gianluka";13;100;0
687;0;"gianmarco";687;100;0
11;0;"gianmarcos";11;100;0
17;0;"gianmichael";17;100;0
77;0;"giann";77;100;0
28;60449;"gianna";60477;0.0462985928534815;99.9537014071465
0;317;"giannah";317;0;100
0;77;"giannamarie";77;0;100
0;5;"giannarose";5;0;100
54;0;"gianncarlo";54;100;0
0;65;"gianne";65;0;100
0;11;"giannella";11;0;100
9026;1789;"gianni";10815;83.4581599630143;16.5418400369857
0;95;"giannie";95;0;100
0;318;"giannina";318;0;100
7;0;"giannis";7;100;0
54;0;"gianno";54;100;0
161;147;"gianny";308;52.2727272727273;47.7272727272727
45;0;"giano";45;100;0
170;0;"gianpaolo";170;100;0
19;0;"gianpaul";19;100;0
28;0;"gianpiero";28;100;0
0;5;"giany";5;0;100
0;62;"giara";62;0;100
0;333;"giavana";333;0;100
0;3977;"giavanna";3977;0;100
0;18;"giavannah";18;0;100
93;209;"giavanni";302;30.794701986755;69.205298013245
0;29;"giavona";29;0;100
0;966;"giavonna";966;0;100
103;163;"giavonni";266;38.7218045112782;61.2781954887218
0;5;"giavonnie";5;0;100
51;0;"gib";51;100;0
11;0;"gibb";11;100;0
71;0;"gibbs";71;100;0
0;6;"gibelly";6;0;100
5;0;"gibert";5;100;0
7;0;"gibram";7;100;0
927;0;"gibran";927;100;0
58;0;"gibril";58;100;0
4049;120;"gibson";4169;97.1216118973375;2.87838810266251
0;19;"gicel";19;0;100
0;80;"gicela";80;0;100
0;12;"gicell";12;0;100
0;53;"gicelle";53;0;100
112;0;"gid";112;100;0
38;0;"giddeon";38;100;0
12541;11;"gideon";12552;99.9123645634162;0.0876354365838113
0;1586;"gidget";1586;0;100
0;26;"gidgett";26;0;100
0;5;"gidgette";5;0;100
0;6;"gieselle";6;0;100
60;0;"giezi";60;100;0
1427;0;"gifford";1427;100;0
0;82;"gift";82;0;100
0;38;"gifty";38;0;100
17;0;"gig";17;100;0
0;5;"giget";5;0;100
0;5;"gigette";5;0;100
0;3872;"gigi";3872;0;100
0;39;"gihanna";39;0;100
4737;0;"gil";4737;100;0
0;534;"gila";534;0;100
306;0;"gilad";306;100;0
0;27;"gilana";27;0;100
126465;674;"gilbert";127139;99.4698715579012;0.530128442098805
0;554;"gilberta";554;0;100
0;196;"gilberte";196;0;100
27416;58;"gilberto";27474;99.7888913154255;0.211108684574507
18;0;"gilchrist";18;100;0
0;10016;"gilda";10016;0;100
1048;0;"gildardo";1048;100;0
177;0;"gildo";177;100;0
5;0;"gile";5;100;0
41;0;"gilead";41;100;0
4331;0;"giles";4331;100;0
1195;0;"gilford";1195;100;0
7;0;"gilfred";7;100;0
0;45;"gili";45;0;100
0;5;"gilia";5;0;100
0;14;"gilian";14;0;100
0;61;"giliana";61;0;100
1211;55;"gill";1266;95.6556082148499;4.34439178515008
0;5;"gillan";5;0;100
5;0;"gillard";5;100;0
5;0;"gillen";5;100;0
0;30;"gillermina";30;0;100
633;0;"gillermo";633;100;0
361;0;"gilles";361;100;0
5;0;"gillespie";5;100;0
10;0;"gillette";10;100;0
147;10;"gilliam";157;93.6305732484076;6.36942675159236
67;15522;"gillian";15589;0.429790236705369;99.5702097632946
0;24;"gilliana";24;0;100
0;10;"gillianna";10;0;100
0;38;"gillianne";38;0;100
185;223;"gillie";408;45.343137254902;54.656862745098
712;0;"gillis";712;100;0
0;16;"gillyan";16;0;100
0;220;"gilma";220;0;100
929;0;"gilman";929;100;0
122;0;"gilmar";122;100;0
1142;0;"gilmer";1142;100;0
754;0;"gilmore";754;100;0
32;0;"gilroy";32;100;0
41;0;"gilson";41;100;0
75;0;"gilverto";75;100;0
0;363;"gimena";363;0;100
23;7;"gin";30;76.6666666666667;23.3333333333333
399;151898;"gina";152297;0.261988089062818;99.7380119109372
0;5;"ginae";5;0;100
0;1070;"ginamarie";1070;0;100
0;6;"ginaya";6;0;100
0;22;"gindy";22;0;100
0;27;"gineen";27;0;100
0;12;"ginelie";12;0;100
0;16;"ginell";16;0;100
0;484;"ginelle";484;0;100
0;10;"giner";10;0;100
0;28;"ginessa";28;0;100
0;11;"ginetta";11;0;100
0;870;"ginette";870;0;100
0;5;"gineva";5;0;100
0;165;"ginevra";165;0;100
0;5;"ging";5;0;100
41;45759;"ginger";45800;0.0895196506550218;99.910480349345
0;505;"gini";505;0;100
0;79;"ginia";79;0;100
0;6;"ginine";6;0;100
0;757;"ginna";757;0;100
0;6;"ginneh";6;0;100
0;92;"ginnette";92;0;100
0;5;"ginney";5;0;100
0;199;"ginni";199;0;100
0;780;"ginnie";780;0;100
0;76;"ginnifer";76;0;100
6;0;"ginno";6;100;0
0;7263;"ginny";7263;0;100
11724;12;"gino";11736;99.8977505112474;0.102249488752556
7;0;"ginobili";7;100;0
389;5;"gio";394;98.7309644670051;1.26903553299492
16;0;"gioacchino";16;100;0
0;5;"gioanna";5;0;100
5;0;"gioanni";5;100;0
5;0;"giobani";5;100;0
5;0;"giobany";5;100;0
0;22;"gioconda";22;0;100
5;0;"gioele";5;100;0
0;549;"gioia";549;0;100
117;0;"giomar";117;100;0
8;0;"gion";8;100;0
0;59;"giona";59;0;100
46;0;"gioni";46;100;0
0;698;"gionna";698;0;100
1036;52;"gionni";1088;95.2205882352941;4.77941176470588
24;0;"gionnie";24;100;0
29;0;"gionny";29;100;0
114;14;"giordan";128;89.0625;10.9375
0;96;"giordana";96;0;100
240;0;"giordano";240;100;0
63;0;"giorgi";63;100;0
0;275;"giorgia";275;0;100
0;26;"giorgina";26;0;100
1494;0;"giorgio";1494;100;0
7;0;"giorgios";7;100;0
5;0;"giorgos";5;100;0
287;0;"giovan";287;100;0
0;746;"giovana";746;0;100
6154;5;"giovani";6159;99.9188179899334;0.0811820100665692
83;0;"giovanie";83;100;0
6;0;"giovanii";6;100;0
42;0;"giovann";42;100;0
0;11239;"giovanna";11239;0;100
0;6;"giovannah";6;0;100
113;0;"giovanne";113;100;0
63093;865;"giovanni";63958;98.6475499546577;1.35245004534226
612;6;"giovannie";618;99.0291262135922;0.970873786407767
5;0;"giovannii";5;100;0
0;76;"giovannina";76;0;100
5880;30;"giovanny";5910;99.492385786802;0.50761421319797
23;0;"giovante";23;100;0
1471;0;"giovany";1471;100;0
0;8;"giovina";8;0;100
70;0;"giovoni";70;100;0
5;0;"giovonie";5;100;0
0;21;"giovonna";21;0;100
976;0;"giovonni";976;100;0
81;0;"giovonnie";81;100;0
5;0;"gipson";5;100;0
0;10;"gipsy";10;0;100
1717;0;"girard";1717;100;0
0;23;"girdie";23;0;100
34;0;"girish";34;100;0
0;393;"girl";393;0;100
0;12;"girlean";12;0;100
0;30;"girlee";30;0;100
0;29;"girlene";29;0;100
0;425;"girlie";425;0;100
56;0;"giro";56;100;0
0;10;"girolama";10;0;100
64;0;"girolamo";64;100;0
0;581;"girtha";581;0;100
0;5;"girther";5;0;100
0;6;"girthie";6;0;100
0;338;"girtie";338;0;100
0;205;"girtrude";205;0;100
0;50;"girtrue";50;0;100
0;10;"girty";10;0;100
17;0;"giscard";17;100;0
0;2120;"gisel";2120;0;100
0;3922;"gisela";3922;0;100
0;26;"giselda";26;0;100
0;4704;"gisele";4704;0;100
0;1736;"gisell";1736;0;100
0;1262;"gisella";1262;0;100
44;41639;"giselle";41683;0.10555862102056;99.8944413789794
0;18;"giselly";18;0;100
0;5;"gisely";5;0;100
0;6;"gisette";6;0;100
0;12;"gislaine";12;0;100
0;2382;"gissel";2382;0;100
0;214;"gissela";214;0;100
0;566;"gissele";566;0;100
0;1288;"gissell";1288;0;100
0;71;"gissella";71;0;100
0;9258;"gisselle";9258;0;100
0;15;"gissette";15;0;100
0;443;"gita";443;0;100
0;15;"gitana";15;0;100
0;40;"gitanjali";40;0;100
0;178;"gitel";178;0;100
0;10;"gitta";10;0;100
0;1003;"gittel";1003;0;100
0;5;"gittle";5;0;100
0;2357;"gitty";2357;0;100
0;55;"gitzel";55;0;100
0;5;"giuditta";5;0;100
0;2222;"giulia";2222;0;100
133;0;"giulian";133;100;0
0;8754;"giuliana";8754;0;100
21;0;"giuliani";21;100;0
0;1094;"giulianna";1094;0;100
653;0;"giuliano";653;100;0
0;259;"giulietta";259;0;100
0;31;"giuliette";31;0;100
538;0;"giulio";538;100;0
0;61;"giulliana";61;0;100
0;11;"giuseppa";11;0;100
5346;0;"giuseppe";5346;100;0
7;0;"giuseppi";7;100;0
0;726;"giuseppina";726;0;100
0;16;"giustina";16;0;100
0;20;"givanna";20;0;100
80;0;"givanni";80;100;0
42;0;"given";42;100;0
30;0;"givon";30;100;0
0;5;"givonna";5;0;100
11;0;"givonni";11;100;0
0;15;"giya";15;0;100
0;5;"giyana";5;0;100
0;24;"giyanna";24;0;100
0;265;"gizel";265;0;100
0;27;"gizela";27;0;100
0;45;"gizele";45;0;100
0;96;"gizell";96;0;100
0;558;"gizella";558;0;100
0;2645;"gizelle";2645;0;100
0;19;"gizem";19;0;100
0;36;"gizzel";36;0;100
0;112;"gizzelle";112;0;100
62;0;"gjon";62;100;0
0;472;"glada";472;0;100
10;0;"gladden";10;100;0
824;0;"glade";824;100;0
0;41;"gladene";41;0;100
0;11;"glades";11;0;100
0;162;"gladie";162;0;100
0;408;"gladies";408;0;100
12;0;"gladimir";12;100;0
0;279;"gladine";279;0;100
0;166;"gladiola";166;0;100
5;2959;"gladis";2964;0.168690958164642;99.8313090418354
0;10;"gladiz";10;0;100
0;6;"gladolia";6;0;100
17;0;"gladston";17;100;0
193;0;"gladstone";193;100;0
0;5;"gladus";5;0;100
40;0;"gladwin";40;100;0
16;0;"gladwyn";16;100;0
5;538;"glady";543;0.920810313075507;99.0791896869245
0;983;"gladyce";983;0;100
0;112;"gladyes";112;0;100
0;11;"gladyne";11;0;100
986;251118;"gladys";252104;0.391108431440993;99.608891568559
0;54;"gladyse";54;0;100
0;9;"gladystine";9;0;100
0;5;"glafira";5;0;100
0;67;"glanda";67;0;100
16;0;"glasco";16;100;0
5;0;"glasper";5;100;0
0;38;"glatha";38;0;100
0;175;"glayds";175;0;100
32;0;"glean";32;100;0
383;0;"gleason";383;100;0
115;0;"gleb";115;100;0
0;47;"gleda";47;0;100
20;771;"glee";791;2.52844500632111;97.4715549936789
667;0;"gleen";667;100;0
0;5;"gleeta";5;0;100
0;8;"gleice";8;0;100
0;169;"glema";169;0;100
123639;1290;"glen";124929;98.9674134908628;1.03258650913719
0;1071;"glena";1071;0;100
0;27;"glenadine";27;0;100
0;9;"glenalee";9;0;100
202;0;"glenard";202;100;0
295;109006;"glenda";109301;0.269896890238882;99.7301031097611
184;5;"glendal";189;97.3544973544974;2.64550264550265
544;81;"glendale";625;87.04;12.96
0;5;"glendalee";5;0;100
0;12;"glendalis";12;0;100
0;17;"glendaliz";17;0;100
17;0;"glendall";17;100;0
0;49;"glendaly";49;0;100
0;12;"glendalys";12;0;100
0;35;"glendean";35;0;100
155;5;"glendel";160;96.875;3.125
491;92;"glendell";583;84.2195540308748;15.7804459691252
104;0;"glenden";104;100;0
0;94;"glendene";94;0;100
0;64;"glender";64;0;100
0;70;"glendi";70;0;100
0;247;"glendia";247;0;100
0;133;"glendine";133;0;100
37;0;"glendle";37;100;0
0;245;"glendola";245;0;100
0;55;"glendolyn";55;0;100
4573;64;"glendon";4637;98.6197972827259;1.3802027172741
0;2296;"glendora";2296;0;100
0;30;"glendoria";30;0;100
0;85;"glendoris";85;0;100
0;413;"glendy";413;0;100
0;15;"glenell";15;0;100
0;11;"glenese";11;0;100
0;6;"glenesha";6;0;100
0;62;"glenetta";62;0;100
0;66;"glenette";66;0;100
0;38;"gleneva";38;0;100
487;0;"glenford";487;100;0
0;943;"glenice";943;0;100
27;400;"glenis";427;6.3231850117096;93.6768149882904
0;26;"glenise";26;0;100
0;119;"glenisha";119;0;100
0;42;"glenita";42;0;100
65;0;"glenmore";65;100;0
245192;1963;"glenn";247155;99.2057615666282;0.794238433371771
5;25059;"glenna";25064;0.0199489307373125;99.9800510692627
5;0;"glennard";5;100;0
0;561;"glennda";561;0;100
0;5;"glenndora";5;0;100
0;5;"glenne";5;0;100
0;17;"glennell";17;0;100
0;32;"glennetta";32;0;100
0;104;"glennette";104;0;100
0;5;"glennia";5;0;100
0;76;"glennice";76;0;100
293;1692;"glennie";1985;14.7607052896725;85.2392947103275
721;2054;"glennis";2775;25.981981981982;74.018018018018
0;41;"glennisha";41;0;100
1244;0;"glennon";1244;100;0
0;5;"glennora";5;0;100
20;0;"glennwood";20;100;0
16;25;"glenny";41;39.0243902439024;60.9756097560976
0;242;"glennys";242;0;100
0;188;"glenola";188;0;100
0;472;"glenora";472;0;100
0;51;"glenrose";51;0;100
161;0;"glenroy";161;100;0
5;0;"glenston";5;100;0
6;0;"glenton";6;100;0
0;16;"glenva";16;0;100
59;0;"glenville";59;100;0
11;0;"glenward";11;100;0
2246;0;"glenwood";2246;100;0
0;5;"gleny";5;0;100
0;105;"glenyce";105;0;100
0;570;"glenys";570;0;100
0;14;"gleora";14;0;100
0;105;"glessie";105;0;100
0;6;"glida";6;0;100
17;0;"glin";17;100;0
0;2547;"glinda";2547;0;100
0;20;"glinnie";20;0;100
0;17;"glo";17;0;100
0;37;"glodine";37;0;100
0;314;"glora";314;0;100
0;62;"glorene";62;0;100
0;5;"gloretha";5;0;100
0;34;"gloretta";34;0;100
0;441;"glori";441;0;100
1737;410658;"gloria";412395;0.421198123158622;99.5788018768414
0;123;"gloriajean";123;0;100
0;120;"glorian";120;0;100
0;552;"gloriana";552;0;100
0;17;"gloriane";17;0;100
0;345;"gloriann";345;0;100
0;429;"glorianna";429;0;100
0;314;"glorianne";314;0;100
0;45;"gloribel";45;0;100
0;12;"glorice";12;0;100
0;8;"gloricely";8;0;100
0;11;"glorida";11;0;100
0;290;"glorie";290;0;100
0;12;"glories";12;0;100
0;57;"glorietta";57;0;100
0;17;"gloriette";17;0;100
0;174;"glorimar";174;0;100
0;195;"glorine";195;0;100
0;293;"glorious";293;0;100
0;313;"gloris";313;0;100
0;7;"gloristeen";7;0;100
0;63;"gloristine";63;0;100
0;5;"glorius";5;0;100
27;3979;"glory";4006;0.673989016475287;99.3260109835247
0;146;"glorya";146;0;100
0;16;"gloryann";16;0;100
0;6;"gloryvee";6;0;100
0;43;"glossie";43;0;100
11;0;"gloster";11;100;0
1035;5;"glover";1040;99.5192307692308;0.480769230769231
77;0;"gloyd";77;100;0
0;5;"glyda";5;0;100
5;0;"glyde";5;100;0
1383;92;"glyn";1475;93.7627118644068;6.23728813559322
0;5;"glyna";5;0;100
0;2425;"glynda";2425;0;100
0;10;"glyndia";10;0;100
145;10;"glyndon";155;93.5483870967742;6.45161290322581
0;5;"glyndora";5;0;100
0;11;"glynes";11;0;100
0;5;"glynice";5;0;100
10;2014;"glynis";2024;0.494071146245059;99.5059288537549
0;6;"glyniss";6;0;100
4940;417;"glynn";5357;92.2157924211312;7.78420757886877
0;212;"glynna";212;0;100
0;7;"glynne";7;0;100
0;559;"glynnis";559;0;100
0;12;"gniya";12;0;100
40;0;"gobel";40;100;0
10;0;"gobind";10;100;0
109;0;"goble";109;100;0
16;0;"god";16;100;0
0;298;"goddess";298;0;100
18;0;"godfred";18;100;0
2990;0;"godfrey";2990;100;0
0;5;"godiva";5;0;100
16;0;"godofredo";16;100;0
213;0;"godric";213;100;0
10;0;"godrick";10;100;0
53;0;"godson";53;100;0
40;0;"godswill";40;100;0
6;0;"godwill";6;100;0
446;0;"godwin";446;100;0
65;0;"goebel";65;100;0
54;0;"goeffrey";54;100;0
209;0;"goerge";209;100;0
6;0;"goff";6;100;0
0;6;"gogi";6;0;100
217;0;"gohan";217;100;0
0;32;"gohar";32;0;100
31;0;"goku";31;100;0
82;0;"gokul";82;100;0
5;267;"gola";272;1.83823529411765;98.1617647058823
17;0;"golan";17;100;0
10;10;"gold";20;50;50
0;5021;"golda";5021;0;100
0;10;"golde";10;0;100
0;6;"goldean";6;0;100
2386;1702;"golden";4088;58.3659491193738;41.6340508806262
0;34;"goldena";34;0;100
0;21;"goldene";21;0;100
0;5;"goldi";5;0;100
0;1662;"goldia";1662;0;100
403;31050;"goldie";31453;1.28127682573999;98.71872317426
0;5;"goldina";5;0;100
0;41;"goldine";41;0;100
104;0;"goldman";104;100;0
5;0;"goldmon";5;100;0
0;1018;"goldy";1018;0;100
0;147;"goldye";147;0;100
0;5;"goldyn";5;0;100
0;11;"golena";11;0;100
11;0;"goliath";11;100;0
0;21;"golie";21;0;100
0;10;"golnaz";10;0;100
399;0;"gomer";399;100;0
5;0;"gomez";5;100;0
230;0;"gonsalo";230;100;0
0;21;"gonzala";21;0;100
31;0;"gonzales";31;100;0
9868;0;"gonzalo";9868;100;0
0;5;"gonzella";5;0;100
8;0;"goodluck";8;100;0
22;0;"goodman";22;100;0
0;15;"goodness";15;0;100
256;0;"goodwin";256;100;0
87;0;"gopal";87;100;0
0;51;"gopi";51;0;100
0;5;"gopika";5;0;100
65;0;"gor";65;100;0
108;0;"goran";108;100;0
1021;0;"gordan";1021;100;0
0;40;"gordana";40;0;100
0;6;"gordean";6;0;100
2021;0;"gorden";2021;100;0
203;79;"gordie";282;71.9858156028369;28.0141843971631
151283;665;"gordon";151948;99.5623502777266;0.437649722273409
336;0;"gordy";336;100;0
26;0;"goree";26;100;0
0;5;"gorete";5;0;100
0;32;"goretti";32;0;100
0;10;"goretty";10;0;100
2587;0;"gorge";2587;100;0
0;157;"gorgeous";157;0;100
13;0;"gorgonio";13;100;0
5;0;"gorham";5;100;0
0;5;"gorizia";5;0;100
91;0;"gorje";91;100;0
5;0;"gorkem";5;100;0
817;0;"gorman";817;100;0
77;0;"goro";77;100;0
5;0;"goshen";5;100;0
5;0;"gospel";5;100;0
5;0;"goten";5;100;0
96;0;"gotham";96;100;0
5;0;"gottfred";5;100;0
115;0;"gottfried";115;100;0
73;0;"gotti";73;100;0
251;0;"gottlieb";251;100;0
5;0;"gottlob";5;100;0
28;0;"gould";28;100;0
0;10;"gouri";10;0;100
27;0;"govan";27;100;0
81;0;"govani";81;100;0
0;5;"govanna";5;0;100
239;0;"govanni";239;100;0
55;0;"govanny";55;100;0
6;0;"govany";6;100;0
337;0;"governor";337;100;0
110;0;"govind";110;100;0
32;0;"govinda";32;100;0
0;100;"gowri";100;0;100
42;0;"gowtham";42;100;0
621;0;"grabiel";621;100;0
0;433;"grabiela";433;0;100
11;0;"grabriel";11;100;0
0;37;"grabriela";37;0;100
1164;444049;"grace";445213;0.261447891234083;99.7385521087659
0;5;"gracean";5;0;100
0;942;"graceann";942;0;100
0;94;"graceanna";94;0;100
0;436;"graceanne";436;0;100
0;1279;"gracee";1279;0;100
0;5;"graceelizabeth";5;0;100
0;5;"gracelan";5;0;100
0;74;"graceland";74;0;100
0;64;"gracelee";64;0;100
0;18;"graceleigh";18;0;100
0;208;"gracelin";208;0;100
0;5;"gracelinn";5;0;100
0;5;"gracella";5;0;100
0;20;"gracely";20;0;100
0;8424;"gracelyn";8424;0;100
0;5;"gracelynd";5;0;100
0;5411;"gracelynn";5411;0;100
0;232;"gracelynne";232;0;100
0;172;"gracemarie";172;0;100
0;22;"gracemary";22;0;100
737;1781;"gracen";2518;29.2692613185068;70.7307386814932
216;23;"graceson";239;90.3765690376569;9.6234309623431
0;6;"gracesyn";6;0;100
0;2267;"gracey";2267;0;100
0;348;"graceyn";348;0;100
0;1375;"graci";1375;0;100
0;1773;"gracia";1773;0;100
5;0;"gracian";5;100;0
0;263;"graciana";263;0;100
0;127;"gracianna";127;0;100
0;10;"gracianne";10;0;100
205;0;"graciano";205;100;0
45;70294;"gracie";70339;0.0639758881985812;99.9360241118014
0;95;"gracieann";95;0;100
0;18;"graciee";18;0;100
39;15325;"graciela";15364;0.253840145795366;99.7461598542046
0;809;"graciella";809;0;100
0;10;"gracielle";10;0;100
0;91;"gracielynn";91;0;100
0;107;"graciemae";107;0;100
0;84;"gracilyn";84;0;100
0;11;"gracilynn";11;0;100
436;213;"gracin";649;67.1802773497689;32.8197226502311
0;120;"gracious";120;0;100
0;193;"graclyn";193;0;100
0;58;"graclynn";58;0;100
0;1390;"gracy";1390;0;100
0;32;"gracye";32;0;100
112;3207;"gracyn";3319;3.3745103946972;96.6254896053028
0;121;"gracynn";121;0;100
5;0;"graddy";5;100;0
656;0;"graden";656;100;0
28;0;"gradey";28;100;0
426;184;"gradie";610;69.8360655737705;30.1639344262295
49;0;"gradin";49;100;0
50;0;"gradon";50;100;0
44743;643;"grady";45386;98.5832635614507;1.41673643854933
219;0;"gradyn";219;100;0
0;5;"gradys";5;0;100
58;75;"grae";133;43.609022556391;56.390977443609
5;0;"graecen";5;100;0
0;6;"graecie";6;0;100
5;50;"graecyn";55;9.09090909090909;90.9090909090909
72;0;"graeden";72;100;0
5;0;"graedy";5;100;0
5;0;"graeham";5;100;0
0;83;"graelyn";83;0;100
0;14;"graelynn";14;0;100
7;0;"graem";7;100;0
2435;0;"graeme";2435;100;0
5;0;"graer";5;100;0
10;0;"graesen";10;100;0
518;15;"graeson";533;97.1857410881801;2.81425891181989
77;22;"graesyn";99;77.7777777777778;22.2222222222222
975;0;"grafton";975;100;0
39660;141;"graham";39801;99.6457375442828;0.354262455717193
6;0;"grahame";6;100;0
583;0;"grahm";583;100;0
0;21;"graice";21;0;100
5;0;"graicen";5;100;0
0;5;"graicyn";5;0;100
80;0;"graiden";80;100;0
11;0;"graidy";11;100;0
0;6;"graidys";6;0;100
1338;0;"graig";1338;100;0
53;0;"grainger";53;100;0
0;87;"grainne";87;0;100
39;0;"graisen";39;100;0
275;36;"graison";311;88.4244372990354;11.5755627009646
26;38;"graisyn";64;40.625;59.375
49;0;"gralin";49;100;0
38;0;"gralyn";38;100;0
273;0;"gram";273;100;0
7;0;"gramm";7;100;0
0;15;"granada";15;0;100
22;0;"granderson";22;100;0
7;0;"grandin";7;100;0
5;0;"grandison";5;100;0
32;0;"grandon";32;100;0
56;0;"grandville";56;100;0
645;0;"granger";645;100;0
83;0;"granite";83;100;0
119124;202;"grant";119326;99.8307158540469;0.169284145953103
200;0;"grantham";200;100;0
119;0;"grantland";119;100;0
10;0;"grantlee";10;100;0
81;0;"grantley";81;100;0
100;0;"granvel";100;100;0
250;0;"granvil";250;100;0
28;0;"granvill";28;100;0
5032;0;"granville";5032;100;0
0;5;"graple";5;0;100
12;0;"grasen";12;100;0
0;5;"grasha";5;0;100
0;298;"grasiela";298;0;100
319;0;"grason";319;100;0
47;21;"grasyn";68;69.1176470588235;30.8823529411765
0;115;"gratia";115;0;100
5;0;"graven";5;100;0
82;0;"graves";82;100;0
95;0;"graviel";95;100;0
0;60;"graviela";60;0;100
3752;365;"gray";4117;91.1343211076026;8.86567889239738
0;3879;"grayce";3879;0;100
0;416;"graycee";416;0;100
0;22;"graycelyn";22;0;100
0;10;"graycelynn";10;0;100
253;559;"graycen";812;31.1576354679803;68.8423645320197
0;53;"grayci";53;0;100
0;385;"graycie";385;0;100
33;41;"graycin";74;44.5945945945946;55.4054054054054
1582;0;"grayden";1582;100;0
11;0;"graydin";11;100;0
3173;0;"graydon";3173;100;0
5;10;"graye";15;33.3333333333333;66.6666666666667
123;0;"grayer";123;100;0
41;0;"graylan";41;100;0
196;0;"grayland";196;100;0
0;44;"graylee";44;0;100
86;0;"graylen";86;100;0
465;34;"graylin";499;93.186372745491;6.81362725450902
529;0;"grayling";529;100;0
292;0;"graylon";292;100;0
5;45;"graylyn";50;10;90
0;11;"graylynn";11;0;100
2265;570;"graysen";2835;79.8941798941799;20.1058201058201
0;5;"graysie";5;0;100
63;0;"graysin";63;100;0
62453;3423;"grayson";65876;94.8038739449875;5.19612605501245
46;5;"graysyn";51;90.1960784313726;9.80392156862745
118;0;"grayton";118;100;0
0;186;"grazia";186;0;100
0;5;"graziana";5;0;100
5;0;"graziano";5;100;0
0;467;"graziella";467;0;100
5;0;"greagory";5;100;0
21;0;"great";21;100;0
0;10;"greathel";10;0;100
6;0;"greatness";6;100;0
0;5;"grechen";5;0;100
0;4777;"grecia";4777;0;100
106;0;"greco";106;100;0
0;5;"greda";5;0;100
0;68;"gredmarie";68;0;100
38;23;"greeley";61;62.2950819672131;37.7049180327869
64;0;"greely";64;100;0
1484;0;"green";1484;100;0
11;0;"greenberry";11;100;0
116;0;"greene";116;100;0
0;15;"greenlea";15;0;100
0;668;"greenlee";668;0;100
0;140;"greenleigh";140;0;100
0;168;"greenley";168;0;100
0;132;"greenly";132;0;100
5;0;"greenville";5;100;0
6;0;"greenwood";6;100;0
517;2270;"greer";2787;18.5504126300682;81.4495873699318
0;19;"greeta";19;0;100
77528;143;"greg";77671;99.8158901005523;0.18410989944767
10;0;"gregario";10;100;0
505;0;"gregary";505;100;0
26;0;"gregeory";26;100;0
493;0;"gregery";493;100;0
36437;113;"gregg";36550;99.6908344733242;0.309165526675787
16;0;"greggery";16;100;0
5063;0;"greggory";5063;100;0
78;0;"gregoire";78;100;0
1130;0;"gregor";1130;100;0
92;0;"gregorey";92;100;0
5;0;"gregorg";5;100;0
83;0;"gregori";83;100;0
6;2148;"gregoria";2154;0.278551532033426;99.7214484679666
43;0;"gregorie";43;100;0
10238;5;"gregorio";10243;99.951186175925;0.048813824074978
5;0;"gregorios";5;100;0
0;18;"gregorita";18;0;100
705766;2861;"gregory";708627;99.5962615028781;0.403738497121899
15;0;"gregoy";15;100;0
224;0;"gregrey";224;100;0
5;0;"gregrory";5;100;0
349;0;"gregroy";349;100;0
32;0;"gregry";32;100;0
10;0;"gregson";10;100;0
0;25;"greicy";25;0;100
0;5;"greidi";5;0;100
0;34;"greidis";34;0;100
0;99;"greidy";99;0;100
0;337;"greidys";337;0;100
383;0;"greig";383;100;0
7;0;"greighson";7;100;0
7;0;"greison";7;100;0
0;30;"greisy";30;0;100
17;0;"greko";17;100;0
0;77;"grenda";77;0;100
0;6;"grenisha";6;0;100
30;0;"grenville";30;100;0
79;0;"greogory";79;100;0
111;0;"greogry";111;100;0
31;0;"greory";31;100;0
0;6;"gresa";6;0;100
111;0;"gresham";111;100;0
0;89;"gresia";89;0;100
5;24180;"greta";24185;0.0206739714699194;99.9793260285301
0;5;"gretal";5;0;100
0;34;"gretchan";34;0;100
38;52778;"gretchen";52816;0.0719478945774008;99.9280521054226
0;36;"gretchin";36;0;100
0;47;"gretchyn";47;0;100
0;61;"grete";61;0;100
0;1080;"gretel";1080;0;100
0;18;"gretell";18;0;100
0;41;"gretha";41;0;100
0;7;"grethe";7;0;100
0;536;"grethel";536;0;100
0;112;"gretna";112;0;100
0;3663;"gretta";3663;0;100
0;448;"grettel";448;0;100
0;58;"grettell";58;0;100
3284;502;"grey";3786;86.7406233491812;13.2593766508188
0;5;"greyce";5;0;100
53;6;"greycen";59;89.8305084745763;10.1694915254237
6;0;"greycin";6;100;0
243;0;"greyden";243;100;0
0;24;"greydi";24;0;100
0;181;"greydis";181;0;100
257;0;"greydon";257;100;0
0;11;"greydy";11;0;100
0;8;"greydys";8;0;100
34;0;"greyer";34;100;0
35;0;"greylan";35;100;0
16;5;"greylin";21;76.1904761904762;23.8095238095238
12;0;"greyling";12;100;0
17;0;"greylon";17;100;0
0;14;"greylyn";14;0;100
0;12;"greylynn";12;0;100
0;6;"greys";6;0;100
1404;170;"greysen";1574;89.1994917407878;10.8005082592122
0;19;"greysi";19;0;100
59;0;"greysin";59;100;0
25226;520;"greyson";25746;97.9802687796163;2.01973122038375
12;0;"greyston";12;100;0
25;0;"greysun";25;100;0
41;5;"greysyn";46;89.1304347826087;10.8695652173913
10;0;"greyton";10;100;0
0;275;"gricel";275;0;100
0;1545;"gricelda";1545;0;100
0;6;"gricell";6;0;100
5;0;"grieg";5;100;0
263;263;"grier";526;50;50
6;0;"griezmann";6;100;0
215;0;"griff";215;100;0
1563;0;"griffen";1563;100;0
30;0;"griffey";30;100;0
36532;556;"griffin";37088;98.5008628127696;1.49913718723037
5;0;"griffinn";5;100;0
1375;0;"griffith";1375;100;0
180;0;"griffon";180;100;0
264;37;"griffyn";301;87.7076411960133;12.2923588039867
5;0;"grifin";5;100;0
162;0;"grigor";162;100;0
19;0;"grigoriy";19;100;0
5;0;"grigory";5;100;0
22;0;"grimm";22;100;0
0;5;"grinda";5;0;100
0;41;"grindl";41;0;100
0;21;"grindle";21;0;100
0;5;"griscelda";5;0;100
7;1616;"grisel";1623;0.431300061614294;99.5686999383857
0;70;"grisela";70;0;100
61;8726;"griselda";8787;0.69420735176966;99.3057926482303
0;170;"grisell";170;0;100
0;379;"griselle";379;0;100
30;0;"grisham";30;100;0
0;28;"grishma";28;0;100
0;231;"grissel";231;0;100
21;0;"grissom";21;100;0
5;0;"gristian";5;100;0
0;52;"grizel";52;0;100
0;166;"grizelda";166;0;100
7;0;"grizzly";7;100;0
6;0;"gross";6;100;0
119;0;"grove";119;100;0
0;6;"grovene";6;0;100
22200;74;"grover";22274;99.6677740863787;0.332225913621262
5;0;"groves";5;100;0
5;0;"grundy";5;100;0
12;0;"gryffen";12;100;0
393;0;"gryffin";393;100;0
11;0;"gryffon";11;100;0
485;0;"gryphon";485;100;0
35;0;"grzegorz";35;100;0
24630;64150;"guadalupe";88780;27.7427348501915;72.2572651498085
0;34;"guadelupe";34;0;100
22;27;"guadlupe";49;44.8979591836735;55.1020408163265
0;5;"guadulupe";5;0;100
102;0;"guage";102;100;0
308;0;"gualberto";308;100;0
6;0;"guan";6;100;0
5;0;"guardian";5;100;0
5;0;"guarionex";5;100;0
5;27;"gudalupe";32;15.625;84.375
0;62;"gudelia";62;0;100
0;388;"gudrun";388;0;100
0;166;"guelda";166;0;100
0;5;"guendalina";5;0;100
0;12;"guendi";12;0;100
0;5;"guendolyn";5;0;100
0;162;"guenevere";162;0;100
5;0;"guenter";5;100;0
71;0;"guenther";71;100;0
23;0;"guerdon";23;100;0
62;0;"guerin";62;100;0
0;5;"guerina";5;0;100
149;0;"guerino";149;100;0
0;55;"guerline";55;0;100
12;0;"guerrero";12;100;0
18;0;"guerrino";18;100;0
145;0;"guerry";145;100;0
5;0;"guess";5;100;0
84;0;"guhan";84;100;0
0;128;"guida";128;0;100
3337;0;"guido";3337;100;0
0;113;"guila";113;0;100
16;0;"guilbert";16;100;0
0;33;"guilda";33;0;100
576;0;"guilford";576;100;0
437;0;"guilherme";437;100;0
7;0;"guilian";7;100;0
0;439;"guiliana";439;0;100
0;164;"guilianna";164;0;100
12;0;"guiliano";12;100;0
26;0;"guilio";26;100;0
318;0;"guillaume";318;100;0
0;33;"guillerma";33;0;100
0;1896;"guillermina";1896;0;100
29385;74;"guillermo";29459;99.7488034217047;0.251196578295258
0;7;"guilliana";7;0;100
5;0;"guilmar";5;100;0
5;0;"guin";5;100;0
0;5;"guinda";5;0;100
0;5;"guinette";5;0;100
0;2418;"guinevere";2418;0;100
0;22;"guinivere";22;0;100
168;0;"guinn";168;100;0
24;0;"guinness";24;100;0
0;20;"guinnevere";20;0;100
0;5;"guisel";5;0;100
0;7;"guisela";7;0;100
0;5;"guisell";5;0;100
0;151;"guiselle";151;0;100
564;0;"guiseppe";564;100;0
16;0;"guiseppi";16;100;0
0;5;"guisselle";5;0;100
5;0;"guistino";5;100;0
0;5;"gul";5;0;100
0;15;"gula";15;0;100
97;0;"guled";97;100;0
10;0;"gulian";10;100;0
0;152;"guliana";152;0;100
0;166;"gulianna";166;0;100
5;0;"gullermo";5;100;0
377;0;"gumaro";377;100;0
81;0;"gumecindo";81;100;0
16;0;"gumercindo";16;100;0
33;0;"gumesindo";33;100;0
43;0;"gunar";43;100;0
13;0;"gunars";13;100;0
0;47;"gunda";47;0;100
10;0;"gunder";10;100;0
0;56;"guneet";56;0;100
22;0;"guner";22;100;0
0;158;"gunhild";158;0;100
13242;17;"gunnar";13259;99.871785202504;0.12821479749604
67;0;"gunnard";67;100;0
21;0;"gunnarr";21;100;0
14802;11;"gunner";14813;99.9257409032606;0.0742590967393506
66;0;"gunnison";66;100;0
330;0;"gunter";330;100;0
934;0;"gunther";934;100;0
0;5;"gunvor";5;0;100
15;0;"guransh";15;100;0
0;49;"gurbani";49;0;100
7;0;"gurbir";7;100;0
22;0;"gurdeep";22;100;0
5;0;"gurdit";5;100;0
54;0;"gurdon";54;100;0
66;0;"gurfateh";66;100;0
26;0;"gurinder";26;100;0
5;0;"gurjeet";5;100;0
10;0;"gurjit";10;100;0
167;6;"gurjot";173;96.5317919075144;3.46820809248555
5;0;"gurkamal";5;100;0
64;12;"gurkirat";76;84.2105263157895;15.7894736842105
0;494;"gurleen";494;0;100
74;0;"gurley";74;100;0
0;5;"gurlie";5;0;100
119;13;"gurman";132;90.1515151515152;9.84848484848485
0;19;"gurnaaz";19;0;100
0;56;"gurneet";56;0;100
761;0;"gurney";761;100;0
108;0;"gurnie";108;100;0
126;228;"gurnoor";354;35.5932203389831;64.4067796610169
5;0;"gurpal";5;100;0
311;172;"gurpreet";483;64.3892339544513;35.6107660455487
0;21;"gurseerat";21;0;100
151;0;"gurshaan";151;100;0
175;0;"gurshan";175;100;0
11;0;"gurshawn";11;100;0
0;10;"gursimar";10;0;100
6;20;"gursimran";26;23.0769230769231;76.9230769230769
0;14;"gursirat";14;0;100
7;0;"gurtaaj";7;100;0
42;0;"gurtaj";42;100;0
49;0;"gurtej";49;100;0
0;188;"gurtha";188;0;100
0;42;"gurtie";42;0;100
0;46;"gurtrude";46;0;100
0;5;"gurtrue";5;0;100
13;0;"guru";13;100;0
0;5;"gurveen";5;0;100
141;0;"gurveer";141;100;0
17;0;"gurvinder";17;100;0
55;0;"gurvir";55;100;0
53;0;"gurvis";53;100;0
16598;5;"gus";16603;99.9698849605493;0.0301150394507017
896;0;"guss";896;100;0
1035;10753;"gussie";11788;8.7801153715643;91.2198846284357
1465;0;"gust";1465;100;0
0;392;"gusta";392;0;100
402;0;"gustabo";402;100;0
581;0;"gustaf";581;100;0
11;0;"gustas";11;100;0
5;0;"gustauo";5;100;0
3414;0;"gustav";3414;100;0
0;339;"gustava";339;0;100
4434;0;"gustave";4434;100;0
0;272;"gustavia";272;0;100
36338;104;"gustavo";36442;99.7146150046649;0.285384995335053
238;0;"gustavus";238;100;0
0;5;"gustena";5;0;100
22;0;"guster";22;100;0
5;82;"gustie";87;5.74712643678161;94.2528735632184
170;0;"gustin";170;100;0
0;6;"gustina";6;0;100
0;46;"gustine";46;0;100
5;0;"guston";5;100;0
10;0;"gusty";10;100;0
755;7;"guthrie";762;99.0813648293963;0.918635170603675
84469;459;"guy";84928;99.4595422004521;0.540457799547852
0;5;"guyann";5;0;100
0;5;"guyanne";5;0;100
0;5;"guydra";5;0;100
16;0;"guye";16;100;0
0;455;"guyla";455;0;100
0;54;"guylene";54;0;100
5;0;"guymon";5;100;0
0;103;"guynell";103;0;100
0;10;"guynelle";10;0;100
0;30;"guyneth";30;0;100
10;0;"guyon";10;100;0
53;0;"guyton";53;100;0
11;0;"guztavo";11;100;0
5;0;"gwain";5;100;0
0;5;"gwan";5;0;100
0;10;"gwana";10;0;100
0;6;"gwanda";6;0;100
0;11;"gwelda";11;0;100
294;29501;"gwen";29795;0.986742742070817;99.0132572579292
0;47;"gwena";47;0;100
0;5;"gwenaelle";5;0;100
0;17;"gwenavere";17;0;100
0;2258;"gwenda";2258;0;100
0;15;"gwendalin";15;0;100
0;6;"gwendalina";6;0;100
0;1013;"gwendalyn";1013;0;100
0;215;"gwendalynn";215;0;100
0;7;"gwendel";7;0;100
5;50;"gwendell";55;9.09090909090909;90.9090909090909
0;350;"gwendelyn";350;0;100
0;5;"gwendelynn";5;0;100
0;5;"gwender";5;0;100
0;5;"gwendia";5;0;100
0;88;"gwendloyn";88;0;100
0;498;"gwendlyn";498;0;100
0;78;"gwendlyon";78;0;100
0;17;"gwendol";17;0;100
0;220;"gwendola";220;0;100
0;767;"gwendolen";767;0;100
0;6;"gwendolene";6;0;100
0;79;"gwendolin";79;0;100
0;271;"gwendoline";271;0;100
0;28;"gwendoly";28;0;100
333;116711;"gwendolyn";117044;0.284508390007177;99.7154916099928
0;305;"gwendolyne";305;0;100
0;1157;"gwendolynn";1157;0;100
0;51;"gwendolynne";51;0;100
0;7;"gwendoyln";7;0;100
0;61;"gwendy";61;0;100
0;26;"gwendylan";26;0;100
0;18;"gwendylon";18;0;100
0;10;"gwenell";10;0;100
0;1167;"gweneth";1167;0;100
0;223;"gwenetta";223;0;100
0;274;"gwenette";274;0;100
0;5;"gweneva";5;0;100
0;802;"gwenevere";802;0;100
0;22;"gweneviere";22;0;100
0;23;"gwenevieve";23;0;100
0;322;"gwenith";322;0;100
0;349;"gwenivere";349;0;100
0;139;"gwenlyn";139;0;100
0;1484;"gwenn";1484;0;100
0;275;"gwenna";275;0;100
0;5;"gwennan";5;0;100
0;6;"gwenne";6;0;100
0;174;"gwenneth";174;0;100
0;5;"gwennetta";5;0;100
0;46;"gwennette";46;0;100
0;48;"gwennyth";48;0;100
0;2554;"gwenyth";2554;0;100
0;5;"gwenyvere";5;0;100
0;19;"gwili";19;0;100
5;0;"gwilym";5;100;0
133;52;"gwin";185;71.8918918918919;28.1081081081081
0;46;"gwinda";46;0;100
0;5;"gwindolyn";5;0;100
18;5;"gwinn";23;78.2608695652174;21.7391304347826
5;0;"gwydion";5;100;0
298;2025;"gwyn";2323;12.8282393456737;87.1717606543263
0;5;"gwynavere";5;0;100
0;41;"gwynda";41;0;100
0;5;"gwyndolin";5;0;100
0;443;"gwyndolyn";443;0;100
0;5;"gwyne";5;0;100
0;9;"gwyned";9;0;100
0;5351;"gwyneth";5351;0;100
0;5;"gwynetta";5;0;100
0;29;"gwynette";29;0;100
0;127;"gwynevere";127;0;100
0;12;"gwynith";12;0;100
133;945;"gwynn";1078;12.3376623376623;87.6623376623377
30;1373;"gwynne";1403;2.13827512473272;97.8617248752673
0;237;"gwynneth";237;0;100
0;5;"gwytha";5;0;100
5;0;"gy";5;100;0
144;0;"gyan";144;100;0
0;17;"gyana";17;0;100
0;154;"gyanna";154;0;100
0;5;"gyanni";5;0;100
409;0;"gyasi";409;100;0
0;6;"gyda";6;0;100
0;24;"gyla";24;0;100
5;0;"gyle";5;100;0
6;0;"gyles";6;100;0
0;29;"gyllian";29;0;100
0;5;"gyna";5;0;100
0;5;"gynesis";5;0;100
0;96;"gyneth";96;0;100
0;5;"gynith";5;0;100
0;43;"gypsie";43;0;100
0;1279;"gypsy";1279;0;100
0;5;"gyra";5;0;100
0;12;"gysel";12;0;100
0;188;"gyselle";188;0;100
0;59;"gyzelle";59;0;100
5;0;"gzim";5;100;0
73;422;"ha";495;14.7474747474747;85.2525252525253
164;0;"haadi";164;100;0
0;60;"haadiya";60;0;100
0;5;"haadiyah";5;0;100
11;0;"haaheo";11;100;0
0;12;"haajar";12;0;100
29;0;"haaken";29;100;0
9;0;"haakim";9;100;0
354;0;"haakon";354;100;0
0;5;"haala";5;0;100
6;0;"haamid";6;100;0
0;52;"haani";52;0;100
0;5;"haania";5;0;100
0;12;"haaniya";12;0;100
0;23;"haarika";23;0;100
221;0;"haaris";221;100;0
5;0;"haasan";5;100;0
7;0;"haashim";7;100;0
6;0;"haashir";6;100;0
0;164;"haasini";164;0;100
14;0;"haaziq";14;100;0
10;0;"habacuc";10;100;0
0;6;"habeba";6;0;100
74;0;"habeeb";74;100;0
0;9;"habeeba";9;0;100
41;10;"haben";51;80.3921568627451;19.6078431372549
7;0;"habert";7;100;0
662;0;"habib";662;100;0
0;526;"habiba";526;0;100
0;37;"habibah";37;0;100
0;5;"habibatou";5;0;100
5;0;"habil";5;100;0
0;10;"habon";10;0;100
6;0;"habraham";6;100;0
28;0;"habram";28;100;0
0;5;"habsa";5;0;100
0;28;"haby";28;0;100
19;0;"hachiro";19;100;0
5;0;"had";5;100;0
0;5;"hada";5;0;100
0;8;"hadalyn";8;0;100
5;0;"hadan";5;100;0
0;167;"hadar";167;0;100
0;46;"hadara";46;0;100
0;14;"hadarah";14;0;100
6;0;"hadari";6;100;0
0;138;"hadas";138;0;100
0;352;"hadasa";352;0;100
0;98;"hadasah";98;0;100
0;28;"hadasha";28;0;100
0;875;"hadassa";875;0;100
0;5146;"hadassah";5146;0;100
0;10;"haddasah";10;0;100
433;26;"hadden";459;94.3355119825708;5.66448801742919
0;27;"haddi";27;0;100
0;944;"haddie";944;0;100
0;7;"haddison";7;0;100
0;11;"haddley";11;0;100
404;7;"haddon";411;98.2968369829684;1.70316301703163
5;0;"haddox";5;100;0
5;126;"haddy";131;3.81679389312977;96.1832061068702
0;58;"hade";58;0;100
8;0;"hadeed";8;100;0
0;629;"hadeel";629;0;100
0;5;"hadeer";5;0;100
0;8;"hadel";8;0;100
0;29;"hadelyn";29;0;100
3601;157;"haden";3758;95.8222458754657;4.17775412453433
36;0;"hades";36;100;0
0;14;"hadessa";14;0;100
0;122;"hadessah";122;0;100
1624;0;"hadi";1624;100;0
0;376;"hadia";376;0;100
0;5;"hadiah";5;0;100
0;10;"hadiatou";10;0;100
0;35;"hadie";35;0;100
0;20;"hadija";20;0;100
0;25;"hadil";25;0;100
0;5;"hadilyn";5;0;100
6;0;"hadin";6;100;0
0;668;"hadiya";668;0;100
0;475;"hadiyah";475;0;100
0;40;"hadiyyah";40;0;100
0;5;"hadiza";5;0;100
0;122;"hadja";122;0;100
5;0;"hadji";5;100;0
0;80;"hadlea";80;0;100
15;2383;"hadlee";2398;0.625521267723103;99.3744787322769
0;54;"hadlei";54;0;100
0;2125;"hadleigh";2125;0;100
1847;24005;"hadley";25852;7.14451493114653;92.8554850688535
0;5;"hadleyann";5;0;100
0;115;"hadli";115;0;100
0;484;"hadlie";484;0;100
0;19;"hadly";19;0;100
0;41;"hadlyn";41;0;100
0;12;"hadlynn";12;0;100
518;0;"hadrian";518;100;0
62;0;"hadriel";62;100;0
18;0;"hadrien";18;100;0
143;39;"hady";182;78.5714285714286;21.4285714285714
0;20;"hadya";20;0;100
537;457;"hadyn";994;54.0241448692153;45.9758551307847
0;127;"hae";127;0;100
242;34;"haeden";276;87.6811594202899;12.3188405797101
5;0;"haedon";5;100;0
178;312;"haedyn";490;36.3265306122449;63.6734693877551
6;0;"haegan";6;100;0
6;0;"haegen";6;100;0
0;5;"haein";5;0;100
5;5;"hael";10;50;50
0;195;"haelee";195;0;100
0;146;"haeleigh";146;0;100
0;397;"haeley";397;0;100
0;226;"haeli";226;0;100
0;75;"haelie";75;0;100
0;221;"haely";221;0;100
0;153;"haelyn";153;0;100
0;23;"haelynn";23;0;100
0;6;"haether";6;0;100
0;37;"haeun";37;0;100
16;120;"haeven";136;11.7647058823529;88.2352941176471
0;101;"haevyn";101;0;100
0;5;"haevynn";5;0;100
17;0;"hafeez";17;100;0
0;12;"hafeeza";12;0;100
0;34;"hafeezah";34;0;100
9;0;"hafford";9;100;0
6;0;"hafid";6;100;0
91;0;"hafiz";91;100;0
0;1487;"hafsa";1487;0;100
0;413;"hafsah";413;0;100
0;5;"hafso";5;0;100
1179;121;"hagan";1300;90.6923076923077;9.30769230769231
0;137;"hagar";137;0;100
2351;167;"hagen";2518;93.3677521842732;6.63224781572677
5;0;"hageo";5;100;0
84;39;"hager";123;68.2926829268293;31.7073170731707
19;0;"haggai";19;100;0
5;0;"haggard";5;100;0
5;0;"hagood";5;100;0
341;0;"hagop";341;100;0
0;6;"hahna";6;0;100
567;21;"hai";588;96.4285714285714;3.57142857142857
61;6;"haidan";67;91.044776119403;8.95522388059701
177;0;"haidar";177;100;0
0;158;"haide";158;0;100
0;576;"haidee";576;0;100
3181;1373;"haiden";4554;69.8506807202459;30.1493192797541
595;0;"haider";595;100;0
0;51;"haidi";51;0;100
21;5;"haidin";26;80.7692307692308;19.2307692307692
47;0;"haidon";47;100;0
0;190;"haidy";190;0;100
529;1532;"haidyn";2061;25.6671518680252;74.3328481319748
0;69;"haidynn";69;0;100
0;10;"haiely";10;0;100
0;151;"haifa";151;0;100
686;0;"haig";686;100;0
25;6;"haigen";31;80.6451612903226;19.3548387096774
95;0;"haik";95;100;0
0;78;"haila";78;0;100
198;805;"haile";1003;19.740777666999;80.259222333001
0;328;"hailea";328;0;100
0;5;"haileah";5;0;100
6;14394;"hailee";14400;0.0416666666666667;99.9583333333333
0;5;"haileen";5;0;100
0;282;"hailei";282;0;100
0;1705;"haileigh";1705;0;100
0;26;"hailen";26;0;100
259;153201;"hailey";153460;0.168773621790695;99.8312263782093
0;87;"haileyann";87;0;100
0;7;"haileyjade";7;0;100
0;5;"haileyjo";5;0;100
0;26;"haileymarie";26;0;100
0;6;"haileyrose";6;0;100
0;829;"haili";829;0;100
0;5586;"hailie";5586;0;100
0;5;"hailiey";5;0;100
0;322;"haille";322;0;100
0;95;"haillee";95;0;100
0;450;"hailley";450;0;100
0;362;"haillie";362;0;100
0;91;"hailly";91;0;100
0;32;"hailo";32;0;100
0;2940;"haily";2940;0;100
0;11;"hailye";11;0;100
0;370;"hailyn";370;0;100
0;186;"hailynn";186;0;100
79;0;"haim";79;100;0
43;0;"haines";43;100;0
41;0;"hairl";41;100;0
85;0;"hairo";85;100;0
0;32;"haislee";32;0;100
0;362;"haisley";362;0;100
5;0;"haisten";5;100;0
224;0;"haitham";224;100;0
11;0;"haithem";11;100;0
0;16;"haiti";16;0;100
28;196;"haiven";224;12.5;87.5
0;61;"haivyn";61;0;100
7;0;"haiyden";7;100;0
0;5;"haiylee";5;0;100
14;5;"haize";19;73.6842105263158;26.3157894736842
0;80;"haizel";80;0;100
18;0;"haizen";18;100;0
0;66;"haizlee";66;0;100
0;119;"haizley";119;0;100
0;172;"haja";172;0;100
0;519;"hajar";519;0;100
0;11;"hajara";11;0;100
6;0;"hajari";6;100;0
0;122;"hajer";122;0;100
70;0;"haji";70;100;0
134;0;"hajime";134;100;0
5;0;"hajin";5;100;0
0;77;"hajira";77;0;100
0;5;"hajirah";5;0;100
6;0;"hajj";6;100;0
7;0;"hajoon";7;100;0
0;165;"hajra";165;0;100
0;41;"hajrah";41;0;100
7;0;"hajun";7;100;0
264;0;"hakan";264;100;0
4670;0;"hakeem";4670;100;0
0;6;"hakeema";6;0;100
68;0;"hakeen";68;100;0
34;0;"hakeim";34;100;0
23;0;"haki";23;100;0
78;0;"hakiem";78;100;0
2017;0;"hakim";2017;100;0
0;29;"hakima";29;0;100
0;10;"hakimah";10;0;100
20;0;"hakob";20;100;0
232;0;"hakop";232;100;0
18;0;"haku";18;100;0
16138;12;"hal";16150;99.9256965944273;0.0743034055727554
7;1363;"hala";1370;0.510948905109489;99.4890510948905
0;124;"halah";124;0;100
0;115;"halaina";115;0;100
0;148;"halana";148;0;100
0;5;"halane";5;0;100
0;6;"halani";6;0;100
14;0;"halas";14;100;0
0;47;"halaya";47;0;100
0;42;"halayah";42;0;100
0;138;"halayna";138;0;100
1132;0;"halbert";1132;100;0
0;5;"halcy";5;0;100
0;73;"halcyon";73;0;100
186;0;"halden";186;100;0
92;0;"haldon";92;100;0
18;0;"haldor";18;100;0
5;0;"haldrin";5;100;0
1140;14;"hale";1154;98.786828422877;1.21317157712305
0;236;"halea";236;0;100
0;36;"haleah";36;0;100
0;2883;"halee";2883;0;100
167;0;"haleem";167;100;0
0;302;"haleema";302;0;100
0;70;"haleemah";70;0;100
0;14;"haleena";14;0;100
0;25;"haleh";25;0;100
0;369;"halei";369;0;100
0;5;"haleia";5;0;100
9;13572;"haleigh";13581;0.0662690523525514;99.9337309476474
0;46;"haleigha";46;0;100
0;15;"halema";15;0;100
863;500;"halen";1363;63.3162142333089;36.6837857666911
0;291;"halena";291;0;100
0;38;"halene";38;0;100
826;154199;"haley";155025;0.532817287534269;99.4671827124657
0;36;"haleyann";36;0;100
0;5;"haleyjo";5;0;100
134;0;"halford";134;100;0
6;0;"halfred";6;100;0
10;4398;"hali";4408;0.226860254083485;99.7731397459165
0;599;"halia";599;0;100
0;6;"haliana";6;0;100
12;0;"halid";12;100;0
0;7322;"halie";7322;0;100
0;31;"haliee";31;0;100
0;395;"haliegh";395;0;100
0;255;"haliey";255;0;100
73;0;"halil";73;100;0
190;0;"halim";190;100;0
0;1447;"halima";1447;0;100
0;413;"halimah";413;0;100
0;43;"halimatou";43;0;100
0;57;"halimo";57;0;100
0;864;"halina";864;0;100
0;6;"haline";6;0;100
5;0;"halit";5;100;0
0;116;"haliyah";116;0;100
796;0;"hall";796;100;0
0;293;"halla";293;0;100
0;14;"hallah";14;0;100
27;0;"hallard";27;100;0
6;13170;"halle";13176;0.0455373406193078;99.9544626593807
0;1117;"hallee";1117;0;100
0;5;"halleh";5;0;100
0;15;"hallei";15;0;100
0;249;"halleigh";249;0;100
0;45;"hallel";45;0;100
0;5;"halleli";5;0;100
0;65;"hallelujah";65;0;100
0;5;"hallema";5;0;100
0;12;"hallene";12;0;100
38;0;"hallet";38;100;0
21;0;"hallett";21;100;0
126;3714;"halley";3840;3.28125;96.71875
0;1249;"halli";1249;0;100
1146;27308;"hallie";28454;4.02755324383215;95.9724467561679
67;0;"hallis";67;100;0
5;635;"hally";640;0.78125;99.21875
0;41;"hallye";41;0;100
173;1218;"halo";1391;12.4370956146657;87.5629043853343
9;0;"haloa";9;100;0
0;291;"halona";291;0;100
389;214;"halsey";603;64.5107794361526;35.4892205638474
5;0;"halstead";5;100;0
19;0;"halsten";19;100;0
494;131;"halston";625;79.04;20.96
140;0;"halton";140;100;0
108;0;"halvor";108;100;0
0;117;"haly";117;0;100
0;5;"halye";5;0;100
0;272;"halyn";272;0;100
0;5;"halyna";5;0;100
0;124;"halynn";124;0;100
23;0;"ham";23;100;0
5;0;"hamaad";5;100;0
365;0;"hamad";365;100;0
53;0;"hamadi";53;100;0
0;68;"hamda";68;0;100
15;0;"hamdaan";15;100;0
159;0;"hamdan";159;100;0
114;299;"hamdi";413;27.6029055690073;72.3970944309927
469;0;"hamed";469;100;0
149;0;"hameed";149;100;0
0;5;"hameedah";5;0;100
16;0;"hameen";16;100;0
56;0;"hamer";56;100;0
748;0;"hamid";748;100;0
0;50;"hamida";50;0;100
0;11;"hamidah";11;0;100
42;0;"hamidou";42;100;0
5689;0;"hamilton";5689;100;0
6;0;"hamim";6;100;0
33;0;"hamin";33;100;0
18;0;"hamir";18;100;0
208;0;"hamish";208;100;0
6;0;"hamiz";6;100;0
217;0;"hamlet";217;100;0
63;0;"hamlin";63;100;0
360;0;"hammad";360;100;0
7;0;"hammed";7;100;0
24;0;"hammie";24;100;0
448;0;"hammond";448;100;0
0;111;"hamna";111;0;100
0;43;"hamnah";43;0;100
893;0;"hamp";893;100;0
3720;101;"hampton";3821;97.3567129023816;2.64328709761842
156;0;"hamsa";156;100;0
44;0;"hamse";44;100;0
0;22;"hamsika";22;0;100
0;106;"hamsini";106;0;100
6373;0;"hamza";6373;100;0
1130;0;"hamzah";1130;100;0
45;0;"hamze";45;100;0
123;0;"hamzeh";123;100;0
541;532;"han";1073;50.4193849021435;49.5806150978565
6;9590;"hana";9596;0.0625260525218841;99.9374739474781
0;285;"hanaa";285;0;100
0;95;"hanaan";95;0;100
274;0;"hanad";274;100;0
0;112;"hanadi";112;0;100
0;11;"hanady";11;0;100
0;110;"hanae";110;0;100
0;1919;"hanah";1919;0;100
0;5;"hanai";5;0;100
0;353;"hanako";353;0;100
0;5;"hanalee";5;0;100
0;127;"hanalei";127;0;100
97;1586;"hanan";1683;5.76351752822341;94.2364824717766
0;5;"hanane";5;0;100
25;37;"hananiah";62;40.3225806451613;59.6774193548387
0;11;"hanayo";11;0;100
75;0;"hance";75;100;0
72;0;"hancel";72;100;0
7;0;"handerson";7;100;0
6;0;"handley";6;100;0
64;0;"handsome";64;100;0
479;5;"handy";484;98.9669421487603;1.03305785123967
520;0;"haneef";520;100;0
0;6;"haneefa";6;0;100
0;164;"haneefah";164;0;100
0;959;"haneen";959;0;100
5;0;"haneesh";5;100;0
0;15;"hanen";15;0;100
30;0;"haney";30;100;0
328;0;"hanford";328;100;0
0;382;"hang";382;0;100
21;454;"hanh";475;4.42105263157895;95.5789473684211
591;76;"hani";667;88.6056971514243;11.3943028485757
0;456;"hania";456;0;100
0;97;"haniah";97;0;100
222;5;"haniel";227;97.7973568281938;2.20264317180617
663;0;"hanif";663;100;0
0;122;"hanifa";122;0;100
0;142;"hanifah";142;0;100
6;0;"haniff";6;100;0
0;5;"hanika";5;0;100
0;94;"hanin";94;0;100
44;0;"hanish";44;100;0
0;537;"haniya";537;0;100
0;234;"haniyah";234;0;100
0;142;"haniyyah";142;0;100
10747;0;"hank";10747;100;0
0;5;"hanlee";5;0;100
549;172;"hanley";721;76.1442441054092;23.8557558945908
127;36290;"hanna";36417;0.348738226652388;99.6512617733476
0;5;"hannabella";5;0;100
0;11;"hannabelle";11;0;100
684;416312;"hannah";416996;0.164030350411035;99.835969649589
0;23;"hannaha";23;0;100
0;5;"hannahelizabeth";5;0;100
0;154;"hannahgrace";154;0;100
0;6;"hannahjo";6;0;100
0;33;"hannahlee";33;0;100
0;5;"hannahlynn";5;0;100
0;26;"hannahmae";26;0;100
0;207;"hannahmarie";207;0;100
0;5;"hannahrae";5;0;100
0;45;"hannahrose";45;0;100
0;56;"hannalee";56;0;100
0;5;"hannaleigh";5;0;100
0;21;"hannaley";21;0;100
0;5;"hannalise";5;0;100
87;408;"hannan";495;17.5757575757576;82.4242424242424
0;170;"hanne";170;0;100
0;243;"hannelore";243;0;100
0;11;"hanner";11;0;100
37;0;"hannes";37;100;0
0;5;"hannha";5;0;100
0;85;"hanni";85;0;100
0;512;"hannia";512;0;100
0;5;"hanniah";5;0;100
674;0;"hannibal";674;100;0
0;59;"hannie";59;0;100
35;0;"hanniel";35;100;0
47;10;"hannon";57;82.4561403508772;17.5438596491228
5;0;"hanns";5;100;0
0;67;"hanny";67;0;100
0;33;"hannya";33;0;100
6;0;"hanoch";6;100;0
0;47;"hanora";47;0;100
14016;5;"hans";14021;99.9643392054775;0.035660794522502
2776;5;"hansel";2781;99.8202085580726;0.179791441927364
35;0;"hansell";35;100;0
635;0;"hansen";635;100;0
581;0;"hansford";581;100;0
0;197;"hansika";197;0;100
0;103;"hansini";103;0;100
11;0;"hansley";11;100;0
1451;0;"hanson";1451;100;0
7;0;"hanssel";7;100;0
5;0;"hantz";5;100;0
0;5;"hanvika";5;0;100
0;5;"hanvitha";5;0;100
37;5;"hany";42;88.0952380952381;11.9047619047619
0;69;"hanya";69;0;100
73;0;"hanz";73;100;0
13;0;"hanzalah";13;100;0
153;0;"hanzel";153;100;0
12;0;"hanzo";12;100;0
419;5;"hao";424;98.8207547169811;1.17924528301887
10;0;"haochen";10;100;0
20;0;"haoran";20;100;0
6;0;"haowen";6;100;0
20;0;"haoxuan";20;100;0
5;0;"haoyang";5;100;0
28;0;"haoyu";28;100;0
5;0;"hap";5;100;0
0;24;"happiness";24;0;100
250;188;"happy";438;57.0776255707763;42.9223744292237
0;102;"hara";102;0;100
151;0;"harace";151;100;0
5;0;"haralabos";5;100;0
253;0;"haralambos";253;100;0
744;0;"harald";744;100;0
5;12;"haram";17;29.4117647058824;70.5882352941177
32;0;"haran";32;100;0
111;0;"harbert";111;100;0
12;0;"harbin";12;100;0
151;276;"harbor";427;35.3629976580796;64.6370023419204
18;36;"harbour";54;33.3333333333333;66.6666666666667
139;0;"harce";139;100;0
11;0;"harcourt";11;100;0
7;0;"hardee";7;100;0
72;25;"hardeep";97;74.2268041237113;25.7731958762887
553;0;"harden";553;100;0
609;0;"hardie";609;100;0
29;0;"hardik";29;100;0
746;0;"hardin";746;100;0
1084;0;"harding";1084;100;0
11;0;"hardison";11;100;0
21;0;"hardwick";21;100;0
5019;10;"hardy";5029;99.8011533107974;0.198846689202625
0;224;"hareem";224;0;100
148;0;"harel";148;100;0
11;0;"hareld";11;100;0
11;0;"haresh";11;100;0
20;0;"harfateh";20;100;0
5;0;"harford";5;100;0
5;0;"hargie";5;100;0
190;0;"hargis";190;100;0
25;93;"hargun";118;21.1864406779661;78.8135593220339
10;0;"hargus";10;100;0
644;0;"hari";644;100;0
10;0;"harice";10;100;0
7;0;"harihar";7;100;0
37;0;"hariharan";37;100;0
0;97;"harika";97;0;100
0;21;"hariklia";21;0;100
5;0;"harilaos";5;100;0
108;0;"harim";108;100;0
11;0;"harin";11;100;0
10;0;"harinder";10;100;0
0;505;"harini";505;0;100
0;5;"haripriya";5;0;100
1280;0;"haris";1280;100;0
338;0;"harish";338;100;0
51;0;"harison";51;100;0
0;5;"harita";5;0;100
76;0;"harith";76;100;0
5;0;"harjaap";5;100;0
0;5;"harjap";5;0;100
40;17;"harjas";57;70.1754385964912;29.8245614035088
246;82;"harjot";328;75;25
17;0;"harkaran";17;100;0
6;0;"harkeem";6;100;0
5;0;"harker";5;100;0
0;20;"harkiran";20;0;100
31;12;"harkirat";43;72.0930232558139;27.906976744186
590;0;"harl";590;100;0
0;136;"harla";136;0;100
22890;177;"harlan";23067;99.2326700481207;0.767329951879308
5287;8;"harland";5295;99.8489140698773;0.151085930122757
15;0;"harld";15;100;0
10;0;"harle";10;100;0
0;116;"harlea";116;0;100
0;184;"harlean";184;0;100
395;4826;"harlee";5221;7.56560045968205;92.4343995403179
0;957;"harleen";957;0;100
0;5;"harleequinn";5;0;100
0;204;"harlei";204;0;100
0;3184;"harleigh";3184;0;100
1366;503;"harlem";1869;73.0872124130551;26.9127875869449
2873;22;"harlen";2895;99.2400690846287;0.75993091537133
0;1104;"harlene";1104;0;100
0;41;"harlequin";41;0;100
0;21;"harlequinn";21;0;100
221;0;"harles";221;100;0
423;0;"harless";423;100;0
14;0;"harleth";14;100;0
36829;21365;"harley";58194;63.2865931195656;36.7134068804344
0;45;"harleyann";45;0;100
0;107;"harleyquinn";107;0;100
0;6;"harleyrose";6;0;100
0;985;"harli";985;0;100
746;3471;"harlie";4217;17.6903011619635;82.3096988380365
0;6;"harliee";6;0;100
0;15;"harliegh";15;0;100
1672;36;"harlin";1708;97.8922716627635;2.10772833723653
0;5;"harline";5;0;100
0;5;"harliquinn";5;0;100
216;0;"harlis";216;100;0
0;6;"harliv";6;0;100
159;155;"harlo";314;50.6369426751592;49.3630573248408
5;0;"harlod";5;100;0
0;33;"harloe";33;0;100
1744;0;"harlon";1744;100;0
1649;4534;"harlow";6183;26.6699013423904;73.3300986576096
26;287;"harlowe";313;8.30670926517572;91.6932907348243
28;159;"harly";187;14.9732620320856;85.0267379679144
16;105;"harlym";121;13.2231404958678;86.7768595041322
275;512;"harlyn";787;34.9428208386277;65.0571791613723
0;359;"harlynn";359;0;100
315;0;"harm";315;100;0
926;63;"harman";989;93.6299292214358;6.37007077856421
10;0;"harmandeep";10;100;0
0;145;"harmani";145;0;100
0;32;"harmanie";32;0;100
6;7;"harmanpreet";13;46.1538461538462;53.8461538461538
0;29;"harmany";29;0;100
6;11;"harmeet";17;35.2941176470588;64.7058823529412
12;0;"harmie";12;100;0
0;5;"harminnie";5;0;100
6046;21;"harmon";6067;99.6538651722433;0.346134827756717
10;0;"harmond";10;100;0
0;54;"harmone";54;0;100
0;828;"harmonee";828;0;100
0;17;"harmonei";17;0;100
0;440;"harmoney";440;0;100
0;2639;"harmoni";2639;0;100
0;1921;"harmonie";1921;0;100
0;24;"harmoniee";24;0;100
0;211;"harmonii";211;0;100
19;22823;"harmony";22842;0.0831801068207688;99.9168198931792
0;115;"harneet";115;0;100
15;0;"harney";15;100;0
89;242;"harnoor";331;26.8882175226586;73.1117824773414
83;0;"harol";83;100;0
540259;2615;"harold";542874;99.5183044315992;0.481695568400771
12;7;"haroldean";19;63.1578947368421;36.8421052631579
0;26;"haroldene";26;0;100
0;235;"haroldine";235;0;100
16;0;"haroldo";16;100;0
0;11;"harolene";11;0;100
0;577;"harolyn";577;0;100
146;0;"haron";146;100;0
862;0;"haroon";862;100;0
170;0;"haroun";170;100;0
292;0;"harout";292;100;0
5;0;"haroutun";5;100;0
5;0;"haroutyun";5;100;0
13;0;"harpal";13;100;0
0;5;"harpar";5;0;100
5225;59727;"harper";64952;8.0444020199532;91.9555979800468
0;6;"harpergrace";6;0;100
249;254;"harpreet";503;49.5029821073559;50.4970178926441
0;11;"harpyr";11;0;100
764;0;"harrel";764;100;0
2635;0;"harrell";2635;100;0
24;0;"harrey";24;100;0
388;52;"harrie";440;88.1818181818182;11.8181818181818
10;0;"harriel";10;100;0
121;80691;"harriet";80812;0.149730238083453;99.8502697619166
5;19384;"harriett";19389;0.0257878178348548;99.9742121821651
0;497;"harrietta";497;0;100
0;8141;"harriette";8141;0;100
5;0;"harril";5;100;0
12;0;"harrill";12;100;0
0;5;"harrilyn";5;0;100
262;0;"harrington";262;100;0
0;16;"harriot";16;0;100
14370;116;"harris";14486;99.1992268397073;0.800773160292696
12;0;"harrisen";12;100;0
68077;232;"harrison";68309;99.6603668623461;0.339633137653896
5;0;"harrisson";5;100;0
72;0;"harrol";72;100;0
1098;0;"harrold";1098;100;0
42;0;"harroll";42;100;0
5;0;"harron";5;100;0
376526;1818;"harry";378344;99.5194849132007;0.480515086799315
0;221;"harryette";221;0;100
13;0;"harryson";13;100;0
0;24;"harseerat";24;0;100
614;0;"harsh";614;100;0
205;19;"harsha";224;91.5178571428571;8.48214285714286
65;0;"harshaan";65;100;0
86;0;"harshal";86;100;0
48;0;"harshan";48;100;0
21;0;"harshdeep";21;100;0
0;10;"harshi";10;0;100
0;54;"harshika";54;0;100
211;0;"harshil";211;100;0
0;242;"harshini";242;0;100
41;0;"harshit";41;100;0
0;177;"harshita";177;0;100
91;0;"harshith";91;100;0
0;165;"harshitha";165;0;100
11;0;"harshiv";11;100;0
5;0;"harshveer";5;100;0
5;0;"harsimar";5;100;0
32;94;"harsimran";126;25.3968253968254;74.6031746031746
0;5;"harsimrat";5;0;100
836;20;"hart";856;97.6635514018692;2.33644859813084
10;0;"hartaj";10;100;0
11;0;"hartej";11;100;0
0;27;"hartense";27;0;100
381;0;"hartford";381;100;0
0;5;"hartie";5;0;100
0;165;"hartlee";165;0;100
0;59;"hartleigh";59;0;100
1379;1061;"hartley";2440;56.5163934426229;43.483606557377
0;5;"hartli";5;0;100
0;12;"hartlie";12;0;100
0;13;"hartly";13;0;100
0;114;"hartlyn";114;0;100
0;51;"hartlynn";51;0;100
94;0;"hartman";94;100;0
58;0;"hartsel";58;100;0
38;0;"hartsell";38;100;0
601;0;"hartwell";601;100;0
5;0;"hartzel";5;100;0
23;0;"hartzell";23;100;0
114;76;"haru";190;60;40
0;248;"harue";248;0;100
0;441;"haruka";441;0;100
227;0;"haruki";227;100;0
0;679;"haruko";679;0;100
20;0;"haruma";20;100;0
21;245;"harumi";266;7.89473684210526;92.1052631578947
570;0;"harun";570;100;0
0;72;"haruna";72;0;100
0;11;"haruno";11;0;100
376;0;"haruo";376;100;0
50;0;"harut";50;100;0
172;0;"haruto";172;100;0
16;0;"harutun";16;100;0
70;0;"harutyun";70;100;0
0;80;"haruye";80;0;100
0;36;"haruyo";36;0;100
7;0;"haruyoshi";7;100;0
597;0;"harvard";597;100;0
348;0;"harve";348;100;0
0;23;"harveen";23;0;100
40;0;"harveer";40;100;0
301;0;"harvel";301;100;0
47;0;"harvell";47;100;0
5;0;"harver";5;100;0
203;220;"harvest";423;47.9905437352246;52.0094562647754
5;0;"harvester";5;100;0
0;42;"harvetta";42;0;100
113452;692;"harvey";114144;99.3937482478273;0.606251752172694
0;11;"harvi";11;0;100
1560;23;"harvie";1583;98.547062539482;1.452937460518
140;12;"harvin";152;92.1052631578947;7.89473684210526
30;0;"harvir";30;100;0
72;0;"harvis";72;100;0
910;0;"harvy";910;100;0
46;0;"harwell";46;100;0
340;0;"harwood";340;100;0
31;0;"hary";31;100;0
511;0;"hasaan";511;100;0
3996;0;"hasan";3996;100;0
0;94;"hasana";94;0;100
0;5;"hasanah";5;0;100
0;11;"hasanat";11;0;100
933;11;"hasani";944;98.8347457627119;1.16525423728814
11;0;"hasaun";11;100;0
21;0;"hascal";21;100;0
432;0;"haseeb";432;100;0
5;0;"haseebullah";5;100;0
5;0;"haseem";5;100;0
0;10;"haseena";10;0;100
6;353;"hasel";359;1.67130919220056;98.3286908077994
5;0;"hasen";5;100;0
0;100;"haset";100;0;100
65;0;"hasheem";65;100;0
336;0;"hashem";336;100;0
1394;0;"hashim";1394;100;0
227;0;"hashir";227;100;0
0;5;"hashley";5;0;100
43;0;"hasib";43;100;0
5;0;"hasiel";5;100;0
0;11;"hasika";11;0;100
16;0;"hasim";16;100;0
5;0;"hasin";5;100;0
0;193;"hasina";193;0;100
0;5;"hasinah";5;0;100
0;356;"hasini";356;0;100
5;0;"hasir";5;100;0
0;11;"hasita";11;0;100
0;5;"hasitha";5;0;100
1160;0;"haskel";1160;100;0
3573;10;"haskell";3583;99.7209042701647;0.279095729835334
27;0;"hasker";27;100;0
5;0;"haskie";5;100;0
5;0;"haskle";5;100;0
0;17;"hasley";17;0;100
0;6;"hasly";6;0;100
0;6;"haslyn";6;0;100
0;59;"hasmik";59;0;100
0;170;"hasna";170;0;100
0;5;"hasnaa";5;0;100
162;0;"hasnain";162;100;0
212;0;"hason";212;100;0
99;0;"hassaan";99;100;0
6;0;"hassain";6;100;0
12;0;"hassam";12;100;0
9139;7;"hassan";9146;99.9234638093155;0.0765361906844522
0;42;"hassana";42;0;100
0;12;"hassanah";12;0;100
0;16;"hassanatou";16;0;100
17;0;"hassane";17;100;0
71;0;"hassani";71;100;0
512;0;"hassel";512;100;0
321;0;"hassell";321;100;0
0;11;"hasseltine";11;0;100
160;0;"hassen";160;100;0
0;98;"hasset";98;0;100
10;1212;"hassie";1222;0.818330605564648;99.1816693944354
10;0;"hassiel";10;100;0
5;0;"hassiem";5;100;0
330;0;"hasson";330;100;0
81;0;"hasten";81;100;0
0;29;"hasti";29;0;100
5;0;"hastiin";5;100;0
53;0;"hastin";53;100;0
17;0;"hasting";17;100;0
25;5;"hastings";30;83.3333333333333;16.6666666666667
123;0;"haston";123;100;0
0;10;"hasty";10;0;100
0;10;"hasya";10;0;100
16;0;"hatch";16;100;0
302;0;"hatcher";302;100;0
79;0;"hatem";79;100;0
0;10;"hateya";10;0;100
0;12;"hathaway";12;0;100
0;11;"hather";11;0;100
0;72;"hatice";72;0;100
207;0;"hatim";207;100;0
0;6;"hatina";6;0;100
0;62;"hatley";62;0;100
0;203;"hatsue";203;0;100
0;204;"hatsuko";204;0;100
0;63;"hatsumi";63;0;100
0;33;"hatsuye";33;0;100
0;48;"hatsuyo";48;0;100
34;0;"hattan";34;100;0
0;44;"hatti";44;0;100
405;75383;"hattie";75788;0.534385390827044;99.465614609173
18;0;"hatton";18;100;0
0;43;"hatty";43;0;100
0;109;"hattye";109;0;100
0;5;"hatziry";5;0;100
105;18;"hau";123;85.3658536585366;14.6341463414634
0;79;"haunani";79;0;100
0;226;"hava";226;0;100
0;85;"havah";85;0;100
5;0;"haval";5;100;0
0;14;"havala";14;0;100
0;21;"havan";21;0;100
0;819;"havana";819;0;100
0;70;"havanah";70;0;100
0;436;"havanna";436;0;100
0;300;"havannah";300;0;100
149;0;"havard";149;100;0
3758;11869;"haven";15627;24.0481218404044;75.9518781595956
5;0;"havery";5;100;0
6;0;"havick";6;100;0
68;0;"havier";68;100;0
16;0;"havik";16;100;0
0;443;"havilah";443;0;100
0;24;"haviland";24;0;100
0;7;"havilland";7;0;100
0;28;"havin";28;0;100
46;0;"havis";46;100;0
123;0;"havish";123;100;0
0;33;"havisha";33;0;100
72;0;"havoc";72;100;0
25;0;"havok";25;100;0
0;6;"havya";6;0;100
48;665;"havyn";713;6.73211781206171;93.2678821879383
0;31;"havynn";31;0;100
0;1374;"hawa";1374;0;100
0;5;"hawah";5;0;100
0;10;"hawaii";10;0;100
0;5;"hawanatu";5;0;100
0;22;"hawanya";22;0;100
179;0;"haward";179;100;0
0;40;"hawi";40;0;100
534;0;"hawk";534;100;0
102;0;"hawke";102;100;0
186;0;"hawken";186;100;0
6;0;"hawkens";6;100;0
16;0;"hawkeye";16;100;0
41;0;"hawkin";41;100;0
448;0;"hawkins";448;100;0
150;61;"hawley";211;71.0900473933649;28.9099526066351
0;43;"hawo";43;0;100
0;45;"hawra";45;0;100
0;74;"hawraa";74;0;100
11;0;"hawthorn";11;100;0
201;6;"hawthorne";207;97.1014492753623;2.89855072463768
0;42;"hawwa";42;0;100
0;6;"hawwaa";6;0;100
13;0;"haxton";13;100;0
7;0;"hay";7;100;0
0;871;"haya";871;0;100
0;13;"hayaa";13;0;100
13;0;"hayaan";13;100;0
0;11;"hayah";11;0;100
0;10;"hayam";10;0;100
0;430;"hayat";430;0;100
206;0;"hayato";206;100;0
273;92;"haydan";365;74.7945205479452;25.2054794520548
22;0;"haydar";22;100;0
0;213;"hayde";213;0;100
0;3175;"haydee";3175;0;100
93782;24191;"hayden";117973;79.4944605969162;20.5055394030838
6;20;"haydenn";26;23.0769230769231;76.9230769230769
25;0;"hayder";25;100;0
0;6;"haydi";6;0;100
402;261;"haydin";663;60.6334841628959;39.3665158371041
1620;344;"haydn";1964;82.4847250509165;17.5152749490835
1060;65;"haydon";1125;94.2222222222222;5.77777777777778
258;238;"haydyn";496;52.0161290322581;47.9838709677419
6793;248;"hayes";7041;96.4777730436018;3.52222695639824
5;0;"haygan";5;100;0
194;17;"haygen";211;91.9431279620853;8.05687203791469
193;0;"hayk";193;100;0
0;377;"hayla";377;0;100
0;5;"haylah";5;0;100
0;10;"haylan";10;0;100
0;1488;"hayle";1488;0;100
0;810;"haylea";810;0;100
0;12;"hayleah";12;0;100
20;27403;"haylee";27423;0.0729314808737191;99.9270685191263
0;66;"hayleen";66;0;100
0;733;"haylei";733;0;100
0;4923;"hayleigh";4923;0;100
115;578;"haylen";693;16.5945165945166;83.4054834054834
46;48149;"hayley";48195;0.0954455856416641;99.9045544143583
0;1783;"hayli";1783;0;100
0;9567;"haylie";9567;0;100
0;10;"hayliee";10;0;100
0;45;"hayliegh";45;0;100
0;261;"haylin";261;0;100
0;16;"hayllie";16;0;100
0;81;"haylo";81;0;100
0;92;"hayly";92;0;100
0;90;"haylyn";90;0;100
0;116;"haylynn";116;0;100
5;0;"haymon";5;100;0
21;0;"haymond";21;100;0
36;0;"hayne";36;100;0
464;5;"haynes";469;98.9339019189765;1.06609808102345
10;0;"haynie";10;100;0
0;5;"hayoon";5;0;100
0;18;"hayoung";18;0;100
557;0;"hays";557;100;0
23;0;"hayse";23;100;0
0;38;"hayslee";38;0;100
5;0;"hayson";5;100;0
22;0;"hayston";22;100;0
197;0;"haytham";197;100;0
6;0;"haythem";6;100;0
169;808;"hayven";977;17.2978505629478;82.7021494370522
0;49;"hayvin";49;0;100
0;33;"hayvn";33;0;100
4936;0;"hayward";4936;100;0
6161;0;"haywood";6161;100;0
5;0;"hayword";5;100;0
26;0;"hayyan";26;100;0
10;0;"hayz";10;100;0
163;0;"hayze";163;100;0
0;221;"hayzel";221;0;100
115;0;"hayzen";115;100;0
0;64;"hayzlee";64;0;100
0;10;"hayzlie";10;0;100
412;0;"hazael";412;100;0
58;0;"hazaiah";58;100;0
0;12;"hazal";12;0;100
465;20;"haze";485;95.8762886597938;4.12371134020619
2530;226581;"hazel";229111;1.10426823679352;98.8957317632065
0;5;"hazelann";5;0;100
0;5;"hazele";5;0;100
0;35;"hazelee";35;0;100
0;18;"hazeleen";18;0;100
0;24;"hazeleigh";24;0;100
0;138;"hazelene";138;0;100
0;37;"hazelgrace";37;0;100
0;253;"hazeline";253;0;100
6;251;"hazell";257;2.33463035019455;97.6653696498054
0;670;"hazelle";670;0;100
0;5;"hazelmae";5;0;100
0;5;"hazelmarie";5;0;100
0;5;"hazelrose";5;0;100
0;10;"hazeltine";10;0;100
0;85;"hazely";85;0;100
0;125;"hazelyn";125;0;100
0;99;"hazelynn";99;0;100
212;0;"hazem";212;100;0
1660;43;"hazen";1703;97.4750440399295;2.52495596007046
654;5;"haziel";659;99.2412746585736;0.758725341426404
84;0;"hazim";84;100;0
6;0;"hazin";6;100;0
21;0;"haziq";21;100;0
5;0;"hazir";5;100;0
43;2252;"hazle";2295;1.87363834422658;98.1263616557734
0;16;"hazlee";16;0;100
0;32;"hazleigh";32;0;100
0;65;"hazley";65;0;100
0;6;"hazlie";6;0;100
0;5;"hazlyn";5;0;100
0;5;"hazlynn";5;0;100
0;5;"hazy";5;0;100
0;82;"hazyl";82;0;100
5;0;"hazyn";5;100;0
0;38;"hazzel";38;0;100
5;0;"hazzie";5;100;0
0;14;"heahter";14;0;100
0;12;"healani";12;0;100
0;5;"healey";5;0;100
0;38;"healy";38;0;100
0;10;"heang";10;0;100
5;0;"heard";5;100;0
189;0;"hearl";189;100;0
30;0;"hearld";30;100;0
7;0;"hearman";7;100;0
39;0;"hearold";39;100;0
0;16;"heart";16;0;100
0;10;"hearther";10;0;100
0;24;"heartlee";24;0;100
0;16;"heartley";16;0;100
0;28;"heartly";28;0;100
0;10;"heartlyn";10;0;100
0;10;"heartlynn";10;0;100
0;53;"heater";53;0;100
27356;181;"heath";27537;99.3427025456658;0.657297454334169
15;0;"heathcliff";15;100;0
24;51;"heathe";75;32;68
1482;524304;"heather";525786;0.281863724024603;99.7181362759754
0;54;"heatherann";54;0;100
0;12;"heatherlee";12;0;100
0;86;"heatherly";86;0;100
0;11;"heatherlyn";11;0;100
0;5;"heatherlynn";5;0;100
0;17;"heathermarie";17;0;100
0;36;"heathr";36;0;100
0;6;"heathre";6;0;100
0;5;"heathyr";5;0;100
63;0;"heaton";63;100;0
0;151;"heavan";151;0;100
290;23929;"heaven";24219;1.19740699450844;98.8025930054916
0;592;"heavenlee";592;0;100
0;11;"heavenlei";11;0;100
0;381;"heavenleigh";381;0;100
0;11;"heavenley";11;0;100
0;24;"heavenli";24;0;100
0;3312;"heavenly";3312;0;100
0;20;"heavenlyjoy";20;0;100
0;6;"heavenlyn";6;0;100
0;5;"heavenor";5;0;100
0;129;"heavin";129;0;100
0;15;"heavon";15;0;100
0;721;"heavyn";721;0;100
0;33;"heavynn";33;0;100
0;1150;"heba";1150;0;100
0;165;"hebah";165;0;100
0;86;"hebe";86;0;100
2709;0;"heber";2709;100;0
1056;0;"hebert";1056;100;0
5;0;"heberth";5;100;0
141;0;"heberto";141;100;0
53;5;"hebron";58;91.3793103448276;8.62068965517241
5;0;"hec";5;100;0
100245;481;"hector";100726;99.5224668903759;0.477533109624129
0;52;"hedaya";52;0;100
0;220;"hedda";220;0;100
0;38;"heddie";38;0;100
0;135;"heddy";135;0;100
8;0;"heder";8;100;0
7;0;"hedgar";7;100;0
0;108;"hedi";108;0;100
0;5;"hedie";5;0;100
0;5;"hedieh";5;0;100
0;5;"hedit";5;0;100
13;0;"hedley";13;100;0
40;0;"hedrick";40;100;0
0;20;"hedvig";20;0;100
0;2590;"hedwig";2590;0;100
0;2231;"hedy";2231;0;100
0;22;"hee";22;0;100
0;5;"heeba";5;0;100
0;53;"heela";53;0;100
0;253;"heena";253;0;100
0;148;"heer";148;0;100
0;18;"heera";18;0;100
5;0;"heet";5;100;0
0;5;"heeya";5;0;100
11;0;"heflin";11;100;0
0;15;"hefziba";15;0;100
0;29;"heida";29;0;100
0;2096;"heide";2096;0;100
0;66;"heidee";66;0;100
0;100;"heidemarie";100;0;100
21;0;"heiden";21;100;0
361;141557;"heidi";141918;0.254372243126312;99.7456277568737
0;5;"heidiann";5;0;100
0;389;"heidie";389;0;100
0;5;"heidimarie";5;0;100
0;5044;"heidy";5044;0;100
0;128;"heike";128;0;100
15;0;"heiko";15;100;0
0;98;"heiley";98;0;100
0;5;"heili";5;0;100
0;6;"heilly";6;0;100
0;532;"heily";532;0;100
0;29;"heilyn";29;0;100
6;0;"hein";6;100;0
6;0;"heiner";6;100;0
366;0;"heinrich";366;100;0
642;0;"heinz";642;100;0
0;230;"heiress";230;0;100
0;11;"heiry";11;0;100
0;11;"heisy";11;0;100
572;0;"heith";572;100;0
22;0;"heitor";22;100;0
69;0;"hektor";69;100;0
0;22;"hela";22;0;100
22;0;"heladio";22;100;0
0;11;"helaena";11;0;100
0;824;"helaina";824;0;100
0;1789;"helaine";1789;0;100
5;0;"helal";5;100;0
5;0;"helam";5;100;0
192;0;"helaman";192;100;0
0;16;"helan";16;0;100
0;514;"helana";514;0;100
0;174;"helane";174;0;100
0;283;"helayna";283;0;100
0;168;"helayne";168;0;100
0;37;"heldana";37;0;100
214;0;"helder";214;100;0
0;20;"heleana";20;0;100
0;22;"heleen";22;0;100
0;73;"heleena";73;0;100
0;5;"heleina";5;0;100
0;78;"helem";78;0;100
2958;968221;"helen";971179;0.304578249735631;99.6954217502644
0;32346;"helena";32346;0;100
0;57;"helenann";57;0;100
0;31934;"helene";31934;0;100
0;10;"helenmae";10;0;100
0;50;"helenmarie";50;0;100
0;39;"helenna";39;0;100
0;18;"heleyna";18;0;100
0;1914;"helga";1914;0;100
49;0;"helge";49;100;0
15;114;"heli";129;11.6279069767442;88.3720930232558
0;103;"helia";103;0;100
0;40;"heliana";40;0;100
0;43;"helin";43;0;100
0;407;"helina";407;0;100
239;0;"helio";239;100;0
163;0;"heliodoro";163;100;0
135;0;"helios";135;100;0
0;5;"helissa";5;0;100
5;0;"helius";5;100;0
43;0;"helix";43;100;0
0;6;"hellan";6;0;100
0;7271;"hellen";7271;0;100
0;140;"hellena";140;0;100
0;9;"hellene";9;0;100
0;5;"heller";5;0;100
0;417;"hellon";417;0;100
0;5;"helly";5;0;100
0;439;"helma";439;0;100
10;0;"helmar";10;100;0
688;0;"helmer";688;100;0
0;360;"helmi";360;0;100
0;5;"helmie";5;0;100
451;0;"helmut";451;100;0
495;0;"helmuth";495;100;0
11;0;"helo";11;100;0
0;11;"heloisa";11;0;100
0;608;"heloise";608;0;100
5;661;"helon";666;0.750750750750751;99.2492492492492
0;13;"helsea";13;0;100
72;0;"helton";72;100;0
0;172;"helvi";172;0;100
0;10;"helvie";10;0;100
0;1071;"helyn";1071;0;100
0;108;"helyne";108;0;100
0;159;"hema";159;0;100
31;0;"hemal";31;100;0
0;17;"hemali";17;0;100
80;0;"heman";80;100;0
0;10;"hemani";10;0;100
22;0;"hemant";22;100;0
21;0;"hemanth";21;100;0
0;13;"hemen";13;0;100
6;0;"hemerson";6;100;0
93;48;"hemi";141;65.9574468085106;34.0425531914894
12;0;"hemingway";12;100;0
0;21;"hemma";21;0;100
5;0;"hemza";5;100;0
0;268;"hena";268;0;100
6;0;"henach";6;100;0
60;0;"hence";60;100;0
0;156;"henchy";156;0;100
0;54;"hend";54;0;100
0;68;"hendel";68;0;100
3501;0;"henderson";3501;100;0
0;5;"hendley";5;0;100
5;0;"hendrex";5;100;0
6;0;"hendric";6;100;0
913;0;"hendrick";913;100;0
88;0;"hendricks";88;100;0
827;0;"hendrik";827;100;0
3540;226;"hendrix";3766;93.9989378651089;6.00106213489113
5;0;"hendrixx";5;100;0
101;0;"hendry";101;100;0
38;0;"hendryx";38;100;0
0;161;"hendy";161;0;100
0;10;"heneretta";10;0;100
0;16;"henerietta";16;0;100
1897;0;"henery";1897;100;0
0;28;"henesis";28;0;100
0;22;"henessey";22;0;100
0;157;"henessy";157;0;100
0;7;"henesy";7;0;100
16;0;"heng";16;100;0
7;0;"henil";7;100;0
0;212;"henlee";212;0;100
0;172;"henleigh";172;0;100
850;2816;"henley";3666;23.1860338243317;76.8139661756683
0;56;"henli";56;0;100
0;39;"henlie";39;0;100
10;13;"henly";23;43.4782608695652;56.5217391304348
0;1067;"henna";1067;0;100
0;8;"hennah";8;0;100
0;15;"hennesey";15;0;100
0;5;"hennesie";5;0;100
0;300;"hennessey";300;0;100
50;1060;"hennessy";1110;4.5045045045045;95.4954954954955
0;83;"hennesy";83;0;100
0;178;"hennie";178;0;100
219;0;"henning";219;100;0
0;13;"hennley";13;0;100
5;0;"hennry";5;100;0
58;615;"henny";673;8.61812778603269;91.3818722139673
11;0;"henoc";11;100;0
24;0;"henoch";24;100;0
23;0;"henock";23;100;0
237;0;"henok";237;100;0
5;0;"henon";5;100;0
29;0;"henos";29;100;0
0;63;"henreitta";63;0;100
0;26;"henrene";26;0;100
0;1161;"henretta";1161;0;100
0;74;"henretter";74;0;100
0;6;"henrettia";6;0;100
5;0;"henrey";5;100;0
4209;625;"henri";4834;87.0707488622259;12.9292511377741
150;0;"henrick";150;100;0
20;51;"henrie";71;28.169014084507;71.830985915493
0;6;"henriella";6;0;100
42;44150;"henrietta";44192;0.0950398262128892;99.9049601737871
0;1133;"henriette";1133;0;100
1944;0;"henrik";1944;100;0
0;13;"henrika";13;0;100
0;84;"henrine";84;0;100
429;0;"henrique";429;100;0
0;334;"henritta";334;0;100
10;0;"henrri";10;100;0
594;0;"henrry";594;100;0
622781;4161;"henry";626942;99.3363022416747;0.663697758325332
0;432;"henryetta";432;0;100
150;0;"henryk";150;100;0
0;5;"henryka";5;0;100
40;0;"hensel";40;100;0
0;76;"henslee";76;0;100
0;5;"hensleigh";5;0;100
108;656;"hensley";764;14.1361256544503;85.8638743455497
342;0;"henson";342;100;0
10;0;"henton";10;100;0
0;78;"henya";78;0;100
0;5;"henzlee";5;0;100
0;23;"henzley";23;0;100
0;81;"hephzibah";81;0;100
16;0;"her";16;100;0
0;456;"hera";456;0;100
272;0;"heraclio";272;100;0
984;0;"herald";984;100;0
44;0;"heraldo";44;100;0
0;79;"heran";79;0;100
1996;0;"herb";1996;100;0
59;0;"herber";59;100;0
217766;1107;"herbert";218873;99.4942272459371;0.505772754062858
0;106;"herberta";106;0;100
167;0;"herberth";167;100;0
87;0;"herberto";87;100;0
21;0;"herbet";21;100;0
5;0;"herbey";5;100;0
1094;0;"herbie";1094;100;0
649;0;"herby";649;100;0
454;0;"herchel";454;100;0
34;0;"herchell";34;100;0
0;5;"hercilia";5;0;100
16;0;"herculano";16;100;0
1156;0;"hercules";1156;100;0
13;0;"herdis";13;100;0
39;0;"heri";39;100;0
0;5;"heriberta";5;0;100
9692;16;"heriberto";9708;99.835187474248;0.164812525751957
0;15;"herica";15;0;100
12;0;"herick";12;100;0
17;0;"herik";17;100;0
0;5;"herika";5;0;100
0;5;"herlaine";5;0;100
0;6;"herlane";6;0;100
0;34;"herlene";34;0;100
149;0;"herley";149;100;0
48;0;"herlin";48;100;0
0;4285;"herlinda";4285;0;100
0;16;"herline";16;0;100
0;809;"herma";809;0;100
0;25;"hermalinda";25;0;100
127502;775;"herman";128277;99.3958386928288;0.6041613071712
0;5;"hermance";5;0;100
0;6;"hermanda";6;0;100
0;5;"hermania";5;0;100
684;0;"hermann";684;100;0
5;0;"hermas";5;100;0
0;216;"hermela";216;0;100
0;1987;"hermelinda";1987;0;100
11;0;"hermelindo";11;100;0
62;0;"hermen";62;100;0
0;59;"hermena";59;0;100
0;6;"hermene";6;0;100
91;0;"hermenegildo";91;100;0
0;159;"hermenia";159;0;100
485;0;"hermes";485;100;0
0;33;"hermia";33;0;100
12;283;"hermie";295;4.06779661016949;95.9322033898305
0;232;"hermila";232;0;100
0;5;"hermilinda";5;0;100
420;0;"hermilo";420;100;0
0;1418;"hermina";1418;0;100
0;1352;"hermine";1352;0;100
0;3700;"herminia";3700;0;100
1372;0;"herminio";1372;100;0
5;0;"hermino";5;100;0
0;985;"hermione";985;0;100
5;0;"hermit";5;100;0
0;50;"hermoine";50;0;100
3822;36;"hermon";3858;99.0668740279938;0.933125972006221
5;0;"hermond";5;100;0
0;16;"hermonie";16;0;100
10;0;"hernaldo";10;100;0
4577;0;"hernan";4577;100;0
109;0;"hernandez";109;100;0
748;0;"hernando";748;100;0
194;0;"herndon";194;100;0
29;0;"hernesto";29;100;0
5;0;"herney";5;100;0
177;0;"herny";177;100;0
261;146;"hero";407;64.1277641277641;35.8722358722359
37;0;"herod";37;100;0
613;0;"herold";613;100;0
522;5;"heron";527;99.0512333965844;0.94876660341556
5;0;"herrel";5;100;0
13;0;"herrell";13;100;0
66;0;"herrick";66;100;0
112;0;"herron";112;100;0
26;0;"herry";26;100;0
12;0;"hersch";12;100;0
26;0;"herschal";26;100;0
10001;0;"herschel";10001;100;0
1056;0;"herschell";1056;100;0
196;0;"hersel";196;100;0
331;0;"hersey";331;100;0
592;0;"hersh";592;100;0
647;0;"hershal";647;100;0
195;0;"hershall";195;100;0
9836;5;"hershel";9841;99.9491921552688;0.0508078447312265
1842;0;"hershell";1842;100;0
118;0;"hershey";118;100;0
597;0;"hershy";597;100;0
10;0;"hersie";10;100;0
464;0;"herson";464;100;0
0;87;"herta";87;0;100
0;1232;"hertha";1232;0;100
5;0;"hertis";5;100;0
98;0;"heru";98;100;0
541;0;"herve";541;100;0
1061;0;"hervey";1061;100;0
39;0;"hervie";39;100;0
53;0;"hervin";53;100;0
13;0;"hervy";13;100;0
5;0;"hery";5;100;0
357;0;"hesham";357;100;0
5;0;"hesher";5;100;0
36;0;"heshimu";36;100;0
24;0;"heshy";24;100;0
0;103;"hesper";103;0;100
10;0;"hess";10;100;0
0;22;"hessa";22;0;100
11;0;"hessel";11;100;0
16;914;"hessie";930;1.72043010752688;98.2795698924731
237;0;"hesston";237;100;0
0;26;"hesta";26;0;100
0;6;"hestel";6;0;100
522;12012;"hester";12534;4.16467209191001;95.83532790809
0;6;"hestia";6;0;100
1088;0;"heston";1088;100;0
16;0;"het";16;100;0
0;120;"hetal";120;0;100
0;364;"hether";364;0;100
0;5187;"hettie";5187;0;100
0;575;"hetty";575;0;100
0;53;"hetvi";53;0;100
0;18;"hevan";18;0;100
0;35;"heven";35;0;100
124;0;"hever";124;100;0
0;79;"hevin";79;0;100
0;39;"hevyn";39;0;100
0;32;"hewan";32;0;100
11;0;"hewell";11;100;0
23;0;"hewey";23;100;0
794;0;"hewitt";794;100;0
36;0;"hewlett";36;100;0
0;20;"heyab";20;0;100
0;25;"heyam";25;0;100
11;0;"heydan";11;100;0
155;0;"heyden";155;100;0
0;539;"heydi";539;0;100
0;168;"heydy";168;0;100
0;73;"heylee";73;0;100
0;5;"heylen";5;0;100
0;21;"heyley";21;0;100
0;68;"heyli";68;0;100
0;5;"heylie";5;0;100
0;32;"heylin";32;0;100
0;12;"heymi";12;0;100
0;5;"heysel";5;0;100
1987;0;"heyward";1987;100;0
305;0;"heywood";305;100;0
66;0;"hezakiah";66;100;0
20;0;"hezeki";20;100;0
6393;5;"hezekiah";6398;99.9218505783057;0.0781494216942795
6;0;"hezekiel";6;100;0
6;0;"hezekyah";6;100;0
67;0;"hezikiah";67;100;0
10;0;"hezkiah";10;100;0
28;0;"hezron";28;100;0
230;0;"hezzie";230;100;0
24;0;"hiatt";24;100;0
925;302;"hiawatha";1227;75.3871230643847;24.6128769356153
0;1505;"hiba";1505;0;100
0;358;"hibah";358;0;100
0;28;"hibaq";28;0;100
0;171;"hibba";171;0;100
5;0;"hibbard";5;100;0
0;58;"hibo";58;0;100
14;0;"hicham";14;100;0
22;0;"hickman";22;100;0
5;0;"hickory";5;100;0
74;0;"hicks";74;100;0
5;0;"hickson";5;100;0
0;101;"hidaya";101;0;100
0;27;"hidayah";27;0;100
27;0;"hideki";27;100;0
0;338;"hideko";338;0;100
12;0;"hidemi";12;100;0
805;0;"hideo";805;100;0
0;57;"hidi";57;0;100
0;38;"hidie";38;0;100
0;12;"hiede";12;0;100
0;1033;"hiedi";1033;0;100
305;327;"hien";632;48.2594936708861;51.7405063291139
120;0;"hiep";120;100;0
784;28;"hieu";812;96.551724137931;3.44827586206897
0;30;"hifza";30;0;100
0;5;"higinia";5;0;100
690;0;"higinio";690;100;0
0;8;"hiiaka";8;0;100
0;106;"hiilani";106;0;100
0;63;"hiilei";63;0;100
16;0;"hijinio";16;100;0
0;141;"hikari";141;0;100
144;18;"hikaru";162;88.8888888888889;11.1111111111111
110;0;"hikeem";110;100;0
0;40;"hikma";40;0;100
0;6;"hikmah";6;0;100
0;597;"hila";597;0;100
0;49;"hilah";49;0;100
29;19;"hilaire";48;60.4166666666667;39.5833333333333
20;39;"hilal";59;33.8983050847458;66.1016949152542
0;44;"hilaree";44;0;100
0;226;"hilari";226;0;100
0;933;"hilaria";933;0;100
0;771;"hilarie";771;0;100
4400;0;"hilario";4400;100;0
15;0;"hilarion";15;100;0
2148;23902;"hilary";26050;8.24568138195777;91.7543186180422
2020;0;"hilbert";2020;100;0
132;0;"hilberto";132;100;0
58;0;"hilburn";58;100;0
183;74553;"hilda";74736;0.244861913937058;99.7551380860629
0;119;"hildagard";119;0;100
0;193;"hildagarde";193;0;100
0;5;"hildah";5;0;100
0;16;"hildana";16;0;100
0;277;"hilde";277;0;100
5;0;"hildebrando";5;100;0
0;1684;"hildegard";1684;0;100
0;2119;"hildegarde";2119;0;100
5;20;"hilder";25;20;80
0;6;"hildia";6;0;100
0;7;"hildie";7;0;100
181;0;"hilding";181;100;0
26;0;"hildon";26;100;0
0;5;"hildra";5;0;100
420;2215;"hildred";2635;15.9392789373814;84.0607210626186
97;758;"hildreth";855;11.3450292397661;88.6549707602339
0;483;"hildur";483;0;100
0;196;"hildy";196;0;100
73;36;"hilery";109;66.9724770642202;33.0275229357798
0;37;"hiley";37;0;100
0;5;"hilia";5;0;100
0;232;"hiliana";232;0;100
0;141;"hiliary";141;0;100
0;46;"hilinai";46;0;100
0;76;"hilja";76;0;100
505;0;"hill";505;100;0
0;6;"hilla";6;0;100
2279;0;"hillard";2279;100;0
0;19;"hillaree";19;0;100
0;7;"hillarey";7;0;100
0;250;"hillari";250;0;100
0;329;"hillarie";329;0;100
1231;28476;"hillary";29707;4.14380449052412;95.8561955094759
1117;0;"hillel";1117;100;0
491;495;"hillery";986;49.7971602434077;50.2028397565923
1716;0;"hilliard";1716;100;0
5;303;"hilliary";308;1.62337662337662;98.3766233766234
16;0;"hillie";16;100;0
10;0;"hillip";10;100;0
407;13;"hillis";420;96.9047619047619;3.0952380952381
344;0;"hillman";344;100;0
5;22;"hillory";27;18.5185185185185;81.4814814814815
0;2333;"hilma";2333;0;100
146;0;"hilman";146;100;0
170;0;"hilmar";170;100;0
483;0;"hilmer";483;100;0
27;0;"hilmon";27;100;0
5;0;"hilo";5;100;0
6;0;"hilrey";6;100;0
5;0;"hilry";5;100;0
6651;26;"hilton";6677;99.6106035644751;0.389396435524936
5;0;"hilyard";5;100;0
0;32;"hima";32;0;100
0;199;"himani";199;0;100
7;0;"himansh";7;100;0
25;0;"himanshu";25;100;0
0;5;"himari";5;0;100
29;0;"himmat";29;100;0
0;589;"hina";589;0;100
0;6;"hinaea";6;0;100
0;39;"hinako";39;0;100
0;5;"hinal";5;0;100
0;5;"hinami";5;0;100
0;11;"hinano";11;0;100
6;143;"hinata";149;4.02684563758389;95.9731543624161
0;6;"hinatea";6;0;100
46;0;"hinckley";46;100;0
0;147;"hind";147;0;100
0;1135;"hinda";1135;0;100
0;17;"hindel";17;0;100
0;1269;"hindy";1269;0;100
74;0;"hines";74;100;0
5;0;"hing";5;100;0
0;5;"hinlee";5;0;100
0;82;"hinley";82;0;100
0;21;"hinsley";21;0;100
10;0;"hinson";10;100;0
548;0;"hinton";548;100;0
0;17;"hipolita";17;0;100
1890;0;"hipolito";1890;100;0
0;525;"hira";525;0;100
0;5;"hirah";5;0;100
0;89;"hiral";89;0;100
12164;0;"hiram";12164;100;0
72;0;"hiran";72;100;0
123;0;"hiren";123;100;0
0;5;"hirma";5;0;100
398;5;"hiro";403;98.7593052109181;1.24069478908189
20;0;"hiroaki";20;100;0
348;0;"hiroki";348;100;0
0;328;"hiroko";328;0;100
16;225;"hiromi";241;6.63900414937759;93.3609958506224
42;0;"hiromu";42;100;0
0;40;"hiromy";40;0;100
1460;0;"hiroshi";1460;100;0
148;0;"hiroto";148;100;0
61;0;"hiroyuki";61;100;0
16;0;"hirsch";16;100;0
8;0;"hirsh";8;100;0
0;6;"hirva";6;0;100
6;0;"hirvin";6;100;0
7;0;"hirving";7;100;0
0;5;"hisa";5;0;100
0;69;"hisae";69;0;100
0;368;"hisako";368;0;100
147;0;"hisao";147;100;0
129;0;"hisashi";129;100;0
0;25;"hisaye";25;0;100
0;69;"hisayo";69;0;100
0;5;"hisela";5;0;100
5;0;"hishaam";5;100;0
708;0;"hisham";708;100;0
10;0;"hiten";10;100;0
75;0;"hitesh";75;100;0
0;5;"hitha";5;0;100
0;6;"hitney";6;0;100
0;108;"hitomi";108;0;100
142;0;"hitoshi";142;100;0
0;11;"hitzel";11;0;100
0;17;"hiwot";17;0;100
0;34;"hixie";34;0;100
16;0;"hixon";16;100;0
0;129;"hiya";129;0;100
19;95;"hiyab";114;16.6666666666667;83.3333333333333
0;13;"hiyam";13;0;100
11;0;"hiyan";11;100;0
98;0;"hjalmar";98;100;0
158;0;"hjalmer";158;100;0
0;53;"hjordis";53;0;100
0;5;"hla";5;0;100
0;96;"hlee";96;0;100
0;33;"hli";33;0;100
129;0;"ho";129;100;0
262;270;"hoa";532;49.2481203007519;50.7518796992481
35;6;"hoai";41;85.3658536585366;14.6341463414634
43;0;"hoan";43;100;0
735;51;"hoang";786;93.5114503816794;6.48854961832061
29;0;"hoarce";29;100;0
3447;0;"hobart";3447;100;0
39;0;"hobbes";39;100;0
5;0;"hobbie";5;100;0
19;0;"hobbs";19;100;0
9;0;"hobby";9;100;0
5534;0;"hobert";5534;100;0
348;0;"hobie";348;100;0
365;0;"hobson";365;100;0
84;0;"hoby";84;100;0
0;428;"hoda";428;0;100
0;10;"hodalis";10;0;100
0;219;"hodan";219;0;100
75;0;"hodari";75;100;0
0;118;"hodaya";118;0;100
68;0;"hodge";68;100;0
232;0;"hodges";232;100;0
5;0;"hoffman";5;100;0
1256;0;"hogan";1256;100;0
611;0;"hoke";611;100;0
5;0;"hoku";5;100;0
0;96;"hokulani";96;0;100
142;0;"holbert";142;100;0
5;0;"holbrook";5;100;0
64;0;"holdan";64;100;0
19850;149;"holden";19999;99.2549627481374;0.745037251862593
13;0;"holder";13;100;0
5;0;"holdin";5;100;0
35;0;"holdon";35;100;0
394;25;"holdyn";419;94.0334128878282;5.96658711217184
233;0;"holger";233;100;0
0;266;"holiday";266;0;100
21;328;"hollace";349;6.01719197707736;93.9828080229226
27;82;"hollan";109;24.7706422018349;75.2293577981651
2301;3910;"holland";6211;37.0471743680567;62.9528256319433
0;76;"holle";76;0;100
0;708;"hollee";708;0;100
0;103;"holleigh";103;0;100
0;31;"hollen";31;0;100
204;4098;"holley";4302;4.74198047419805;95.258019525802
5;8607;"holli";8612;0.0580585229911751;99.9419414770088
0;35;"holliann";35;0;100
0;60;"hollianne";60;0;100
55;22;"hollice";77;71.4285714285714;28.5714285714286
0;58;"holliday";58;0;100
1356;17761;"hollie";19117;7.09316315321442;92.9068368467856
0;50;"hollin";50;0;100
13938;4086;"hollis";18024;77.3302263648469;22.6697736351531
84;25;"hollister";109;77.0642201834862;22.9357798165138
15;0;"holloway";15;100;0
1502;199186;"holly";200688;0.748425416567009;99.251574583433
0;612;"hollyann";612;0;100
0;145;"hollyanne";145;0;100
0;445;"hollye";445;0;100
0;5;"hollylynn";5;0;100
0;5;"hollymarie";5;0;100
0;819;"hollyn";819;0;100
0;20;"hollynd";20;0;100
0;58;"hollynn";58;0;100
292;0;"holman";292;100;0
5;0;"holmer";5;100;0
577;0;"holmes";577;100;0
34;0;"holsey";34;100;0
10;0;"holsten";10;100;0
69;0;"holston";69;100;0
1219;0;"holt";1219;100;0
232;0;"holten";232;100;0
11;0;"holter";11;100;0
691;0;"holton";691;100;0
5;82;"holy";87;5.74712643678161;94.2528735632184
0;19;"holyn";19;0;100
558;0;"homar";558;100;0
20;0;"homas";20;100;0
8;0;"hombre";8;100;0
55790;357;"homer";56147;99.3641690562274;0.635830943772597
3559;0;"homero";3559;100;0
78;0;"hommer";78;100;0
6;0;"hommy";6;100;0
58;0;"hondo";58;100;0
49;75;"honest";124;39.5161290322581;60.4838709677419
0;117;"honestee";117;0;100
0;515;"honesti";515;0;100
0;75;"honestie";75;0;100
0;38;"honestii";38;0;100
0;3321;"honesty";3321;0;100
0;3342;"honey";3342;0;100
197;450;"hong";647;30.4482225656878;69.5517774343122
0;5;"hongan";5;0;100
5;0;"hongyu";5;100;0
0;51;"honi";51;0;100
0;7;"honie";7;0;100
0;26;"honoka";26;0;100
516;2171;"honor";2687;19.2035727577224;80.7964272422776
0;1360;"honora";1360;0;100
0;5;"honorae";5;0;100
11;0;"honorato";11;100;0
27;220;"honore";247;10.9311740890688;89.0688259109312
0;37;"honoria";37;0;100
0;29;"honorine";29;0;100
219;0;"honorio";219;100;0
36;146;"honour";182;19.7802197802198;80.2197802197802
35;0;"hood";35;100;0
5;0;"hooker";5;100;0
29;0;"hooman";29;100;0
79;0;"hooper";79;100;0
0;35;"hoor";35;0;100
0;66;"hoorain";66;0;100
0;52;"hooria";52;0;100
0;36;"hooriya";36;0;100
1114;7;"hoover";1121;99.3755575379126;0.624442462087422
495;85893;"hope";86388;0.572996249479094;99.4270037505209
0;23;"hopelyn";23;0;100
0;75;"hopelynn";75;0;100
0;11;"hopemarie";11;0;100
16;0;"hopeton";16;100;0
0;5;"hopi";5;0;100
0;104;"hopie";104;0;100
23;0;"hopper";23;100;0
5;0;"hopson";5;100;0
50505;202;"horace";50707;99.6016329106435;0.398367089356499
4208;0;"horacio";4208;100;0
71;0;"horald";71;100;0
1267;0;"horatio";1267;100;0
5;0;"horeb";5;100;0
97;0;"horice";97;100;0
0;46;"horizon";46;0;100
18;0;"horlando";18;100;0
5;0;"horold";5;100;0
73;0;"horrace";73;100;0
79;0;"horris";79;100;0
83;0;"horst";83;100;0
0;200;"hortence";200;0;100
0;3931;"hortencia";3931;0;100
0;5659;"hortense";5659;0;100
0;1789;"hortensia";1789;0;100
586;0;"horton";586;100;0
11;0;"horus";11;100;0
71;0;"hosam";71;100;0
0;1010;"hosanna";1010;0;100
0;10;"hosannah";10;0;100
5;0;"hoscar";5;100;0
12;0;"hose";12;100;0
4686;20;"hosea";4706;99.5750106247344;0.424989375265618
384;0;"hosey";384;100;0
0;6;"hoshi";6;0;100
25;0;"hosia";25;100;0
1186;11;"hosie";1197;99.0810359231412;0.918964076858814
47;0;"hoskie";47;100;0
34;0;"hoss";34;100;0
13;0;"hossain";13;100;0
39;0;"hossam";39;100;0
40;0;"hossein";40;100;0
6;0;"hosteen";6;100;0
5;0;"hoston";5;100;0
79;181;"houa";260;30.3846153846154;69.6153846153846
0;102;"houda";102;0;100
21;0;"houghton";21;100;0
6;0;"housten";6;100;0
5;0;"houstin";5;100;0
14452;285;"houston";14737;98.0660921490127;1.93390785098731
63;0;"hovanes";63;100;0
22;0;"hovannes";22;100;0
7;0;"hover";7;100;0
5;0;"hovey";5;100;0
36;0;"hovhannes";36;100;0
10;0;"hovie";10;100;0
11;0;"hovig";11;100;0
13;0;"hovik";13;100;0
33;0;"hovsep";33;100;0
334394;1640;"howard";336034;99.511954147497;0.488045852503021
0;7;"howardine";7;0;100
28;0;"howe";28;100;0
3656;0;"howell";3656;100;0
642;0;"howie";642;100;0
17;0;"howland";17;100;0
801;0;"hoy";801;100;0
16;0;"hoyal";16;100;0
5;0;"hoyd";5;100;0
54;0;"hoye";54;100;0
38;0;"hoyet";38;100;0
15;0;"hoyett";15;100;0
1002;0;"hoyle";1002;100;0
7712;10;"hoyt";7722;99.8704998704999;0.129500129500129
257;0;"hoyte";257;100;0
6;0;"hoytt";6;100;0
0;5;"hozel";5;0;100
32;0;"hozie";32;100;0
11;0;"hrach";11;100;0
22;0;"hrag";22;100;0
11;0;"hrehaan";11;100;0
58;0;"hridaan";58;100;0
6;0;"hridan";6;100;0
71;0;"hriday";71;100;0
101;0;"hridhaan";101;100;0
0;11;"hridya";11;0;100
13;0;"hrihaan";13;100;0
0;5;"hripsime";5;0;100
0;6;"hrisha";6;0;100
40;0;"hrishi";40;100;0
6;0;"hrishik";6;100;0
86;0;"hrishikesh";86;100;0
0;48;"hristina";48;0;100
0;16;"hristine";16;0;100
24;0;"hristo";24;100;0
194;0;"hristopher";194;100;0
28;0;"hristos";28;100;0
63;0;"hrithik";63;100;0
0;10;"hrithika";10;0;100
10;0;"hritik";10;100;0
0;5;"hritika";5;0;100
5;0;"hriyaan";5;100;0
10;0;"hsa";10;100;0
20;43;"hser";63;31.7460317460317;68.2539682539683
33;0;"htoo";33;100;0
5;0;"hu";5;100;0
0;10;"huai";10;0;100
87;0;"huan";87;100;0
5;0;"huascar";5;100;0
5;0;"hub";5;100;0
5;0;"hubart";5;100;0
703;0;"hubbard";703;100;0
118;0;"hubbert";118;100;0
0;5;"hubbie";5;0;100
333;0;"huber";333;100;0
55586;189;"hubert";55775;99.6611385029135;0.338861497086508
0;218;"huberta";218;0;100
0;5;"hubertine";5;0;100
6;0;"huberto";6;100;0
5;0;"hubery";5;100;0
5;0;"hubie";5;100;0
5;0;"huburt";5;100;0
528;0;"huck";528;100;0
168;0;"huckleberry";168;100;0
7;0;"hucksley";7;100;0
14;0;"huckson";14;100;0
12;0;"huckston";12;100;0
40;0;"hud";40;100;0
0;1299;"huda";1299;0;100
5;0;"hudaifa";5;100;0
5;0;"hudayfa";5;100;0
5;0;"hudayfi";5;100;0
0;5;"hudes";5;0;100
10;0;"hudeyfa";10;100;0
5;0;"hudeyfi";5;100;0
5;0;"hudhayfah";5;100;0
46;0;"hudie";46;100;0
0;6;"hudis";6;0;100
304;11;"hudsen";315;96.5079365079365;3.49206349206349
48298;964;"hudson";49262;98.043116398035;1.956883601965
179;261;"hudsyn";440;40.6818181818182;59.3181818181818
0;10;"hudsynn";10;0;100
0;5;"hudy";5;0;100
464;89;"hue";553;83.9059674502712;16.0940325497288
8;0;"huebert";8;100;0
331;0;"huel";331;100;0
10;0;"huell";10;100;0
43;0;"hueston";43;100;0
6710;5;"huey";6715;99.9255398361876;0.0744601638123604
0;5;"hufsa";5;0;100
76221;354;"hugh";76575;99.537708129285;0.462291870714985
5;0;"hughe";5;100;0
757;0;"hughes";757;100;0
387;0;"hughey";387;100;0
1598;0;"hughie";1598;100;0
0;5;"hughlene";5;0;100
18;0;"hughlon";18;100;0
49;0;"hughston";49;100;0
13;0;"hughy";13;100;0
30105;30;"hugo";30135;99.9004479840717;0.0995520159283226
10;0;"hugues";10;100;0
0;22;"huguette";22;0;100
0;30;"hui";30;0;100
155;0;"huie";155;100;0
0;82;"hula";82;0;100
0;5;"hulali";5;0;100
178;0;"hulan";178;100;0
128;0;"hulbert";128;100;0
0;3133;"hulda";3133;0;100
0;552;"huldah";552;0;100
0;5;"huldia";5;0;100
469;0;"hulen";469;100;0
0;32;"hulene";32;0;100
65;0;"hulet";65;100;0
48;0;"hulett";48;100;0
27;0;"huley";27;100;0
24;0;"hulices";24;100;0
13;0;"hulin";13;100;0
41;0;"hulises";41;100;0
1125;0;"hulon";1125;100;0
0;216;"huma";216;0;100
0;154;"humaira";154;0;100
0;16;"humayra";16;0;100
431;0;"humbert";431;100;0
16022;10;"humberto";16032;99.937624750499;0.062375249500998
12;0;"hume";12;100;0
0;5;"humeyra";5;0;100
0;68;"humna";68;0;100
6;0;"humphery";6;100;0
957;0;"humphrey";957;100;0
1032;0;"humza";1032;100;0
146;0;"humzah";146;100;0
27;0;"hunberto";27;100;0
8;0;"huner";8;100;0
1004;0;"hung";1004;100;0
344;0;"hunner";344;100;0
0;6;"hunnie";6;0;100
0;7;"hunny";7;0;100
181;0;"hunt";181;100;0
222096;11339;"hunter";233435;95.1425450339495;4.85745496605051
193;0;"huntington";193;100;0
25;27;"huntlee";52;48.0769230769231;51.9230769230769
0;58;"huntleigh";58;0;100
430;153;"huntley";583;73.7564322469983;26.2435677530017
53;0;"huntter";53;100;0
16;0;"huntur";16;100;0
14;37;"huntyr";51;27.4509803921569;72.5490196078431
0;578;"huong";578;0;100
0;5;"hurain";5;0;100
623;0;"hurbert";623;100;0
55;0;"hurchel";55;100;0
5;0;"hurdis";5;100;0
5;0;"hurel";5;100;0
277;0;"huriel";277;100;0
30;0;"hurl";30;100;0
2371;73;"hurley";2444;97.013093289689;2.98690671031097
7;0;"hurlie";7;100;0
199;0;"hurman";199;100;0
16;0;"hurmon";16;100;0
48;0;"huron";48;100;0
0;5;"hurrem";5;0;100
67;0;"hurschel";67;100;0
40;0;"hursel";40;100;0
841;0;"hurshel";841;100;0
131;0;"hurshell";131;100;0
16;0;"hurst";16;100;0
47;0;"hurston";47;100;0
0;6;"hurtha";6;0;100
57;0;"hurtis";57;100;0
5;0;"husai";5;100;0
303;0;"husain";303;100;0
0;5;"husaina";5;0;100
364;0;"husam";364;100;0
36;0;"husani";36;100;0
70;0;"husayn";70;100;0
88;0;"husein";88;100;0
0;322;"husna";322;0;100
18;0;"husnain";18;100;0
1253;0;"hussain";1253;100;0
191;0;"hussam";191;100;0
50;0;"hussan";50;100;0
2511;0;"hussein";2511;100;0
15;0;"hussen";15;100;0
263;0;"hussien";263;100;0
6;0;"hussin";6;100;0
2520;0;"huston";2520;100;0
274;0;"hutch";274;100;0
5;0;"hutchins";5;100;0
89;0;"hutchinson";89;100;0
27;0;"hutchison";27;100;0
373;0;"hutson";373;100;0
298;13;"hutton";311;95.8199356913183;4.18006430868167
5;0;"hux";5;100;0
15;10;"huxlee";25;60;40
0;5;"huxleigh";5;0;100
976;90;"huxley";1066;91.5572232645403;8.44277673545966
0;6;"huxlie";6;0;100
7;0;"huxon";7;100;0
114;0;"huxton";114;100;0
1613;0;"huy";1613;100;0
0;276;"huyen";276;0;100
22;0;"huynh";22;100;0
211;0;"huzaifa";211;100;0
40;0;"huzaifah";40;100;0
98;0;"hy";98;100;0
0;828;"hyacinth";828;0;100
305;29;"hyatt";334;91.3173652694611;8.68263473053892
133;0;"hyde";133;100;0
0;13;"hydea";13;0;100
0;143;"hydee";143;0;100
0;214;"hydeia";214;0;100
66;0;"hyden";66;100;0
87;0;"hyder";87;100;0
0;26;"hydi";26;0;100
0;154;"hydia";154;0;100
0;9;"hydiah";9;0;100
0;69;"hydie";69;0;100
0;9;"hydiea";9;0;100
0;5;"hydiyah";5;0;100
0;73;"hye";73;0;100
267;0;"hykeem";267;100;0
5;0;"hykeim";5;100;0
0;511;"hyla";511;0;100
44;0;"hylan";44;100;0
145;10;"hyland";155;93.5483870967742;6.45161290322581
0;49;"hylda";49;0;100
5;0;"hyle";5;100;0
0;32;"hylee";32;0;100
0;12;"hyleigh";12;0;100
0;5;"hylie";5;0;100
5;0;"hylton";5;100;0
5733;0;"hyman";5733;100;0
285;0;"hymen";285;100;0
108;0;"hymie";108;100;0
0;40;"hynlee";40;0;100
0;5;"hynleigh";5;0;100
5;0;"hyon";5;100;0
0;26;"hypatia";26;0;100
53;0;"hyram";53;100;0
2781;0;"hyrum";2781;100;0
5;0;"hyson";5;100;0
5;0;"hytham";5;100;0
263;168;"hyun";431;61.0208816705336;38.9791183294664
5;0;"hyung";5;100;0
0;144;"ia";144;0;100
79;0;"iaan";79;100;0
58;0;"iago";58;100;0
0;5;"iah";5;0;100
6;0;"iahn";6;100;0
2642;0;"iain";2642;100;0
0;31;"iaisha";31;0;100
6;0;"iakona";6;100;0
0;6;"ialene";6;0;100
0;24;"ialiyah";24;0;100
133;0;"iam";133;100;0
217175;738;"ian";217913;99.6613327337056;0.338667266294347
0;562;"iana";562;0;100
0;5;"ianah";5;0;100
32;0;"iancarlo";32;100;0
64;0;"ianmichael";64;100;0
390;0;"iann";390;100;0
0;893;"ianna";893;0;100
0;11;"iannah";11;0;100
0;511;"iantha";511;0;100
0;47;"ianthe";47;0;100
0;11;"ianthia";11;0;100
12;0;"ianto";12;100;0
0;143;"iara";143;0;100
0;120;"iasha";120;0;100
0;13;"iashia";13;0;100
0;410;"iasia";410;0;100
68;7;"iasiah";75;90.6666666666667;9.33333333333333
32;0;"iason";32;100;0
5;0;"iassac";5;100;0
0;21;"iayana";21;0;100
0;5;"iba";5;0;100
34;0;"ibaad";34;100;0
5;0;"ibad";5;100;0
513;0;"iban";513;100;0
0;17;"ibbie";17;0;100
7;0;"ibe";7;100;0
0;32;"ibet";32;0;100
0;391;"ibeth";391;0;100
0;13;"ibette";13;0;100
5;0;"ibhan";5;100;0
21;0;"ibin";21;100;0
12;57;"ibis";69;17.3913043478261;82.6086956521739
0;5;"ibiza";5;0;100
855;0;"ibn";855;100;0
0;5;"ibon";5;0;100
5;0;"ibraaheem";5;100;0
66;0;"ibraham";66;100;0
1136;0;"ibraheem";1136;100;0
5;0;"ibraheim";5;100;0
71;0;"ibrahem";71;100;0
10726;0;"ibrahim";10726;100;0
774;0;"ibrahima";774;100;0
27;0;"ibrohim";27;100;0
0;10;"ibtihaj";10;0;100
0;5;"ibtihal";5;0;100
0;112;"ibtisam";112;0;100
29;22;"ibukunoluwa";51;56.8627450980392;43.1372549019608
0;176;"ica";176;0;100
49;0;"icarus";49;100;0
0;10;"icee";10;0;100
0;71;"iceis";71;0;100
0;130;"icel";130;0;100
0;161;"icela";161;0;100
0;5;"iceland";5;0;100
0;10;"icelean";10;0;100
0;5;"icelene";5;0;100
0;5;"icely";5;0;100
0;36;"icelyn";36;0;100
0;78;"icelynn";78;0;100
0;10;"iceola";10;0;100
0;26;"ices";26;0;100
0;134;"icesis";134;0;100
0;108;"icess";108;0;100
0;5;"icesys";5;0;100
0;122;"icey";122;0;100
390;0;"ichael";390;100;0
10;0;"ichard";10;100;0
0;79;"ichelle";79;0;100
10;0;"ichigo";10;100;0
261;0;"ichiro";261;100;0
70;0;"icholas";70;100;0
0;1029;"icie";1029;0;100
0;183;"icis";183;0;100
0;13;"iciss";13;0;100
122;0;"icker";122;100;0
0;37;"icle";37;0;100
0;19;"icole";19;0;100
0;6;"icsel";6;0;100
0;18;"icsis";18;0;100
0;824;"icy";824;0;100
0;10;"icysis";10;0;100
0;63;"icyss";63;0;100
614;146497;"ida";147111;0.417371916444046;99.582628083556
0;41;"idabel";41;0;100
0;148;"idabell";148;0;100
0;567;"idabelle";567;0;100
0;35;"idah";35;0;100
0;6;"idahlia";6;0;100
0;88;"idalee";88;0;100
0;43;"idalene";43;0;100
0;251;"idali";251;0;100
0;2717;"idalia";2717;0;100
0;68;"idalie";68;0;100
0;16;"idalina";16;0;100
0;815;"idalis";815;0;100
0;113;"idaliz";113;0;100
0;10;"idalmis";10;0;100
0;5;"idalou";5;0;100
0;851;"idaly";851;0;100
0;5;"idalynn";5;0;100
0;158;"idalys";158;0;100
0;16;"idalyz";16;0;100
0;911;"idamae";911;0;100
0;84;"idamay";84;0;100
359;0;"idan";359;100;0
0;5;"idanell";5;0;100
0;544;"idania";544;0;100
0;72;"idara";72;0;100
5;0;"idas";5;100;0
0;5;"idasia";5;0;100
0;5;"idaya";5;0;100
11;0;"iddo";11;100;0
0;5;"ideal";5;0;100
5;0;"idean";5;100;0
5;18;"idel";23;21.7391304347826;78.2608695652174
0;20;"idele";20;0;100
5;0;"idelfonso";5;100;0
0;126;"idelia";126;0;100
0;5;"idelisa";5;0;100
38;3240;"idell";3278;1.15924344112264;98.8407565588774
0;5854;"idella";5854;0;100
0;30;"idellar";30;0;100
0;740;"idelle";740;0;100
0;5;"idellia";5;0;100
318;0;"iden";318;100;0
0;16;"idena";16;0;100
0;20;"idesha";20;0;100
0;30;"idessa";30;0;100
0;6;"idette";6;0;100
25;0;"idhant";25;100;0
9;0;"idi";9;100;0
0;28;"idia";28;0;100
0;115;"idil";115;0;100
28;0;"idiris";28;100;0
0;28;"idman";28;0;100
113;0;"ido";113;100;0
0;44;"idola";44;0;100
0;306;"idolina";306;0;100
0;5;"idoma";5;0;100
0;99;"idona";99;0;100
0;118;"idonia";118;0;100
0;111;"idonna";111;0;100
0;99;"idora";99;0;100
267;0;"idrees";267;100;0
0;5;"idrena";5;0;100
2416;30;"idris";2446;98.7735077677841;1.22649223221586
114;0;"idriss";114;100;0
104;6;"idrissa";110;94.5454545454545;5.45454545454545
0;6;"iduma";6;0;100
165;0;"idus";165;100;0
0;238;"idy";238;0;100
5;0;"iean";5;100;0
0;534;"ieasha";534;0;100
0;29;"ieashia";29;0;100
0;8;"ieda";8;0;100
0;174;"ieesha";174;0;100
0;799;"ieisha";799;0;100
0;9;"ieishia";9;0;100
16;0;"ien";16;100;0
5;0;"iesa";5;100;0
15;7416;"iesha";7431;0.20185708518369;99.7981429148163
0;50;"ieshea";50;0;100
0;1650;"ieshia";1650;0;100
5;0;"iestyn";5;100;0
5;0;"ieuan";5;100;0
0;53;"ieva";53;0;100
0;5;"ieysha";5;0;100
0;187;"ife";187;0;100
105;0;"ifeanyi";105;100;0
128;0;"ifeanyichukwu";128;100;0
0;5;"ifechukwu";5;0;100
5;0;"ifenna";5;100;0
98;226;"ifeoluwa";324;30.2469135802469;69.7530864197531
0;346;"ifeoma";346;0;100
0;19;"ifetayo";19;0;100
0;7;"ifeyinwa";7;0;100
0;31;"iffany";31;0;100
0;11;"iffat";11;0;100
0;54;"ifra";54;0;100
0;218;"ifrah";218;0;100
10;0;"ifrain";10;100;0
0;5;"iftu";5;0;100
0;43;"ifunanya";43;0;100
5;0;"iggy";5;100;0
22;0;"ignac";22;100;0
96;0;"ignace";96;100;0
0;1029;"ignacia";1029;0;100
17691;22;"ignacio";17713;99.8757974369107;0.124202563089256
0;5;"ignacita";5;0;100
43;0;"ignasio";43;100;0
0;6;"ignatia";6;0;100
3194;0;"ignatius";3194;100;0
22;0;"ignatuis";22;100;0
152;0;"ignatz";152;100;0
559;0;"ignazio";559;100;0
681;0;"igor";681;100;0
23;0;"ihab";23;100;0
60;0;"ihan";60;100;0
0;16;"ihla";16;0;100
164;0;"ihor";164;100;0
37;5;"ihsaan";42;88.0952380952381;11.9047619047619
402;6;"ihsan";408;98.5294117647059;1.47058823529412
0;5;"ihuoma";5;0;100
5;0;"ii";5;100;0
11;0;"iian";11;100;0
0;6;"iiana";6;0;100
0;36;"iiesha";36;0;100
0;254;"iisha";254;0;100
0;5;"iishia";5;0;100
0;5;"iiyana";5;0;100
0;21;"ija";21;0;100
11;57;"ijah";68;16.1764705882353;83.8235294117647
0;22;"ijahnae";22;0;100
0;5;"ijana";5;0;100
0;91;"ijanae";91;0;100
0;12;"ijanay";12;0;100
11;0;"ijaz";11;100;0
0;477;"ijeoma";477;0;100
0;10;"ijnanya";10;0;100
5;0;"ikai";5;100;0
20;0;"ikaia";20;100;0
849;0;"ikaika";849;100;0
5853;0;"ike";5853;100;0
9;580;"ikea";589;1.52801358234295;98.471986417657
5;0;"ikeam";5;100;0
41;0;"ikechi";41;100;0
453;0;"ikechukwu";453;100;0
0;5;"ikeda";5;0;100
5;0;"ikee";5;100;0
320;0;"ikeem";320;100;0
17;0;"ikeer";17;100;0
0;51;"ikeia";51;0;100
0;69;"ikeisha";69;0;100
5;0;"ikem";5;100;0
576;0;"ikenna";576;100;0
10520;0;"iker";10520;100;0
0;11;"ikera";11;0;100
0;57;"ikeria";57;0;100
0;88;"ikesha";88;0;100
0;49;"ikeshia";49;0;100
114;0;"ikey";114;100;0
0;102;"ikeya";102;0;100
0;10;"ikeyia";10;0;100
15;0;"ikher";15;100;0
0;10;"ikhlaas";10;0;100
0;128;"ikhlas";128;0;100
0;252;"ikia";252;0;100
35;0;"ikie";35;100;0
0;11;"ikira";11;0;100
0;37;"ikisha";37;0;100
5;0;"ikponmwosa";5;100;0
0;5;"ikra";5;0;100
0;11;"ikraan";11;0;100
17;247;"ikram";264;6.43939393939394;93.5606060606061
0;151;"ikran";151;0;100
0;17;"iksha";17;0;100
52;0;"iktan";52;100;0
0;10;"ikuko";10;0;100
60;20627;"ila";20687;0.290037221443419;99.7099627785566
0;1251;"ilah";1251;0;100
93;0;"ilai";93;100;0
0;43;"ilaina";43;0;100
0;66;"ilaisaane";66;0;100
5;0;"ilam";5;100;0
0;127;"ilamae";127;0;100
2103;41;"ilan";2144;98.0876865671642;1.91231343283582
0;4915;"ilana";4915;0;100
0;12;"ilanah";12;0;100
0;251;"ilani";251;0;100
0;15;"ilanie";15;0;100
0;74;"ilanna";74;0;100
0;5;"ilanny";5;0;100
0;46;"ilany";46;0;100
0;30;"ilar";30;0;100
0;387;"ilaria";387;0;100
160;0;"ilario";160;100;0
57;0;"ilay";57;100;0
0;11;"ilaya";11;0;100
0;20;"ilayah";20;0;100
0;105;"ilayda";105;0;100
0;30;"ilayna";30;0;100
0;44;"ilce";44;0;100
0;5;"ilcia";5;0;100
0;1444;"ilda";1444;0;100
388;0;"ildefonso";388;100;0
0;55;"ildiko";55;0;100
0;237;"ilea";237;0;100
0;270;"ileah";270;0;100
0;965;"ilean";965;0;100
0;4863;"ileana";4863;0;100
0;230;"ileane";230;0;100
0;285;"ileanna";285;0;100
0;118;"ilee";118;0;100
0;2110;"ileen";2110;0;100
0;11;"ileena";11;0;100
0;451;"ileene";451;0;100
0;11;"ileia";11;0;100
0;80;"ileigh";80;0;100
0;585;"ilena";585;0;100
0;17627;"ilene";17627;0;100
0;15;"ilenia";15;0;100
0;5;"ilenna";5;0;100
0;6;"ilenne";6;0;100
0;50;"iler";50;0;100
0;17;"ilesha";17;0;100
0;5;"ilet";5;0;100
0;261;"ileta";261;0;100
0;5;"iletta";5;0;100
0;6;"ilette";6;0;100
108;114;"iley";222;48.6486486486487;51.3513513513513
0;21;"ileyah";21;0;100
0;6;"ilga";6;0;100
0;12;"ilhaan";12;0;100
5;162;"ilham";167;2.9940119760479;97.0059880239521
85;247;"ilhan";332;25.6024096385542;74.3975903614458
0;5;"ilhana";5;0;100
108;666;"ilia";774;13.953488372093;86.046511627907
0;22;"iliah";22;0;100
104;35;"ilian";139;74.8201438848921;25.1798561151079
0;10469;"iliana";10469;0;100
0;12;"ilianah";12;0;100
0;54;"iliani";54;0;100
0;5;"ilianie";5;0;100
0;11;"ilianis";11;0;100
0;864;"ilianna";864;0;100
0;5;"ilianne";5;0;100
0;5;"ilianny";5;0;100
0;77;"iliany";77;0;100
606;0;"ilias";606;100;0
0;40;"ilicia";40;0;100
0;5;"ilihia";5;0;100
121;0;"ilija";121;100;0
401;0;"ilijah";401;100;0
0;30;"ilima";30;0;100
0;110;"ilina";110;0;100
0;17;"ilinca";17;0;100
0;190;"iline";190;0;100
148;0;"ilir";148;100;0
5;0;"ilirian";5;100;0
0;5;"ilirida";5;0;100
0;175;"ilisa";175;0;100
0;49;"ilise";49;0;100
0;9;"ilish";9;0;100
0;97;"ilisha";97;0;100
0;249;"ilissa";249;0;100
0;5;"ilithia";5;0;100
0;7;"ilithya";7;0;100
0;56;"ilithyia";56;0;100
0;11;"ilitia";11;0;100
130;22;"iliya";152;85.5263157894737;14.4736842105263
5;0;"iliyaas";5;100;0
0;267;"iliyah";267;0;100
29;0;"iliyan";29;100;0
0;80;"iliyana";80;0;100
0;70;"iliza";70;0;100
0;246;"ilka";246;0;100
0;1672;"illa";1672;0;100
0;5;"illah";5;0;100
0;162;"illana";162;0;100
0;343;"illeana";343;0;100
0;22;"illeanna";22;0;100
0;368;"illene";368;0;100
0;5;"illia";5;0;100
42;0;"illiam";42;100;0
0;1455;"illiana";1455;0;100
0;298;"illianna";298;0;100
63;0;"illias";63;100;0
5;0;"illidan";5;100;0
11;0;"illijah";11;100;0
5;11;"illinois";16;31.25;68.75
0;5;"illissa";5;0;100
0;7;"illiyana";7;0;100
0;251;"illona";251;0;100
354;31;"illya";385;91.9480519480519;8.05194805194805
0;486;"illyana";486;0;100
0;159;"illyanna";159;0;100
5;0;"illyas";5;100;0
0;83;"illyria";83;0;100
0;20;"illyssa";20;0;100
0;5;"illythia";5;0;100
0;290;"ilma";290;0;100
0;5;"ilmi";5;0;100
24;624;"ilo";648;3.7037037037037;96.2962962962963
0;5;"ilomae";5;0;100
0;17;"ilomay";17;0;100
0;3096;"ilona";3096;0;100
0;6;"ilora";6;0;100
0;5;"ilori";5;0;100
0;763;"ilsa";763;0;100
0;2081;"ilse";2081;0;100
0;5;"ilsi";5;0;100
0;15;"ilsy";15;0;100
0;57;"ilva";57;0;100
0;10;"ilwad";10;0;100
0;539;"ily";539;0;100
645;99;"ilya";744;86.6935483870968;13.3064516129032
76;0;"ilyaas";76;100;0
13;0;"ilyan";13;100;0
0;828;"ilyana";828;0;100
0;275;"ilyanna";275;0;100
1018;0;"ilyas";1018;100;0
10;0;"ilyass";10;100;0
17;0;"ilyjah";17;100;0
0;56;"ilyn";56;0;100
0;6;"ilyne";6;0;100
0;52;"ilynn";52;0;100
0;18;"ilysa";18;0;100
0;372;"ilyse";372;0;100
0;736;"ilyssa";736;0;100
0;5;"ilythia";5;0;100
0;5;"ilyza";5;0;100
0;68;"ilze";68;0;100
0;6490;"ima";6490;0;100
162;0;"imaad";162;100;0
48;527;"imaan";575;8.34782608695652;91.6521739130435
0;10;"imaani";10;0;100
453;0;"imad";453;100;0
0;31;"imagean";31;0;100
0;33;"imagen";33;0;100
0;547;"imagene";547;0;100
0;50;"imagin";50;0;100
0;118;"imagine";118;0;100
0;38;"imahni";38;0;100
0;6;"imajae";6;0;100
0;160;"imajean";160;0;100
0;5;"imajen";5;0;100
0;5;"imal";5;0;100
0;23;"imala";23;0;100
0;5;"imalai";5;0;100
0;41;"imalay";41;0;100
19;0;"imam";19;100;0
5;0;"imamu";5;100;0
858;4256;"iman";5114;16.7774736018772;83.2225263981228
0;14;"imana";14;0;100
0;224;"imane";224;0;100
0;47;"imanee";47;0;100
1019;22468;"imani";23487;4.33857027291693;95.6614297270831
0;169;"imanie";169;0;100
0;92;"imanii";92;0;100
0;93;"imanni";93;0;100
1166;0;"imanol";1166;100;0
260;0;"imanuel";260;100;0
0;11;"imany";11;0;100
11;16;"imar";27;40.7407407407407;59.2592592592593
0;398;"imara";398;0;100
770;2170;"imari";2940;26.1904761904762;73.8095238095238
0;26;"imaria";26;0;100
39;0;"imarion";39;100;0
5;0;"imauri";5;100;0
0;112;"imaya";112;0;100
0;74;"imberly";74;0;100
0;8;"imee";8;0;100
0;7119;"imelda";7119;0;100
0;15;"imena";15;0;100
214;0;"imer";214;100;0
24;0;"imere";24;100;0
0;10;"imesha";10;0;100
38;0;"imhotep";38;100;0
0;5;"imia";5;0;100
113;0;"imir";113;100;0
0;5;"imira";5;0;100
0;11;"imisioluwa";11;0;100
0;6;"imiya";6;0;100
0;10;"imiyah";10;0;100
0;12;"immacolata";12;0;100
0;18;"immaculata";18;0;100
0;68;"immaculate";68;0;100
0;18;"immani";18;0;100
14;0;"immanol";14;100;0
4506;0;"immanuel";4506;100;0
11;0;"immer";11;100;0
0;5;"immogene";5;0;100
5;795;"imo";800;0.625;99.375
0;313;"imogean";313;0;100
0;1514;"imogen";1514;0;100
55;26915;"imogene";26970;0.203930292918057;99.7960697070819
0;5;"imogin";5;0;100
0;61;"imogine";61;0;100
0;435;"imojean";435;0;100
0;6;"imojene";6;0;100
35;16;"imon";51;68.6274509803922;31.3725490196078
0;459;"imoni";459;0;100
0;95;"imonie";95;0;100
15;0;"imothy";15;100;0
0;13;"imperia";13;0;100
0;40;"impi";40;0;100
153;0;"imraan";153;100;0
2626;0;"imran";2626;100;0
24;0;"imrane";24;100;0
117;0;"imre";117;100;0
47;14;"imri";61;77.0491803278689;22.9508196721311
15;0;"imron";15;100;0
30;0;"imtiaz";30;100;0
0;263;"imunique";263;0;100
0;66;"imya";66;0;100
0;5;"imyah";5;0;100
5;16;"in";21;23.8095238095238;76.1904761904762
65;29801;"ina";29866;0.217638786580058;99.7823612134199
0;60;"inaara";60;0;100
0;609;"inaaya";609;0;100
0;19;"inaayah";19;0;100
0;48;"inabelle";48;0;100
17;0;"inacio";17;100;0
0;11;"inah";11;0;100
173;0;"inaki";173;100;0
29;0;"inaky";29;100;0
0;35;"inamae";35;0;100
0;63;"inanna";63;0;100
0;1177;"inara";1177;0;100
0;11;"inarah";11;0;100
0;276;"inari";276;0;100
0;230;"inas";230;0;100
0;27;"inasia";27;0;100
0;5;"inass";5;0;100
0;1232;"inaya";1232;0;100
0;500;"inayah";500;0;100
0;10;"inayat";10;0;100
0;16;"inbal";16;0;100
0;20;"inbar";20;0;100
0;5;"inchara";5;0;100
0;6;"inci";6;0;100
0;464;"inda";464;0;100
136;0;"indalecio";136;100;0
0;5;"indasha";5;0;100
0;8;"indasia";8;0;100
0;77;"indea";77;0;100
0;29;"indee";29;0;100
0;16;"independence";16;0;100
22;0;"inderjit";22;100;0
7;0;"inderpreet";7;100;0
0;43;"indeya";43;0;100
0;5;"indhira";5;0;100
6;240;"indi";246;2.4390243902439;97.5609756097561
27;21473;"india";21500;0.125581395348837;99.8744186046512
0;176;"indiah";176;0;100
0;5;"indian";5;0;100
790;1101;"indiana";1891;41.776837652036;58.223162347964
0;43;"indianna";43;0;100
0;382;"indica";382;0;100
85;828;"indie";913;9.30996714129244;90.6900328587076
446;1793;"indigo";2239;19.9196069673962;80.0803930326038
0;33;"indika";33;0;100
105;0;"indio";105;100;0
0;2106;"indira";2106;0;100
0;282;"indiya";282;0;100
0;141;"indiyah";141;0;100
0;83;"indonesia";83;0;100
30;665;"indra";695;4.31654676258993;95.6834532374101
0;16;"indrani";16;0;100
0;50;"indria";50;0;100
0;6;"indsay";6;0;100
0;15;"indu";15;0;100
299;432;"indy";731;40.9028727770178;59.0971272229822
0;1396;"indya";1396;0;100
0;87;"indyah";87;0;100
0;60;"indyia";60;0;100
0;5;"ineda";5;0;100
0;16;"ineisha";16;0;100
0;13;"ineka";13;0;100
0;25;"ineke";25;0;100
0;5;"inelda";5;0;100
0;2147;"inell";2147;0;100
0;63;"inella";63;0;100
0;5;"inelle";5;0;100
399;5363;"ines";5762;6.92467893092676;93.0753210690732
0;5;"inesa";5;0;100
0;16;"inese";16;0;100
54;0;"inesh";54;100;0
0;112;"inesha";112;0;100
0;31;"ineshia";31;0;100
0;107;"iness";107;0;100
0;466;"inessa";466;0;100
0;130;"ineta";130;0;100
0;100;"inetha";100;0;100
0;5;"inett";5;0;100
0;371;"inetta";371;0;100
0;69;"inette";69;0;100
0;11;"ineva";11;0;100
0;5;"iney";5;0;100
944;62029;"inez";62973;1.49905515062011;98.5009448493799
0;5;"ineza";5;0;100
0;169;"ineze";169;0;100
4097;3771;"infant";7868;52.0716827656329;47.9283172343671
17;0;"infantboy";17;100;0
0;5;"infantfemale";5;0;100
0;11;"infantgirl";11;0;100
5;0;"infantmale";5;100;0
57;67;"infantof";124;45.9677419354839;54.0322580645161
5;0;"infboy";5;100;0
44;0;"infinite";44;100;0
0;368;"infiniti";368;0;100
5;679;"infinity";684;0.730994152046784;99.2690058479532
0;3348;"inga";3348;0;100
0;7;"ingar";7;0;100
0;711;"inge";711;0;100
0;724;"ingeborg";724;0;100
21;0;"ingemar";21;100;0
0;1307;"inger";1307;0;100
6;0;"ingmar";6;100;0
45;0;"ingo";45;100;0
17;0;"ingolf";17;100;0
0;71;"ingra";71;0;100
353;13;"ingram";366;96.448087431694;3.55191256830601
0;18;"ingred";18;0;100
0;128;"ingri";128;0;100
17;25508;"ingrid";25525;0.0666013712047013;99.9333986287953
0;10;"ingrida";10;0;100
0;240;"ingris";240;0;100
0;6;"ingrit";6;0;100
0;25;"ingry";25;0;100
69;0;"ingvald";69;100;0
0;13;"inia";13;0;100
0;144;"inice";144;0;100
94;0;"inigo";94;100;0
0;60;"inika";60;0;100
7;45;"iniki";52;13.4615384615385;86.5384615384615
0;5;"inikki";5;0;100
65;0;"iniko";65;100;0
64;105;"inioluwa";169;37.8698224852071;62.1301775147929
0;681;"inis";681;0;100
0;42;"inisha";42;0;100
0;199;"inita";199;0;100
0;270;"iniya";270;0;100
0;60;"iniyah";60;0;100
31;0;"iniyan";31;100;0
266;0;"inman";266;100;0
41;0;"inmar";41;100;0
63;0;"inmer";63;100;0
0;406;"inna";406;0;100
0;6;"innaya";6;0;100
0;6;"innessa";6;0;100
0;5;"innie";5;0;100
38;5;"innis";43;88.3720930232558;11.6279069767442
0;80;"innocence";80;0;100
22;0;"innocent";22;100;0
0;174;"inocencia";174;0;100
465;0;"inocencio";465;100;0
65;0;"inocente";65;100;0
29;0;"inoke";29;100;0
0;117;"inola";117;0;100
0;10;"inona";10;0;100
0;6;"inori";6;0;100
91;0;"inri";91;100;0
0;46;"insha";46;0;100
0;7;"inshirah";7;0;100
0;49;"insiya";49;0;100
0;23;"insiyah";23;0;100
0;6;"insley";6;0;100
0;18;"inta";18;0;100
30;0;"inti";30;100;0
0;62;"intisar";62;0;100
0;26;"inus";26;0;100
0;5;"inya";5;0;100
0;215;"inza";215;0;100
13;106;"io";119;10.9243697478992;89.0756302521009
93;5;"ioan";98;94.8979591836735;5.10204081632653
0;61;"ioana";61;0;100
86;0;"ioane";86;100;0
0;483;"ioanna";483;0;100
1133;0;"ioannis";1133;100;0
68;0;"iokepa";68;100;0
0;8878;"iola";8878;0;100
0;46;"iolana";46;0;100
0;63;"iolanda";63;0;100
0;82;"iolani";82;0;100
0;18;"iole";18;0;100
0;50;"iolene";50;0;100
0;5;"iolia";5;0;100
0;222;"ioma";222;0;100
218;0;"ion";218;100;0
5;11000;"iona";11005;0.0454338936846888;99.9545661063153
0;9140;"ione";9140;0;100
0;5;"ioni";5;0;100
0;267;"ionia";267;0;100
0;217;"ionna";217;0;100
74;0;"iori";74;100;0
5;0;"iory";5;100;0
53;0;"iosefa";53;100;0
5;0;"ioseph";5;100;0
16;0;"iosif";16;100;0
12;0;"iosua";12;100;0
0;6;"iota";6;0;100
0;5;"iovanna";5;0;100
0;54;"iowa";54;0;100
0;42;"ipek";42;0;100
5;0;"ipolito";5;100;0
0;5;"ipsa";5;0;100
35;0;"iqbal";35;100;0
0;15;"iqlas";15;0;100
0;937;"iqra";937;0;100
25;0;"iquan";25;100;0
48739;5209;"ira";53948;90.3444057240306;9.65559427596945
0;61;"iracema";61;0;100
5;0;"irael";5;100;0
21;15;"irah";36;58.3333333333333;41.6666666666667
0;525;"iraida";525;0;100
0;30;"iraima";30;0;100
0;560;"irais";560;0;100
0;16;"iraiz";16;0;100
0;16;"iraj";16;0;100
0;5;"iralene";5;0;100
0;11;"iralyn";11;0;100
0;5;"iralynn";5;0;100
684;102;"iram";786;87.0229007633588;12.9770992366412
1269;416;"iran";1685;75.3115727002967;24.6884272997033
0;5;"irandy";5;0;100
0;12;"irani";12;0;100
0;208;"irania";208;0;100
0;21;"irany";21;0;100
0;6;"iras";6;0;100
0;949;"irasema";949;0;100
0;34;"iratze";34;0;100
0;6;"irayda";6;0;100
0;16;"irazema";16;0;100
116;0;"irbin";116;100;0
1098;21;"irby";1119;98.1233243967828;1.87667560321716
48;0;"ire";48;100;0
0;5;"ireal";5;0;100
0;466;"irean";466;0;100
0;53;"ireana";53;0;100
0;92;"ireanna";92;0;100
0;15;"ireatha";15;0;100
6;0;"iredell";6;100;0
0;52;"iree";52;0;100
0;22;"ireen";22;0;100
0;97;"ireene";97;0;100
0;6;"ireion";6;0;100
0;7;"ireka";7;0;100
0;35;"irelan";35;0;100
188;4961;"ireland";5149;3.65119440668091;96.3488055933191
0;14;"irelia";14;0;100
0;7;"irely";7;0;100
0;1098;"irelyn";1098;0;100
0;163;"irelynd";163;0;100
0;1085;"irelynn";1085;0;100
0;33;"irelynne";33;0;100
0;78;"irem";78;0;100
33;18;"iremide";51;64.7058823529412;35.2941176470588
64;5;"iren";69;92.7536231884058;7.2463768115942
0;1802;"irena";1802;0;100
1288;333572;"irene";334860;0.384638356328018;99.615361643672
21;0;"ireneo";21;100;0
51;67;"ireoluwa";118;43.2203389830509;56.7796610169492
5;15;"ireon";20;25;75
0;10;"ireona";10;0;100
0;10;"ireonna";10;0;100
0;37;"ireri";37;0;100
0;53;"iresha";53;0;100
0;448;"ireta";448;0;100
0;359;"iretha";359;0;100
0;279;"iretta";279;0;100
6;0;"irey";6;100;0
0;6;"ireyanna";6;0;100
5;0;"irfaan";5;100;0
511;0;"irfan";511;100;0
0;23;"irha";23;0;100
0;9;"irhaa";9;0;100
0;5;"iri";5;0;100
10;49;"iria";59;16.9491525423729;83.0508474576271
0;15;"irian";15;0;100
0;493;"iriana";493;0;100
0;182;"irianna";182;0;100
21;0;"iric";21;100;0
0;91;"iridessa";91;0;100
7;581;"iridian";588;1.19047619047619;98.8095238095238
0;154;"iridiana";154;0;100
396;1482;"irie";1878;21.0862619808307;78.9137380191693
0;11;"irieana";11;0;100
0;5;"iriee";5;0;100
0;71;"iriel";71;0;100
0;38;"irielle";38;0;100
0;28;"irihanna";28;0;100
5;5;"irin";10;50;50
0;1411;"irina";1411;0;100
0;1496;"irine";1496;0;100
328;0;"irineo";328;100;0
0;58;"irini";58;0;100
654;77171;"iris";77825;0.840346932219724;99.1596530677803
0;158;"irisa";158;0;100
120;1393;"irish";1513;7.93126239259749;92.0687376074025
0;80;"irisha";80;0;100
0;48;"irissa";48;0;100
0;11;"iristine";11;0;100
0;5;"irit";5;0;100
0;25;"irita";25;0;100
0;5;"iriyana";5;0;100
0;11;"iriz";11;0;100
0;156;"irja";156;0;100
466;0;"irl";466;100;0
6;0;"irland";6;100;0
0;591;"irlanda";591;0;100
0;108;"irlene";108;0;100
0;5;"irline";5;0;100
252;70066;"irma";70318;0.358371967348332;99.6416280326517
0;12;"irmagene";12;0;100
0;6;"irmak";6;0;100
0;62;"irmalee";62;0;100
0;48;"irmalinda";48;0;100
0;7;"irmani";7;0;100
0;469;"irmgard";469;0;100
0;5;"irmina";5;0;100
5;0;"irmuun";5;100;0
0;25;"irna";25;0;100
36;0;"iroh";36;100;0
0;6;"iroha";6;0;100
13;0;"iron";13;100;0
0;21;"irona";21;0;100
0;24;"ironesha";24;0;100
0;27;"irsa";27;0;100
5;0;"irshad";5;100;0
0;45;"irulan";45;0;100
14;0;"irv";14;100;0
0;210;"irva";210;0;100
264;0;"irvan";264;100;0
1028;0;"irven";1028;100;0
37515;74;"irvin";37589;99.8031338955546;0.196866104445449
0;6;"irvina";6;0;100
871;5;"irvine";876;99.4292237442922;0.570776255707762
41841;85;"irving";41926;99.7972618422936;0.202738157706435
17;0;"irvyn";17;100;0
15328;12;"irwin";15340;99.9217731421121;0.0782268578878748
12;0;"irwing";12;100;0
15;0;"iry";15;100;0
0;16;"iryana";16;0;100
0;16;"iryanna";16;0;100
0;7;"iryna";7;0;100
0;90;"irys";90;0;100
0;5;"iryss";5;0;100
1706;2298;"isa";4004;42.6073926073926;57.3926073926074
0;5;"isaabella";5;0;100
261398;715;"isaac";262113;99.727216887373;0.272783112626997
114;0;"isaack";114;100;0
409;0;"isaah";409;100;0
3581;0;"isaak";3581;100;0
6;0;"isaam";6;100;0
6;0;"isaaq";6;100;0
0;369;"isabeau";369;0;100
1817;111909;"isabel";113726;1.59769973444947;98.4023002655505
0;9161;"isabela";9161;0;100
0;13;"isabelah";13;0;100
0;169;"isabele";169;0;100
0;5;"isabeli";5;0;100
0;24;"isabelita";24;0;100
5;13296;"isabell";13301;0.0375911585595068;99.9624088414405
356;303978;"isabella";304334;0.116976742657738;99.8830232573423
0;44;"isabellagrace";44;0;100
0;282;"isabellah";282;0;100
0;139;"isabellamarie";139;0;100
0;118;"isabellarose";118;0;100
0;5;"isabellasophia";5;0;100
20;84185;"isabelle";84205;0.0237515586960394;99.976248441304
0;5;"isabellemarie";5;0;100
0;10;"isabellia";10;0;100
0;60;"isabelly";60;0;100
16;0;"isabelo";16;100;0
0;5;"isabeth";5;0;100
0;5;"isabeya";5;0;100
0;5;"isable";5;0;100
2936;0;"isac";2936;100;0
1801;0;"isacc";1801;100;0
166;0;"isack";166;100;0
172;0;"isador";172;100;0
0;3100;"isadora";3100;0;100
5325;127;"isadore";5452;97.6705796038151;2.32942039618489
1794;0;"isael";1794;100;0
36;5;"isah";41;87.8048780487805;12.1951219512195
53;0;"isaha";53;100;0
0;5;"isahbella";5;0;100
145;0;"isahi";145;100;0
122;0;"isahia";122;100;0
5;0;"isahiah";5;100;0
16;0;"isahias";16;100;0
5662;27;"isai";5689;99.5253998945333;0.47460010546669
388;0;"isaia";388;100;0
199754;601;"isaiah";200355;99.7000324424147;0.299967557585286
13;0;"isaiaha";13;100;0
5;0;"isaiahmichael";5;100;0
126;0;"isaiahs";126;100;0
10;0;"isaian";10;100;0
12915;0;"isaias";12915;100;0
183;0;"isaic";183;100;0
103;0;"isaid";103;100;0
1418;0;"isaih";1418;100;0
623;0;"isaiha";623;100;0
6;0;"isaihas";6;100;0
11;0;"isain";11;100;0
56;0;"isair";56;100;0
0;11;"isaira";11;0;100
0;5;"isairis";5;0;100
178;0;"isais";178;100;0
86;0;"isaish";86;100;0
109;0;"isaiyah";109;100;0
5;0;"isajah";5;100;0
869;0;"isak";869;100;0
0;5;"isalei";5;0;100
0;5;"isalena";5;0;100
0;5;"isalia";5;0;100
0;134;"isaly";134;0;100
241;0;"isam";241;100;0
91;2122;"isamar";2213;4.11206507004067;95.8879349299593
0;27;"isamara";27;0;100
0;27;"isamari";27;0;100
0;16;"isamarie";16;0;100
0;34;"isamary";34;0;100
6;0;"isamel";6;100;0
136;0;"isami";136;100;0
556;0;"isamu";556;100;0
12;0;"isan";12;100;0
0;18;"isana";18;0;100
8;0;"isander";8;100;0
38;0;"isandro";38;100;0
246;0;"isao";246;100;0
5;0;"isaque";5;100;0
0;5;"isara";5;0;100
5;0;"isarael";5;100;0
15;0;"isarel";15;100;0
0;6;"isarely";6;0;100
0;41;"isata";41;0;100
0;273;"isatou";273;0;100
0;143;"isatu";143;0;100
10;0;"isau";10;100;0
152;0;"isaul";152;100;0
0;1399;"isaura";1399;0;100
335;0;"isauro";335;100;0
0;48;"isavel";48;0;100
0;11;"isavela";11;0;100
0;13;"isavella";13;0;100
84;0;"isay";84;100;0
47;0;"isaya";47;100;0
661;0;"isayah";661;100;0
0;5;"isayana";5;0;100
6;0;"isayiah";6;100;0
0;11;"isbel";11;0;100
0;15;"isbell";15;0;100
0;119;"isbella";119;0;100
7;0;"isco";7;100;0
148;0;"iseah";148;100;0
0;5;"isebell";5;0;100
0;92;"isebella";92;0;100
0;253;"isel";253;0;100
0;5071;"isela";5071;0;100
0;16;"iselda";16;0;100
0;10;"iselin";10;0;100
0;14;"iselis";14;0;100
0;164;"isella";164;0;100
0;34;"iselle";34;0;100
0;5;"iselys";5;0;100
29;0;"isen";29;100;0
0;18;"isenia";18;0;100
5;0;"iseral";5;100;0
0;5;"ises";5;0;100
0;5;"iseult";5;0;100
5;0;"ish";5;100;0
0;3711;"isha";3711;0;100
0;6;"ishaal";6;0;100
3085;0;"ishaan";3085;100;0
0;13;"ishaani";13;0;100
0;6;"ishaanvi";6;0;100
74;0;"ishaaq";74;100;0
0;10;"ishah";10;0;100
29;0;"ishak";29;100;0
490;0;"isham";490;100;0
22;0;"ishamel";22;100;0
1987;0;"ishan";1987;100;0
0;275;"ishana";275;0;100
0;6;"ishanae";6;0;100
0;763;"ishani";763;0;100
30;0;"ishant";30;100;0
32;0;"ishanth";32;100;0
0;12;"ishanti";12;0;100
0;207;"ishanvi";207;0;100
385;0;"ishaq";385;100;0
0;54;"ishara";54;0;100
5;0;"ishaun";5;100;0
33;0;"ishawn";33;100;0
6;0;"ishayu";6;100;0
0;5;"ishbel";5;0;100
0;26;"ishea";26;0;100
7;72;"ishi";79;8.86075949367089;91.1392405063291
0;147;"ishia";147;0;100
6;0;"ishiah";6;100;0
0;627;"ishika";627;0;100
0;475;"ishita";475;0;100
0;48;"ishitha";48;0;100
5579;0;"ishmael";5579;100;0
208;0;"ishmail";208;100;0
5;0;"ishmam";5;100;0
11;0;"ishman";11;100;0
294;0;"ishmeal";294;100;0
5;10;"ishmeet";15;33.3333333333333;66.6666666666667
291;0;"ishmel";291;100;0
19;0;"ishmil";19;100;0
0;6;"ishna";6;0;100
25;0;"ishraq";25;100;0
0;47;"ishrat";47;0;100
0;5;"ishta";5;0;100
0;10;"ishwaq";10;0;100
0;7;"ishwari";7;0;100
0;24;"ishya";24;0;100
5;39;"isia";44;11.3636363636364;88.6363636363636
60;0;"isiaah";60;100;0
195;0;"isiac";195;100;0
22823;11;"isiah";22834;99.9518262240519;0.0481737759481475
352;0;"isiaha";352;100;0
187;0;"isiaih";187;100;0
20;0;"isias";20;100;0
6;0;"isiash";6;100;0
0;14;"isibeal";14;0;100
0;6;"isibella";6;0;100
330;0;"isidor";330;100;0
0;436;"isidora";436;0;100
3093;0;"isidore";3093;100;0
1256;0;"isidoro";1256;100;0
0;602;"isidra";602;0;100
7493;0;"isidro";7493;100;0
28;0;"isileli";28;100;0
0;25;"isioma";25;0;100
12;10890;"isis";10902;0.110071546505228;99.8899284534948
0;39;"isiss";39;0;100
5;0;"iskandar";5;100;0
43;0;"iskander";43;100;0
0;15610;"isla";15610;0;100
5;61;"islah";66;7.57575757575758;92.4242424242424
519;128;"islam";647;80.2163833075734;19.7836166924266
6;238;"island";244;2.45901639344262;97.5409836065574
0;12;"islarose";12;0;100
0;92;"islay";92;0;100
0;18;"islee";18;0;100
181;618;"isley";799;22.6533166458073;77.3466833541927
0;15;"islynn";15;0;100
0;65;"isma";65;0;100
5;0;"ismaaeel";5;100;0
243;0;"ismaeel";243;100;0
34413;73;"ismael";34486;99.7883198979296;0.211680102070405
0;5;"ismaela";5;0;100
0;5;"ismah";5;0;100
0;102;"ismahan";102;0;100
2732;0;"ismail";2732;100;0
43;0;"ismaila";43;100;0
93;11;"ismar";104;89.4230769230769;10.5769230769231
0;48;"ismari";48;0;100
0;15;"ismary";15;0;100
0;5;"ismat";5;0;100
0;52;"ismay";52;0;100
85;0;"ismeal";85;100;0
11;0;"ismel";11;100;0
0;101;"ismelda";101;0;100
0;7;"ismene";7;0;100
0;49;"ismenia";49;0;100
0;235;"ismerai";235;0;100
0;15;"ismeralda";15;0;100
10;0;"ismet";10;100;0
0;2943;"isobel";2943;0;100
0;13;"isobell";13;0;100
0;193;"isobella";193;0;100
0;81;"isobelle";81;0;100
0;6;"isoke";6;0;100
0;5;"isoken";5;0;100
0;259;"isola";259;0;100
0;202;"isolde";202;0;100
0;48;"isolene";48;0;100
0;35;"isolina";35;0;100
1435;0;"isom";1435;100;0
95;0;"ison";95;100;0
5;879;"isra";884;0.565610859728507;99.4343891402715
0;435;"israa";435;0;100
0;5;"israe";5;0;100
57549;1131;"israel";58680;98.0725971370143;1.92740286298568
0;16;"israela";16;0;100
0;82;"israella";82;0;100
0;29;"israelle";29;0;100
0;18;"israh";18;0;100
0;7;"israt";7;0;100
7;0;"israyel";7;100;0
4188;58;"isreal";4246;98.6340084785681;1.36599152143194
5;0;"isriel";5;100;0
524;0;"isrrael";524;100;0
1474;388;"issa";1862;79.1621911922664;20.8378088077336
163;0;"issaac";163;100;0
0;26;"issabel";26;0;100
0;53;"issabela";53;0;100
0;16;"issabell";16;0;100
0;1286;"issabella";1286;0;100
0;190;"issabelle";190;0;100
20814;17;"issac";20831;99.9183908597763;0.0816091402237051
74;0;"issacc";74;100;0
66;0;"issachar";66;100;0
49;0;"issack";49;100;0
42;0;"issael";42;100;0
35;0;"issah";35;100;0
91;0;"issai";91;100;0
440;0;"issaiah";440;100;0
18;0;"issaias";18;100;0
78;0;"issaic";78;100;0
117;0;"issaih";117;100;0
417;0;"issak";417;100;0
143;0;"issam";143;100;0
0;48;"issamar";48;0;100
5;0;"issay";5;100;0
18;0;"isse";18;100;0
6;0;"issei";6;100;0
0;11;"issel";11;0;100
0;5;"issela";5;0;100
17;0;"issey";17;100;0
105;0;"issiac";105;100;0
1317;0;"issiah";1317;100;0
5;0;"issiaka";5;100;0
20;0;"issic";20;100;0
5;6;"issie";11;45.4545454545455;54.5454545454545
0;159;"issis";159;0;100
0;42;"issys";42;0;100
81;0;"istvan";81;100;0
0;304;"isys";304;0;100
0;583;"isyss";583;0;100
0;167;"iszabella";167;0;100
11;0;"iszac";11;100;0
16;0;"iszak";16;100;0
0;492;"ita";492;0;100
379;0;"itai";379;100;0
0;30;"italee";30;0;100
0;103;"itali";103;0;100
0;2334;"italia";2334;0;100
0;27;"italie";27;0;100
685;0;"italo";685;100;0
5;1114;"italy";1119;0.446827524575514;99.5531724754245
0;45;"italya";45;0;100
238;16;"itamar";254;93.7007874015748;6.2992125984252
5;0;"itan";5;100;0
0;5;"itasca";5;0;100
0;12;"itasha";12;0;100
0;10;"itaska";10;0;100
0;376;"itati";376;0;100
0;39;"itaty";39;0;100
121;0;"itay";121;100;0
0;10;"itayetzi";10;0;100
0;40;"itcel";40;0;100
0;134;"itha";134;0;100
0;5;"ithalia";5;0;100
116;0;"ithan";116;100;0
5;0;"ithel";5;100;0
51;0;"ithiel";51;100;0
0;150;"ithzel";150;0;100
0;5;"itia";5;0;100
0;8;"itiana";8;0;100
0;6;"itianna";6;0;100
40;0;"itiel";40;100;0
0;6;"itisha";6;0;100
0;5;"itohan";5;0;100
0;5;"itsamari";5;0;100
0;197;"itsel";197;0;100
0;5;"itsue";5;0;100
41;0;"itsuki";41;100;0
0;50;"itsuko";50;0;100
30;0;"itsuo";30;100;0
0;33;"itta";33;0;100
18;0;"ittai";18;100;0
0;115;"itxel";115;0;100
0;301;"itza";301;0;100
0;141;"itzabella";141;0;100
0;5;"itzabelle";5;0;100
309;67;"itzae";376;82.1808510638298;17.8191489361702
99;0;"itzael";99;100;0
0;118;"itzamar";118;0;100
0;113;"itzamara";113;0;100
0;5;"itzamaray";5;0;100
0;20;"itzanami";20;0;100
0;5;"itzany";5;0;100
0;5;"itzary";5;0;100
0;1964;"itzayana";1964;0;100
0;28;"itzayani";28;0;100
0;74;"itzayanna";74;0;100
6;0;"itzcoatl";6;100;0
101;15336;"itzel";15437;0.65427220314828;99.3457277968517
0;26;"itzela";26;0;100
0;257;"itzell";257;0;100
0;79;"itzelle";79;0;100
0;6;"itzelt";6;0;100
0;10;"itzely";10;0;100
35;0;"itzhak";35;100;0
0;19;"itzhel";19;0;100
0;338;"itzia";338;0;100
6;0;"itziar";6;100;0
0;25;"itzuri";25;0;100
0;11;"itzury";11;0;100
0;106;"itzy";106;0;100
0;58;"iula";58;0;100
0;8;"iuma";8;0;100
519;31176;"iva";31695;1.63748225272125;98.3625177472788
140;0;"ivaan";140;100;0
0;26;"ivadean";26;0;100
0;7;"ivadel";7;0;100
0;349;"ivadell";349;0;100
0;24;"ivadelle";24;0;100
0;18;"ivagene";18;0;100
0;580;"ivah";580;0;100
292;127;"ival";419;69.6897374701671;30.3102625298329
0;344;"ivalee";344;0;100
0;119;"ivalene";119;0;100
0;8;"ivaline";8;0;100
0;47;"ivalou";47;0;100
126417;639;"ivan";127056;99.4970721571591;0.502927842840952
0;6107;"ivana";6107;0;100
0;5;"ivanah";5;0;100
5;0;"ivandejesus";5;100;0
0;27;"ivane";27;0;100
0;103;"ivanell";103;0;100
0;44;"ivanelle";44;0;100
15;0;"ivanhoe";15;100;0
0;11;"ivani";11;0;100
0;497;"ivania";497;0;100
5;0;"ivaniel";5;100;0
0;518;"ivanka";518;0;100
158;0;"ivann";158;100;0
0;5489;"ivanna";5489;0;100
0;65;"ivannah";65;0;100
0;61;"ivannia";61;0;100
5;0;"ivano";5;100;0
0;5;"ivany";5;0;100
0;6;"ivanya";6;0;100
592;0;"ivar";592;100;0
28;0;"ivars";28;100;0
0;5;"ivary";5;0;100
0;6;"ivaya";6;0;100
9;33;"ive";42;21.4285714285714;78.5714285714286
0;262;"ivee";262;0;100
15;16;"ivel";31;48.3870967741936;51.6129032258064
0;8;"ivelin";8;0;100
0;168;"ivelis";168;0;100
0;135;"ivelise";135;0;100
0;1553;"ivelisse";1553;0;100
0;147;"iveliz";147;0;100
0;5;"ivell";5;0;100
0;15;"ivelyn";15;0;100
989;0;"iven";989;100;0
0;10;"ivena";10;0;100
1080;92;"iver";1172;92.1501706484642;7.84982935153584
0;14;"ivera";14;0;100
0;70;"iverna";70;0;100
1193;13;"iverson";1206;98.9220563847429;1.07794361525705
796;370;"ivery";1166;68.2675814751287;31.7324185248714
42;0;"ives";42;100;0
0;233;"ivet";233;0;100
0;596;"iveth";596;0;100
0;650;"ivett";650;0;100
0;5;"ivetta";5;0;100
10;10435;"ivette";10445;0.0957395883197702;99.9042604116802
1693;3060;"ivey";4753;35.6196086682096;64.3803913317904
0;60;"ivi";60;0;100
0;17;"ivia";17;0;100
0;5;"ivian";5;0;100
0;168;"iviana";168;0;100
0;131;"ivianna";131;0;100
0;5;"iviannah";5;0;100
11;0;"ivica";11;100;0
82;1573;"ivie";1655;4.95468277945619;95.0453172205438
447;0;"ivin";447;100;0
16;0;"ivion";16;100;0
0;90;"iviona";90;0;100
0;58;"ivionna";58;0;100
87;306;"ivis";393;22.1374045801527;77.8625954198473
5;0;"ivison";5;100;0
710;5;"ivo";715;99.3006993006993;0.699300699300699
6;0;"ivol";6;100;0
0;6;"ivola";6;0;100
535;1139;"ivon";1674;31.9593787335723;68.0406212664277
0;46;"ivona";46;0;100
0;421;"ivone";421;0;100
0;7;"ivonn";7;0;100
0;151;"ivonna";151;0;100
14;5845;"ivonne";5859;0.2389486260454;99.7610513739546
768;46;"ivor";814;94.3488943488943;5.65110565110565
0;85;"ivoree";85;0;100
0;348;"ivori";348;0;100
0;282;"ivorie";282;0;100
8092;9148;"ivory";17240;46.9373549883991;53.0626450116009
0;5;"ivoryana";5;0;100
0;7;"ivoryanna";7;0;100
0;7;"ivoryrose";7;0;100
0;5;"ivra";5;0;100
0;17;"ivree";17;0;100
5;0;"ivri";5;100;0
5;62;"ivry";67;7.46268656716418;92.5373134328358
3098;43024;"ivy";46122;6.71696804128182;93.2830319587182
0;266;"ivyana";266;0;100
0;5;"ivyann";5;0;100
0;353;"ivyanna";353;0;100
0;12;"ivyanne";12;0;100
0;5;"ivye";5;0;100
5;0;"ivyl";5;100;0
0;42;"ivylynn";42;0;100
0;6;"ivymarie";6;0;100
15;0;"ivyn";15;100;0
18;0;"ivyon";18;100;0
0;35;"ivyona";35;0;100
0;309;"ivyonna";309;0;100
0;59;"ivyrose";59;0;100
0;14;"ivyunna";14;0;100
0;101;"iwalani";101;0;100
5;0;"iwan";5;100;0
0;40;"iwana";40;0;100
177;0;"iwao";177;100;0
0;33;"iwona";33;0;100
0;6;"ixareli";6;0;100
0;27;"ixayana";27;0;100
0;20;"ixcel";20;0;100
0;747;"ixchel";747;0;100
0;12;"ixchell";12;0;100
0;86;"ixel";86;0;100
0;5;"ixsel";5;0;100
0;10;"ixtzel";10;0;100
0;13;"ixzel";13;0;100
0;254;"iya";254;0;100
16;0;"iyaad";16;100;0
145;0;"iyad";145;100;0
0;79;"iyah";79;0;100
0;153;"iyahna";153;0;100
0;5;"iyali";5;0;100
227;0;"iyan";227;100;0
0;4545;"iyana";4545;0;100
0;489;"iyanah";489;0;100
0;156;"iyani";156;0;100
0;124;"iyania";124;0;100
0;244;"iyanla";244;0;100
0;4333;"iyanna";4333;0;100
0;391;"iyannah";391;0;100
0;69;"iyanni";69;0;100
6;38;"iyanuoluwa";44;13.6363636363636;86.3636363636364
6;134;"iyari";140;4.28571428571429;95.7142857142857
0;6;"iyasia";6;0;100
0;75;"iyauna";75;0;100
0;5;"iyaunna";5;0;100
0;5;"iycess";5;0;100
0;5;"iyeisha";5;0;100
0;269;"iyesha";269;0;100
0;15;"iyeshia";15;0;100
0;6;"iyhana";6;0;100
0;21;"iyiana";21;0;100
0;5;"iyinoluwa";5;0;100
0;9;"iyisha";9;0;100
0;816;"iyla";816;0;100
0;109;"iylah";109;0;100
0;5;"iylan";5;0;100
0;25;"iylee";25;0;100
0;6;"iyleen";6;0;100
0;7;"iymona";7;0;100
38;0;"iyon";38;100;0
0;450;"iyona";450;0;100
0;16;"iyonah";16;0;100
0;7;"iyone";7;0;100
0;5;"iyoni";5;0;100
0;32;"iyonia";32;0;100
0;1561;"iyonna";1561;0;100
0;65;"iyonnah";65;0;100
0;5;"iyonnie";5;0;100
0;92;"iysha";92;0;100
0;5;"iyshia";5;0;100
0;279;"iysis";279;0;100
0;5;"iysiss";5;0;100
0;11;"iyssis";11;0;100
0;7;"iyuna";7;0;100
0;26;"iyunna";26;0;100
0;267;"iza";267;0;100
2283;0;"izaac";2283;100;0
23;0;"izaack";23;100;0
78;0;"izaah";78;100;0
2388;0;"izaak";2388;100;0
183;0;"izaan";183;100;0
0;3014;"izabel";3014;0;100
0;1394;"izabela";1394;0;100
0;13;"izabelah";13;0;100
0;7;"izabele";7;0;100
0;1100;"izabell";1100;0;100
0;23220;"izabella";23220;0;100
0;288;"izabellah";288;0;100
0;3617;"izabelle";3617;0;100
679;0;"izac";679;100;0
109;0;"izacc";109;100;0
53;0;"izach";53;100;0
362;0;"izack";362;100;0
0;146;"izadora";146;0;100
42;0;"izaeah";42;100;0
6;0;"izaeh";6;100;0
354;0;"izael";354;100;0
5;0;"izah";5;100;0
67;0;"izaha";67;100;0
0;10;"izahbella";10;0;100
22;0;"izahia";22;100;0
47;0;"izai";47;100;0
89;0;"izaia";89;100;0
10259;5;"izaiah";10264;99.9512860483242;0.0487139516757599
114;0;"izaias";114;100;0
6;0;"izaic";6;100;0
154;0;"izaih";154;100;0
272;0;"izaiha";272;100;0
39;0;"izair";39;100;0
25;0;"izais";25;100;0
18;0;"izaiya";18;100;0
192;0;"izaiyah";192;100;0
1561;0;"izak";1561;100;0
0;12;"izalea";12;0;100
7;530;"izamar";537;1.30353817504655;98.6964618249534
0;5;"izamara";5;0;100
0;31;"izamary";31;0;100
312;0;"izan";312;100;0
0;16;"izara";16;0;100
0;34;"izaria";34;0;100
0;33;"izariah";33;0;100
0;7;"izarra";7;0;100
0;15;"izavella";15;0;100
15;0;"izavier";15;100;0
7;0;"izavion";7;100;0
896;0;"izaya";896;100;0
3171;0;"izayah";3171;100;0
17;0;"izayha";17;100;0
226;0;"izayiah";226;100;0
5;0;"izayuh";5;100;0
66;0;"izea";66;100;0
286;0;"izeah";286;100;0
5;0;"izeal";5;100;0
76;0;"izear";76;100;0
0;45;"izebella";45;0;100
16;0;"izeck";16;100;0
44;0;"izeiah";44;100;0
376;0;"izek";376;100;0
60;0;"izekiel";60;100;0
257;996;"izel";1253;20.5107741420591;79.4892258579409
0;104;"izela";104;0;100
0;5;"izelia";5;0;100
665;17;"izell";682;97.5073313782991;2.49266862170088
0;387;"izella";387;0;100
0;50;"izellah";50;0;100
0;37;"izelle";37;0;100
73;0;"izen";73;100;0
0;10;"izena";10;0;100
0;1493;"izetta";1493;0;100
213;0;"izeyah";213;100;0
0;7;"izhane";7;0;100
40;0;"izhar";40;100;0
1114;0;"iziah";1114;100;0
24;0;"iziaha";24;100;0
0;33;"izibella";33;0;100
170;0;"izic";170;100;0
223;0;"izick";223;100;0
0;5;"izidora";5;0;100
570;0;"izik";570;100;0
0;41;"izma";41;0;100
140;0;"izmael";140;100;0
0;23;"izna";23;0;100
0;10;"izobel";10;0;100
0;1091;"izola";1091;0;100
0;53;"izona";53;0;100
0;903;"izora";903;0;100
5;0;"izra";5;100;0
671;0;"izrael";671;100;0
214;0;"izreal";214;100;0
5;0;"izriel";5;100;0
0;57;"izsabella";57;0;100
61;0;"izsak";61;100;0
20;0;"izuchukwu";20;100;0
0;64;"izumi";64;0;100
10;0;"izyaan";10;100;0
5;0;"izyah";5;100;0
102;0;"izyan";102;100;0
0;13;"izybella";13;0;100
7;0;"izyck";7;100;0
83;0;"izyk";83;100;0
0;63;"izza";63;0;100
0;34;"izzabel";34;0;100
0;7;"izzabela";7;0;100
0;138;"izzabell";138;0;100
0;1817;"izzabella";1817;0;100
0;11;"izzabellah";11;0;100
0;336;"izzabelle";336;0;100
175;0;"izzac";175;100;0
5;0;"izzack";5;100;0
0;81;"izzah";81;0;100
10;0;"izzaiah";10;100;0
118;0;"izzak";118;100;0
11;0;"izzat";11;100;0
0;28;"izzi";28;0;100
33;0;"izziah";33;100;0
0;25;"izzibella";25;0;100
0;134;"izzie";134;0;100
5;0;"izzik";5;100;0
175;391;"izzy";566;30.9187279151943;69.0812720848057
0;11;"izzybella";11;0;100
264;136;"ja";400;66;34
5;0;"jaabir";5;100;0
20;0;"jaad";20;100;0
0;5;"jaada";5;0;100
0;5;"jaade";5;0;100
33;0;"jaaden";33;100;0
55;0;"jaafar";55;100;0
0;356;"jaala";356;0;100
0;42;"jaalah";42;0;100
34;0;"jaalen";34;100;0
6;0;"jaali";6;100;0
0;290;"jaaliyah";290;0;100
6;5;"jaalyn";11;54.5454545454545;45.4545454545455
81;0;"jaamal";81;100;0
110;0;"jaan";110;100;0
0;65;"jaana";65;0;100
0;106;"jaanai";106;0;100
0;17;"jaanna";17;0;100
0;113;"jaanvi";113;0;100
307;0;"jaaron";307;100;0
0;113;"jaasia";113;0;100
411;0;"jaasiel";411;100;0
14;0;"jaasir";14;100;0
22;0;"jaason";22;100;0
0;19;"jaasritha";19;0;100
5;0;"jaavon";5;100;0
5;15;"jaazaniah";20;25;75
161;6;"jaaziah";167;96.4071856287425;3.59281437125748
330;5;"jaaziel";335;98.5074626865672;1.49253731343284
5;0;"jab";5;100;0
15;0;"jabaar";15;100;0
9;0;"jabahri";9;100;0
16;0;"jabali";16;100;0
420;0;"jabar";420;100;0
15;0;"jabare";15;100;0
124;0;"jabaree";124;100;0
7716;0;"jabari";7716;100;0
229;0;"jabarie";229;100;0
9;0;"jabarion";9;100;0
34;0;"jabaris";34;100;0
7;0;"jabarius";7;100;0
11;0;"jabarr";11;100;0
264;0;"jabarri";264;100;0
5;0;"jabarrie";5;100;0
11;0;"jabary";11;100;0
5;0;"jabbaar";5;100;0
697;0;"jabbar";697;100;0
27;0;"jabdiel";27;100;0
237;0;"jabe";237;100;0
10;0;"jabel";10;100;0
69;0;"jaben";69;100;0
80;0;"jaber";80;100;0
141;0;"jabes";141;100;0
957;0;"jabez";957;100;0
10;0;"jabian";10;100;0
8;0;"jabien";8;100;0
336;0;"jabier";336;100;0
551;0;"jabin";551;100;0
0;7;"jabina";7;0;100
257;0;"jabir";257;100;0
11;0;"jabo";11;100;0
0;15;"jaboa";15;0;100
11;0;"jabob";11;100;0
6;0;"jabon";6;100;0
0;5;"jabora";5;0;100
12;0;"jaboree";12;100;0
170;0;"jabori";170;100;0
11;0;"jaborie";11;100;0
28;0;"jaboris";28;100;0
5;0;"jabrae";5;100;0
12;0;"jabrail";12;100;0
5;0;"jabrandon";5;100;0
6;0;"jabraun";6;100;0
0;6;"jabrayah";6;0;100
5;0;"jabrayden";5;100;0
31;0;"jabraylen";31;100;0
8;0;"jabraylin";8;100;0
42;0;"jabraylon";42;100;0
126;10;"jabre";136;92.6470588235294;7.35294117647059
0;288;"jabrea";288;0;100
305;70;"jabree";375;81.3333333333333;18.6666666666667
94;0;"jabreel";94;100;0
0;9;"jabreena";9;0;100
0;31;"jabreia";31;0;100
5;0;"jabrel";5;100;0
35;0;"jabrell";35;100;0
10;0;"jabreon";10;100;0
0;5;"jabreya";5;0;100
191;16;"jabri";207;92.2705314009662;7.72946859903382
0;993;"jabria";993;0;100
0;33;"jabriah";33;0;100
23;0;"jabrian";23;100;0
806;0;"jabriel";806;100;0
0;11;"jabrielle";11;0;100
16;0;"jabrien";16;100;0
1282;0;"jabril";1282;100;0
16;0;"jabrill";16;100;0
0;13;"jabrina";13;0;100
11;0;"jabrion";11;100;0
0;10;"jabriya";10;0;100
0;13;"jabriyah";13;0;100
146;0;"jabron";146;100;0
18;0;"jabryan";18;100;0
28;0;"jabulani";28;100;0
5;0;"jabus";5;100;0
514;0;"jac";514;100;0
10;0;"jacab";10;100;0
69;0;"jacaden";69;100;0
84;0;"jacai";84;100;0
22;0;"jacaiden";22;100;0
32;0;"jacaleb";32;100;0
0;5173;"jacalyn";5173;0;100
0;100;"jacalynn";100;0;100
27;0;"jacameron";27;100;0
15;0;"jacan";15;100;0
0;412;"jacara";412;0;100
0;5;"jacaranda";5;0;100
6;0;"jacare";6;100;0
21;0;"jacaree";21;100;0
6;0;"jacarey";6;100;0
1694;74;"jacari";1768;95.814479638009;4.18552036199095
0;79;"jacaria";79;0;100
64;0;"jacarie";64;100;0
6;0;"jacarii";6;100;0
42;0;"jacarion";42;100;0
34;0;"jacarious";34;100;0
101;0;"jacarius";101;100;0
0;5;"jacarla";5;0;100
5;0;"jacarr";5;100;0
0;95;"jacarra";95;0;100
341;0;"jacarri";341;100;0
0;5;"jacarria";5;0;100
13;0;"jacarter";13;100;0
21;0;"jacary";21;100;0
5;0;"jacaryous";5;100;0
5;0;"jacauri";5;100;0
5;0;"jacaury";5;100;0
5;0;"jacavion";5;100;0
51;0;"jacayden";51;100;0
0;97;"jacayla";97;0;100
5;0;"jacbo";5;100;0
11;0;"jaccari";11;100;0
0;242;"jacci";242;0;100
597;0;"jaccob";597;100;0
57873;658;"jace";58531;98.8758094001469;1.12419059985307
35;1445;"jacee";1480;2.36486486486486;97.6351351351351
203;0;"jaceion";203;100;0
458;0;"jacek";458;100;0
0;24;"jacelin";24;0;100
0;5;"jaceline";5;0;100
0;6;"jacella";6;0;100
0;38;"jacelle";38;0;100
0;5;"jacely";5;0;100
0;2525;"jacelyn";2525;0;100
0;659;"jacelynn";659;0;100
1954;0;"jacen";1954;100;0
0;10;"jacenda";10;0;100
0;5;"jacenia";5;0;100
12;0;"jacent";12;100;0
0;44;"jacenta";44;0;100
619;0;"jaceon";619;100;0
55;0;"jacere";55;100;0
13;0;"jaceson";13;100;0
6;0;"jacetin";6;100;0
15;0;"jaceton";15;100;0
430;7179;"jacey";7609;5.65120252332764;94.3487974766724
302;0;"jaceyon";302;100;0
0;6;"jacgueline";6;0;100
279;10;"jachai";289;96.5397923875433;3.46020761245675
0;6;"jache";6;0;100
0;120;"jachelle";120;0;100
393;0;"jachin";393;100;0
146;0;"jachob";146;100;0
0;4538;"jaci";4538;0;100
0;98;"jacia";98;0;100
0;5;"jaciah";5;0;100
49;0;"jacian";49;100;0
0;33;"jaciana";33;0;100
0;18;"jacianna";18;0;100
5;3711;"jacie";3716;0.134553283100108;99.8654467168999
604;5;"jaciel";609;99.1789819376026;0.821018062397373
30;0;"jacieon";30;100;0
60;0;"jacier";60;100;0
0;381;"jacilyn";381;0;100
0;5;"jacilynn";5;0;100
19;0;"jacin";19;100;0
0;16;"jacina";16;0;100
0;4114;"jacinda";4114;0;100
0;5;"jacine";5;0;100
0;3234;"jacinta";3234;0;100
11;12;"jacinth";23;47.8260869565217;52.1739130434783
0;33;"jacintha";33;0;100
2698;0;"jacinto";2698;100;0
259;0;"jacion";259;100;0
5;0;"jacione";5;100;0
0;8;"jacionna";8;0;100
12;0;"jacir";12;100;0
0;5;"jaciya";5;0;100
0;16;"jaciyah";16;0;100
5;0;"jaciyon";5;100;0
669278;2608;"jack";671886;99.611838913149;0.388161086851043
0;5;"jackalin";5;0;100
0;39;"jackaline";39;0;100
0;586;"jackalyn";586;0;100
0;116;"jackalynn";116;0;100
5;0;"jacke";5;100;0
0;322;"jackee";322;0;100
0;1326;"jackelin";1326;0;100
0;6093;"jackeline";6093;0;100
0;22;"jackelinne";22;0;100
0;3735;"jackelyn";3735;0;100
0;414;"jackelyne";414;0;100
0;121;"jackelynn";121;0;100
683;38;"jackey";721;94.7295423023578;5.27045769764216
41;0;"jackhenry";41;100;0
5;3514;"jacki";3519;0.14208581983518;99.8579141801648
0;6;"jackia";6;0;100
78331;90510;"jackie";168841;46.3933523255607;53.6066476744393
0;15;"jackielyn";15;0;100
0;306;"jackilyn";306;0;100
0;16;"jackilynn";16;0;100
20;0;"jackjohn";20;100;0
0;48;"jackleen";48;0;100
0;5;"jacklen";5;0;100
0;33;"jacklene";33;0;100
0;890;"jacklin";890;0;100
0;338;"jackline";338;0;100
0;11;"jacklon";11;0;100
5;16275;"jacklyn";16280;0.0307125307125307;99.9692874692875
0;108;"jacklyne";108;0;100
0;2069;"jacklynn";2069;0;100
0;33;"jacklynne";33;0;100
45;0;"jackman";45;100;0
110;0;"jackob";110;100;0
0;154;"jackolyn";154;0;100
0;37;"jackquelin";37;0;100
0;1375;"jackqueline";1375;0;100
0;259;"jackquelyn";259;0;100
0;11;"jackqulin";11;0;100
0;571;"jackquline";571;0;100
0;81;"jackqulyn";81;0;100
39;0;"jacks";39;100;0
481;0;"jacksen";481;100;0
10;0;"jacksin";10;100;0
217789;581;"jackson";218370;99.7339378119705;0.266062188029491
89;0;"jackston";89;100;0
178;46;"jacksyn";224;79.4642857142857;20.5357142857143
6;0;"jackthomas";6;100;0
0;5;"jackueline";5;0;100
6424;1133;"jacky";7557;85.0072780203785;14.9927219796215
0;197;"jackye";197;0;100
0;30;"jacleen";30;0;100
0;89;"jaclene";89;0;100
0;153;"jaclin";153;0;100
103;48679;"jaclyn";48782;0.211143454552909;99.7888565454471
0;151;"jaclyne";151;0;100
0;2619;"jaclynn";2619;0;100
0;149;"jaclynne";149;0;100
35;0;"jaco";35;100;0
900016;2227;"jacob";902243;99.7531707089997;0.246829291000318
0;286;"jacoba";286;0;100
14;0;"jacobalexander";14;100;0
31;0;"jacobanthony";31;100;0
245;0;"jacobb";245;100;0
5;0;"jacobdaniel";5;100;0
1188;0;"jacobe";1188;100;0
59;0;"jacobee";59;100;0
158;0;"jacobey";158;100;0
3240;289;"jacobi";3529;91.8107112496458;8.18928875035421
5;10;"jacobia";15;33.3333333333333;66.6666666666667
15;0;"jacobian";15;100;0
798;22;"jacobie";820;97.3170731707317;2.68292682926829
5;0;"jacobjames";5;100;0
6;0;"jacoblee";6;100;0
5;0;"jacobmatthew";5;100;0
2695;0;"jacobo";2695;100;0
6;0;"jacobrobert";6;100;0
5;0;"jacobryan";5;100;0
69;0;"jacobs";69;100;0
29;0;"jacobson";29;100;0
5;0;"jacobthomas";5;100;0
111;0;"jacobus";111;100;0
9215;114;"jacoby";9329;98.7780040733198;1.22199592668024
5;0;"jacodi";5;100;0
75;0;"jacody";75;100;0
27;0;"jacolbi";27;100;0
1391;15;"jacolby";1406;98.9331436699858;1.06685633001422
5;127;"jacole";132;3.78787878787879;96.2121212121212
0;381;"jacolyn";381;0;100
90;0;"jacon";90;100;0
13;0;"jacop";13;100;0
11;0;"jacopo";11;100;0
0;112;"jacora";112;0;100
5;0;"jacore";5;100;0
5;0;"jacoree";5;100;0
1986;0;"jacorey";1986;100;0
850;12;"jacori";862;98.6078886310905;1.39211136890951
0;145;"jacoria";145;0;100
428;0;"jacorian";428;100;0
141;0;"jacorie";141;100;0
21;0;"jacorien";21;100;0
108;0;"jacorion";108;100;0
10;0;"jacorious";10;100;0
38;0;"jacorius";38;100;0
22;0;"jacorri";22;100;0
19;0;"jacorrian";19;100;0
5;0;"jacorrion";5;100;0
1150;0;"jacory";1150;100;0
5;0;"jacoub";5;100;0
6;0;"jacoury";6;100;0
6;0;"jacovian";6;100;0
13;0;"jacoy";13;100;0
0;132;"jacoya";132;0;100
0;99;"jacqeline";99;0;100
0;5;"jacqelyn";5;0;100
0;10;"jacqlene";10;0;100
0;39;"jacqline";39;0;100
0;760;"jacqlyn";760;0;100
0;49;"jacqlynn";49;0;100
0;33;"jacqua";33;0;100
5;0;"jacqual";5;100;0
0;82;"jacqualin";82;0;100
0;2381;"jacqualine";2381;0;100
0;1053;"jacqualyn";1053;0;100
0;5;"jacqualyne";5;0;100
0;71;"jacqualynn";71;0;100
440;0;"jacquan";440;100;0
0;31;"jacquana";31;0;100
5;0;"jacquane";5;100;0
0;5;"jacquanna";5;0;100
5;0;"jacquari";5;100;0
8;0;"jacquarius";8;100;0
17;13;"jacquay";30;56.6666666666667;43.3333333333333
2334;4889;"jacque";7223;32.3134431676589;67.6865568323411
0;5;"jacquece";5;0;100
0;6;"jacquee";6;0;100
37;0;"jacquees";37;100;0
163;363;"jacquel";526;30.9885931558935;69.0114068441065
0;67;"jacqueleen";67;0;100
0;8;"jacquelen";8;0;100
0;1302;"jacquelene";1302;0;100
0;157;"jacqueli";157;0;100
0;9547;"jacquelin";9547;0;100
0;368;"jacquelina";368;0;100
1386;419667;"jacqueline";421053;0.329174711972127;99.6708252880279
0;5;"jacqueling";5;0;100
0;68;"jacquelinne";68;0;100
16;15;"jacquell";31;51.6129032258064;48.3870967741936
0;34;"jacquella";34;0;100
0;7;"jacquelle";7;0;100
0;17;"jacquelline";17;0;100
0;50;"jacquely";50;0;100
110;84158;"jacquelyn";84268;0.130535909241942;99.8694640907581
0;3167;"jacquelyne";3167;0;100
0;4977;"jacquelynn";4977;0;100
0;868;"jacquelynne";868;0;100
0;47;"jacquenette";47;0;100
9117;242;"jacques";9359;97.414253659579;2.58574634042099
97;149;"jacquese";246;39.4308943089431;60.5691056910569
0;12;"jacquesha";12;0;100
0;1705;"jacquetta";1705;0;100
0;158;"jacquette";158;0;100
1597;0;"jacquez";1597;100;0
5;0;"jacqueze";5;100;0
13;871;"jacqui";884;1.47058823529412;98.5294117647059
0;33;"jacquia";33;0;100
0;1525;"jacquie";1525;0;100
5;0;"jacquil";5;100;0
0;710;"jacquiline";710;0;100
0;10;"jacquilla";10;0;100
11;0;"jacquille";11;100;0
0;342;"jacquilyn";342;0;100
0;19;"jacquilynn";19;0;100
31;15;"jacquin";46;67.3913043478261;32.6086956521739
77;10;"jacquis";87;88.5057471264368;11.4942528735632
73;47;"jacquise";120;60.8333333333333;39.1666666666667
0;22;"jacquisha";22;0;100
0;414;"jacquita";414;0;100
0;11;"jacquitta";11;0;100
0;6;"jacquleen";6;0;100
0;134;"jacqulene";134;0;100
0;650;"jacqulin";650;0;100
0;6;"jacqulina";6;0;100
0;8022;"jacquline";8022;0;100
0;3958;"jacqulyn";3958;0;100
0;174;"jacqulyne";174;0;100
0;329;"jacqulynn";329;0;100
0;6;"jacquoline";6;0;100
0;12;"jacquolyn";12;0;100
21;0;"jacquon";21;100;0
33;0;"jacsen";33;100;0
187;0;"jacson";187;100;0
184;0;"jacub";184;100;0
0;27;"jacueline";27;0;100
0;94;"jaculin";94;0;100
0;5;"jaculine";5;0;100
695;3216;"jacy";3911;17.7703912042956;82.2296087957044
10;0;"jacyeon";10;100;0
6;0;"jacyion";6;100;0
0;173;"jacyln";173;0;100
0;11;"jacylyn";11;0;100
23;23;"jacyn";46;50;50
0;149;"jacynda";149;0;100
0;5;"jacynth";5;0;100
0;5;"jacynthia";5;0;100
30;0;"jacyon";30;100;0
0;5;"jacyra";5;0;100
2130;0;"jad";2130;100;0
242;63165;"jada";63407;0.381661330767896;99.6183386692321
22;0;"jadaan";22;100;0
0;167;"jadae";167;0;100
0;1752;"jadah";1752;0;100
0;19;"jadai";19;0;100
0;5;"jadaiah";5;0;100
0;5;"jadaija";5;0;100
0;31;"jadaisha";31;0;100
31;0;"jadakis";31;100;0
88;13;"jadakiss";101;87.1287128712871;12.8712871287129
0;133;"jadalee";133;0;100
0;5;"jadali";5;0;100
0;10;"jadalin";10;0;100
0;47;"jadalise";47;0;100
0;26;"jadaliz";26;0;100
0;585;"jadalyn";585;0;100
0;577;"jadalynn";577;0;100
0;6;"jadalys";6;0;100
0;16;"jadalyse";16;0;100
0;107;"jadamarie";107;0;100
1121;343;"jadan";1464;76.5710382513661;23.4289617486339
0;6;"jadaria";6;0;100
256;0;"jadarian";256;100;0
52;0;"jadarien";52;100;0
95;0;"jadarion";95;100;0
136;0;"jadarious";136;100;0
1339;0;"jadarius";1339;100;0
0;5;"jadarose";5;0;100
21;0;"jadarrian";21;100;0
5;0;"jadarrien";5;100;0
51;0;"jadarrion";51;100;0
5;0;"jadarrious";5;100;0
332;0;"jadarrius";332;100;0
0;13;"jadasha";13;0;100
0;82;"jadasia";82;0;100
20;0;"jadaveon";20;100;0
18;0;"jadavian";18;100;0
72;0;"jadavion";72;100;0
0;145;"jadaya";145;0;100
0;28;"jadayah";28;0;100
65;0;"jadd";65;100;0
0;99;"jadda";99;0;100
5;0;"jaddan";5;100;0
306;28;"jadden";334;91.6167664670659;8.38323353293413
6;0;"jaddiel";6;100;0
5354;78049;"jade";83403;6.41943335371629;93.5805666462837
0;344;"jadea";344;0;100
0;11;"jadeah";11;0;100
5;15;"jadean";20;25;75
0;17;"jadeann";17;0;100
0;19;"jaded";19;0;100
0;298;"jadee";298;0;100
5;15;"jadeen";20;25;75
23;0;"jadein";23;100;0
27;0;"jadel";27;100;0
0;80;"jadelin";80;0;100
0;42;"jadeline";42;0;100
23;0;"jadell";23;100;0
0;1753;"jadelyn";1753;0;100
0;968;"jadelynn";968;0;100
0;11;"jadelynne";11;0;100
0;28;"jademarie";28;0;100
71000;13264;"jaden";84264;84.2589955378335;15.7410044621665
30;161;"jadence";191;15.7068062827225;84.2931937172775
0;70;"jadene";70;0;100
35;5;"jadenn";40;87.5;12.5
0;6;"jadenne";6;0;100
49;0;"jadeon";49;100;0
89;0;"jader";89;100;0
5;0;"jadereon";5;100;0
10;0;"jaderian";10;100;0
18;0;"jaderion";18;100;0
5;0;"jaderious";5;100;0
11;0;"jaderius";11;100;0
12;0;"jaderrick";12;100;0
0;5;"jadesha";5;0;100
0;64;"jadesola";64;0;100
0;5;"jadeth";5;0;100
43;0;"jadeveon";43;100;0
0;58;"jadey";58;0;100
43;656;"jadeyn";699;6.1516452074392;93.8483547925608
0;5;"jadha";5;0;100
10;0;"jadhiel";10;100;0
0;177;"jadi";177;0;100
0;277;"jadia";277;0;100
38;26;"jadiah";64;59.375;40.625
0;5;"jadiamond";5;0;100
126;16;"jadian";142;88.7323943661972;11.2676056338028
0;5;"jadiana";5;0;100
61;706;"jadie";767;7.95306388526727;92.0469361147327
3200;0;"jadiel";3200;100;0
0;5;"jadielys";5;0;100
209;31;"jadien";240;87.0833333333333;12.9166666666667
68;0;"jadier";68;100;0
1472;643;"jadin";2115;69.5981087470449;30.4018912529551
0;287;"jadine";287;0;100
35;0;"jadir";35;100;0
0;463;"jadira";463;0;100
142;131;"jadis";273;52.014652014652;47.985347985348
6;0;"jadison";6;100;0
10;0;"jadiss";10;100;0
6;0;"jadius";6;100;0
0;10;"jadiyah";10;0;100
0;55;"jadlyn";55;0;100
0;5;"jadlynn";5;0;100
7;0;"jadn";7;100;0
9358;168;"jadon";9526;98.2364056267059;1.76359437329414
0;10;"jadonna";10;0;100
5;0;"jadonte";5;100;0
0;31;"jadora";31;0;100
60;571;"jadore";631;9.50871632329635;90.4912836767036
496;50;"jadrian";546;90.8424908424908;9.15750915750916
149;0;"jadriel";149;100;0
341;5;"jadrien";346;98.5549132947977;1.44508670520231
27;0;"jadus";27;100;0
0;85;"jadwiga";85;0;100
5;198;"jady";203;2.46305418719212;97.5369458128079
21;0;"jadyel";21;100;0
15;0;"jadyen";15;100;0
3305;11407;"jadyn";14712;22.4646547036433;77.5353452963567
0;5;"jadynce";5;0;100
22;26;"jadyne";48;45.8333333333333;54.1666666666667
34;535;"jadynn";569;5.97539543057996;94.02460456942
0;10;"jadynne";10;0;100
0;489;"jadzia";489;0;100
0;5;"jadziah";5;0;100
1379;1074;"jae";2453;56.2168772931105;43.7831227068895
0;11;"jaea";11;0;100
0;39;"jaeana";39;0;100
0;61;"jaeanna";61;0;100
85;0;"jaece";85;100;0
0;13;"jaecee";13;0;100
5;0;"jaeceion";5;100;0
133;0;"jaeceon";133;100;0
0;17;"jaeci";17;0;100
0;5;"jaecia";5;0;100
80;0;"jaecion";80;100;0
126;0;"jaecob";126;100;0
14;0;"jaecyon";14;100;0
0;2449;"jaeda";2449;0;100
0;141;"jaedah";141;0;100
0;5;"jaedalyn";5;0;100
465;83;"jaedan";548;84.8540145985401;15.1459854014599
0;5;"jaede";5;0;100
4692;871;"jaeden";5563;84.3429804062556;15.6570195937444
416;122;"jaedin";538;77.3234200743494;22.6765799256506
2057;33;"jaedon";2090;98.4210526315789;1.57894736842105
1849;2444;"jaedyn";4293;43.0701141392965;56.9298858607035
16;144;"jaedynn";160;10;90
99;0;"jaegar";99;100;0
640;0;"jaeger";640;100;0
54;0;"jaekob";54;100;0
154;0;"jaekwon";154;100;0
2126;3240;"jael";5366;39.6198285501305;60.3801714498695
0;2343;"jaela";2343;0;100
0;717;"jaelah";717;0;100
238;39;"jaelan";277;85.9205776173285;14.0794223826715
0;116;"jaelani";116;0;100
0;5;"jaelanie";5;0;100
0;5;"jaelea";5;0;100
0;62;"jaeleah";62;0;100
0;346;"jaelee";346;0;100
0;226;"jaeleen";226;0;100
0;5;"jaelei";5;0;100
0;240;"jaeleigh";240;0;100
1237;217;"jaelen";1454;85.0756533700138;14.9243466299862
0;408;"jaelene";408;0;100
0;59;"jaeley";59;0;100
0;197;"jaeli";197;0;100
0;6;"jaelia";6;0;100
0;5;"jaeliah";5;0;100
0;175;"jaeliana";175;0;100
0;5;"jaeliani";5;0;100
0;33;"jaelianna";33;0;100
0;92;"jaelie";92;0;100
1161;865;"jaelin";2026;57.3050345508391;42.6949654491609
0;10;"jaelina";10;0;100
0;69;"jaeline";69;0;100
0;15;"jaelinn";15;0;100
0;5;"jaelithe";5;0;100
0;6;"jaeliyah";6;0;100
5;0;"jaell";5;100;0
0;69;"jaella";69;0;100
0;413;"jaelle";413;0;100
639;0;"jaelon";639;100;0
0;126;"jaely";126;0;100
1101;12080;"jaelyn";13181;8.3529322509673;91.6470677490327
0;158;"jaelyne";158;0;100
102;7193;"jaelynn";7295;1.39821795750514;98.6017820424949
0;341;"jaelynne";341;0;100
0;6;"jaelys";6;0;100
0;61;"jaemarie";61;0;100
5;0;"jaemeson";5;100;0
0;41;"jaemi";41;0;100
0;10;"jaemie";10;0;100
40;0;"jaemin";40;100;0
5;0;"jaemir";5;100;0
22;0;"jaemon";22;100;0
47;0;"jaems";47;100;0
34;0;"jaen";34;100;0
0;116;"jaena";116;0;100
0;6;"jaenelle";6;0;100
52;0;"jaeon";52;100;0
0;6;"jaeona";6;0;100
0;53;"jaeonna";53;0;100
232;0;"jaequan";232;100;0
12;0;"jaeron";12;100;0
5;0;"jaes";5;100;0
0;6;"jaesa";6;0;100
129;0;"jaesean";129;100;0
0;46;"jaesha";46;0;100
99;0;"jaeshaun";99;100;0
148;0;"jaeshawn";148;100;0
32;0;"jaeshon";32;100;0
528;0;"jaeson";528;100;0
16;0;"jaesun";16;100;0
9;0;"jaesyn";9;100;0
37;0;"jaethan";37;100;0
28;0;"jaetyn";28;100;0
5;0;"jaevaughn";5;100;0
73;0;"jaeven";73;100;0
99;0;"jaeveon";99;100;0
100;0;"jaevian";100;100;0
11;0;"jaevien";11;100;0
5;0;"jaevier";5;100;0
123;0;"jaevin";123;100;0
340;0;"jaevion";340;100;0
459;0;"jaevon";459;100;0
51;0;"jaevyn";51;100;0
47;0;"jaewon";47;100;0
5;0;"jaewoo";5;100;0
0;23;"jaeya";23;0;100
0;18;"jaeyla";18;0;100
5;0;"jaeyon";5;100;0
532;0;"jafar";532;100;0
164;0;"jafari";164;100;0
5;0;"jafer";5;100;0
1065;0;"jafet";1065;100;0
165;0;"jafeth";165;100;0
31;0;"jaffar";31;100;0
41;0;"jaffer";41;100;0
26;0;"jaffet";26;100;0
14;0;"jafus";14;100;0
101;0;"jag";101;100;0
25;0;"jagan";25;100;0
67;0;"jagar";67;100;0
44;0;"jagdeep";44;100;0
21;0;"jagen";21;100;0
496;0;"jager";496;100;0
219;0;"jaggar";219;100;0
5282;83;"jagger";5365;98.452935694315;1.547064305685
5;0;"jaggyr";5;100;0
21;0;"jagjit";21;100;0
6;0;"jagjot";6;100;0
10;0;"jagmeet";10;100;0
67;0;"jago";67;100;0
25;0;"jagr";25;100;0
6;0;"jagroop";6;100;0
51;0;"jaguar";51;100;0
40;0;"jagur";40;100;0
191;0;"jah";191;100;0
195;0;"jahaad";195;100;0
95;5;"jahaan";100;95;5
379;0;"jahad";379;100;0
11;0;"jahai";11;100;0
0;28;"jahaida";28;0;100
21;0;"jahair";21;100;0
0;1419;"jahaira";1419;0;100
34;0;"jahaire";34;100;0
0;5;"jahairy";5;0;100
0;5;"jahala";5;0;100
531;31;"jahan";562;94.4839857651246;5.51601423487545
0;10;"jahana";10;0;100
0;10;"jahanara";10;0;100
0;171;"jahanna";171;0;100
5;178;"jahara";183;2.73224043715847;97.2677595628415
5;0;"jahare";5;100;0
5;0;"jaharee";5;100;0
1148;126;"jahari";1274;90.1098901098901;9.89010989010989
20;0;"jaharie";20;100;0
15;0;"jaharri";15;100;0
0;28;"jahasia";28;0;100
5;0;"jahaud";5;100;0
52;0;"jahaun";52;100;0
16;0;"jahaven";16;100;0
0;255;"jahayra";255;0;100
20;0;"jahaziah";20;100;0
1003;0;"jahaziel";1003;100;0
119;0;"jahbari";119;100;0
23;0;"jahcari";23;100;0
44;0;"jahcere";44;100;0
6;0;"jahcure";6;100;0
0;28;"jahda";28;0;100
0;10;"jahdae";10;0;100
48;96;"jahdai";144;33.3333333333333;66.6666666666667
5;0;"jahdari";5;100;0
0;10;"jahde";10;0;100
108;0;"jahden";108;100;0
383;0;"jahdiel";383;100;0
5;0;"jahdir";5;100;0
6;0;"jahdon";6;100;0
10;0;"jaheam";10;100;0
29;0;"jaheed";29;100;0
1024;0;"jaheem";1024;100;0
5;0;"jaheen";5;100;0
5;0;"jaheer";5;100;0
3525;5;"jaheim";3530;99.8583569405099;0.141643059490085
41;0;"jaheir";41;100;0
144;5;"jahel";149;96.6442953020134;3.35570469798658
33;0;"jahem";33;100;0
60;0;"jahfari";60;100;0
716;0;"jahi";716;100;0
0;22;"jahia";22;0;100
151;0;"jahid";151;100;0
0;51;"jahida";51;0;100
5;0;"jahidi";5;100;0
6;0;"jahiel";6;100;0
1366;0;"jahiem";1366;100;0
31;0;"jahier";31;100;0
12;0;"jahim";12;100;0
5;0;"jahime";5;100;0
5;0;"jahin";5;100;0
1899;0;"jahir";1899;100;0
0;340;"jahira";340;0;100
0;18;"jahirah";18;0;100
19;0;"jahiro";19;100;0
0;29;"jahiya";29;0;100
0;18;"jahiyah";18;0;100
7;0;"jahjuan";7;100;0
282;0;"jahkai";282;100;0
174;0;"jahkari";174;100;0
0;30;"jahkayla";30;0;100
222;0;"jahkeem";222;100;0
10;0;"jahkeim";10;100;0
15;0;"jahkel";15;100;0
11;0;"jahkhi";11;100;0
312;0;"jahki";312;100;0
0;10;"jahkia";10;0;100
11;0;"jahkim";11;100;0
44;0;"jahking";44;100;0
5;0;"jahkir";5;100;0
0;13;"jahkira";13;0;100
10;0;"jahkobe";10;100;0
5;0;"jahkobi";5;100;0
40;0;"jahkye";40;100;0
0;53;"jahla";53;0;100
188;11;"jahlani";199;94.4723618090452;5.52763819095477
0;41;"jahlaya";41;0;100
0;12;"jahlayah";12;0;100
0;31;"jahlea";31;0;100
0;83;"jahleah";83;0;100
5;0;"jahleal";5;100;0
5;0;"jahlee";5;100;0
976;0;"jahleel";976;100;0
8;0;"jahleil";8;100;0
92;0;"jahlen";92;100;0
0;7;"jahleya";7;0;100
0;200;"jahlia";200;0;100
0;5;"jahliah";5;0;100
38;0;"jahliel";38;100;0
15;0;"jahlik";15;100;0
1784;0;"jahlil";1784;100;0
25;0;"jahlin";25;100;0
5;0;"jahlique";5;100;0
0;65;"jahlisa";65;0;100
0;6;"jahlissa";6;0;100
0;25;"jahliya";25;0;100
0;151;"jahliyah";151;0;100
115;0;"jahlon";115;100;0
10;0;"jahlyn";10;100;0
0;5;"jahlynn";5;0;100
15;0;"jahmaad";15;100;0
16;0;"jahmaal";16;100;0
116;0;"jahmad";116;100;0
251;0;"jahmai";251;100;0
11;0;"jahmaine";11;100;0
37;0;"jahmair";37;100;0
1167;0;"jahmal";1167;100;0
25;0;"jahmali";25;100;0
5;0;"jahmall";5;100;0
108;0;"jahmani";108;100;0
487;0;"jahmar";487;100;0
14;0;"jahmarcus";14;100;0
5;0;"jahmaree";5;100;0
874;0;"jahmari";874;100;0
93;0;"jahmarion";93;100;0
32;0;"jahmarley";32;100;0
16;0;"jahmauri";16;100;0
0;23;"jahmaya";23;0;100
65;0;"jahmeek";65;100;0
16;0;"jahmeel";16;100;0
170;0;"jahmeer";170;100;0
242;0;"jahmeir";242;100;0
588;0;"jahmel";588;100;0
0;5;"jahmela";5;0;100
0;5;"jahmelia";5;0;100
8;0;"jahmell";8;100;0
526;0;"jahmere";526;100;0
61;0;"jahmez";61;100;0
30;0;"jahmi";30;100;0
0;110;"jahmia";110;0;100
11;35;"jahmiah";46;23.9130434782609;76.0869565217391
5;0;"jahmiel";5;100;0
233;0;"jahmier";233;100;0
53;0;"jahmiere";53;100;0
230;0;"jahmil";230;100;0
0;31;"jahmila";31;0;100
1781;0;"jahmir";1781;100;0
0;5;"jahmira";5;0;100
99;0;"jahmire";99;100;0
0;89;"jahmiya";89;0;100
0;63;"jahmiyah";63;0;100
36;0;"jahmon";36;100;0
0;220;"jahmya";220;0;100
0;15;"jahmyah";15;0;100
0;5;"jahmyia";5;0;100
349;0;"jahn";349;100;0
0;409;"jahna";409;0;100
0;410;"jahnae";410;0;100
11;103;"jahnai";114;9.64912280701754;90.3508771929825
5;19;"jahnari";24;20.8333333333333;79.1666666666667
0;85;"jahnasia";85;0;100
7;0;"jahnathan";7;100;0
0;362;"jahnavi";362;0;100
0;179;"jahnay";179;0;100
0;115;"jahnaya";115;0;100
0;97;"jahne";97;0;100
0;46;"jahnea";46;0;100
0;56;"jahnee";56;0;100
5;0;"jahneil";5;100;0
0;12;"jahnel";12;0;100
0;24;"jahnell";24;0;100
0;27;"jahnelle";27;0;100
0;101;"jahnessa";101;0;100
85;121;"jahni";206;41.2621359223301;58.7378640776699
0;244;"jahnia";244;0;100
0;93;"jahniah";93;0;100
0;28;"jahnice";28;0;100
0;23;"jahniece";23;0;100
7;0;"jahniel";7;100;0
0;13;"jahnique";13;0;100
0;6;"jahnise";6;0;100
0;486;"jahniya";486;0;100
0;263;"jahniyah";263;0;100
0;25;"jahnna";25;0;100
0;36;"jahnvi";36;0;100
0;232;"jahnya";232;0;100
0;49;"jahnyah";49;0;100
0;11;"jahnyia";11;0;100
0;67;"jahnyla";67;0;100
41;0;"jahod";41;100;0
126;0;"jahon";126;100;0
15;0;"jahongir";15;100;0
0;7;"jahonna";7;0;100
285;0;"jahquan";285;100;0
5;0;"jahque";5;100;0
29;0;"jahquel";29;100;0
11;0;"jahquell";11;100;0
136;0;"jahquez";136;100;0
5;0;"jahray";5;100;0
131;0;"jahred";131;100;0
71;0;"jahree";71;100;0
74;0;"jahrel";74;100;0
178;0;"jahrell";178;100;0
60;0;"jahri";60;100;0
0;5;"jahria";5;0;100
0;8;"jahriah";8;0;100
16;0;"jahriel";16;100;0
17;0;"jahrod";17;100;0
151;0;"jahron";151;100;0
48;0;"jahsai";48;100;0
17;0;"jahsan";17;100;0
43;0;"jahsean";43;100;0
5;0;"jahseem";5;100;0
5;0;"jahseer";5;100;0
5;0;"jahseim";5;100;0
6;0;"jahseir";6;100;0
10;0;"jahshaun";10;100;0
54;0;"jahshawn";54;100;0
114;0;"jahshua";114;100;0
26;0;"jahsi";26;100;0
536;0;"jahsiah";536;100;0
25;0;"jahsier";25;100;0
17;0;"jahsim";17;100;0
440;0;"jahsir";440;100;0
11;0;"jahsire";11;100;0
5;0;"jahsiyah";5;100;0
265;0;"jahson";265;100;0
18;0;"jahsun";18;100;0
7;0;"jahtavious";7;100;0
7;0;"jahvari";7;100;0
6;0;"jahvaughn";6;100;0
6;0;"jahvel";6;100;0
92;0;"jahvier";92;100;0
40;0;"jahvion";40;100;0
548;0;"jahvon";548;100;0
5;0;"jahvonte";5;100;0
5;0;"jahwan";5;100;0
0;25;"jahya";25;0;100
0;5;"jahyda";5;0;100
16;0;"jahyden";16;100;0
5;0;"jahyr";5;100;0
0;81;"jahyra";81;0;100
5;0;"jahzair";5;100;0
0;1220;"jahzara";1220;0;100
0;24;"jahzarah";24;0;100
0;5;"jahzari";5;0;100
0;91;"jahzaria";91;0;100
0;52;"jahzarra";52;0;100
142;47;"jahzeel";189;75.1322751322751;24.8677248677249
5;58;"jahzel";63;7.93650793650794;92.0634920634921
0;10;"jahzell";10;0;100
0;21;"jahzelle";21;0;100
156;17;"jahziah";173;90.1734104046243;9.82658959537572
325;15;"jahziel";340;95.5882352941177;4.41176470588235
83;0;"jahzier";83;100;0
57;0;"jahzion";57;100;0
130;0;"jahzir";130;100;0
0;8;"jahziya";8;0;100
0;18;"jahziyah";18;0;100
0;5;"jahzlynn";5;0;100
5;0;"jahzon";5;100;0
3773;1045;"jai";4818;78.310502283105;21.689497716895
0;600;"jaia";600;0;100
0;127;"jaiah";127;0;100
0;300;"jaiana";300;0;100
0;234;"jaianna";234;0;100
0;30;"jaiannah";30;0;100
474;102;"jaice";576;82.2916666666667;17.7083333333333
0;603;"jaicee";603;0;100
11;0;"jaiceion";11;100;0
5;0;"jaicen";5;100;0
354;0;"jaiceon";354;100;0
0;96;"jaicey";96;0;100
11;0;"jaiceyon";11;100;0
0;21;"jaici";21;0;100
0;17;"jaicie";17;0;100
57;0;"jaicion";57;100;0
7;0;"jaico";7;100;0
141;0;"jaicob";141;100;0
17;0;"jaicyon";17;100;0
5;168;"jaid";173;2.89017341040462;97.1098265895954
0;8463;"jaida";8463;0;100
0;834;"jaidah";834;0;100
0;64;"jaidalyn";64;0;100
0;24;"jaidalynn";24;0;100
905;572;"jaidan";1477;61.2728503723764;38.7271496276236
7;0;"jaidden";7;100;0
0;1274;"jaide";1274;0;100
0;55;"jaidee";55;0;100
66;0;"jaideep";66;100;0
5;0;"jaidel";5;100;0
0;12;"jaidelyn";12;0;100
26305;7931;"jaiden";34236;76.8343264400047;23.1656735599953
12;76;"jaidence";88;13.6363636363636;86.3636363636364
11;0;"jaidenn";11;100;0
116;0;"jaidev";116;100;0
0;5;"jaidi";5;0;100
291;189;"jaidin";480;60.625;39.375
0;16;"jaidlyn";16;0;100
5;0;"jaidn";5;100;0
1271;65;"jaidon";1336;95.1347305389222;4.86526946107784
0;177;"jaidy";177;0;100
2764;5334;"jaidyn";8098;34.1318844159052;65.8681155840948
36;261;"jaidynn";297;12.1212121212121;87.8787878787879
5;29;"jaie";34;14.7058823529412;85.2941176470588
65;52;"jaiel";117;55.5555555555556;44.4444444444444
0;69;"jaielle";69;0;100
14;0;"jaier";14;100;0
5;0;"jaiheem";5;100;0
8;0;"jaiheim";8;100;0
6;0;"jaiiden";6;100;0
16;0;"jaijuan";16;100;0
6;0;"jaik";6;100;0
77;0;"jaikob";77;100;0
5;0;"jaikub";5;100;0
0;2259;"jaila";2259;0;100
0;973;"jailah";973;0;100
148;32;"jailan";180;82.2222222222222;17.7777777777778
0;94;"jailani";94;0;100
0;18;"jaileah";18;0;100
0;460;"jailee";460;0;100
0;869;"jaileen";869;0;100
0;12;"jaileene";12;0;100
0;11;"jailei";11;0;100
0;71;"jaileigh";71;0;100
1207;289;"jailen";1496;80.6818181818182;19.3181818181818
0;2849;"jailene";2849;0;100
0;44;"jailenne";44;0;100
0;241;"jailey";241;0;100
0;38;"jaili";38;0;100
0;42;"jailia";42;0;100
207;299;"jailin";506;40.9090909090909;59.0909090909091
0;385;"jailine";385;0;100
0;6;"jailinne";6;0;100
0;6;"jailiyah";6;0;100
263;0;"jailon";263;100;0
0;43;"jaily";43;0;100
656;4145;"jailyn";4801;13.6638200374922;86.3361799625078
0;295;"jailyne";295;0;100
44;1869;"jailynn";1913;2.30005227391532;97.6999477260847
0;100;"jailynne";100;0;100
0;204;"jaima";204;0;100
5;0;"jaimal";5;100;0
5;0;"jaiman";5;100;0
21;0;"jaimar";21;100;0
5;0;"jaimari";5;100;0
0;91;"jaimarie";91;0;100
10;0;"jaimarion";10;100;0
0;9;"jaimaya";9;0;100
66978;49612;"jaime";116590;57.4474654773137;42.5525345226863
43;4426;"jaimee";4469;0.962183933765943;99.0378160662341
0;20;"jaimelee";20;0;100
0;38;"jaimelyn";38;0;100
0;27;"jaimelynn";27;0;100
177;0;"jaimen";177;100;0
77;0;"jaimere";77;100;0
148;0;"jaimes";148;100;0
241;16;"jaimeson";257;93.7743190661479;6.22568093385214
25;120;"jaimey";145;17.2413793103448;82.7586206896552
0;1142;"jaimi";1142;0;100
899;9447;"jaimie";10346;8.68934854049874;91.3106514595013
0;6;"jaimielee";6;0;100
130;0;"jaimin";130;100;0
50;0;"jaimir";50;100;0
15;5;"jaimison";20;75;25
0;7;"jaimmie";7;0;100
78;0;"jaimon";78;100;0
29;381;"jaimy";410;7.07317073170732;92.9268292682927
0;67;"jaimya";67;0;100
6;0;"jaimyn";6;100;0
11;0;"jaimz";11;100;0
0;5;"jain";5;0;100
0;1616;"jaina";1616;0;100
0;30;"jainaba";30;0;100
0;5;"jainah";5;0;100
0;252;"jaine";252;0;100
0;5;"jainee";5;0;100
0;18;"jaini";18;0;100
0;5;"jainie";5;0;100
35;0;"jainil";35;100;0
0;10;"jainiya";10;0;100
0;5;"jainiyah";5;0;100
0;5;"jainy";5;0;100
256;0;"jaion";256;100;0
0;118;"jaiona";118;0;100
0;259;"jaionna";259;0;100
403;0;"jaiquan";403;100;0
5;0;"jaiquez";5;100;0
5430;11;"jair";5441;99.7978312810145;0.202168718985481
0;476;"jaira";476;0;100
0;17;"jairah";17;0;100
17;0;"jairdan";17;100;0
13;0;"jairden";13;100;0
354;35;"jaire";389;91.0025706940874;8.9974293059126
55;0;"jaired";55;100;0
6;0;"jairee";6;100;0
158;0;"jairen";158;100;0
55;0;"jairius";55;100;0
9335;0;"jairo";9335;100;0
368;0;"jairon";368;100;0
2262;0;"jairus";2262;100;0
0;61;"jairy";61;0;100
59;0;"jais";59;100;0
0;230;"jaisa";230;0;100
6;0;"jaisal";6;100;0
188;16;"jaise";204;92.156862745098;7.84313725490196
164;0;"jaisean";164;100;0
228;0;"jaisen";228;100;0
10;0;"jaiseon";10;100;0
0;235;"jaisha";235;0;100
164;0;"jaishaun";164;100;0
177;0;"jaishawn";177;100;0
168;0;"jaishon";168;100;0
14;0;"jaisiah";14;100;0
0;18;"jaisley";18;0;100
0;61;"jaislyn";61;0;100
1552;0;"jaison";1552;100;0
0;6;"jaisy";6;0;100
5;5;"jaisyn";10;50;50
42;0;"jaithan";42;100;0
5;0;"jaithen";5;100;0
5;0;"jaiton";5;100;0
5;0;"jaival";5;100;0
46;0;"jaivan";46;100;0
128;0;"jaiveer";128;100;0
372;0;"jaiven";372;100;0
233;0;"jaiveon";233;100;0
21;0;"jaiver";21;100;0
73;0;"jaivian";73;100;0
24;0;"jaivien";24;100;0
30;0;"jaivin";30;100;0
366;0;"jaivion";366;100;0
628;0;"jaivon";628;100;0
148;0;"jaivyn";148;100;0
9;0;"jaivyon";9;100;0
6;0;"jaiwan";6;100;0
0;524;"jaiya";524;0;100
0;170;"jaiyah";170;0;100
0;353;"jaiyana";353;0;100
0;59;"jaiyanna";59;0;100
5;0;"jaiyce";5;100;0
0;37;"jaiyda";37;0;100
150;5;"jaiyden";155;96.7741935483871;3.2258064516129
0;114;"jaiyla";114;0;100
0;23;"jaiylah";23;0;100
49;0;"jaiyon";49;100;0
0;17;"jaiza";17;0;100
24;0;"jaizen";24;100;0
80;0;"jaizon";80;100;0
109;0;"jaja";109;100;0
0;205;"jajaira";205;0;100
22;0;"jajaun";22;100;0
2297;11;"jajuan";2308;99.5233968804159;0.476603119584055
0;23;"jajuana";23;0;100
5;0;"jajuane";5;100;0
315;0;"jak";315;100;0
6;0;"jakab";6;100;0
0;5;"jakada";5;0;100
202;0;"jakaden";202;100;0
0;17;"jakaela";17;0;100
10;0;"jakahri";10;100;0
1561;158;"jakai";1719;90.8086096567772;9.1913903432228
0;44;"jakaia";44;0;100
159;0;"jakaiden";159;100;0
0;209;"jakaila";209;0;100
0;41;"jakailah";41;0;100
0;31;"jakailyn";31;0;100
0;28;"jakaira";28;0;100
0;151;"jakaiya";151;0;100
0;32;"jakaiyah";32;0;100
0;258;"jakala";258;0;100
0;5;"jakalah";5;0;100
17;0;"jakale";17;100;0
61;0;"jakaleb";61;100;0
12;0;"jakalen";12;100;0
0;6;"jakalia";6;0;100
0;39;"jakalya";39;0;100
0;61;"jakalyn";61;0;100
0;5;"jakalynn";5;0;100
5;0;"jakameron";5;100;0
6;0;"jakanye";6;100;0
54;0;"jakar";54;100;0
0;453;"jakara";453;0;100
0;6;"jakarah";6;0;100
10;0;"jakare";10;100;0
91;0;"jakaree";91;100;0
2491;194;"jakari";2685;92.7746741154562;7.22532588454376
0;184;"jakaria";184;0;100
112;0;"jakarie";112;100;0
8;0;"jakarii";8;100;0
37;0;"jakarion";37;100;0
5;0;"jakarious";5;100;0
5;0;"jakaris";5;100;0
80;0;"jakarius";80;100;0
0;47;"jakarra";47;0;100
290;0;"jakarri";290;100;0
0;5;"jakashia";5;0;100
0;6;"jakasia";6;0;100
6;0;"jakauri";6;100;0
11;0;"jakavian";11;100;0
90;0;"jakavion";90;100;0
30;0;"jakavious";30;100;0
0;198;"jakaya";198;0;100
0;25;"jakayah";25;0;100
281;0;"jakayden";281;100;0
0;6;"jakayia";6;0;100
0;6026;"jakayla";6026;0;100
0;244;"jakaylah";244;0;100
0;5;"jakayle";5;0;100
0;58;"jakaylee";58;0;100
33;0;"jakaylen";33;100;0
10;40;"jakaylin";50;20;80
12;0;"jakaylon";12;100;0
118305;212;"jake";118517;99.8211227081347;0.178877291865302
0;25;"jakea";25;0;100
5;0;"jakeal";5;100;0
0;5;"jakeara";5;0;100
1165;0;"jakeb";1165;100;0
71;0;"jakeel";71;100;0
0;10;"jakeela";10;0;100
0;11;"jakeelah";11;0;100
894;0;"jakeem";894;100;0
0;11;"jakeena";11;0;100
0;99;"jakeia";99;0;100
18;0;"jakeil";18;100;0
84;0;"jakeim";84;100;0
0;195;"jakeira";195;0;100
0;134;"jakeisha";134;0;100
43;0;"jakeith";43;100;0
0;5;"jakeitha";5;0;100
275;11;"jakel";286;96.1538461538462;3.84615384615385
0;54;"jakela";54;0;100
0;5;"jakelia";5;0;100
0;625;"jakelin";625;0;100
0;574;"jakeline";574;0;100
156;6;"jakell";162;96.2962962962963;3.7037037037037
0;5;"jakelle";5;0;100
0;359;"jakelyn";359;0;100
0;21;"jakelyne";21;0;100
0;5;"jakelynn";5;0;100
0;13;"jakema";13;0;100
97;0;"jaken";97;100;0
0;11;"jakendra";11;0;100
31;0;"jakendrick";31;100;0
0;44;"jakenya";44;0;100
0;51;"jakenzie";51;0;100
182;0;"jakeob";182;100;0
0;281;"jakera";281;0;100
0;10;"jakerah";10;0;100
0;662;"jakeria";662;0;100
5;0;"jakerion";5;100;0
0;5;"jakeriya";5;0;100
0;84;"jakerra";84;0;100
0;163;"jakerria";163;0;100
30;0;"jakeryan";30;100;0
0;29;"jakesha";29;0;100
0;12;"jakeshia";12;0;100
0;5;"jaketa";5;0;100
6;0;"jakeveon";6;100;0
0;52;"jakevia";52;0;100
90;0;"jakevion";90;100;0
88;0;"jakevious";88;100;0
5;0;"jakevis";5;100;0
5;0;"jakey";5;100;0
0;180;"jakeya";180;0;100
0;10;"jakeyah";10;0;100
0;27;"jakeyla";27;0;100
245;5;"jakhai";250;98;2
493;0;"jakhari";493;100;0
730;0;"jakhi";730;100;0
0;450;"jakhia";450;0;100
0;5;"jakhira";5;0;100
0;77;"jakhiya";77;0;100
5;0;"jakhy";5;100;0
0;54;"jakhya";54;0;100
5;0;"jakhye";5;100;0
0;5;"jakhyia";5;0;100
0;11;"jakhyla";11;0;100
197;100;"jaki";297;66.3299663299663;33.6700336700337
0;1153;"jakia";1153;0;100
58;388;"jakiah";446;13.0044843049327;86.9955156950673
0;16;"jakiara";16;0;100
0;6;"jakiaya";6;0;100
759;17;"jakie";776;97.8092783505155;2.19072164948454
11;0;"jakiel";11;100;0
38;0;"jakiem";38;100;0
6;0;"jakier";6;100;0
0;157;"jakiera";157;0;100
0;12;"jakierra";12;0;100
6;0;"jakii";6;100;0
21;0;"jakil";21;100;0
0;25;"jakila";25;0;100
0;17;"jakilah";17;0;100
163;0;"jakim";163;100;0
0;50;"jakima";50;0;100
229;0;"jakin";229;100;0
71;0;"jaking";71;100;0
8;0;"jakir";8;100;0
0;1208;"jakira";1208;0;100
0;154;"jakirah";154;0;100
0;42;"jakiria";42;0;100
0;31;"jakirra";31;0;100
0;5;"jakirrah";5;0;100
0;5;"jakirria";5;0;100
0;48;"jakisha";48;0;100
0;117;"jakita";117;0;100
5;0;"jakius";5;100;0
0;1268;"jakiya";1268;0;100
0;1176;"jakiyah";1176;0;100
0;30;"jakiyla";30;0;100
0;5;"jakiylah";5;0;100
0;6;"jakiyra";6;0;100
10;0;"jakk";10;100;0
12;0;"jakkar";12;100;0
0;140;"jakki";140;0;100
8;16;"jakkia";24;33.3333333333333;66.6666666666667
5;0;"jakkob";5;100;0
5;0;"jakkson";5;100;0
0;248;"jaklyn";248;0;100
0;34;"jaklynn";34;0;100
29592;0;"jakob";29592;100;0
3284;0;"jakobe";3284;100;0
63;0;"jakobee";63;100;0
37;0;"jakobey";37;100;0
1454;29;"jakobi";1483;98.0445043830074;1.95549561699258
441;0;"jakobie";441;100;0
1174;0;"jakoby";1174;100;0
30;0;"jakoda";30;100;0
10;0;"jakodi";10;100;0
5;0;"jakolbe";5;100;0
10;0;"jakolbi";10;100;0
145;0;"jakolby";145;100;0
0;11;"jakora";11;0;100
164;0;"jakorey";164;100;0
425;5;"jakori";430;98.8372093023256;1.16279069767442
0;11;"jakoria";11;0;100
90;0;"jakorian";90;100;0
10;0;"jakorie";10;100;0
109;0;"jakory";109;100;0
117;0;"jakota";117;100;0
11;0;"jakov";11;100;0
5;0;"jaks";5;100;0
66;0;"jaksen";66;100;0
685;0;"jakson";685;100;0
19;0;"jaksyn";19;100;0
2619;0;"jakub";2619;100;0
143;0;"jakwan";143;100;0
5;0;"jakwaun";5;100;0
265;0;"jakwon";265;100;0
0;424;"jakya";424;0;100
0;246;"jakyah";246;0;100
5;0;"jakyan";5;100;0
253;0;"jakye";253;100;0
46;0;"jakyi";46;100;0
0;239;"jakyia";239;0;100
0;95;"jakyiah";95;0;100
0;761;"jakyla";761;0;100
0;147;"jakylah";147;0;100
82;0;"jakylan";82;100;0
85;0;"jakyle";85;100;0
0;26;"jakylee";26;0;100
51;0;"jakylen";51;100;0
0;5;"jakylia";5;0;100
27;0;"jakylin";27;100;0
19;0;"jakylon";19;100;0
0;969;"jakyra";969;0;100
0;108;"jakyrah";108;0;100
6;0;"jakyran";6;100;0
5;0;"jakyre";5;100;0
34;0;"jakyree";34;100;0
74;0;"jakyren";74;100;0
93;0;"jakyri";93;100;0
0;90;"jakyria";90;0;100
0;11;"jakyriah";11;0;100
6;0;"jakyrian";6;100;0
47;0;"jakyrie";47;100;0
43;0;"jakyrin";43;100;0
5;0;"jakyrion";5;100;0
60;0;"jakyron";60;100;0
0;11;"jakzenny";11;0;100
17;0;"jal";17;100;0
0;1939;"jala";1939;0;100
0;5;"jalaa";5;0;100
10;0;"jalaal";10;100;0
0;69;"jalacia";69;0;100
0;13;"jalae";13;0;100
5;550;"jalah";555;0.900900900900901;99.0990990990991
0;48;"jalaia";48;0;100
0;47;"jalaiah";47;0;100
0;67;"jalaila";67;0;100
0;145;"jalaina";145;0;100
0;164;"jalaine";164;0;100
0;123;"jalaiya";123;0;100
0;99;"jalaiyah";99;0;100
606;0;"jalal";606;100;0
872;70;"jalan";942;92.5690021231423;7.43099787685775
0;297;"jalana";297;0;100
24;0;"jaland";24;100;0
0;40;"jalanda";40;0;100
0;20;"jalane";20;0;100
480;359;"jalani";839;57.2109654350417;42.7890345649583
0;5;"jalanie";5;0;100
0;5;"jalanna";5;0;100
0;6;"jalanni";6;0;100
7;0;"jalante";7;100;0
0;10;"jalasha";10;0;100
0;10;"jalashia";10;0;100
0;158;"jalasia";158;0;100
10;0;"jalaun";10;100;0
0;11;"jalay";11;0;100
0;1268;"jalaya";1268;0;100
0;1079;"jalayah";1079;0;100
0;15;"jalaycia";15;0;100
0;5;"jalayha";5;0;100
0;133;"jalayia";133;0;100
0;79;"jalayiah";79;0;100
0;200;"jalayla";200;0;100
0;5;"jalaylah";5;0;100
0;233;"jalayna";233;0;100
0;74;"jalayne";74;0;100
0;76;"jalaysha";76;0;100
0;33;"jalayshia";33;0;100
0;353;"jalaysia";353;0;100
0;603;"jalea";603;0;100
0;2679;"jaleah";2679;0;100
0;38;"jaleaha";38;0;100
158;0;"jaleal";158;100;0
28;0;"jalean";28;100;0
0;18;"jaleana";18;0;100
0;27;"jaleasa";27;0;100
19;0;"jaleb";19;100;0
0;366;"jalecia";366;0;100
0;431;"jalee";431;0;100
0;103;"jaleea";103;0;100
0;115;"jaleeah";115;0;100
33;0;"jaleek";33;100;0
4092;24;"jaleel";4116;99.4169096209913;0.583090379008746
0;5;"jaleela";5;0;100
375;344;"jaleen";719;52.1557719054242;47.8442280945758
0;210;"jaleena";210;0;100
6;3125;"jaleesa";3131;0.19163206643245;99.8083679335676
0;32;"jaleese";32;0;100
0;51;"jaleesha";51;0;100
0;17;"jaleesia";17;0;100
0;106;"jaleeya";106;0;100
0;161;"jaleeyah";161;0;100
0;33;"jaleeza";33;0;100
0;52;"jaleh";52;0;100
0;76;"jalei";76;0;100
0;176;"jaleia";176;0;100
0;106;"jaleiah";106;0;100
0;692;"jaleigh";692;0;100
0;333;"jaleigha";333;0;100
75;0;"jaleil";75;100;0
10;0;"jalein";10;100;0
0;104;"jaleisa";104;0;100
0;41;"jaleisha";41;0;100
0;32;"jaleiya";32;0;100
0;69;"jaleiyah";69;0;100
5;0;"jalem";5;100;0
35570;1639;"jalen";37209;95.5951517106077;4.40484828939235
0;939;"jalena";939;0;100
0;15;"jalencia";15;0;100
10;0;"jalend";10;100;0
67;1138;"jalene";1205;5.56016597510373;94.4398340248963
10;0;"jalenn";10;100;0
0;5;"jaleny";5;0;100
18;0;"jaleo";18;100;0
34;0;"jaleon";34;100;0
0;12;"jaleria";12;0;100
0;647;"jalesa";647;0;100
0;41;"jalese";41;0;100
0;137;"jalesha";137;0;100
0;44;"jaleshia";44;0;100
0;223;"jalesia";223;0;100
0;685;"jalessa";685;0;100
0;5;"jalesse";5;0;100
0;14;"jalessia";14;0;100
0;64;"jalexa";64;0;100
0;18;"jalexi";18;0;100
0;148;"jalexia";148;0;100
0;5;"jalexie";5;0;100
0;232;"jalexis";232;0;100
0;107;"jalexus";107;0;100
0;27;"jalexy";27;0;100
0;366;"jaley";366;0;100
0;234;"jaleya";234;0;100
0;402;"jaleyah";402;0;100
0;11;"jaleyiah";11;0;100
0;24;"jaleyza";24;0;100
0;44;"jali";44;0;100
0;1316;"jalia";1316;0;100
6;868;"jaliah";874;0.68649885583524;99.3135011441648
10;0;"jalian";10;100;0
0;59;"jaliana";59;0;100
0;23;"jaliayah";23;0;100
0;5;"jalica";5;0;100
0;23;"jalice";23;0;100
0;657;"jalicia";657;0;100
0;287;"jalie";287;0;100
0;6;"jaliea";6;0;100
0;5;"jalieah";5;0;100
6;0;"jaliek";6;100;0
149;0;"jaliel";149;100;0
76;5;"jalien";81;93.8271604938272;6.17283950617284
0;6;"jaliene";6;0;100
0;18;"jaliesa";18;0;100
34;0;"jalijah";34;100;0
222;0;"jalik";222;100;0
2513;5;"jalil";2518;99.801429706116;0.198570293884035
0;170;"jalila";170;0;100
0;128;"jalilah";128;0;100
12;0;"jalill";12;100;0
1684;470;"jalin";2154;78.180129990715;21.8198700092851
0;521;"jalina";521;0;100
0;53;"jalinda";53;0;100
0;102;"jaline";102;0;100
31;0;"jalique";31;100;0
0;10;"jalis";10;0;100
6;5916;"jalisa";5922;0.101317122593718;99.8986828774063
0;270;"jalise";270;0;100
0;541;"jalisha";541;0;100
0;20;"jalishia";20;0;100
0;145;"jalisia";145;0;100
0;3173;"jalissa";3173;0;100
0;6;"jalisse";6;0;100
0;60;"jalissia";60;0;100
0;15;"jalita";15;0;100
0;48;"jalitza";48;0;100
0;19;"jalivia";19;0;100
0;505;"jaliya";505;0;100
0;8001;"jaliyah";8001;0;100
0;29;"jaliyha";29;0;100
0;41;"jaliyiah";41;0;100
11;0;"jaliyl";11;100;0
0;101;"jaliza";101;0;100
59;0;"jallen";59;100;0
0;33;"jallisa";33;0;100
0;54;"jalliyah";54;0;100
28;0;"jalmer";28;100;0
0;15;"jalna";15;0;100
6;0;"jalob";6;100;0
2281;74;"jalon";2355;96.8577494692144;3.14225053078556
0;150;"jalonda";150;0;100
153;78;"jaloni";231;66.2337662337662;33.7662337662338
5;0;"jalonni";5;100;0
30;0;"jalonnie";30;100;0
21;0;"jalontae";21;100;0
19;0;"jalonte";19;100;0
0;5;"jalpa";5;0;100
25;0;"jalun";25;100;0
0;30;"jalya";30;0;100
0;97;"jalyah";97;0;100
0;5;"jalyce";5;0;100
0;10;"jalycia";10;0;100
0;5;"jalyia";5;0;100
0;121;"jalyiah";121;0;100
0;22;"jalyla";22;0;100
0;6;"jalylah";6;0;100
1621;4647;"jalyn";6268;25.8615188257817;74.1384811742183
0;10;"jalyna";10;0;100
10;147;"jalyne";157;6.36942675159236;93.6305732484076
351;4405;"jalynn";4756;7.38015138772077;92.6198486122792
0;274;"jalynne";274;0;100
10;90;"jalyric";100;10;90
0;388;"jalysa";388;0;100
0;53;"jalyse";53;0;100
0;29;"jalysia";29;0;100
0;1533;"jalyssa";1533;0;100
0;11;"jalyssia";11;0;100
0;6;"jalyza";6;0;100
23;0;"jam";23;100;0
76;1552;"jama";1628;4.66830466830467;95.3316953316953
13;0;"jamaa";13;100;0
5;0;"jamaad";5;100;0
5;0;"jamaah";5;100;0
8163;45;"jamaal";8208;99.4517543859649;0.548245614035088
592;0;"jamaar";592;100;0
38;0;"jamaari";38;100;0
0;18;"jamaca";18;0;100
0;123;"jamacia";123;0;100
23;0;"jamad";23;100;0
5;74;"jamae";79;6.32911392405063;93.6708860759494
394;0;"jamael";394;100;0
37;0;"jamah";37;100;0
5;0;"jamahd";5;100;0
706;0;"jamahl";706;100;0
48;0;"jamahri";48;100;0
202;27;"jamai";229;88.2096069868996;11.7903930131004
0;69;"jamaia";69;0;100
0;15;"jamaiah";15;0;100
32;1461;"jamaica";1493;2.14333556597455;97.8566644340254
0;7;"jamaicia";7;0;100
0;26;"jamaika";26;0;100
349;0;"jamail";349;100;0
5;0;"jamaile";5;100;0
57;0;"jamain";57;100;0
1292;16;"jamaine";1308;98.7767584097859;1.22324159021407
112;0;"jamair";112;100;0
0;94;"jamaira";94;0;100
28;0;"jamaire";28;100;0
0;269;"jamaiya";269;0;100
0;67;"jamaiyah";67;0;100
0;31;"jamaka";31;0;100
31072;266;"jamal";31338;99.1511902482609;0.848809751739103
0;103;"jamala";103;0;100
5;0;"jamalachi";5;100;0
480;0;"jamale";480;100;0
0;21;"jamalia";21;0;100
1438;0;"jamall";1438;100;0
14;0;"jamalle";14;100;0
0;6;"jamalyn";6;0;100
94;0;"jaman";94;100;0
0;46;"jamanda";46;0;100
41;0;"jamane";41;100;0
282;250;"jamani";532;53.0075187969925;46.9924812030075
0;5;"jamantha";5;0;100
14886;73;"jamar";14959;99.5119994652049;0.488000534795107
45;868;"jamara";913;4.92880613362541;95.0711938663746
6;0;"jamarae";6;100;0
0;47;"jamarah";47;0;100
233;0;"jamarco";233;100;0
5170;0;"jamarcus";5170;100;0
32;0;"jamard";32;100;0
454;0;"jamare";454;100;0
82;34;"jamarea";116;70.6896551724138;29.3103448275862
702;5;"jamaree";707;99.2927864214993;0.707213578500707
6;0;"jamareo";6;100;0
236;0;"jamareon";236;100;0
10;0;"jamarey";10;100;0
10646;711;"jamari";11357;93.7395438936339;6.26045610636612
37;1108;"jamaria";1145;3.23144104803493;96.7685589519651
6;0;"jamariae";6;100;0
0;266;"jamariah";266;0;100
835;6;"jamarian";841;99.2865636147444;0.713436385255648
0;34;"jamariana";34;0;100
547;88;"jamarie";635;86.1417322834646;13.8582677165354
6;0;"jamariea";6;100;0
161;0;"jamarien";161;100;0
16;0;"jamarieon";16;100;0
118;0;"jamarii";118;100;0
10;0;"jamarin";10;100;0
1323;0;"jamario";1323;100;0
6415;0;"jamarion";6415;100;0
0;31;"jamariona";31;0;100
740;0;"jamarious";740;100;0
365;77;"jamaris";442;82.579185520362;17.420814479638
5;0;"jamariun";5;100;0
1631;0;"jamarius";1631;100;0
0;137;"jamariya";137;0;100
0;77;"jamariyah";77;0;100
56;0;"jamariyon";56;100;0
66;0;"jamarkis";66;100;0
563;0;"jamarkus";563;100;0
129;0;"jamarl";129;100;0
7;0;"jamarley";7;100;0
54;0;"jamarlon";54;100;0
5;0;"jamaro";5;100;0
90;0;"jamarques";90;100;0
33;0;"jamarquez";33;100;0
127;0;"jamarquis";127;100;0
31;0;"jamarqus";31;100;0
1304;0;"jamarr";1304;100;0
0;30;"jamarra";30;0;100
31;0;"jamarre";31;100;0
23;0;"jamarreon";23;100;0
547;0;"jamarri";547;100;0
0;100;"jamarria";100;0;100
20;0;"jamarrian";20;100;0
37;0;"jamarrie";37;100;0
12;0;"jamarrio";12;100;0
353;0;"jamarrion";353;100;0
5;0;"jamarris";5;100;0
83;0;"jamarrius";83;100;0
27;0;"jamarus";27;100;0
5;0;"jamarvion";5;100;0
21;5;"jamary";26;80.7692307692308;19.2307692307692
0;12;"jamarya";12;0;100
13;0;"jamaryon";13;100;0
170;0;"jamas";170;100;0
0;5;"jamasia";5;0;100
213;0;"jamason";213;100;0
516;0;"jamaul";516;100;0
17;0;"jamaun";17;100;0
10;0;"jamaur";10;100;0
824;11;"jamauri";835;98.6826347305389;1.31736526946108
0;35;"jamauria";35;0;100
76;0;"jamaurie";76;100;0
80;0;"jamaurion";80;100;0
210;0;"jamaury";210;100;0
0;6;"jamay";6;0;100
0;2017;"jamaya";2017;0;100
0;200;"jamayah";200;0;100
0;5;"jamayca";5;0;100
7;0;"jamayel";7;100;0
0;69;"jamayia";69;0;100
0;6;"jamayiah";6;0;100
0;16;"jamayka";16;0;100
0;46;"jamayla";46;0;100
0;27;"jamayra";27;0;100
3416;403;"jame";3819;89.4474993453784;10.5525006546216
0;456;"jamea";456;0;100
0;154;"jameah";154;0;100
219;0;"jameal";219;100;0
121;0;"jamear";121;100;0
0;202;"jameca";202;0;100
0;5;"jamecca";5;0;100
0;5;"jamece";5;0;100
0;817;"jamecia";817;0;100
218;2706;"jamee";2924;7.45554035567716;92.5444596443228
0;5;"jameece";5;0;100
120;0;"jameek";120;100;0
0;166;"jameeka";166;0;100
2767;18;"jameel";2785;99.3536804308797;0.646319569120287
0;742;"jameela";742;0;100
0;1156;"jameelah";1156;0;100
0;10;"jameele";10;0;100
5;0;"jameen";5;100;0
1308;0;"jameer";1308;100;0
0;16;"jameera";16;0;100
0;20;"jameerah";20;0;100
0;7;"jameese";7;0;100
0;28;"jameesha";28;0;100
0;41;"jamei";41;0;100
0;218;"jameia";218;0;100
0;10;"jameiah";10;0;100
0;74;"jameica";74;0;100
0;16;"jameice";16;0;100
0;265;"jameika";265;0;100
226;0;"jameil";226;100;0
0;118;"jameila";118;0;100
24;0;"jameion";24;100;0
442;0;"jameir";442;100;0
0;35;"jameira";35;0;100
60;0;"jameire";60;100;0
95;0;"jameis";95;100;0
0;482;"jameisha";482;0;100
58;0;"jameison";58;100;0
0;1631;"jameka";1631;0;100
0;258;"jamekia";258;0;100
10571;367;"jamel";10938;96.64472481258;3.35527518742
0;891;"jamela";891;0;100
0;135;"jamelah";135;0;100
49;0;"jamele";49;100;0
0;818;"jamelia";818;0;100
0;23;"jameliah";23;0;100
2000;75;"jamell";2075;96.3855421686747;3.6144578313253
0;445;"jamella";445;0;100
0;22;"jamellah";22;0;100
776;382;"jamelle";1158;67.0120898100173;32.9879101899827
5;0;"jamelvin";5;100;0
0;18;"jamely";18;0;100
0;84;"jamelyn";84;0;100
605;0;"jamen";605;100;0
0;5;"jamena";5;0;100
0;5;"jamene";5;0;100
67;0;"jameon";67;100;0
0;12;"jamequa";12;0;100
39;0;"jamer";39;100;0
0;362;"jamera";362;0;100
0;15;"jamerah";15;0;100
1410;22;"jamere";1432;98.463687150838;1.53631284916201
0;835;"jameria";835;0;100
0;88;"jameriah";88;0;100
0;5;"jamerial";5;0;100
18;0;"jamerian";18;100;0
0;89;"jamerica";89;0;100
20;0;"jamerio";20;100;0
117;0;"jamerion";117;100;0
31;0;"jamerious";31;100;0
5;0;"jameris";5;100;0
115;0;"jamerius";115;100;0
0;13;"jameriya";13;0;100
0;5;"jamerra";5;0;100
0;29;"jamerria";29;0;100
542;0;"jamerson";542;100;0
5031247;22731;"james";5053978;99.550235477875;0.449764522124948
0;293;"jamesa";293;0;100
21;0;"jamesandrew";21;100;0
55;0;"jamesanthony";55;100;0
0;6;"jamescia";6;0;100
5;0;"jamesdaniel";5;100;0
42;0;"jamesdavid";42;100;0
22;0;"jamesdean";22;100;0
0;763;"jamese";763;0;100
40;0;"jamesedward";40;100;0
113;5;"jamesen";118;95.7627118644068;4.23728813559322
0;10;"jamesena";10;0;100
0;623;"jamesetta";623;0;100
0;2265;"jamesha";2265;0;100
0;725;"jameshia";725;0;100
0;659;"jamesia";659;0;100
0;89;"jamesina";89;0;100
32;0;"jamesjoseph";32;100;0
18;0;"jameslee";18;100;0
25;0;"jamesley";25;100;0
7;0;"jamesly";7;100;0
21;0;"jamesmatthew";21;100;0
355;0;"jamesmichael";355;100;0
27025;816;"jameson";27841;97.0690707948709;2.93092920512913
53;0;"jamespatrick";53;100;0
72;0;"jamespaul";72;100;0
76;0;"jamesrobert";76;100;0
23;0;"jamesryan";23;100;0
10;0;"jamess";10;100;0
0;21;"jamessa";21;0;100
15;0;"jamesson";15;100;0
20;0;"jamesthomas";20;100;0
6;0;"jameswilliam";6;100;0
57;73;"jamesyn";130;43.8461538461538;56.1538461538462
0;5;"jameta";5;0;100
0;22;"jametra";22;0;100
0;43;"jametria";43;0;100
0;5;"jametrice";5;0;100
27;0;"jametrius";27;100;0
0;98;"jametta";98;0;100
0;30;"jamette";30;0;100
6565;2984;"jamey";9549;68.7506545187978;31.2493454812022
0;181;"jameya";181;0;100
0;65;"jameyah";65;0;100
554;0;"jamez";554;100;0
5;0;"jamhal";5;100;0
905;21374;"jami";22279;4.06212128012927;95.9378787198707
6;3975;"jamia";3981;0.150715900527506;99.8492840994725
317;2051;"jamiah";2368;13.3868243243243;86.6131756756757
5;0;"jamial";5;100;0
432;0;"jamian";432;100;0
0;6;"jamiann";6;0;100
0;6;"jamianne";6;0;100
28;0;"jamias";28;100;0
0;68;"jamiaya";68;0;100
0;801;"jamica";801;0;100
95;0;"jamicah";95;100;0
0;116;"jamice";116;0;100
1338;0;"jamichael";1338;100;0
314;0;"jamicheal";314;100;0
0;91;"jamicia";91;0;100
0;34;"jamicka";34;0;100
84981;266989;"jamie";351970;24.1443873057363;75.8556126942637
0;42;"jamieann";42;0;100
0;16;"jamiece";16;0;100
0;373;"jamiee";373;0;100
0;54;"jamieka";54;0;100
768;19;"jamiel";787;97.5857687420584;2.41423125794155
0;28;"jamiela";28;0;100
0;465;"jamielee";465;0;100
0;5;"jamielle";5;0;100
0;252;"jamielyn";252;0;100
0;550;"jamielynn";550;0;100
0;24;"jamiemarie";24;0;100
458;5;"jamien";463;98.9200863930886;1.07991360691145
70;0;"jamieon";70;100;0
988;0;"jamier";988;100;0
0;44;"jamiera";44;0;100
242;0;"jamiere";242;100;0
0;121;"jamiesha";121;0;100
1366;78;"jamieson";1444;94.5983379501385;5.4016620498615
6;0;"jamih";6;100;0
0;5;"jamii";5;0;100
11;0;"jamiir";11;100;0
10;0;"jamik";10;100;0
0;1379;"jamika";1379;0;100
24;0;"jamikal";24;100;0
6;0;"jamikel";6;100;0
0;5;"jamikka";5;0;100
6822;254;"jamil";7076;96.4104013566987;3.5895986433013
0;7139;"jamila";7139;0;100
16;2176;"jamilah";2192;0.72992700729927;99.2700729927007
224;204;"jamile";428;52.3364485981308;47.6635514018692
0;231;"jamilee";231;0;100
0;17;"jamileh";17;0;100
0;10;"jamiles";10;0;100
0;764;"jamilet";764;0;100
0;716;"jamileth";716;0;100
0;118;"jamilett";118;0;100
0;281;"jamilette";281;0;100
0;343;"jamilex";343;0;100
0;10;"jamiley";10;0;100
0;474;"jamilia";474;0;100
0;5;"jamilka";5;0;100
358;0;"jamill";358;100;0
0;1079;"jamilla";1079;0;100
0;1018;"jamillah";1018;0;100
260;445;"jamille";705;36.8794326241135;63.1205673758865
0;13;"jamillette";13;0;100
0;103;"jamillia";103;0;100
0;6;"jamilliah";6;0;100
0;6;"jamily";6;0;100
0;185;"jamilya";185;0;100
0;8;"jamilyah";8;0;100
0;644;"jamilyn";644;0;100
0;179;"jamilynn";179;0;100
0;6;"jamima";6;0;100
3131;138;"jamin";3269;95.7785255429795;4.2214744570205
0;161;"jamina";161;0;100
137;324;"jamine";461;29.7180043383948;70.2819956616052
218;0;"jamion";218;100;0
0;6;"jamiqua";6;0;100
15;0;"jamique";15;100;0
5086;20;"jamir";5106;99.60830395613;0.391696043869957
0;1050;"jamira";1050;0;100
0;327;"jamiracle";327;0;100
0;572;"jamirah";572;0;100
419;0;"jamire";419;100;0
0;85;"jamiria";85;0;100
11;0;"jamirion";11;100;0
6;0;"jamiron";6;100;0
29;0;"jamiroquai";29;100;0
13;0;"jamiroquan";13;100;0
14;0;"jamirr";14;100;0
0;87;"jamirra";87;0;100
0;23;"jamirrah";23;0;100
0;5;"jamirya";5;0;100
235;0;"jamis";235;100;0
0;26;"jamisa";26;0;100
0;151;"jamise";151;0;100
300;185;"jamisen";485;61.8556701030928;38.1443298969072
0;694;"jamisha";694;0;100
15929;1710;"jamison";17639;90.3055728782811;9.69442712171892
12;174;"jamisyn";186;6.45161290322581;93.5483870967742
0;56;"jamita";56;0;100
19;0;"jamius";19;100;0
0;2947;"jamiya";2947;0;100
0;2850;"jamiyah";2850;0;100
0;16;"jamiyha";16;0;100
23;0;"jamiyl";23;100;0
0;68;"jamiyla";68;0;100
0;11;"jamiylah";11;0;100
287;0;"jammal";287;100;0
33;0;"jammar";33;100;0
35;0;"jammel";35;100;0
31;0;"jammes";31;100;0
31;0;"jammey";31;100;0
0;172;"jammi";172;0;100
2429;4045;"jammie";6474;37.5193080012357;62.4806919987643
12;0;"jamms";12;100;0
332;130;"jammy";462;71.8614718614719;28.1385281385281
5;0;"jamod";5;100;0
183;0;"jamol";183;100;0
2572;6;"jamon";2578;99.767261442979;0.232738557020946
523;0;"jamond";523;100;0
266;0;"jamone";266;100;0
146;107;"jamoni";253;57.7075098814229;42.2924901185771
0;246;"jamonica";246;0;100
41;6;"jamonie";47;87.2340425531915;12.7659574468085
95;0;"jamont";95;100;0
84;0;"jamonta";84;100;0
214;0;"jamontae";214;100;0
6;0;"jamontay";6;100;0
698;0;"jamonte";698;100;0
5;0;"jamontez";5;100;0
28;0;"jamor";28;100;0
0;59;"jamora";59;0;100
13;0;"jamore";13;100;0
174;0;"jamori";174;100;0
0;16;"jamoria";16;0;100
77;0;"jamorian";77;100;0
41;0;"jamorie";41;100;0
92;0;"jamorion";92;100;0
162;0;"jamorris";162;100;0
157;0;"jams";157;100;0
57;0;"jamse";57;100;0
5;0;"jamson";5;100;0
34;0;"jamual";34;100;0
14;0;"jamuel";14;100;0
98;0;"jamus";98;100;0
383;751;"jamy";1134;33.7742504409171;66.2257495590829
0;5069;"jamya";5069;0;100
0;958;"jamyah";958;0;100
12;835;"jamye";847;1.41676505312869;98.5832349468713
0;658;"jamyia";658;0;100
0;324;"jamyiah";324;0;100
10;0;"jamyis";10;100;0
5;0;"jamykal";5;100;0
15;0;"jamyl";15;100;0
0;471;"jamyla";471;0;100
0;138;"jamylah";138;0;100
5;0;"jamyle";5;100;0
0;6;"jamyleth";6;0;100
0;5;"jamylex";5;0;100
6;0;"jamyn";6;100;0
11;0;"jamyr";11;100;0
0;863;"jamyra";863;0;100
0;164;"jamyrah";164;0;100
15;0;"jamyre";15;100;0
6;17;"jamyri";23;26.0869565217391;73.9130434782609
0;203;"jamyria";203;0;100
0;56;"jamyriah";56;0;100
0;6;"jamyrie";6;0;100
31;0;"jamyrion";31;100;0
91;0;"jamyron";91;100;0
82;0;"jamyson";82;100;0
21787;54510;"jan";76297;28.5555133229354;71.4444866770646
39;44149;"jana";44188;0.088259255906581;99.9117407440934
0;61;"janaa";61;0;100
0;38;"janaan";38;0;100
0;184;"janace";184;0;100
0;22;"janacia";22;0;100
0;6;"janada";6;0;100
0;6;"janadia";6;0;100
6;16450;"janae";16456;0.0364608653378707;99.9635391346621
0;43;"janaea";43;0;100
0;11;"janaee";11;0;100
0;21;"janaeh";21;0;100
0;5;"janael";5;0;100
0;5;"janaesha";5;0;100
0;59;"janaeya";59;0;100
0;9;"janaeyah";9;0;100
0;303;"janah";303;0;100
0;5;"janahi";5;0;100
0;12;"janahla";12;0;100
83;2620;"janai";2703;3.07066222715501;96.929337772845
0;227;"janaia";227;0;100
0;131;"janaiah";131;0;100
0;14;"janaih";14;0;100
0;24;"janaii";24;0;100
0;24;"janaija";24;0;100
0;6;"janaijah";6;0;100
0;5;"janaila";5;0;100
0;5;"janaina";5;0;100
0;6;"janaira";6;0;100
0;24;"janais";24;0;100
0;73;"janaisa";73;0;100
0;163;"janaisha";163;0;100
0;13;"janaisia";13;0;100
0;504;"janaiya";504;0;100
0;157;"janaiyah";157;0;100
0;25;"janaja";25;0;100
0;44;"janajah";44;0;100
15;0;"janak";15;100;0
5;0;"janaka";5;100;0
0;155;"janaki";155;0;100
5;69;"janal";74;6.75675675675676;93.2432432432432
0;20;"janala";20;0;100
0;988;"janalee";988;0;100
0;6;"janalene";6;0;100
0;5;"janalis";5;0;100
0;5;"janalise";5;0;100
0;6;"janaliz";6;0;100
0;5;"janalle";5;0;100
0;523;"janalyn";523;0;100
0;56;"janalynn";56;0;100
0;5;"janalyse";5;0;100
10;640;"janan";650;1.53846153846154;98.4615384615385
0;323;"janani";323;0;100
0;135;"janann";135;0;100
0;15;"jananne";15;0;100
0;64;"janara";64;0;100
168;0;"janard";168;100;0
126;64;"janari";190;66.3157894736842;33.6842105263158
0;166;"janaria";166;0;100
0;39;"janariah";39;0;100
5;0;"janaris";5;100;0
24;0;"janarius";24;100;0
5;41;"janas";46;10.8695652173913;89.1304347826087
0;7;"janascia";7;0;100
0;170;"janasha";170;0;100
0;83;"janashia";83;0;100
0;1101;"janasia";1101;0;100
0;62;"janat";62;0;100
0;11;"janath";11;0;100
380;0;"janathan";380;100;0
5;0;"janathean";5;100;0
0;71;"janautica";71;0;100
0;17;"janavi";17;0;100
0;115;"janavia";115;0;100
0;5645;"janay";5645;0;100
0;3433;"janaya";3433;0;100
0;568;"janayah";568;0;100
0;927;"janaye";927;0;100
0;145;"janayia";145;0;100
0;11;"janayiah";11;0;100
0;6;"janayja";6;0;100
0;174;"janayla";174;0;100
0;12;"janayra";12;0;100
0;116;"janaysha";116;0;100
0;11;"janayshia";11;0;100
0;155;"janaysia";155;0;100
0;61;"janazia";61;0;100
587;0;"jancarlo";587;100;0
993;0;"jancarlos";993;100;0
72;5;"jance";77;93.5064935064935;6.49350649350649
0;10;"jancey";10;0;100
0;17;"janci";17;0;100
0;189;"jancie";189;0;100
5;313;"jancy";318;1.57232704402516;98.4276729559748
0;254;"janda";254;0;100
0;7;"jande";7;0;100
0;11;"jandee";11;0;100
246;5;"jandel";251;98.00796812749;1.99203187250996
22;6;"jandell";28;78.5714285714286;21.4285714285714
0;5;"jandery";5;0;100
0;155;"jandi";155;0;100
118;0;"jandiel";118;100;0
0;20;"jandra";20;0;100
39;0;"jandre";39;100;0
19;0;"jandriel";19;100;0
7;77;"jandy";84;8.33333333333333;91.6666666666667
1134;362392;"jane";363526;0.311944675208926;99.6880553247911
0;1943;"janea";1943;0;100
0;149;"janeah";149;0;100
0;315;"janeal";315;0;100
0;1567;"janean";1567;0;100
0;451;"janeane";451;0;100
0;129;"janeann";129;0;100
0;27;"janeanne";27;0;100
0;20;"janear";20;0;100
0;643;"janece";643;0;100
0;345;"janecia";345;0;100
6;3211;"janee";3217;0.186509170034193;99.8134908299658
0;215;"janeece";215;0;100
0;22;"janeeka";22;0;100
0;5;"janeel";5;0;100
0;6528;"janeen";6528;0;100
0;208;"janeene";208;0;100
0;53;"janeesa";53;0;100
0;89;"janeese";89;0;100
0;11;"janeesha";11;0;100
0;10;"janeeva";10;0;100
0;120;"janei";120;0;100
0;39;"janeia";39;0;100
0;6;"janeiah";6;0;100
0;584;"janeice";584;0;100
0;5;"janeicia";5;0;100
0;5;"janeida";5;0;100
0;5;"janeidy";5;0;100
0;7;"janeigh";7;0;100
0;30;"janeika";30;0;100
23;217;"janeil";240;9.58333333333333;90.4166666666667
0;6;"janeily";6;0;100
0;26;"janeira";26;0;100
6;0;"janeiro";6;100;0
0;28;"janeiry";28;0;100
0;5;"janeisa";5;0;100
0;5;"janeise";5;0;100
0;352;"janeisha";352;0;100
0;38;"janeisy";38;0;100
0;6;"janeiya";6;0;100
16;0;"janek";16;100;0
0;249;"janeka";249;0;100
0;5;"janekia";5;0;100
32;11834;"janel";11866;0.269678071801787;99.7303219281982
0;5;"janela";5;0;100
0;59;"janelda";59;0;100
0;256;"janele";256;0;100
0;17;"janelee";17;0;100
0;423;"janeli";423;0;100
0;66;"janelie";66;0;100
0;278;"janelis";278;0;100
0;18;"janelise";18;0;100
0;12;"janelisse";12;0;100
0;175;"janeliz";175;0;100
23;15461;"janell";15484;0.14854042882976;99.8514595711702
0;1813;"janella";1813;0;100
86;52720;"janelle";52806;0.162860281028671;99.8371397189713
0;40;"janellen";40;0;100
0;216;"janelli";216;0;100
0;208;"janellie";208;0;100
0;1827;"janelly";1827;0;100
0;28;"janellys";28;0;100
0;1687;"janely";1687;0;100
0;43;"janelyn";43;0;100
0;233;"janelys";233;0;100
0;5;"janelyz";5;0;100
0;50;"janemarie";50;0;100
0;3544;"janene";3544;0;100
0;12;"janenne";12;0;100
0;104;"janequa";104;0;100
0;56;"janera";56;0;100
0;18;"janeria";18;0;100
0;5;"janerica";5;0;100
358;0;"janes";358;100;0
0;311;"janesa";311;0;100
0;1103;"janese";1103;0;100
0;519;"janesha";519;0;100
0;162;"janeshia";162;0;100
0;92;"janesia";92;0;100
0;12;"janess";12;0;100
0;12866;"janessa";12866;0;100
0;36;"janessah";36;0;100
0;20;"janesse";20;0;100
0;10;"janessia";10;0;100
1518;554401;"janet";555919;0.273061363256158;99.7269386367438
0;17;"janeta";17;0;100
0;81;"janete";81;0;100
0;4299;"janeth";4299;0;100
0;5;"janetha";5;0;100
0;10;"janetlee";10;0;100
0;5;"janetra";5;0;100
0;3510;"janett";3510;0;100
0;3274;"janetta";3274;0;100
42;31662;"janette";31704;0.132475397426192;99.8675246025738
0;5;"janetzi";5;0;100
0;56;"janetzy";56;0;100
0;297;"janeva";297;0;100
0;4698;"janey";4698;0;100
0;285;"janeya";285;0;100
0;44;"janeyah";44;0;100
10;0;"jangelo";10;100;0
0;39;"janhavi";39;0;100
79;1562;"jani";1641;4.81413772090189;95.1858622790981
0;2601;"jania";2601;0;100
0;3907;"janiah";3907;0;100
0;14;"janiaha";14;0;100
0;184;"janiaya";184;0;100
0;7;"janiayah";7;0;100
0;5;"janic";5;0;100
0;587;"janica";587;0;100
1158;405426;"janice";406584;0.284811994569388;99.7151880054306
0;209;"janicia";209;0;100
5;0;"janick";5;100;0
0;10;"janicka";10;0;100
276;70598;"janie";70874;0.389423483929227;99.6105765160708
0;3097;"janiece";3097;0;100
0;28;"janiecia";28;0;100
0;12;"janieka";12;0;100
620;207;"janiel";827;74.9697702539299;25.0302297460701
0;11;"janielis";11;0;100
0;12;"janieliz";12;0;100
0;598;"janielle";598;0;100
0;5;"janiely";5;0;100
0;44;"janielys";44;0;100
0;6;"janien";6;0;100
0;121;"janiene";121;0;100
12;0;"janier";12;100;0
0;6;"janiera";6;0;100
0;12;"janiese";12;0;100
0;87;"janiesha";87;0;100
0;39;"janieya";39;0;100
0;326;"janifer";326;0;100
0;21;"janiha";21;0;100
0;6;"janihya";6;0;100
0;22;"janii";22;0;100
0;5;"janiia";5;0;100
0;69;"janijah";69;0;100
0;754;"janika";754;0;100
0;5;"janikqua";5;0;100
0;41;"janil";41;0;100
0;162;"janila";162;0;100
0;139;"janilah";139;0;100
0;23;"janilee";23;0;100
0;23;"janill";23;0;100
0;81;"janille";81;0;100
0;6;"janilya";6;0;100
0;26;"janilyn";26;0;100
0;87;"janin";87;0;100
0;2772;"janina";2772;0;100
11;33254;"janine";33265;0.0330677889673831;99.9669322110326
0;41;"janinne";41;0;100
0;361;"janiqua";361;0;100
0;529;"janique";529;0;100
0;724;"janira";724;0;100
0;21;"janirah";21;0;100
0;24;"janiris";24;0;100
163;48714;"janis";48877;0.333490189659758;99.6665098103402
0;341;"janisa";341;0;100
0;2039;"janise";2039;0;100
0;929;"janisha";929;0;100
0;16;"janishia";16;0;100
0;5;"janisia";5;0;100
0;477;"janissa";477;0;100
0;85;"janisse";85;0;100
0;104;"janit";104;0;100
0;1797;"janita";1797;0;100
0;631;"janith";631;0;100
0;5;"janitha";5;0;100
0;6;"janitra";6;0;100
0;6;"janitta";6;0;100
0;291;"janitza";291;0;100
0;15;"janitzy";15;0;100
0;5;"janivea";5;0;100
6;9822;"janiya";9828;0.061050061050061;99.9389499389499
0;5;"janiyaa";5;0;100
0;10173;"janiyah";10173;0;100
0;6;"janiyan";6;0;100
0;137;"janiyha";137;0;100
0;46;"janiyia";46;0;100
0;263;"janiyla";263;0;100
0;123;"janiylah";123;0;100
0;5;"janiyyah";5;0;100
0;5;"janiza";5;0;100
12;0;"jankarlo";12;100;0
0;254;"janki";254;0;100
5;0;"janko";5;100;0
14;0;"janluca";14;100;0
25;0;"janlucas";25;100;0
16;0;"janluis";16;100;0
0;26;"janlyn";26;0;100
13;0;"janmarco";13;100;0
6;0;"janmarcos";6;100;0
0;68;"janmarie";68;0;100
279;0;"janmichael";279;100;0
133;2138;"jann";2271;5.85645090268604;94.143549097314
0;15373;"janna";15373;0;100
0;140;"jannae";140;0;100
0;1601;"jannah";1601;0;100
0;10;"jannai";10;0;100
0;10;"jannali";10;0;100
0;10;"jannalyn";10;0;100
0;10;"jannan";10;0;100
0;697;"jannat";697;0;100
0;117;"jannatul";117;0;100
0;15;"jannay";15;0;100
0;505;"janne";505;0;100
0;5;"jannea";5;0;100
0;7;"jannean";7;0;100
0;497;"jannel";497;0;100
0;5;"janneli";5;0;100
0;890;"jannell";890;0;100
0;1118;"jannelle";1118;0;100
0;101;"jannelly";101;0;100
0;305;"jannely";305;0;100
0;19;"jannene";19;0;100
0;5;"jannesa";5;0;100
0;232;"jannessa";232;0;100
0;2291;"jannet";2291;0;100
0;58;"jannete";58;0;100
0;415;"janneth";415;0;100
0;1025;"jannett";1025;0;100
0;324;"jannetta";324;0;100
0;5194;"jannette";5194;0;100
0;523;"janney";523;0;100
0;43;"janni";43;0;100
0;10;"jannia";10;0;100
0;5;"janniah";5;0;100
0;28;"jannica";28;0;100
0;656;"jannice";656;0;100
28;13967;"jannie";13995;0.200071454090747;99.7999285459093
5;0;"janniel";5;100;0
0;855;"jannifer";855;0;100
12;0;"jannik";12;100;0
0;14;"jannika";14;0;100
0;6;"jannike";6;0;100
0;16;"jannina";16;0;100
0;677;"jannine";677;0;100
0;410;"jannis";410;0;100
0;5;"jannita";5;0;100
0;5;"janniyah";5;0;100
7;0;"jannuel";7;100;0
0;509;"janny";509;0;100
182;0;"janoah";182;100;0
0;40;"janon";40;0;100
0;46;"janora";46;0;100
25;0;"janorris";25;100;0
139;0;"janos";139;100;0
0;13;"janovia";13;0;100
63;0;"jansel";63;100;0
1737;214;"jansen";1951;89.031266017427;10.968733982573
18;0;"jansiel";18;100;0
961;0;"janson";961;100;0
174;0;"janssen";174;100;0
5;25;"jansyn";30;16.6666666666667;83.3333333333333
41;14;"jante";55;74.5454545454545;25.4545454545455
0;5;"jantel";5;0;100
131;0;"janthony";131;100;0
5;0;"jantsen";5;100;0
75;0;"jantz";75;100;0
641;14;"jantzen";655;97.8625954198473;2.13740458015267
0;44;"januari";44;0;100
0;10;"januarie";10;0;100
0;2019;"january";2019;0;100
254;0;"januel";254;100;0
7;0;"januell";7;100;0
8;0;"januelle";8;100;0
0;32;"januita";32;0;100
31;127;"janus";158;19.620253164557;80.379746835443
5;0;"janusz";5;100;0
0;316;"janvi";316;0;100
17;15;"janvier";32;53.125;46.875
5;0;"janxiel";5;100;0
0;104;"jany";104;0;100
0;2194;"janya";2194;0;100
0;1010;"janyah";1010;0;100
0;1860;"janyce";1860;0;100
0;63;"janye";63;0;100
0;10;"janyha";10;0;100
0;5;"janyhia";5;0;100
0;6;"janyi";6;0;100
0;712;"janyia";712;0;100
0;407;"janyiah";407;0;100
0;6;"janyl";6;0;100
0;1240;"janyla";1240;0;100
0;491;"janylah";491;0;100
0;35;"janyll";35;0;100
0;21;"janyne";21;0;100
0;95;"janyra";95;0;100
0;32;"janyria";32;0;100
0;5;"janyriah";5;0;100
0;5;"janys";5;0;100
0;5;"janyse";5;0;100
0;33;"janyssa";33;0;100
0;122;"janyth";122;0;100
5;0;"janyus";5;100;0
17;0;"janzel";17;100;0
73;0;"janzen";73;100;0
50;0;"janziel";50;100;0
0;10;"jaona";10;0;100
0;5;"jaoni";5;0;100
0;116;"jaonna";116;0;100
8;0;"jaonte";8;100;0
5;0;"jaosn";5;100;0
25;0;"jap";25;100;0
11;0;"japaul";11;100;0
0;21;"japera";21;0;100
37;0;"japeth";37;100;0
208;0;"japhet";208;100;0
1069;0;"japheth";1069;100;0
5;0;"japhy";5;100;0
0;58;"japji";58;0;100
0;71;"japleen";71;0;100
0;25;"japneet";25;0;100
0;5;"japnoor";5;0;100
0;45;"japonica";45;0;100
5;0;"japree";5;100;0
0;5;"japria";5;0;100
0;5;"japrice";5;0;100
21;0;"jaqai";21;100;0
11;0;"jaqari";11;100;0
6;0;"jaqaun";6;100;0
9;0;"jaqavious";9;100;0
0;64;"jaqlyn";64;0;100
63;28;"jaqua";91;69.2307692307692;30.7692307692308
34;6;"jaquae";40;85;15
38;0;"jaquai";38;100;0
98;0;"jaquail";98;100;0
34;0;"jaquain";34;100;0
0;6;"jaquaisha";6;0;100
17;0;"jaqual";17;100;0
0;200;"jaquala";200;0;100
10;0;"jaquale";10;100;0
12;0;"jaqualen";12;100;0
82;0;"jaqualin";82;100;0
0;18;"jaqualine";18;0;100
0;12;"jaqualla";12;0;100
40;0;"jaqualon";40;100;0
96;11;"jaqualyn";107;89.7196261682243;10.2803738317757
9857;58;"jaquan";9915;99.4150277357539;0.584972264246092
0;399;"jaquana";399;0;100
0;115;"jaquanda";115;0;100
0;13;"jaquandra";13;0;100
6;0;"jaquandre";6;100;0
120;0;"jaquane";120;100;0
119;0;"jaquann";119;100;0
0;185;"jaquanna";185;0;100
5;0;"jaquantae";5;100;0
43;0;"jaquante";43;100;0
11;0;"jaquar";11;100;0
179;0;"jaquari";179;100;0
30;0;"jaquarion";30;100;0
176;0;"jaquarious";176;100;0
28;0;"jaquaris";28;100;0
797;0;"jaquarius";797;100;0
24;0;"jaquarrius";24;100;0
0;71;"jaquasha";71;0;100
0;15;"jaquashia";15;0;100
0;116;"jaquasia";116;0;100
0;7;"jaquata";7;0;100
11;0;"jaquaun";11;100;0
65;0;"jaquaveon";65;100;0
0;47;"jaquavia";47;0;100
110;0;"jaquavian";110;100;0
5;0;"jaquavien";5;100;0
410;0;"jaquavion";410;100;0
752;0;"jaquavious";752;100;0
206;0;"jaquavis";206;100;0
362;0;"jaquavius";362;100;0
159;0;"jaquawn";159;100;0
376;156;"jaquay";532;70.6766917293233;29.3233082706767
0;67;"jaquaya";67;0;100
0;107;"jaquayla";107;0;100
5;0;"jaquaylin";5;100;0
34;0;"jaquaylon";34;100;0
10;0;"jaquayvion";10;100;0
5;0;"jaquaze";5;100;0
135;23;"jaque";158;85.4430379746835;14.5569620253165
6;0;"jaqueal";6;100;0
0;7;"jaqueisha";7;0;100
378;123;"jaquel";501;75.4491017964072;24.5508982035928
0;41;"jaquela";41;0;100
0;5;"jaquelene";5;0;100
0;3663;"jaquelin";3663;0;100
0;34;"jaquelina";34;0;100
23;14799;"jaqueline";14822;0.155174740250978;99.844825259749
0;6;"jaquelinee";6;0;100
0;159;"jaquelinne";159;0;100
226;5;"jaquell";231;97.8354978354978;2.16450216450216
0;17;"jaquella";17;0;100
29;0;"jaquelle";29;100;0
0;12;"jaquelline";12;0;100
0;2627;"jaquelyn";2627;0;100
0;218;"jaquelyne";218;0;100
0;263;"jaquelynn";263;0;100
0;12;"jaqueria";12;0;100
306;5;"jaques";311;98.3922829581994;1.60771704180064
79;31;"jaquese";110;71.8181818181818;28.1818181818182
0;130;"jaquesha";130;0;100
5;0;"jaquest";5;100;0
0;26;"jaqueta";26;0;100
0;776;"jaquetta";776;0;100
0;33;"jaquette";33;0;100
1964;0;"jaquez";1964;100;0
20;0;"jaqueze";20;100;0
23;17;"jaqui";40;57.5;42.5
0;70;"jaquia";70;0;100
0;6;"jaquice";6;0;100
183;0;"jaquil";183;100;0
0;59;"jaquila";59;0;100
40;0;"jaquill";40;100;0
0;90;"jaquilla";90;0;100
134;0;"jaquille";134;100;0
0;5;"jaquilyn";5;0;100
186;5;"jaquin";191;97.3821989528796;2.61780104712042
19;0;"jaquincy";19;100;0
45;0;"jaquinn";45;100;0
0;5;"jaquinta";5;0;100
29;0;"jaquinton";29;100;0
0;37;"jaquira";37;0;100
234;10;"jaquis";244;95.9016393442623;4.0983606557377
197;40;"jaquise";237;83.1223628691983;16.8776371308017
0;218;"jaquisha";218;0;100
0;785;"jaquita";785;0;100
0;60;"jaquitta";60;0;100
0;44;"jaquline";44;0;100
0;72;"jaqulyn";72;0;100
0;5;"jaqulynn";5;0;100
0;11;"jaquoia";11;0;100
690;0;"jaquon";690;100;0
29;0;"jaquori";29;100;0
5;0;"jaquory";5;100;0
0;6;"jaquoya";6;0;100
10;0;"jaquwan";10;100;0
258;0;"jaqwan";258;100;0
103;0;"jaqwon";103;100;0
0;779;"jara";779;0;100
29;0;"jaraad";29;100;0
2090;0;"jarad";2090;100;0
5;0;"jarade";5;100;0
62;203;"jarae";265;23.3962264150943;76.6037735849057
16;0;"jarael";16;100;0
11;411;"jarah";422;2.60663507109005;97.39336492891
5;0;"jarai";5;100;0
5;0;"jarail";5;100;0
5;0;"jarald";5;100;0
92;0;"jaramiah";92;100;0
106;0;"jaramie";106;100;0
18;0;"jaramy";18;100;0
236;0;"jaran";236;100;0
42;0;"jarard";42;100;0
248;0;"jaray";248;100;0
0;30;"jaraya";30;0;100
0;5;"jarayah";5;0;100
6;0;"jard";6;100;0
5;0;"jardan";5;100;0
19;0;"jarden";19;100;0
5;7;"jardin";12;41.6666666666667;58.3333333333333
32;0;"jardon";32;100;0
0;28;"jardyn";28;0;100
38;0;"jare";38;100;0
15;0;"jareal";15;100;0
72;0;"jareb";72;100;0
198528;768;"jared";199296;99.6146435452794;0.385356454720617
7;0;"jaredd";7;100;0
92;106;"jaree";198;46.4646464646465;53.5353535353535
29;0;"jareem";29;100;0
33;0;"jareese";33;100;0
1481;0;"jarek";1481;100;0
0;6;"jareka";6;0;100
1049;6;"jarel";1055;99.4312796208531;0.568720379146919
0;216;"jareli";216;0;100
0;5;"jarelin";5;0;100
0;95;"jarelis";95;0;100
0;10;"jareliz";10;0;100
2711;0;"jarell";2711;100;0
321;0;"jarelle";321;100;0
0;90;"jarelly";90;0;100
0;819;"jarely";819;0;100
0;66;"jarelyn";66;0;100
0;38;"jarelys";38;0;100
15;0;"jarem";15;100;0
38;0;"jaremiah";38;100;0
200;0;"jaremy";200;100;0
4776;253;"jaren";5029;94.9691787631736;5.03082123682641
0;7;"jarena";7;0;100
0;5;"jareny";5;0;100
14;0;"jareo";14;100;0
0;5;"jaresha";5;0;100
2837;22;"jaret";2859;99.2305001748863;0.769499825113676
1486;32;"jareth";1518;97.8919631093544;2.10803689064559
0;24;"jarethzy";24;0;100
0;5;"jaretsi";5;0;100
0;64;"jaretssi";64;0;100
0;26;"jaretsy";26;0;100
3437;0;"jarett";3437;100;0
0;22;"jaretta";22;0;100
35;0;"jarette";35;100;0
0;206;"jaretzi";206;0;100
0;443;"jaretzy";443;0;100
0;5;"jarexi";5;0;100
0;11;"jarexy";11;0;100
17;0;"jarez";17;100;0
10;0;"jarhett";10;100;0
0;5;"jarhia";5;0;100
0;14;"jarhonda";14;0;100
188;321;"jari";509;36.9351669941061;63.0648330058939
0;137;"jaria";137;0;100
183;961;"jariah";1144;15.9965034965035;84.0034965034965
332;0;"jarian";332;100;0
0;107;"jariana";107;0;100
0;48;"jarianna";48;0;100
15;0;"jarib";15;100;0
49;0;"jaric";49;100;0
0;148;"jarica";148;0;100
76;0;"jarick";76;100;0
0;5;"jaricka";5;0;100
5;0;"jarico";5;100;0
1401;0;"jarid";1401;100;0
6;11;"jarie";17;35.2941176470588;64.7058823529412
1535;39;"jariel";1574;97.5222363405337;2.47776365946633
0;43;"jarielis";43;0;100
0;27;"jarieliz";27;0;100
12;0;"jariell";12;100;0
0;14;"jarielle";14;0;100
0;10;"jariely";10;0;100
0;84;"jarielys";84;0;100
35;0;"jarien";35;100;0
19;0;"jarif";19;100;0
54;0;"jarik";54;100;0
0;63;"jarika";63;0;100
0;59;"jarilyn";59;0;100
5;0;"jarimiah";5;100;0
980;33;"jarin";1013;96.7423494570582;3.25765054294176
0;11;"jarina";11;0;100
6;0;"jario";6;100;0
208;0;"jarion";208;100;0
109;0;"jarious";109;100;0
5;0;"jarique";5;100;0
266;21;"jaris";287;92.6829268292683;7.31707317073171
0;6;"jarisa";6;0;100
5;0;"jarison";5;100;0
0;185;"jarissa";185;0;100
5;0;"jarit";5;100;0
0;206;"jarita";206;0;100
0;9;"jaritsa";9;0;100
0;731;"jaritza";731;0;100
0;5;"jaritzi";5;0;100
0;16;"jaritzy";16;0;100
1676;0;"jarius";1676;100;0
0;222;"jariya";222;0;100
10;703;"jariyah";713;1.40252454417952;98.5974754558205
133;0;"jarl";133;100;0
0;26;"jarlene";26;0;100
0;11;"jarlin";11;0;100
0;5;"jarline";5;0;100
0;11;"jarlyn";11;0;100
0;12;"jarma";12;0;100
18;0;"jarmain";18;100;0
376;0;"jarmaine";376;100;0
266;0;"jarmal";266;100;0
17;0;"jarmall";17;100;0
76;0;"jarman";76;100;0
5;0;"jarmani";5;100;0
359;0;"jarmar";359;100;0
166;0;"jarmarcus";166;100;0
9;0;"jarmarion";9;100;0
5;0;"jarmaris";5;100;0
179;0;"jarmel";179;100;0
18;0;"jarmell";18;100;0
5;0;"jarmen";5;100;0
0;18;"jarmila";18;0;100
111;0;"jarmon";111;100;0
0;16;"jarnae";16;0;100
51;0;"jarnell";51;100;0
5;0;"jaro";5;100;0
11647;5;"jarod";11652;99.9570889117748;0.0429110882251974
10;0;"jarodd";10;100;0
51;0;"jarol";51;100;0
652;0;"jarold";652;100;0
1201;0;"jarom";1201;100;0
220;0;"jarome";220;100;0
6;0;"jaromir";6;100;0
10605;48;"jaron";10653;99.5494226978316;0.450577302168403
0;16;"jaronda";16;0;100
60;0;"jarone";60;100;0
10;0;"jaronn";10;100;0
5;0;"jaronte";5;100;0
12;0;"jaroslav";12;100;0
17;0;"jaroslaw";17;100;0
73;0;"jarquavious";73;100;0
11;0;"jarquavius";11;100;0
24;0;"jarques";24;100;0
277;0;"jarquez";277;100;0
79;0;"jarquis";79;100;0
22;0;"jarquise";22;100;0
1897;0;"jarrad";1897;100;0
5;59;"jarrah";64;7.8125;92.1875
5;0;"jarran";5;100;0
57;0;"jarrard";57;100;0
25;0;"jarratt";25;100;0
152;0;"jarreau";152;100;0
13069;8;"jarred";13077;99.9388238892712;0.0611761107287604
5;0;"jarrek";5;100;0
1001;0;"jarrel";1001;100;0
4021;22;"jarrell";4043;99.4558496166213;0.544150383378679
11;0;"jarrelle";11;100;0
2012;10;"jarren";2022;99.5054401582591;0.494559841740851
3366;0;"jarret";3366;100;0
50;0;"jarreth";50;100;0
22024;78;"jarrett";22102;99.6470907610171;0.352909238982897
142;0;"jarrette";142;100;0
0;5;"jarriah";5;0;100
5;0;"jarrian";5;100;0
0;35;"jarrica";35;0;100
220;0;"jarrick";220;100;0
1199;0;"jarrid";1199;100;0
68;0;"jarriel";68;100;0
5;0;"jarriet";5;100;0
402;0;"jarrin";402;100;0
21;0;"jarrion";21;100;0
136;0;"jarris";136;100;0
5;0;"jarrison";5;100;0
10;0;"jarrit";10;100;0
5;0;"jarritt";5;100;0
165;0;"jarrius";165;100;0
24992;65;"jarrod";25057;99.7405914514906;0.259408548509399
23;0;"jarrold";23;100;0
1448;0;"jarron";1448;100;0
11;0;"jarrot";11;100;0
5;0;"jarrott";5;100;0
144;0;"jarry";144;100;0
692;0;"jarryd";692;100;0
5;0;"jarryl";5;100;0
59;0;"jarryn";59;100;0
74;0;"jartavious";74;100;0
5;0;"jartavis";5;100;0
12;0;"jartavius";12;100;0
26;0;"jaruis";26;100;0
25;0;"jarule";25;100;0
5;0;"jarus";5;100;0
5;0;"jarvais";5;100;0
56;0;"jarvaris";56;100;0
15;0;"jarvas";15;100;0
29;0;"jarvell";29;100;0
10;0;"jarvez";10;100;0
7;0;"jarvie";7;100;0
180;0;"jarvin";180;100;0
16;0;"jarvion";16;100;0
16811;123;"jarvis";16934;99.2736506436755;0.726349356324554
12;0;"jarvius";12;100;0
60;0;"jarvon";60;100;0
7;0;"jarvous";7;100;0
11;0;"jarvus";11;100;0
72;0;"jary";72;100;0
0;23;"jarya";23;0;100
0;95;"jaryah";95;0;100
77;0;"jaryan";77;100;0
754;0;"jaryd";754;100;0
5;0;"jaryel";5;100;0
0;16;"jaryia";16;0;100
0;53;"jaryiah";53;0;100
11;0;"jaryl";11;100;0
531;335;"jaryn";866;61.3163972286374;38.6836027713626
95;13;"jas";108;87.962962962963;12.037037037037
0;224;"jasa";224;0;100
55;0;"jasaan";55;100;0
0;5;"jasabelle";5;0;100
6;0;"jasahn";6;100;0
275;5;"jasai";280;98.2142857142857;1.78571428571429
93;10;"jasaiah";103;90.2912621359223;9.70873786407767
0;12;"jasalin";12;0;100
0;201;"jasalyn";201;0;100
0;57;"jasalynn";57;0;100
0;264;"jasamine";264;0;100
193;0;"jasan";193;100;0
0;5;"jasana";5;0;100
0;9;"jasandra";9;0;100
100;258;"jasani";358;27.9329608938547;72.0670391061452
0;60;"jasara";60;0;100
0;13;"jasarah";13;0;100
157;0;"jasaun";157;100;0
15;0;"jasavion";15;100;0
0;15;"jasaya";15;0;100
32;0;"jascha";32;100;0
219;49;"jasdeep";268;81.7164179104478;18.2835820895522
18205;109;"jase";18314;99.4048269083761;0.595173091623894
838;0;"jasean";838;100;0
6;0;"jasear";6;100;0
0;5;"jasee";5;0;100
5;0;"jaseem";5;100;0
0;16;"jaseena";16;0;100
5;0;"jaseer";5;100;0
5;0;"jaseir";5;100;0
12;0;"jasek";12;100;0
0;37;"jasel";37;0;100
0;6;"jaselin";6;0;100
0;10;"jasella";10;0;100
0;355;"jaselle";355;0;100
0;360;"jaselyn";360;0;100
0;84;"jaselynn";84;0;100
10;0;"jasem";10;100;0
0;183;"jasemine";183;0;100
4440;0;"jasen";4440;100;0
0;152;"jasenia";152;0;100
0;19;"jasenya";19;0;100
36;0;"jaseon";36;100;0
6;0;"jaseph";6;100;0
71;0;"jaser";71;100;0
0;5;"jasera";5;0;100
5;0;"jasere";5;100;0
5;521;"jasey";526;0.950570342205323;99.0494296577947
115;0;"jash";115;100;0
0;249;"jasha";249;0;100
77;0;"jashad";77;100;0
0;84;"jashae";84;0;100
0;6;"jashala";6;0;100
209;5;"jashan";214;97.6635514018692;2.33644859813084
0;6;"jashana";6;0;100
11;0;"jashandeep";11;100;0
0;11;"jashanna";11;0;100
5;0;"jashanpreet";5;100;0
0;6;"jashante";6;0;100
0;153;"jashanti";153;0;100
0;6;"jashara";6;0;100
1141;0;"jashaun";1141;100;0
0;45;"jashauna";45;0;100
2024;34;"jashawn";2058;98.3479105928085;1.65208940719145
0;88;"jashawna";88;0;100
0;86;"jashay";86;0;100
0;185;"jashayla";185;0;100
0;5;"jashea";5;0;100
10;0;"jasheem";10;100;0
0;6;"jashelle";6;0;100
76;0;"jasher";76;100;0
0;57;"jashia";57;0;100
0;61;"jashira";61;0;100
0;84;"jashiya";84;0;100
0;13;"jashiyah";13;0;100
0;68;"jashley";68;0;100
5;0;"jashod";5;100;0
849;6;"jashon";855;99.2982456140351;0.701754385964912
0;10;"jashona";10;0;100
0;7;"jashonda";7;0;100
5;0;"jashone";5;100;0
0;33;"jashonna";33;0;100
1636;0;"jashua";1636;100;0
280;0;"jashun";280;100;0
0;41;"jashya";41;0;100
0;5;"jashyia";5;0;100
0;20;"jashyra";20;0;100
18;32;"jasi";50;36;64
6;470;"jasia";476;1.26050420168067;98.7394957983193
4486;519;"jasiah";5005;89.6303696303696;10.3696303696304
11;0;"jasian";11;100;0
0;5;"jasiana";5;0;100
0;5;"jasianna";5;0;100
29;0;"jasias";29;100;0
0;12;"jasibe";12;0;100
0;6;"jasicianna";6;0;100
0;204;"jasie";204;0;100
1020;84;"jasiel";1104;92.3913043478261;7.60869565217391
0;6;"jasielle";6;0;100
96;0;"jasier";96;100;0
5;0;"jasik";5;100;0
0;92;"jasilyn";92;0;100
0;12;"jasilynn";12;0;100
207;0;"jasim";207;100;0
0;7;"jasiman";7;0;100
0;116;"jasime";116;0;100
0;12;"jasimen";12;0;100
0;383;"jasimine";383;0;100
336;0;"jasin";336;100;0
0;5;"jasine";5;0;100
24;0;"jasinto";24;100;0
53;0;"jasion";53;100;0
916;0;"jasir";916;100;0
0;183;"jasira";183;0;100
0;12;"jasirah";12;0;100
46;0;"jasire";46;100;0
100;32;"jasiri";132;75.7575757575758;24.2424242424242
8;196;"jasiya";204;3.92156862745098;96.078431372549
219;356;"jasiyah";575;38.0869565217391;61.9130434782609
6;0;"jasjeet";6;100;0
344;0;"jaskaran";344;100;0
43;0;"jaskarn";43;100;0
0;50;"jaskiran";50;0;100
87;37;"jaskirat";124;70.1612903225807;29.8387096774194
0;5;"jaslean";5;0;100
0;1752;"jasleen";1752;0;100
0;24;"jasleene";24;0;100
0;72;"jaslen";72;0;100
0;5;"jaslena";5;0;100
0;2811;"jaslene";2811;0;100
0;13;"jaslenne";13;0;100
0;16;"jasley";16;0;100
0;568;"jaslin";568;0;100
0;352;"jasline";352;0;100
0;5;"jaslinn";5;0;100
0;43;"jasly";43;0;100
0;3595;"jaslyn";3595;0;100
0;197;"jaslyne";197;0;100
0;1767;"jaslynn";1767;0;100
0;100;"jaslynne";100;0;100
0;366;"jasma";366;0;100
0;82;"jasmain";82;0;100
6;818;"jasmaine";824;0.728155339805825;99.2718446601942
46;259;"jasman";305;15.0819672131148;84.9180327868852
0;81;"jasmane";81;0;100
6;0;"jasmany";6;100;0
0;16;"jasmari";16;0;100
0;185;"jasmarie";185;0;100
0;6;"jasmary";6;0;100
0;584;"jasmeen";584;0;100
64;187;"jasmeet";251;25.4980079681275;74.5019920318725
0;6;"jasmeh";6;0;100
0;6;"jasmely";6;0;100
11;606;"jasmen";617;1.78282009724473;98.2171799027553
0;101;"jasmene";101;0;100
0;29;"jasmere";29;0;100
0;89;"jasmia";89;0;100
0;38;"jasmie";38;0;100
0;27;"jasmien";27;0;100
0;5;"jasmijn";5;0;100
0;5;"jasmil";5;0;100
584;43395;"jasmin";43979;1.32790650082994;98.6720934991701
0;971;"jasmina";971;0;100
0;11;"jasminda";11;0;100
1260;241898;"jasmine";243158;0.518181593860782;99.4818184061392
0;93;"jasminemarie";93;0;100
0;23;"jasminerose";23;0;100
0;46;"jasminn";46;0;100
0;123;"jasminne";123;0;100
20;6;"jasmir";26;76.9230769230769;23.0769230769231
0;5;"jasmire";5;0;100
74;128;"jasmon";202;36.6336633663366;63.3663366336634
81;43;"jasmond";124;65.3225806451613;34.6774193548387
0;18;"jasmone";18;0;100
0;26;"jasmonique";26;0;100
0;5694;"jasmyn";5694;0;100
0;3936;"jasmyne";3936;0;100
0;306;"jasmynn";306;0;100
0;37;"jasmynne";37;0;100
224;0;"jasn";224;100;0
0;10;"jasna";10;0;100
0;59;"jasneet";59;0;100
9;0;"jasniel";9;100;0
14;85;"jasnoor";99;14.1414141414141;85.8585858585859
12;0;"jaso";12;100;0
10;0;"jasom";10;100;0
1024207;5011;"jason";1029218;99.5131254991654;0.486874500834614
0;5;"jasona";5;0;100
5;0;"jasonanthony";5;100;0
5;0;"jasonjr";5;100;0
6;0;"jasonlee";6;100;0
6;0;"jasonn";6;100;0
0;23;"jasonna";23;0;100
5;0;"jasonpaul";5;100;0
5;0;"jasontyler";5;100;0
49;0;"jaspal";49;100;0
41;0;"jaspar";41;100;0
11;0;"jaspen";11;100;0
36440;711;"jasper";37151;98.0861887970714;1.91381120292859
252;385;"jaspreet";637;39.5604395604396;60.4395604395604
5;0;"jaspyr";5;100;0
121;0;"jasraj";121;100;0
0;6;"jasreen";6;0;100
0;28;"jasreet";28;0;100
5;0;"jassan";5;100;0
10;0;"jassar";10;100;0
0;28;"jassel";28;0;100
0;5;"jasselle";5;0;100
5;0;"jassem";5;100;0
266;0;"jassen";266;100;0
46;0;"jasser";46;100;0
196;17;"jassiah";213;92.018779342723;7.981220657277
0;236;"jassica";236;0;100
0;21;"jassidy";21;0;100
0;5;"jassie";5;0;100
372;5;"jassiel";377;98.6737400530504;1.3262599469496
24;0;"jassiem";24;100;0
39;0;"jassim";39;100;0
36;0;"jassir";36;100;0
0;121;"jasslyn";121;0;100
0;5;"jasslynn";5;0;100
0;6;"jassmen";6;0;100
0;294;"jassmin";294;0;100
0;486;"jassmine";486;0;100
0;38;"jassmyn";38;0;100
1161;0;"jasson";1161;100;0
102;0;"jasten";102;100;0
205;14;"jastin";219;93.6073059360731;6.39269406392694
234;0;"jaston";234;100;0
0;11;"jastyn";11;0;100
5;0;"jasuan";5;100;0
156;0;"jasun";156;100;0
6;0;"jasur";6;100;0
5;0;"jaswinder";5;100;0
0;7;"jaswiry";7;0;100
0;5;"jasy";5;0;100
0;11;"jasya";11;0;100
56;18;"jasyah";74;75.6756756756757;24.3243243243243
5;0;"jasye";5;100;0
0;11;"jasyia";11;0;100
10;17;"jasyiah";27;37.037037037037;62.962962962963
172;0;"jasyn";172;100;0
0;10;"jasyra";10;0;100
0;5;"jaszlyn";5;0;100
0;44;"jaszmin";44;0;100
0;102;"jaszmine";102;0;100
0;5;"jata";5;0;100
0;5;"jataiya";5;0;100
0;37;"jatana";37;0;100
0;25;"jatanna";25;0;100
0;185;"jatara";185;0;100
5;0;"jatari";5;100;0
58;0;"jatarius";58;100;0
0;26;"jatasha";26;0;100
0;72;"jatasia";72;0;100
0;17;"jataun";17;0;100
5;0;"jataurus";5;100;0
0;7;"jatava";7;0;100
16;0;"jataveon";16;100;0
0;403;"jatavia";403;0;100
101;0;"jatavian";101;100;0
5;0;"jatavien";5;100;0
271;0;"jatavion";271;100;0
508;0;"jatavious";508;100;0
80;0;"jatavis";80;100;0
276;0;"jatavius";276;100;0
0;111;"jataya";111;0;100
29;0;"jatayvion";29;100;0
10;0;"jaten";10;100;0
0;31;"jateria";31;0;100
0;5;"jaterica";5;0;100
10;0;"jaterion";10;100;0
5;0;"jaterious";5;100;0
5;0;"jaterius";5;100;0
0;11;"jaterra";11;0;100
0;25;"jaterria";25;0;100
10;0;"jaterrian";10;100;0
0;11;"jaterrica";11;0;100
47;0;"jaterrion";47;100;0
18;0;"jaterrious";18;100;0
77;0;"jaterrius";77;100;0
1349;0;"jathan";1349;100;0
46;0;"jathaniel";46;100;0
156;0;"jathen";156;100;0
76;0;"jathniel";76;100;0
16;0;"jathon";16;100;0
0;17;"jathziry";17;0;100
0;113;"jatia";113;0;100
0;10;"jatiana";10;0;100
291;0;"jatin";291;100;0
0;34;"jatina";34;0;100
34;0;"jatinder";34;100;0
0;5;"jatisha";5;0;100
0;10;"jatiya";10;0;100
195;0;"jatniel";195;100;0
55;62;"jaton";117;47.008547008547;52.991452991453
0;5;"jatonya";5;0;100
5;19;"jatori";24;20.8333333333333;79.1666666666667
0;246;"jatoria";246;0;100
62;0;"jatorian";62;100;0
0;11;"jatorria";11;0;100
15;0;"jatory";15;100;0
0;141;"jatoya";141;0;100
10;0;"jatwan";10;100;0
5;0;"jatyler";5;100;0
0;30;"jatyra";30;0;100
0;288;"jatziri";288;0;100
0;326;"jatziry";326;0;100
196;0;"jauan";196;100;0
5;0;"jaudiel";5;100;0
5;0;"jauier";5;100;0
542;0;"jaun";542;100;0
0;95;"jauna";95;0;100
0;6;"jaunell";6;0;100
0;5;"jauneta";5;0;100
0;84;"jaunice";84;0;100
0;6872;"jaunita";6872;0;100
0;5;"jaunna";5;0;100
5;0;"jaunte";5;100;0
6;0;"jauquan";6;100;0
34;0;"jaurice";34;100;0
56;0;"jauron";56;100;0
11;0;"jaushua";11;100;0
10;0;"jaustin";10;100;0
0;7;"jauwana";7;0;100
20;17;"java";37;54.0540540540541;45.945945945946
57;0;"javad";57;100;0
41;127;"javae";168;24.4047619047619;75.5952380952381
0;100;"javaeh";100;0;100
21;0;"javahn";21;100;0
10;0;"javair";10;100;0
36;0;"javale";36;100;0
3307;43;"javan";3350;98.7164179104478;1.28358208955224
0;72;"javana";72;0;100
91;0;"javani";91;100;0
0;136;"javanna";136;0;100
78;0;"javanni";78;100;0
17;0;"javant";17;100;0
5;0;"javanta";5;100;0
5;0;"javantay";5;100;0
575;0;"javante";575;100;0
645;0;"javar";645;100;0
6;0;"javare";6;100;0
31;0;"javaree";31;100;0
5;0;"javareon";5;100;0
219;0;"javares";219;100;0
875;0;"javari";875;100;0
0;93;"javaria";93;0;100
84;0;"javarian";84;100;0
120;0;"javarie";120;100;0
22;0;"javario";22;100;0
266;0;"javarion";266;100;0
461;0;"javarious";461;100;0
1591;0;"javaris";1591;100;0
776;0;"javarius";776;100;0
39;0;"javarous";39;100;0
61;0;"javarri";61;100;0
5;0;"javarrie";5;100;0
12;0;"javarrion";12;100;0
15;0;"javarris";15;100;0
17;0;"javarrius";17;100;0
6;0;"javarron";6;100;0
289;0;"javarus";289;100;0
10;0;"javary";10;100;0
16;0;"javas";16;100;0
834;0;"javaughn";834;100;0
294;0;"javaun";294;100;0
6;0;"javaunte";6;100;0
5;0;"javawn";5;100;0
0;60;"javaya";60;0;100
0;70;"javayah";70;0;100
5;0;"jave";5;100;0
0;5;"javea";5;0;100
0;185;"javeah";185;0;100
12;0;"javean";12;100;0
245;0;"javed";245;100;0
10;0;"javeed";10;100;0
16;0;"javein";16;100;0
228;0;"javeion";228;100;0
166;0;"javel";166;100;0
0;6;"javelin";6;0;100
380;0;"javell";380;100;0
118;0;"javelle";118;100;0
0;5;"javelyn";5;0;100
2975;100;"javen";3075;96.7479674796748;3.2520325203252
0;5;"javene";5;0;100
1402;0;"javeon";1402;100;0
5;0;"javere";5;100;0
0;98;"javeria";98;0;100
41;0;"javery";41;100;0
0;22;"javetta";22;0;100
0;54;"javette";54;0;100
0;5;"javeya";5;0;100
0;23;"javeyah";23;0;100
52;0;"javeyon";52;100;0
15;0;"javez";15;100;0
170;0;"javi";170;100;0
0;249;"javia";249;0;100
0;16;"javiah";16;0;100
5;0;"javiair";5;100;0
2296;6;"javian";2302;99.7393570807993;0.260642919200695
0;78;"javiana";78;0;100
0;22;"javianna";22;0;100
59;0;"javiar";59;100;0
357;0;"javid";357;100;0
359;0;"javiel";359;100;0
1394;0;"javien";1394;100;0
28;0;"javieon";28;100;0
94623;488;"javier";95111;99.4869152884524;0.51308471154756
0;57;"javiera";57;0;100
10;0;"javiere";10;100;0
5;0;"javierjr";5;100;0
2145;5;"javin";2150;99.7674418604651;0.232558139534884
0;5;"javina";5;0;100
5380;11;"javion";5391;99.7959562233352;0.204043776664812
0;24;"javiona";24;0;100
65;0;"javione";65;100;0
0;63;"javionna";63;0;100
32;0;"javionne";32;100;0
5;0;"javionte";5;100;0
155;0;"javious";155;100;0
11;0;"javir";11;100;0
831;5;"javis";836;99.4019138755981;0.598086124401914
0;29;"javita";29;0;100
211;0;"javius";211;100;0
15;0;"javiyon";15;100;0
0;5;"javlyn";5;0;100
125;0;"javohn";125;100;0
15987;755;"javon";16742;95.4903834667304;4.50961653326962
0;231;"javona";231;0;100
0;278;"javonda";278;0;100
6;0;"javondre";6;100;0
419;11;"javone";430;97.4418604651163;2.55813953488372
207;10;"javoni";217;95.3917050691244;4.60829493087558
0;5;"javonia";5;0;100
13;0;"javonie";13;100;0
247;0;"javonn";247;100;0
0;824;"javonna";824;0;100
308;362;"javonne";670;45.9701492537313;54.0298507462687
281;36;"javonni";317;88.6435331230284;11.3564668769716
88;10;"javonnie";98;89.7959183673469;10.2040816326531
808;0;"javonta";808;100;0
1388;0;"javontae";1388;100;0
9;0;"javontai";9;100;0
306;0;"javontay";306;100;0
5;0;"javontaye";5;100;0
3497;39;"javonte";3536;98.8970588235294;1.10294117647059
24;0;"javontez";24;100;0
5;0;"javonti";5;100;0
5;0;"javor";5;100;0
11;0;"javori";11;100;0
395;0;"javoris";395;100;0
15;0;"javorius";15;100;0
38;0;"javy";38;100;0
7;0;"javyion";7;100;0
215;0;"javyn";215;100;0
80;0;"javyon";80;100;0
47;0;"jawaad";47;100;0
199;0;"jawaan";199;100;0
1057;0;"jawad";1057;100;0
0;22;"jawaher";22;0;100
1380;12;"jawan";1392;99.1379310344828;0.862068965517241
0;378;"jawana";378;0;100
0;257;"jawanda";257;0;100
5;0;"jawane";5;100;0
167;0;"jawann";167;100;0
0;306;"jawanna";306;0;100
201;5;"jawanza";206;97.5728155339806;2.42718446601942
274;5;"jawara";279;98.2078853046595;1.7921146953405
5;0;"jawarren";5;100;0
5;0;"jawaski";5;100;0
812;0;"jawaun";812;100;0
11;0;"jawayne";11;100;0
5;0;"jawdat";5;100;0
6;0;"jawhar";6;100;0
748;5;"jawon";753;99.33598937583;0.664010624169987
21;0;"jawone";21;100;0
0;5;"jawonna";5;0;100
58;0;"jaworski";58;100;0
661;0;"jawuan";661;100;0
48;0;"jawun";48;100;0
5;0;"jawvan";5;100;0
6;0;"jawwaad";6;100;0
10;0;"jawwad";10;100;0
12579;115;"jax";12694;99.0940601859146;0.905939814085395
92;0;"jaxan";92;100;0
5;0;"jaxcyn";5;100;0
48;0;"jaxden";48;100;0
17;0;"jaxel";17;100;0
3838;44;"jaxen";3882;98.8665636269964;1.13343637300361
0;43;"jaxi";43;0;100
0;92;"jaxie";92;0;100
139;0;"jaxiel";139;100;0
673;0;"jaxin";673;100;0
6;0;"jaxion";6;100;0
0;10;"jaxlyn";10;0;100
0;14;"jaxlynn";14;0;100
40;0;"jaxn";40;100;0
17;0;"jaxom";17;100;0
63211;268;"jaxon";63479;99.5778131350525;0.422186864947463
5;0;"jaxonjames";5;100;0
5;0;"jaxper";5;100;0
18;0;"jaxs";18;100;0
1285;6;"jaxsen";1291;99.5352439969016;0.464756003098373
143;0;"jaxsin";143;100;0
36065;69;"jaxson";36134;99.8090441135772;0.19095588642276
29;0;"jaxsten";29;100;0
27;0;"jaxstin";27;100;0
380;0;"jaxston";380;100;0
14;0;"jaxstyn";14;100;0
82;0;"jaxsun";82;100;0
481;81;"jaxsyn";562;85.5871886120996;14.4128113879004
288;0;"jaxten";288;100;0
193;0;"jaxtin";193;100;0
4768;0;"jaxton";4768;100;0
234;0;"jaxtyn";234;100;0
6;0;"jaxun";6;100;0
1180;15;"jaxx";1195;98.744769874477;1.25523012552301
88;0;"jaxxen";88;100;0
5;0;"jaxxin";5;100;0
1091;0;"jaxxon";1091;100;0
92;0;"jaxxson";92;100;0
20;0;"jaxxton";20;100;0
18;0;"jaxxyn";18;100;0
645;196;"jaxyn";841;76.6944114149822;23.3055885850178
68;0;"jaxzen";68;100;0
39;0;"jaxzon";39;100;0
13;0;"jaxzyn";13;100;0
185986;2478;"jay";188464;98.6851600305629;1.31483996943713
23;3065;"jaya";3088;0.744818652849741;99.2551813471503
6;0;"jayace";6;100;0
0;466;"jayah";466;0;100
0;5;"jayahna";5;0;100
225;0;"jayan";225;100;0
0;951;"jayana";951;0;100
0;49;"jayanah";49;0;100
6;0;"jayandre";6;100;0
0;351;"jayani";351;0;100
0;45;"jayann";45;0;100
0;936;"jayanna";936;0;100
0;17;"jayannah";17;0;100
0;5;"jayanne";5;0;100
0;19;"jayanni";19;0;100
7;0;"jayansh";7;100;0
126;0;"jayant";126;100;0
136;0;"jayanth";136;100;0
41;0;"jayanthony";41;100;0
0;6;"jayanti";6;0;100
5;0;"jayar";5;100;0
5;0;"jayaun";5;100;0
0;29;"jayauna";29;0;100
5;0;"jayben";5;100;0
5;0;"jaybin";5;100;0
0;5;"jaybree";5;0;100
10;0;"jaybriel";10;100;0
35;0;"jayc";35;100;0
23254;1362;"jayce";24616;94.4670133246669;5.53298667533312
32;0;"jaycean";32;100;0
1120;8454;"jaycee";9574;11.6983496970963;88.3016503029037
21;0;"jayceeon";21;100;0
168;0;"jayceion";168;100;0
26;0;"jaycek";26;100;0
0;199;"jaycelyn";199;0;100
0;93;"jaycelynn";93;0;100
885;5;"jaycen";890;99.438202247191;0.561797752808989
7222;35;"jayceon";7257;99.5177070414772;0.482292958522806
0;43;"jayceona";43;0;100
0;20;"jayceonna";20;0;100
0;60;"jaycey";60;0;100
19;0;"jayceyon";19;100;0
0;1502;"jayci";1502;0;100
0;10;"jaycia";10;0;100
12;0;"jaycian";12;100;0
0;22;"jayciana";22;0;100
5;3321;"jaycie";3326;0.150330727600722;99.8496692723993
30;0;"jaycieon";30;100;0
0;5;"jaycii";5;0;100
13;0;"jaycin";13;100;0
492;0;"jaycion";492;100;0
34;0;"jayco";34;100;0
3598;0;"jaycob";3598;100;0
11;0;"jaycon";11;100;0
96;0;"jaycub";96;100;0
106;329;"jayd";435;24.367816091954;75.632183908046
24;17730;"jayda";17754;0.135180804325786;99.8648191956742
0;1239;"jaydah";1239;0;100
0;69;"jaydalee";69;0;100
0;15;"jaydalin";15;0;100
0;27;"jaydalis";27;0;100
0;7;"jaydalise";7;0;100
0;60;"jaydaliz";60;0;100
0;101;"jaydalyn";101;0;100
0;123;"jaydalynn";123;0;100
0;10;"jaydamarie";10;0;100
2656;571;"jaydan";3227;82.3055469476294;17.6944530523706
0;5;"jaydann";5;0;100
50;0;"jaydden";50;100;0
345;6322;"jayde";6667;5.17474126293685;94.8252587370632
12;0;"jaydean";12;100;0
411;507;"jaydee";918;44.7712418300654;55.2287581699346
113;77;"jaydeen";190;59.4736842105263;40.5263157894737
14;0;"jaydeep";14;100;0
5;0;"jaydehn";5;100;0
10;0;"jaydein";10;100;0
21;0;"jaydel";21;100;0
0;27;"jaydelin";27;0;100
0;12;"jaydeliz";12;0;100
0;37;"jaydelyn";37;0;100
0;19;"jaydelynn";19;0;100
28;0;"jaydem";28;100;0
191243;20605;"jayden";211848;90.2736867943053;9.72631320569465
5;0;"jaydenalexander";5;100;0
117;156;"jaydence";273;42.8571428571429;57.1428571428571
5;0;"jaydenjames";5;100;0
11;0;"jaydenlee";11;100;0
5;0;"jaydenmatthew";5;100;0
5;0;"jaydenmichael";5;100;0
295;48;"jaydenn";343;86.0058309037901;13.9941690962099
6;0;"jaydhen";6;100;0
0;109;"jaydi";109;0;100
0;20;"jaydia";20;0;100
127;0;"jaydian";127;100;0
0;55;"jaydie";55;0;100
31;0;"jaydiel";31;100;0
164;0;"jaydien";164;100;0
2854;1100;"jaydin";3954;72.1800708143652;27.8199291856348
120;13;"jaydis";133;90.2255639097744;9.77443609022556
614;377;"jaydn";991;61.9576185671039;38.0423814328961
8195;196;"jaydon";8391;97.6641639852223;2.33583601477774
159;0;"jaydrian";159;100;0
56;0;"jaydrien";56;100;0
23;0;"jaydun";23;100;0
24;0;"jaydus";24;100;0
0;143;"jaydy";143;0;100
864;665;"jaydyn";1529;56.5075212557227;43.4924787442773
22;58;"jaydynn";80;27.5;72.5
1027;2358;"jaye";3385;30.3397341211226;69.6602658788774
0;5;"jayeda";5;0;100
28;0;"jayeden";28;100;0
71;77;"jayel";148;47.972972972973;52.027027027027
0;11;"jayela";11;0;100
5;0;"jayelin";5;100;0
0;146;"jayelle";146;0;100
0;66;"jayelyn";66;0;100
0;56;"jayelynn";56;0;100
157;0;"jayen";157;100;0
72;0;"jayesh";72;100;0
0;5;"jayetta";5;0;100
23;0;"jayger";23;100;0
5;0;"jayhden";5;100;0
0;25;"jayia";25;0;100
0;6;"jayiah";6;0;100
5;0;"jayiden";5;100;0
65;0;"jayin";65;100;0
93;0;"jayion";93;100;0
131;0;"jayjay";131;100;0
22;0;"jayjuan";22;100;0
39;0;"jayk";39;100;0
314;0;"jayke";314;100;0
10;0;"jayken";10;100;0
5;0;"jaykin";5;100;0
141;0;"jayko";141;100;0
966;0;"jaykob";966;100;0
5;0;"jaykon";5;100;0
70;0;"jaykub";70;100;0
5;0;"jaykwan";5;100;0
77;0;"jaykwon";77;100;0
51;37097;"jayla";37148;0.137288683105416;99.8627113168946
0;76;"jaylaa";76;0;100
0;6;"jaylaah";6;0;100
0;5;"jaylaan";5;0;100
0;7640;"jaylah";7640;0;100
0;13;"jaylamarie";13;0;100
4184;774;"jaylan";4958;84.3888664784187;15.6111335215813
0;19;"jaylana";19;0;100
335;0;"jayland";335;100;0
23;701;"jaylani";724;3.1767955801105;96.8232044198895
0;361;"jaylanie";361;0;100
0;17;"jaylanis";17;0;100
0;11;"jaylann";11;0;100
0;47;"jaylanni";47;0;100
0;33;"jaylannie";33;0;100
0;19;"jaylany";19;0;100
0;12;"jaylarose";12;0;100
6;0;"jaylaun";6;100;0
0;87;"jayle";87;0;100
0;247;"jaylea";247;0;100
0;136;"jayleah";136;0;100
0;265;"jaylean";265;0;100
0;57;"jayleana";57;0;100
0;19;"jayleanna";19;0;100
0;5;"jaylece";5;0;100
99;6201;"jaylee";6300;1.57142857142857;98.4285714285714
199;8800;"jayleen";8999;2.21135681742416;97.7886431825758
0;61;"jayleena";61;0;100
0;175;"jayleene";175;0;100
0;184;"jaylei";184;0;100
0;1076;"jayleigh";1076;0;100
5;16;"jaylein";21;23.8095238095238;76.1904761904762
6;0;"jaylem";6;100;0
31515;4193;"jaylen";35708;88.2575333258654;11.7424666741346
0;126;"jaylena";126;0;100
95;0;"jaylend";95;100;0
75;7956;"jaylene";8031;0.933881210310048;99.06611878969
95;164;"jaylenn";259;36.6795366795367;63.3204633204633
0;202;"jaylenne";202;0;100
77;0;"jayleon";77;100;0
0;15;"jaylese";15;0;100
10;0;"jaylex";10;100;0
0;239;"jayley";239;0;100
0;406;"jayli";406;0;100
0;200;"jaylia";200;0;100
0;184;"jayliah";184;0;100
10;0;"jaylian";10;100;0
0;408;"jayliana";408;0;100
0;49;"jayliani";49;0;100
0;48;"jaylianie";48;0;100
0;35;"jaylianis";35;0;100
0;5;"jaylianiz";5;0;100
0;140;"jaylianna";140;0;100
0;16;"jayliannie";16;0;100
0;11;"jayliany";11;0;100
0;5;"jaylicia";5;0;100
0;767;"jaylie";767;0;100
29;19;"jaylien";48;60.4166666666667;39.5833333333333
9236;7337;"jaylin";16573;55.7291980932843;44.2708019067157
0;123;"jaylina";123;0;100
27;0;"jaylind";27;100;0
5;811;"jayline";816;0.612745098039216;99.3872549019608
28;622;"jaylinn";650;4.30769230769231;95.6923076923077
0;52;"jaylinne";52;0;100
0;17;"jaylis";17;0;100
0;24;"jaylisa";24;0;100
0;64;"jaylise";64;0;100
0;65;"jaylissa";65;0;100
0;5;"jaylisse";5;0;100
0;10;"jayliyah";10;0;100
0;10;"jayliz";10;0;100
6;0;"jayllen";6;100;0
414;226;"jayln";640;64.6875;35.3125
0;92;"jaylnn";92;0;100
9069;252;"jaylon";9321;97.2964274219504;2.70357257804957
19;0;"jaylond";19;100;0
5;0;"jayloni";5;100;0
5;0;"jaylonn";5;100;0
165;0;"jaylun";165;100;0
0;5;"jayly";5;0;100
1554;5012;"jaylyn";6566;23.6673773987207;76.3326226012793
5;99;"jaylyne";104;4.80769230769231;95.1923076923077
472;7878;"jaylynn";8350;5.65269461077844;94.3473053892216
0;340;"jaylynne";340;0;100
0;381;"jayma";381;0;100
6;0;"jayman";6;100;0
12;0;"jaymani";12;100;0
426;0;"jaymar";426;100;0
85;0;"jaymari";85;100;0
0;110;"jaymarie";110;0;100
72;0;"jaymarion";72;100;0
88;0;"jaymason";88;100;0
3717;13783;"jayme";17500;21.24;78.76
23;2023;"jaymee";2046;1.12414467253177;98.8758553274682
11;0;"jaymeir";11;100;0
18;0;"jaymel";18;100;0
234;0;"jaymen";234;100;0
144;0;"jaymere";144;100;0
2194;60;"jaymes";2254;97.338065661047;2.66193433895297
0;7;"jaymesha";7;0;100
444;18;"jaymeson";462;96.1038961038961;3.8961038961039
11;0;"jaymez";11;100;0
5;1314;"jaymi";1319;0.379075056861259;99.6209249431387
0;10;"jaymiah";10;0;100
90;0;"jaymian";90;100;0
6;0;"jaymichael";6;100;0
418;3444;"jaymie";3862;10.8234075608493;89.1765924391507
61;0;"jaymien";61;100;0
40;0;"jaymier";40;100;0
502;0;"jaymin";502;100;0
5;0;"jaymion";5;100;0
126;0;"jaymir";126;100;0
5;0;"jaymis";5;100;0
0;6;"jaymisha";6;0;100
216;0;"jaymison";216;100;0
0;5;"jaymiya";5;0;100
332;0;"jaymon";332;100;0
109;0;"jaymond";109;100;0
17;0;"jayms";17;100;0
0;5;"jaymya";5;0;100
340;0;"jaymz";340;100;0
0;39;"jayn";39;0;100
0;4864;"jayna";4864;0;100
0;42;"jaynae";42;0;100
0;34;"jaynah";34;0;100
0;5;"jaynalis";5;0;100
32;28485;"jayne";28517;0.112213767226567;99.8877862327734
0;762;"jaynee";762;0;100
0;6;"jayneen";6;0;100
0;130;"jaynell";130;0;100
0;38;"jaynelle";38;0;100
0;17;"jaynesha";17;0;100
0;17;"jaynette";17;0;100
30;162;"jayni";192;15.625;84.375
0;95;"jaynia";95;0;100
0;46;"jayniah";46;0;100
0;10;"jaynice";10;0;100
0;1028;"jaynie";1028;0;100
0;6;"jaynisha";6;0;100
0;7;"jayniyah";7;0;100
0;15;"jaynne";15;0;100
725;0;"jayon";725;100;0
0;243;"jayona";243;0;100
0;6;"jayonah";6;0;100
16;0;"jayonn";16;100;0
0;843;"jayonna";843;0;100
11;10;"jayonni";21;52.3809523809524;47.6190476190476
11;0;"jayonte";11;100;0
1576;0;"jayquan";1576;100;0
5;0;"jayquin";5;100;0
65;0;"jayquon";65;100;0
11;0;"jayqwan";11;100;0
106;0;"jayr";106;100;0
0;91;"jayra";91;0;100
0;12;"jayre";12;0;100
8;0;"jayree";8;100;0
8;0;"jayrell";8;100;0
381;0;"jayren";381;100;0
19;0;"jayriel";19;100;0
5;0;"jayrin";5;100;0
573;0;"jayro";573;100;0
539;0;"jayron";539;100;0
0;479;"jaysa";479;0;100
5;0;"jaysan";5;100;0
11;0;"jaysaun";11;100;0
1612;29;"jayse";1641;98.2327848872639;1.76721511273614
0;6;"jaysea";6;0;100
559;0;"jaysean";559;100;0
2481;0;"jaysen";2481;100;0
54;0;"jayseon";54;100;0
0;319;"jaysha";319;0;100
5;0;"jayshan";5;100;0
567;0;"jayshaun";567;100;0
1506;0;"jayshawn";1506;100;0
423;0;"jayshon";423;100;0
100;0;"jayshun";100;100;0
0;13;"jaysia";13;0;100
95;0;"jaysiah";95;100;0
6;0;"jaysian";6;100;0
0;84;"jaysie";84;0;100
213;0;"jaysin";213;100;0
49;0;"jaysion";49;100;0
0;10;"jayslin";10;0;100
31171;32;"jayson";31203;99.8974457584207;0.102554241579335
15;0;"jaysson";15;100;0
62;0;"jaysten";62;100;0
56;0;"jaystin";56;100;0
168;0;"jayston";168;100;0
165;0;"jaysun";165;100;0
15;0;"jaytee";15;100;0
81;0;"jayten";81;100;0
685;0;"jaythan";685;100;0
123;0;"jaythen";123;100;0
6;0;"jaythian";6;100;0
29;0;"jaython";29;100;0
29;0;"jaytin";29;100;0
754;0;"jayton";754;100;0
0;22;"jayva";22;0;100
105;0;"jayvan";105;100;0
37;0;"jayvaughn";37;100;0
5;0;"jayvaun";5;100;0
6;0;"jayvean";6;100;0
10;0;"jayvee";10;100;0
10;0;"jayveer";10;100;0
5;0;"jayvein";5;100;0
79;0;"jayveion";79;100;0
1515;0;"jayven";1515;100;0
1044;0;"jayveon";1044;100;0
0;6;"jayvia";6;0;100
862;0;"jayvian";862;100;0
561;0;"jayvien";561;100;0
206;0;"jayvier";206;100;0
821;0;"jayvin";821;100;0
2537;0;"jayvion";2537;100;0
0;5;"jayviona";5;0;100
0;10;"jayvionna";10;0;100
14;0;"jayvis";14;100;0
10;0;"jayvius";10;100;0
20;0;"jayvn";20;100;0
3269;0;"jayvon";3269;100;0
30;0;"jayvone";30;100;0
45;0;"jayvonn";45;100;0
0;5;"jayvonna";5;0;100
42;0;"jayvonne";42;100;0
24;0;"jayvonni";24;100;0
49;0;"jayvonte";49;100;0
557;0;"jayvyn";557;100;0
0;20;"jaywana";20;0;100
0;8;"jaywanna";8;0;100
16;0;"jaywon";16;100;0
43;0;"jayz";43;100;0
0;5;"jayza";5;0;100
15;0;"jayze";15;100;0
180;0;"jayzen";180;100;0
21;0;"jayzeon";21;100;0
55;0;"jayziah";55;100;0
5;0;"jayziel";5;100;0
5;0;"jayzier";5;100;0
17;0;"jayzin";17;100;0
37;0;"jayzion";37;100;0
193;0;"jayzon";193;100;0
215;105;"jaz";320;67.1875;32.8125
0;37;"jaza";37;0;100
0;19;"jazabel";19;0;100
0;10;"jazabell";10;0;100
0;15;"jazabella";15;0;100
0;14;"jazabelle";14;0;100
0;75;"jazae";75;0;100
46;0;"jazael";46;100;0
0;13;"jazahria";13;0;100
5;0;"jazai";5;100;0
18;10;"jazaiah";28;64.2857142857143;35.7142857142857
5;0;"jazaih";5;100;0
0;5;"jazaiya";5;0;100
0;41;"jazale";41;0;100
0;5;"jazalin";5;0;100
0;13;"jazalle";13;0;100
0;337;"jazalyn";337;0;100
0;193;"jazalynn";193;0;100
0;11;"jazamine";11;0;100
0;10;"jazanae";10;0;100
0;5;"jazaniah";5;0;100
0;211;"jazara";211;0;100
0;133;"jazarah";133;0;100
22;49;"jazari";71;30.9859154929577;69.0140845070423
0;411;"jazaria";411;0;100
0;283;"jazariah";283;0;100
5;0;"jazarian";5;100;0
40;0;"jazarion";40;100;0
0;19;"jazariya";19;0;100
0;35;"jazariyah";35;0;100
5;0;"jazavian";5;100;0
17;0;"jazavier";17;100;0
24;0;"jazavion";24;100;0
0;6;"jazay";6;0;100
0;52;"jazaya";52;0;100
0;57;"jazayah";57;0;100
5;0;"jazayvion";5;100;0
0;5;"jazbel";5;0;100
65;0;"jaze";65;100;0
5;0;"jazeel";5;100;0
5;0;"jazeer";5;100;0
0;10;"jazeera";10;0;100
11;572;"jazel";583;1.88679245283019;98.1132075471698
0;343;"jazell";343;0;100
0;5;"jazella";5;0;100
0;2180;"jazelle";2180;0;100
0;172;"jazelyn";172;0;100
0;39;"jazelynn";39;0;100
0;10;"jazemine";10;0;100
73;0;"jazen";73;100;0
47;0;"jazer";47;100;0
0;5;"jazette";5;0;100
0;5;"jazharia";5;0;100
33;0;"jazhiel";33;100;0
0;72;"jazia";72;0;100
797;680;"jaziah";1477;53.960731211916;46.039268788084
17;0;"jazib";17;100;0
1897;44;"jaziel";1941;97.7331272539928;2.26687274600721
126;0;"jazier";126;100;0
0;166;"jazilyn";166;0;100
0;12;"jazilynn";12;0;100
0;16;"jazimine";16;0;100
5;0;"jazin";5;100;0
192;0;"jazion";192;100;0
142;0;"jazir";142;100;0
0;179;"jazira";179;0;100
0;25;"jazirah";25;0;100
0;7;"jazire";7;0;100
0;11;"jazive";11;0;100
0;265;"jaziya";265;0;100
24;695;"jaziyah";719;3.33796940194715;96.6620305980529
0;6;"jazlean";6;0;100
0;28;"jazlee";28;0;100
0;922;"jazleen";922;0;100
0;15;"jazleene";15;0;100
0;84;"jazlen";84;0;100
0;5;"jazlena";5;0;100
0;1279;"jazlene";1279;0;100
0;975;"jazlin";975;0;100
0;6;"jazlina";6;0;100
0;218;"jazline";218;0;100
0;28;"jazly";28;0;100
0;12026;"jazlyn";12026;0;100
0;442;"jazlyne";442;0;100
0;5840;"jazlynn";5840;0;100
0;272;"jazlynne";272;0;100
0;109;"jazma";109;0;100
0;179;"jazmaine";179;0;100
11;329;"jazman";340;3.23529411764706;96.7647058823529
0;31;"jazmane";31;0;100
5;0;"jazmany";5;100;0
0;23;"jazmari";23;0;100
0;17;"jazmariah";17;0;100
0;233;"jazmarie";233;0;100
0;152;"jazmeen";152;0;100
0;5;"jazmein";5;0;100
5;1069;"jazmen";1074;0.465549348230912;99.5344506517691
0;94;"jazmene";94;0;100
0;5;"jazmenn";5;0;100
0;56;"jazmere";56;0;100
0;41;"jazmia";41;0;100
227;40203;"jazmin";40430;0.561464259213455;99.4385357407865
0;86;"jazmina";86;0;100
99;35074;"jazmine";35173;0.281465897137008;99.718534102863
0;112;"jazminn";112;0;100
0;34;"jazminne";34;0;100
36;225;"jazmon";261;13.7931034482759;86.2068965517241
17;10;"jazmond";27;62.962962962963;37.037037037037
0;5;"jazmone";5;0;100
0;12;"jazmun";12;0;100
0;8481;"jazmyn";8481;0;100
0;5050;"jazmyne";5050;0;100
0;519;"jazmynn";519;0;100
0;47;"jazmynne";47;0;100
214;0;"jazon";214;100;0
172;0;"jazper";172;100;0
0;108;"jazsmin";108;0;100
0;109;"jazsmine";109;0;100
0;5;"jazuri";5;0;100
0;30;"jazya";30;0;100
0;68;"jazyah";68;0;100
0;17;"jazyia";17;0;100
0;92;"jazyiah";92;0;100
0;6;"jazymne";6;0;100
6;0;"jazyon";6;100;0
0;10;"jazyra";10;0;100
0;17;"jazyria";17;0;100
0;16;"jazyriah";16;0;100
704;498;"jazz";1202;58.5690515806988;41.4309484193012
0;22;"jazzabella";22;0;100
0;11;"jazzabelle";11;0;100
0;5;"jazzae";5;0;100
0;221;"jazzalyn";221;0;100
0;90;"jazzalynn";90;0;100
0;5;"jazzanae";5;0;100
0;5;"jazzarae";5;0;100
0;5;"jazzariah";5;0;100
0;54;"jazzel";54;0;100
0;58;"jazzell";58;0;100
0;244;"jazzelle";244;0;100
0;21;"jazzelyn";21;0;100
0;27;"jazzi";27;0;100
0;5;"jazzia";5;0;100
0;6;"jazziah";6;0;100
0;125;"jazzie";125;0;100
68;0;"jazziel";68;100;0
0;30;"jazzilyn";30;0;100
0;7;"jazzilynn";7;0;100
0;34;"jazzleen";34;0;100
0;88;"jazzlene";88;0;100
0;178;"jazzlin";178;0;100
0;2991;"jazzlyn";2991;0;100
0;59;"jazzlyne";59;0;100
0;1298;"jazzlynn";1298;0;100
0;31;"jazzlynne";31;0;100
0;57;"jazzma";57;0;100
0;5;"jazzmaine";5;0;100
24;240;"jazzman";264;9.09090909090909;90.9090909090909
0;11;"jazzmarie";11;0;100
0;488;"jazzmen";488;0;100
0;5;"jazzmene";5;0;100
0;2219;"jazzmin";2219;0;100
0;2373;"jazzmine";2373;0;100
0;5;"jazzminn";5;0;100
0;106;"jazzmon";106;0;100
0;5;"jazzmond";5;0;100
0;6;"jazzmun";6;0;100
0;1087;"jazzmyn";1087;0;100
0;497;"jazzmyne";497;0;100
0;5;"jazzmynn";5;0;100
0;148;"jazzy";148;0;100
571;0;"jb";571;100;0
1648;37;"jc";1685;97.8041543026706;2.19584569732938
19;0;"jceion";19;100;0
142;0;"jceon";142;100;0
6;0;"jceyon";6;100;0
55;0;"jcion";55;100;0
5;0;"jcorey";5;100;0
11;0;"jcyon";11;100;0
1270;30;"jd";1300;97.6923076923077;2.30769230769231
0;54;"jda";54;0;100
0;5;"jdah";5;0;100
5;0;"jdan";5;100;0
274;0;"jden";274;100;0
6;0;"jdin";6;100;0
5;0;"jdon";5;100;0
122;0;"jdyn";122;100;0
5;0;"jdynn";5;100;0
10;0;"je";10;100;0
0;16;"jea";16;0;100
5;0;"jeaden";5;100;0
5;0;"jeadon";5;100;0
0;9;"jealisa";9;0;100
0;21;"jealousy";21;0;100
0;11;"jealyn";11;0;100
0;10;"jeamileth";10;0;100
23361;454320;"jean";477681;4.89050223894189;95.1094977610581
0;7575;"jeana";7575;0;100
0;149;"jeanae";149;0;100
0;644;"jeanann";644;0;100
0;376;"jeananne";376;0;100
0;6;"jeanasia";6;0;100
0;10;"jeanaya";10;0;100
5;0;"jeanbaptiste";5;100;0
839;0;"jeancarlo";839;100;0
1026;0;"jeancarlos";1026;100;0
6;0;"jeanchristophe";6;100;0
356;0;"jeanclaude";356;100;0
16;4437;"jeane";4453;0.359308331461936;99.6406916685381
0;24;"jeanea";24;0;100
0;196;"jeanean";196;0;100
0;72;"jeaneane";72;0;100
0;173;"jeanee";173;0;100
0;886;"jeaneen";886;0;100
0;15;"jeanel";15;0;100
0;874;"jeanell";874;0;100
0;30;"jeanella";30;0;100
0;2171;"jeanelle";2171;0;100
0;26;"jeanelly";26;0;100
0;2425;"jeanene";2425;0;100
0;373;"jeanenne";373;0;100
0;17;"jeanessa";17;0;100
0;209;"jeanet";209;0;100
0;11;"jeanete";11;0;100
0;35;"jeaneth";35;0;100
0;1079;"jeanett";1079;0;100
0;5101;"jeanetta";5101;0;100
538;160522;"jeanette";161060;0.334037004842916;99.6659629951571
0;5;"jeanettie";5;0;100
0;422;"jeani";422;0;100
0;374;"jeania";374;0;100
0;1255;"jeanice";1255;0;100
0;16848;"jeanie";16848;0;100
0;10;"jeaniece";10;0;100
0;16;"jeaniene";16;0;100
0;100;"jeanifer";100;0;100
0;51;"jeanina";51;0;100
11;23677;"jeanine";23688;0.0464370145221209;99.9535629854779
0;210;"jeaninne";210;0;100
0;11;"jeanique";11;0;100
0;84;"jeanise";84;0;100
0;281;"jeanita";281;0;100
0;5;"jeanitta";5;0;100
0;5;"jeaniyah";5;0;100
5;0;"jeanjacques";5;100;0
848;0;"jeanluc";848;100;0
5;0;"jeanluca";5;100;0
6;0;"jeanlucas";6;100;0
12;0;"jeanluke";12;100;0
168;0;"jeanmarc";168;100;0
5;0;"jeanmarco";5;100;0
0;2302;"jeanmarie";2302;0;100
26;0;"jeanmichael";26;100;0
42;0;"jeanmichel";42;100;0
0;53;"jeann";53;0;100
0;8720;"jeanna";8720;0;100
361;162257;"jeanne";162618;0.221992645340614;99.7780073546594
0;5;"jeannea";5;0;100
0;58;"jeannean";58;0;100
0;28;"jeannedarc";28;0;100
0;33;"jeannee";33;0;100
0;5;"jeannell";5;0;100
0;75;"jeannelle";75;0;100
0;271;"jeannemarie";271;0;100
0;683;"jeannene";683;0;100
0;30;"jeannet";30;0;100
0;37;"jeannete";37;0;100
0;677;"jeannett";677;0;100
0;1476;"jeannetta";1476;0;100
49;67039;"jeannette";67088;0.0730383973288815;99.9269616026711
0;7;"jeanney";7;0;100
0;139;"jeanni";139;0;100
0;63;"jeannia";63;0;100
0;5;"jeannice";5;0;100
0;5;"jeannicole";5;0;100
55;35842;"jeannie";35897;0.153216146196061;99.8467838538039
0;79;"jeannifer";79;0;100
6;24003;"jeannine";24009;0.0249906285143071;99.9750093714857
0;361;"jeanny";361;0;100
1659;0;"jeanpaul";1659;100;0
33;0;"jeanphilippe";33;100;0
1041;0;"jeanpierre";1041;100;0
0;28;"jeantte";28;0;100
0;137;"jeany";137;0;100
538;54;"jearl";592;90.8783783783784;9.12162162162162
547;0;"jearld";547;100;0
0;63;"jearldean";63;0;100
0;382;"jearldine";382;0;100
0;276;"jearlean";276;0;100
0;185;"jearlene";185;0;100
0;347;"jearline";347;0;100
32;0;"jearold";32;100;0
10;0;"jeason";10;100;0
7;0;"jeaven";7;100;0
2431;0;"jeb";2431;100;0
181;0;"jebadiah";181;100;0
34;0;"jebb";34;100;0
573;0;"jebediah";573;100;0
92;0;"jebidiah";92;100;0
5;0;"jebreel";5;100;0
0;15;"jebria";15;0;100
25;0;"jebron";25;100;0
59;0;"jecaryous";59;100;0
0;11;"jeccica";11;0;100
0;119;"jecenia";119;0;100
6;0;"jeckson";6;100;0
7;0;"jeconiah";7;100;0
36;0;"jecorey";36;100;0
10;0;"jecori";10;100;0
38;0;"jecory";38;100;0
8242;0;"jed";8242;100;0
0;169;"jeda";169;0;100
12;0;"jedadia";12;100;0
527;0;"jedadiah";527;100;0
0;5;"jedah";5;0;100
136;0;"jedaiah";136;100;0
12;0;"jedarius";12;100;0
767;0;"jedd";767;100;0
5;0;"jeddie";5;100;0
2856;0;"jedediah";2856;100;0
5;0;"jeden";5;100;0
145;0;"jedi";145;100;0
23;0;"jediael";23;100;0
602;0;"jediah";602;100;0
0;53;"jedidah";53;0;100
6434;28;"jedidiah";6462;99.5666976168369;0.433302383163107
34;0;"jediel";34;100;0
7;0;"jedikiah";7;100;0
166;0;"jedrek";166;100;0
6;0;"jedric";6;100;0
92;0;"jedrick";92;100;0
5;0;"jedriel";5;100;0
19;0;"jedrik";19;100;0
5;38;"jee";43;11.6279069767442;88.3720930232558
5;5;"jeel";10;50;50
0;431;"jeena";431;0;100
0;5;"jeenifer";5;0;100
12;0;"jeese";12;100;0
0;5;"jeesica";5;0;100
196;0;"jeet";196;100;0
5;0;"jeeva";5;100;0
375;0;"jeevan";375;100;0
0;10;"jeevika";10;0;100
0;45;"jeeya";45;0;100
0;5;"jeeyoung";5;0;100
129;0;"jef";129;100;0
304;0;"jeferson";304;100;0
52;0;"jefery";52;100;0
118479;258;"jeff";118737;99.7827130549028;0.217286945097147
35;0;"jeffary";35;100;0
30;0;"jeffer";30;100;0
3958;0;"jefferey";3958;100;0
6;0;"jefferi";6;100;0
108;0;"jefferie";108;100;0
20680;0;"jefferson";20680;100;0
228703;1269;"jeffery";229972;99.4481936931452;0.551806306854748
150;0;"jeffey";150;100;0
671;901;"jeffie";1572;42.6844783715013;57.3155216284987
0;170;"jeffifer";170;0;100
11;0;"jeffon";11;100;0
11;0;"jefford";11;100;0
5;0;"jefforey";5;100;0
1167;0;"jeffory";1167;100;0
55;0;"jeffray";55;100;0
257;0;"jeffre";257;100;0
105;0;"jeffree";105;100;0
84;0;"jeffren";84;100;0
5;0;"jeffrery";5;100;0
972679;3499;"jeffrey";976178;99.6415612726367;0.358438727363247
5;0;"jeffreyjames";5;100;0
50;0;"jeffri";50;100;0
929;86;"jeffrie";1015;91.5270935960591;8.47290640394089
10;0;"jeffries";10;100;0
5;0;"jeffro";5;100;0
15208;10;"jeffry";15218;99.934288342752;0.0657116572479958
49;0;"jeffy";49;100;0
21;0;"jefre";21;100;0
18;0;"jefren";18;100;0
762;0;"jefrey";762;100;0
30;0;"jefri";30;100;0
5;0;"jefrin";5;100;0
246;0;"jefry";246;100;0
127;0;"jefte";127;100;0
5;0;"jeg";5;100;0
175;0;"jehad";175;100;0
106;330;"jehan";436;24.3119266055046;75.6880733944954
127;0;"jehiel";127;100;0
0;105;"jehieli";105;0;100
0;11;"jehilyn";11;0;100
12;8;"jehlani";20;60;40
0;17;"jehna";17;0;100
0;15;"jehnna";15;0;100
7;0;"jehonadab";7;100;0
14;0;"jehoshua";14;100;0
27;0;"jehovah";27;100;0
5;0;"jehovany";5;100;0
5;0;"jehremy";5;100;0
5;0;"jehron";5;100;0
831;0;"jehu";831;100;0
7;0;"jeice";7;100;0
5;0;"jeicob";5;100;0
0;50;"jeida";50;0;100
5;0;"jeidan";5;100;0
117;0;"jeiden";117;100;0
0;87;"jeidi";87;0;100
0;279;"jeidy";279;0;100
5;0;"jeidyn";5;100;0
23;0;"jeiel";23;100;0
0;53;"jeila";53;0;100
0;56;"jeilani";56;0;100
0;28;"jeilany";28;0;100
0;27;"jeileen";27;0;100
0;16;"jeilene";16;0;100
0;10;"jeilianys";10;0;100
0;53;"jeilin";53;0;100
0;184;"jeily";184;0;100
0;292;"jeilyn";292;0;100
0;12;"jeilynn";12;0;100
0;43;"jeimi";43;0;100
0;25;"jeimmy";25;0;100
0;548;"jeimy";548;0;100
5;0;"jeiner";5;100;0
0;10;"jeinny";10;0;100
0;6;"jeiny";6;0;100
0;5;"jeira";5;0;100
30;0;"jeiren";30;100;0
0;5;"jeiri";5;0;100
0;61;"jeiry";61;0;100
295;0;"jeison";295;100;0
0;6;"jeisy";6;0;100
0;12;"jeiza";12;0;100
217;0;"jejuan";217;100;0
16;0;"jekai";16;100;0
0;5;"jekalyn";5;0;100
10;0;"jekari";10;100;0
0;36;"jekayla";36;0;100
0;5;"jekeria";5;0;100
5;0;"jekhari";5;100;0
101;0;"jekhi";101;100;0
0;26;"jekia";26;0;100
0;7;"jekiah";7;0;100
12;0;"jekobe";12;100;0
5;0;"jekori";5;100;0
0;59;"jela";59;0;100
0;11;"jelah";11;0;100
0;5;"jelaina";5;0;100
0;48;"jelaine";48;0;100
73;0;"jelan";73;100;0
0;12;"jelana";12;0;100
3828;418;"jelani";4246;90.1554404145078;9.84455958549223
0;5;"jelanie";5;0;100
0;5;"jelany";5;0;100
0;5;"jelaya";5;0;100
0;5;"jelayne";5;0;100
0;52;"jeleah";52;0;100
0;21;"jelecia";21;0;100
0;57;"jeleesa";57;0;100
18;0;"jelen";18;100;0
0;1273;"jelena";1273;0;100
0;62;"jelene";62;0;100
0;71;"jelesa";71;0;100
0;23;"jelesia";23;0;100
0;32;"jelessa";32;0;100
0;15;"jelia";15;0;100
0;21;"jeliah";21;0;100
0;6;"jeliana";6;0;100
0;13;"jelica";13;0;100
0;131;"jelicia";131;0;100
14;0;"jeliel";14;100;0
0;175;"jelina";175;0;100
0;1083;"jelisa";1083;0;100
0;5;"jelise";5;0;100
0;74;"jelisha";74;0;100
0;10;"jelisia";10;0;100
0;868;"jelissa";868;0;100
0;91;"jelitza";91;0;100
0;68;"jeliyah";68;0;100
0;29;"jellisa";29;0;100
22;0;"jelon";22;100;0
12;0;"jeloni";12;100;0
0;10;"jelsy";10;0;100
0;12;"jelyn";12;0;100
0;10;"jelynn";10;0;100
0;6;"jelysa";6;0;100
0;21;"jelyssa";21;0;100
36;69;"jem";105;34.2857142857143;65.7142857142857
0;302;"jema";302;0;100
169;0;"jemaine";169;100;0
890;0;"jemal";890;100;0
24;0;"jemale";24;100;0
469;0;"jemar";469;100;0
315;0;"jemarcus";315;100;0
240;0;"jemari";240;100;0
98;0;"jemario";98;100;0
121;0;"jemarion";121;100;0
13;0;"jemarius";13;100;0
6;0;"jemarr";6;100;0
5;0;"jemauri";5;100;0
0;5;"jemaya";5;0;100
0;73;"jemeka";73;0;100
0;5;"jemekia";5;0;100
714;0;"jemel";714;100;0
0;5;"jemelia";5;0;100
149;0;"jemell";149;100;0
30;0;"jemelle";30;100;0
0;5;"jemely";5;0;100
32;0;"jemere";32;100;0
0;6;"jemeria";6;0;100
5;0;"jemerrio";5;100;0
88;0;"jemery";88;100;0
5;0;"jemes";5;100;0
0;10;"jemi";10;0;100
0;181;"jemia";181;0;100
99;195;"jemiah";294;33.6734693877551;66.3265306122449
0;42;"jemica";42;0;100
10;0;"jemichael";10;100;0
5;0;"jemier";5;100;0
0;44;"jemika";44;0;100
33;0;"jemil";33;100;0
0;125;"jemila";125;0;100
0;6;"jemilla";6;0;100
0;16;"jemily";16;0;100
0;1257;"jemima";1257;0;100
0;323;"jemimah";323;0;100
0;101;"jemina";101;0;100
17;52;"jemini";69;24.6376811594203;75.3623188405797
12;0;"jemir";12;100;0
0;6;"jemira";6;0;100
0;35;"jemiya";35;0;100
0;33;"jemiyah";33;0;100
0;3861;"jemma";3861;0;100
0;24;"jemmah";24;0;100
8;0;"jemmerio";8;100;0
110;91;"jemmie";201;54.726368159204;45.273631840796
0;10;"jemmy";10;0;100
5;0;"jemon";5;100;0
5;0;"jemond";5;100;0
91;0;"jemuel";91;100;0
0;109;"jemya";109;0;100
0;5;"jemyah";5;0;100
86;319;"jen";405;21.2345679012346;78.7654320987654
7;12966;"jena";12973;0.0539582209203731;99.9460417790796
0;7;"jenabelle";7;0;100
0;6;"jenacia";6;0;100
0;3214;"jenae";3214;0;100
0;179;"jenafer";179;0;100
0;465;"jenah";465;0;100
0;737;"jenai";737;0;100
0;5;"jenaia";5;0;100
0;5;"jenaiah";5;0;100
0;37;"jenaiya";37;0;100
0;6;"jenaka";6;0;100
0;12;"jenal";12;0;100
0;6;"jenalea";6;0;100
0;442;"jenalee";442;0;100
0;6;"jenali";6;0;100
0;16;"jenalis";16;0;100
0;53;"jenalise";53;0;100
0;11;"jenaliz";11;0;100
0;259;"jenalyn";259;0;100
0;21;"jenalynn";21;0;100
0;5;"jenalys";5;0;100
0;10;"jenalyse";10;0;100
0;253;"jenan";253;0;100
0;5;"jenanne";5;0;100
0;16;"jenara";16;0;100
51;0;"jenard";51;100;0
644;0;"jenaro";644;100;0
0;81;"jenascia";81;0;100
0;88;"jenasia";88;0;100
0;275;"jenasis";275;0;100
0;37;"jenasys";37;0;100
0;5;"jenave";5;0;100
0;45;"jenavecia";45;0;100
0;107;"jenavee";107;0;100
0;94;"jenaveve";94;0;100
0;61;"jenavi";61;0;100
0;9;"jenavicia";9;0;100
0;200;"jenavie";200;0;100
0;724;"jenavieve";724;0;100
0;65;"jenavive";65;0;100
0;10;"jenavy";10;0;100
5;948;"jenay";953;0.524658971668415;99.4753410283316
0;895;"jenaya";895;0;100
0;100;"jenayah";100;0;100
0;143;"jenaye";143;0;100
167;0;"jencarlo";167;100;0
905;0;"jencarlos";905;100;0
0;5;"jenci";5;0;100
0;21;"jencie";21;0;100
10;206;"jency";216;4.62962962962963;95.3703703703704
0;5;"jencyn";5;0;100
0;74;"jendaya";74;0;100
0;124;"jendayi";124;0;100
6;0;"jendriel";6;100;0
5;0;"jendry";5;100;0
646;1572;"jene";2218;29.1253381424707;70.8746618575293
0;810;"jenea";810;0;100
0;71;"jeneal";71;0;100
0;798;"jenean";798;0;100
0;568;"jeneane";568;0;100
0;24;"jeneanne";24;0;100
0;5;"jeneba";5;0;100
0;18;"jeneca";18;0;100
0;17;"jenece";17;0;100
0;27;"jenecia";27;0;100
0;5;"jenedy";5;0;100
0;1996;"jenee";1996;0;100
0;1091;"jeneen";1091;0;100
0;17;"jeneene";17;0;100
0;320;"jenefer";320;0;100
0;42;"jeneffer";42;0;100
0;47;"jeneice";47;0;100
0;17;"jeneil";17;0;100
0;5;"jeneine";5;0;100
0;13;"jeneka";13;0;100
0;510;"jenel";510;0;100
0;5;"jenele";5;0;100
0;5;"jenelee";5;0;100
0;3035;"jenell";3035;0;100
0;55;"jenella";55;0;100
0;6827;"jenelle";6827;0;100
0;34;"jenelly";34;0;100
0;35;"jenely";35;0;100
0;543;"jenene";543;0;100
0;5;"jenera";5;0;100
0;109;"jenesa";109;0;100
0;157;"jenese";157;0;100
0;6;"jenesha";6;0;100
0;5;"jenesi";5;0;100
0;20;"jenesia";20;0;100
32;2674;"jenesis";2706;1.18255728011826;98.8174427198817
0;5;"jeness";5;0;100
0;3007;"jenessa";3007;0;100
0;5;"jenesse";5;0;100
0;5;"jenessia";5;0;100
0;11;"jenessis";11;0;100
0;53;"jenessy";53;0;100
0;5;"jenesy";5;0;100
0;107;"jenesys";107;0;100
0;103;"jenet";103;0;100
0;46;"jenett";46;0;100
0;652;"jenetta";652;0;100
0;1924;"jenette";1924;0;100
0;5;"jenettie";5;0;100
0;978;"jeneva";978;0;100
0;11;"jenevi";11;0;100
0;136;"jenevie";136;0;100
0;1173;"jenevieve";1173;0;100
0;5;"jenevive";5;0;100
0;44;"jenevy";44;0;100
0;12;"jeneya";12;0;100
0;2834;"jeni";2834;0;100
0;398;"jenia";398;0;100
0;444;"jeniah";444;0;100
0;5;"jenibelle";5;0;100
0;1937;"jenica";1937;0;100
0;1899;"jenice";1899;0;100
0;6;"jenicia";6;0;100
0;194;"jenicka";194;0;100
0;244;"jenie";244;0;100
0;508;"jeniece";508;0;100
79;0;"jeniel";79;100;0
0;47;"jenielle";47;0;100
0;34;"jeniene";34;0;100
22;25388;"jenifer";25410;0.0865800865800866;99.9134199134199
0;3629;"jeniffer";3629;0;100
0;780;"jenika";780;0;100
8;0;"jenil";8;100;0
0;7;"jenilca";7;0;100
0;806;"jenilee";806;0;100
0;69;"jenille";69;0;100
0;136;"jenilyn";136;0;100
0;144;"jenin";144;0;100
0;87;"jenina";87;0;100
0;2246;"jenine";2246;0;100
0;10;"jeninne";10;0;100
0;226;"jenipher";226;0;100
0;13;"jeniqua";13;0;100
0;60;"jenique";60;0;100
0;5;"jenis";5;0;100
0;149;"jenisa";149;0;100
0;2695;"jenise";2695;0;100
5;0;"jenish";5;100;0
0;230;"jenisha";230;0;100
0;129;"jenisis";129;0;100
0;193;"jenissa";193;0;100
0;75;"jenisse";75;0;100
0;19;"jenisys";19;0;100
0;473;"jenita";473;0;100
0;6;"jenith";6;0;100
0;5;"jenitha";5;0;100
0;24;"jenitza";24;0;100
0;25;"jeniva";25;0;100
0;5;"jenive";5;0;100
0;15;"jeniveve";15;0;100
0;13;"jenivieve";13;0;100
0;375;"jeniya";375;0;100
0;457;"jeniyah";457;0;100
5;0;"jenkarlo";5;100;0
218;0;"jenkins";218;100;0
0;23;"jenn";23;0;100
257;143429;"jenna";143686;0.178862241276116;99.8211377587239
0;5;"jennabel";5;0;100
0;5;"jennabella";5;0;100
0;21;"jennabelle";21;0;100
0;10;"jennaca";10;0;100
0;360;"jennae";360;0;100
0;1080;"jennafer";1080;0;100
0;2702;"jennah";2702;0;100
0;11;"jennaka";11;0;100
0;10;"jennalea";10;0;100
0;662;"jennalee";662;0;100
0;11;"jennaleigh";11;0;100
0;49;"jennalise";49;0;100
0;5;"jennaliz";5;0;100
0;421;"jennalyn";421;0;100
0;190;"jennalynn";190;0;100
0;5;"jennalyse";5;0;100
0;194;"jennamarie";194;0;100
0;32;"jennarae";32;0;100
0;22;"jennarose";22;0;100
0;46;"jennasis";46;0;100
0;244;"jennavecia";244;0;100
0;10;"jennavee";10;0;100
0;21;"jennaveve";21;0;100
0;5;"jennavi";5;0;100
0;40;"jennavicia";40;0;100
0;127;"jennavie";127;0;100
0;397;"jennavieve";397;0;100
0;44;"jennavive";44;0;100
0;51;"jennay";51;0;100
0;87;"jennaya";87;0;100
0;569;"jenne";569;0;100
0;78;"jennea";78;0;100
0;23;"jennean";23;0;100
0;6;"jennedy";6;0;100
0;18;"jennee";18;0;100
0;1498;"jennefer";1498;0;100
0;15;"jenneffer";15;0;100
0;12;"jenneh";12;0;100
0;13;"jenneifer";13;0;100
0;270;"jennel";270;0;100
0;1296;"jennell";1296;0;100
0;1072;"jennelle";1072;0;100
0;14;"jennely";14;0;100
0;15;"jennelyn";15;0;100
0;110;"jennene";110;0;100
483;15;"jenner";498;96.9879518072289;3.01204819277108
0;29;"jennesa";29;0;100
0;72;"jennesis";72;0;100
0;79;"jenness";79;0;100
0;603;"jennessa";603;0;100
0;121;"jennessy";121;0;100
0;15;"jennesy";15;0;100
0;166;"jennet";166;0;100
0;41;"jenneth";41;0;100
0;586;"jennett";586;0;100
0;550;"jennetta";550;0;100
0;3390;"jennette";3390;0;100
0;5;"jennevie";5;0;100
0;5;"jennevieve";5;0;100
0;5;"jennevy";5;0;100
0;509;"jenney";509;0;100
0;128;"jennfer";128;0;100
0;234;"jennfier";234;0;100
0;5386;"jenni";5386;0;100
0;56;"jennia";56;0;100
0;63;"jenniah";63;0;100
0;1836;"jennica";1836;0;100
0;305;"jennice";305;0;100
0;15;"jennicka";15;0;100
419;104453;"jennie";104872;0.39953467083683;99.6004653291632
0;309;"jenniefer";309;0;100
0;5;"jennieke";5;0;100
0;6;"jennielee";6;0;100
0;247;"jennier";247;0;100
0;18;"jennieve";18;0;100
0;265;"jennife";265;0;100
4838;1465243;"jennifer";1470081;0.329097512313947;99.670902487686
0;110;"jenniferann";110;0;100
0;29;"jenniferanne";29;0;100
0;10;"jennifere";10;0;100
0;24;"jenniferlee";24;0;100
0;111;"jenniferlynn";111;0;100
0;56;"jennifermarie";56;0;100
0;7;"jenniferr";7;0;100
0;10;"jenniferrose";10;0;100
0;2877;"jenniffer";2877;0;100
0;506;"jennifier";506;0;100
0;106;"jennifr";106;0;100
0;47;"jenniger";47;0;100
0;413;"jennika";413;0;100
0;483;"jennilee";483;0;100
0;11;"jennille";11;0;100
0;333;"jennilyn";333;0;100
0;16;"jennilynn";16;0;100
0;1239;"jennine";1239;0;100
10;0;"jenning";10;100;0
4013;127;"jennings";4140;96.9323671497585;3.06763285024155
0;5;"jenniper";5;0;100
0;639;"jennipher";639;0;100
29;20;"jennis";49;59.1836734693878;40.8163265306122
0;15;"jennisa";15;0;100
0;158;"jennise";158;0;100
0;36;"jenniver";36;0;100
0;16;"jenniya";16;0;100
0;22;"jenniyah";22;0;100
0;38;"jennnifer";38;0;100
605;90060;"jenny";90665;0.667291678155848;99.3327083218442
0;5;"jennya";5;0;100
0;68;"jennye";68;0;100
0;1723;"jennyfer";1723;0;100
0;101;"jennylee";101;0;100
0;12;"jennylyn";12;0;100
0;19;"jennylynn";19;0;100
254;0;"jeno";254;100;0
11;0;"jenoah";11;100;0
0;14;"jenohn";14;0;100
0;5;"jenola";5;0;100
0;16;"jenora";16;0;100
0;40;"jenova";40;0;100
24;0;"jenri";24;100;0
11;0;"jenrri";11;100;0
35;0;"jenrry";35;100;0
57;0;"jenry";57;100;0
2207;0;"jens";2207;100;0
7249;2308;"jensen";9557;75.850162184786;24.149837815214
0;15;"jensie";15;0;100
5;0;"jensiel";5;100;0
5;0;"jensin";5;100;0
0;333;"jensine";333;0;100
1434;27;"jenson";1461;98.1519507186858;1.84804928131417
5;0;"jenssy";5;100;0
59;39;"jensy";98;60.2040816326531;39.7959183673469
91;450;"jensyn";541;16.8207024029575;83.1792975970425
18;0;"jentezen";18;100;0
0;228;"jentri";228;0;100
0;39;"jentrie";39;0;100
280;717;"jentry";997;28.0842527582748;71.9157472417252
115;0;"jentzen";115;100;0
6;0;"jenuel";6;100;0
0;351;"jeny";351;0;100
0;141;"jenya";141;0;100
0;29;"jenyah";29;0;100
0;15;"jenyce";15;0;100
0;168;"jenyfer";168;0;100
0;5;"jenyiah";5;0;100
0;5;"jenyka";5;0;100
0;11;"jenyla";11;0;100
0;6;"jenysis";6;0;100
0;5;"jenyssa";5;0;100
11;0;"jenzel";11;100;0
5;0;"jenzen";5;100;0
23;0;"jenziel";23;100;0
244;0;"jeoffrey";244;100;0
5;0;"jeon";5;100;0
5;0;"jeong";5;100;0
0;6;"jeopardy";6;0;100
344;0;"jeorge";344;100;0
0;139;"jeorgia";139;0;100
0;5;"jeorgina";5;0;100
5;0;"jeovan";5;100;0
0;11;"jeovana";11;0;100
316;0;"jeovani";316;100;0
0;16;"jeovanna";16;0;100
396;0;"jeovanni";396;100;0
368;0;"jeovanny";368;100;0
444;0;"jeovany";444;100;0
92;0;"jep";92;100;0
25;0;"jephte";25;100;0
12;0;"jephthah";12;100;0
12;0;"jephthe";12;100;0
10;0;"jeppie";10;100;0
25;0;"jepson";25;100;0
246;0;"jeptha";246;100;0
265;0;"jequan";265;100;0
6;0;"jequarius";6;100;0
0;34;"jequetta";34;0;100
0;16;"jequita";16;0;100
10;12;"jer";22;45.4545454545455;54.5454545454545
0;735;"jera";735;0;100
3782;0;"jerad";3782;100;0
11;0;"jerade";11;100;0
6;61;"jerae";67;8.95522388059701;91.044776119403
0;96;"jerah";96;0;100
8;0;"jerahmy";8;100;0
5;0;"jerail";5;100;0
421;10;"jeral";431;97.6798143851508;2.32018561484919
25911;102;"jerald";26013;99.6078883635106;0.392111636489448
0;88;"jeraldean";88;0;100
0;45;"jeraldene";45;0;100
0;11;"jeraldi";11;0;100
0;66;"jeraldin";66;0;100
0;4313;"jeraldine";4313;0;100
58;0;"jeraldo";58;100;0
0;51;"jeraldy";51;0;100
0;6;"jeraldyn";6;0;100
0;36;"jeralee";36;0;100
0;49;"jeralene";49;0;100
0;254;"jeraline";254;0;100
0;1308;"jeralyn";1308;0;100
0;107;"jeralynn";107;0;100
12;0;"jeramaine";12;100;0
563;0;"jerame";563;100;0
40;0;"jeramee";40;100;0
636;0;"jeramey";636;100;0
375;6;"jerami";381;98.4251968503937;1.5748031496063
134;0;"jeramia";134;100;0
4386;0;"jeramiah";4386;100;0
3352;41;"jeramie";3393;98.7916298261126;1.20837017388742
50;0;"jeramih";50;100;0
28;0;"jeramiha";28;100;0
95;0;"jeramine";95;100;0
5;0;"jeramiyah";5;100;0
4448;5;"jeramy";4453;99.8877161464181;0.112283853581855
6;0;"jeramya";6;100;0
203;0;"jeramyah";203;100;0
487;8;"jeran";495;98.3838383838384;1.61616161616162
0;5;"jerane";5;0;100
1017;0;"jerard";1017;100;0
1438;0;"jerardo";1438;100;0
140;0;"jerauld";140;100;0
62;0;"jeray";62;100;0
0;10;"jerdean";10;0;100
0;7;"jerdine";7;0;100
4256;1159;"jere";5415;78.5964912280702;21.4035087719298
5;0;"jereal";5;100;0
6;0;"jereck";6;100;0
3735;0;"jered";3735;100;0
22;0;"jerediah";22;100;0
5;202;"jeree";207;2.41545893719807;97.5845410628019
5;0;"jereimah";5;100;0
459;0;"jerek";459;100;0
3517;5;"jerel";3522;99.8580352072686;0.141964792731403
72;0;"jereld";72;100;0
0;16;"jereldine";16;0;100
0;31;"jerelean";31;0;100
0;349;"jerelene";349;0;100
0;6;"jerelin";6;0;100
0;185;"jereline";185;0;100
1603;5;"jerell";1608;99.6890547263682;0.310945273631841
187;12;"jerelle";199;93.9698492462311;6.03015075376884
0;8;"jerelly";8;0;100
0;6;"jerely";6;0;100
0;886;"jerelyn";886;0;100
13;0;"jerem";13;100;0
5;0;"jeremah";5;100;0
40;0;"jeremai";40;100;0
22;0;"jeremaiah";22;100;0
413;0;"jeremaih";413;100;0
213;0;"jeremaine";213;100;0
2214;0;"jereme";2214;100;0
59;0;"jeremee";59;100;0
5;0;"jeremery";5;100;0
3382;0;"jeremey";3382;100;0
1525;44;"jeremi";1569;97.195666029318;2.80433397068196
629;10;"jeremia";639;98.4350547730829;1.56494522691706
183877;644;"jeremiah";184521;99.6509882344015;0.349011765598496
13;0;"jeremiaha";13;100;0
11;0;"jeremiahs";11;100;0
6;0;"jeremial";6;100;0
69;0;"jeremian";69;100;0
2778;0;"jeremias";2778;100;0
4130;70;"jeremie";4200;98.3333333333333;1.66666666666667
811;0;"jeremih";811;100;0
50;0;"jeremiha";50;100;0
6;0;"jeremiya";6;100;0
190;0;"jeremiyah";190;100;0
34;0;"jeremmy";34;100;0
432205;2302;"jeremy";434507;99.4702041624186;0.529795837581443
19;7;"jeremya";26;73.0769230769231;26.9230769230769
765;0;"jeremyah";765;100;0
5;0;"jeremyh";5;100;0
11;0;"jeremyiah";11;100;0
391;0;"jeren";391;100;0
0;10;"jerena";10;0;100
0;537;"jerene";537;0;100
6;0;"jereny";6;100;0
6;0;"jereomy";6;100;0
0;5;"jeresa";5;0;100
6;0;"jeresiah";6;100;0
223;0;"jeret";223;100;0
31;0;"jereth";31;100;0
320;0;"jerett";320;100;0
0;46;"jeretta";46;0;100
5;0;"jerey";5;100;0
12;0;"jerez";12;100;0
0;10;"jerhonda";10;0;100
377;22528;"jeri";22905;1.64592883649858;98.3540711635014
0;6;"jeria";6;0;100
1051;267;"jeriah";1318;79.742033383915;20.257966616085
62;0;"jerian";62;100;0
0;6;"jeriana";6;0;100
0;249;"jeriann";249;0;100
0;6;"jerianna";6;0;100
0;116;"jerianne";116;0;100
543;0;"jeric";543;100;0
0;3834;"jerica";3834;0;100
0;31;"jericah";31;0;100
0;68;"jericca";68;0;100
0;216;"jericha";216;0;100
3804;249;"jericho";4053;93.8564026646928;6.14359733530718
0;5;"jericia";5;0;100
711;0;"jerick";711;100;0
0;441;"jericka";441;0;100
12;0;"jericko";12;100;0
777;8;"jerico";785;98.9808917197452;1.01910828025478
858;0;"jerid";858;100;0
0;300;"jerie";300;0;100
775;0;"jeriel";775;100;0
5;0;"jeries";5;100;0
0;34;"jeriesha";34;0;100
174;0;"jerik";174;100;0
0;1396;"jerika";1396;0;100
0;15;"jerikah";15;0;100
0;7;"jerikka";7;0;100
98;0;"jeriko";98;100;0
0;148;"jerilee";148;0;100
0;5;"jerilene";5;0;100
0;9;"jerilou";9;0;100
0;5199;"jerilyn";5199;0;100
0;1265;"jerilynn";1265;0;100
0;13;"jerilynne";13;0;100
176;0;"jerimah";176;100;0
10;0;"jerimaine";10;100;0
281;0;"jerime";281;100;0
5;0;"jerimee";5;100;0
81;0;"jerimey";81;100;0
41;0;"jerimi";41;100;0
16;0;"jerimia";16;100;0
4705;0;"jerimiah";4705;100;0
229;0;"jerimie";229;100;0
16;0;"jerimih";16;100;0
5;0;"jerimiha";5;100;0
10;0;"jerimiyah";10;100;0
751;0;"jerimy";751;100;0
20;0;"jerimya";20;100;0
243;0;"jerimyah";243;100;0
535;54;"jerin";589;90.8319185059423;9.16808149405773
0;50;"jerina";50;0;100
0;65;"jerine";65;0;100
5;0;"jeriod";5;100;0
29;0;"jerion";29;100;0
5;0;"jerious";5;100;0
173;116;"jeris";289;59.8615916955017;40.1384083044983
0;60;"jerisha";60;0;100
27;0;"jerison";27;100;0
0;45;"jerissa";45;0;100
37;0;"jerit";37;100;0
0;100;"jerita";100;0;100
16;0;"jerith";16;100;0
36;0;"jerius";36;100;0
0;157;"jeriyah";157;0;100
17;0;"jerjuan";17;100;0
0;5;"jerkayla";5;0;100
0;5;"jerkiya";5;0;100
178;0;"jerl";178;100;0
0;11;"jerldean";11;0;100
0;53;"jerldine";53;0;100
0;683;"jerlean";683;0;100
0;34;"jerleen";34;0;100
0;924;"jerlene";924;0;100
0;12;"jerlin";12;0;100
0;1136;"jerline";1136;0;100
0;116;"jerlisa";116;0;100
0;7;"jerlisha";7;0;100
0;254;"jerlyn";254;0;100
34;0;"jermail";34;100;0
1951;0;"jermain";1951;100;0
40367;967;"jermaine";41334;97.6605216044902;2.33947839550975
733;0;"jermal";733;100;0
209;0;"jermale";209;100;0
70;0;"jermall";70;100;0
425;0;"jerman";425;100;0
709;0;"jermane";709;100;0
0;5;"jermanee";5;0;100
83;365;"jermani";448;18.5267857142857;81.4732142857143
113;15;"jermanie";128;88.28125;11.71875
0;11;"jermanii";11;0;100
16;0;"jermanine";16;100;0
103;118;"jermany";221;46.606334841629;53.393665158371
322;0;"jermar";322;100;0
360;0;"jermarcus";360;100;0
181;0;"jermari";181;100;0
0;6;"jermaria";6;0;100
68;0;"jermario";68;100;0
221;0;"jermarion";221;100;0
40;0;"jermarius";40;100;0
7;0;"jermarkus";7;100;0
5;0;"jermaul";5;100;0
0;55;"jermaya";55;0;100
367;0;"jermayne";367;100;0
14;0;"jerme";14;100;0
0;52;"jermecia";52;0;100
0;29;"jermeisha";29;0;100
0;107;"jermeka";107;0;100
1289;5;"jermel";1294;99.613601236476;0.386398763523957
586;0;"jermell";586;100;0
48;0;"jermelle";48;100;0
23;0;"jermere";23;100;0
0;54;"jermeria";54;0;100
110;0;"jermery";110;100;0
0;109;"jermesha";109;0;100
0;7;"jermeshia";7;0;100
2657;0;"jermey";2657;100;0
0;203;"jermia";203;0;100
2973;125;"jermiah";3098;95.9651387992253;4.03486120077469
13;0;"jermiane";13;100;0
0;48;"jermica";48;0;100
405;0;"jermichael";405;100;0
21;0;"jermicheal";21;100;0
327;0;"jermie";327;100;0
6;0;"jermih";6;100;0
0;83;"jermika";83;0;100
12;0;"jermil";12;100;0
372;0;"jermine";372;100;0
22;0;"jermir";22;100;0
0;5;"jermira";5;0;100
0;96;"jermisha";96;0;100
0;135;"jermiya";135;0;100
17;161;"jermiyah";178;9.55056179775281;90.4494382022472
6;0;"jermol";6;100;0
493;0;"jermon";493;100;0
190;0;"jermond";190;100;0
248;0;"jermone";248;100;0
0;7;"jermonica";7;0;100
14;0;"jermont";14;100;0
40;0;"jermonte";40;100;0
717;0;"jermy";717;100;0
0;308;"jermya";308;0;100
19;18;"jermyah";37;51.3513513513513;48.6486486486487
0;12;"jermyia";12;0;100
52;0;"jermyn";52;100;0
0;15;"jermyra";15;0;100
0;16;"jernae";16;0;100
109;0;"jernard";109;100;0
0;112;"jernee";112;0;100
0;25;"jernei";25;0;100
5;22;"jernell";27;18.5185185185185;81.4814814814815
0;5;"jerneshia";5;0;100
10;130;"jerney";140;7.14285714285714;92.8571428571429
0;103;"jerni";103;0;100
0;12;"jerniah";12;0;100
0;5;"jernice";5;0;100
0;78;"jernie";78;0;100
0;5;"jernika";5;0;100
0;16;"jernisha";16;0;100
0;52;"jerniya";52;0;100
0;52;"jerniyah";52;0;100
0;10;"jernya";10;0;100
5946;0;"jerod";5946;100;0
34;0;"jerode";34;100;0
6;0;"jeroen";6;100;0
134;10;"jerol";144;93.0555555555556;6.94444444444444
7402;0;"jerold";7402;100;0
0;51;"jeroldine";51;0;100
0;99;"jerolene";99;0;100
0;159;"jeroline";159;0;100
0;544;"jerolyn";544;0;100
11;0;"jerom";11;100;0
0;5;"jeroma";5;0;100
158423;1061;"jerome";159484;99.334729502646;0.665270497353966
10;0;"jeromee";10;100;0
416;0;"jeromey";416;100;0
40;0;"jeromi";40;100;0
56;0;"jeromiah";56;100;0
585;0;"jeromie";585;100;0
4772;0;"jeromy";4772;100;0
2205;0;"jeron";2205;100;0
0;15;"jerona";15;0;100
0;76;"jeronda";76;0;100
1317;0;"jerone";1317;100;0
0;179;"jeronica";179;0;100
1691;0;"jeronimo";1691;100;0
40;0;"jerquan";40;100;0
0;509;"jerra";509;0;100
1747;0;"jerrad";1747;100;0
0;5;"jerrae";5;0;100
0;27;"jerrah";27;0;100
6;0;"jerrail";6;100;0
281;0;"jerral";281;100;0
836;0;"jerrald";836;100;0
0;5;"jerralee";5;0;100
11;0;"jerrall";11;100;0
0;14;"jerralyn";14;0;100
12;0;"jerrame";12;100;0
30;0;"jerramie";30;100;0
43;0;"jerramy";43;100;0
202;0;"jerran";202;100;0
253;0;"jerrard";253;100;0
17;0;"jerray";17;100;0
795;617;"jerre";1412;56.3031161473088;43.6968838526912
1556;0;"jerred";1556;100;0
2415;26;"jerrel";2441;98.9348627611635;1.06513723883654
6941;91;"jerrell";7032;98.7059158134244;1.29408418657565
74;0;"jerrelle";74;100;0
5;0;"jerremiah";5;100;0
405;0;"jerremy";405;100;0
512;0;"jerren";512;100;0
0;20;"jerrene";20;0;100
453;0;"jerret";453;100;0
1194;0;"jerrett";1194;100;0
279;15418;"jerri";15697;1.77740969612028;98.2225903038797
0;10;"jerria";10;0;100
0;118;"jerriah";118;0;100
68;0;"jerrian";68;100;0
0;6;"jerriana";6;0;100
0;129;"jerriann";129;0;100
0;5;"jerrianna";5;0;100
0;92;"jerrianne";92;0;100
80;0;"jerric";80;100;0
0;4411;"jerrica";4411;0;100
0;6;"jerricca";6;0;100
0;6;"jerricha";6;0;100
37;0;"jerricho";37;100;0
1933;0;"jerrick";1933;100;0
0;217;"jerricka";217;0;100
188;0;"jerrico";188;100;0
1086;0;"jerrid";1086;100;0
345;5251;"jerrie";5596;6.1651179413867;93.8348820586133
34;0;"jerriel";34;100;0
63;0;"jerrik";63;100;0
0;598;"jerrika";598;0;100
22;0;"jerril";22;100;0
0;45;"jerrilee";45;0;100
23;0;"jerrill";23;100;0
0;1277;"jerrilyn";1277;0;100
0;9;"jerrilyne";9;0;100
0;373;"jerrilynn";373;0;100
5;0;"jerrime";5;100;0
30;0;"jerrimiah";30;100;0
17;0;"jerrimy";17;100;0
479;16;"jerrin";495;96.7676767676768;3.23232323232323
0;5;"jerrina";5;0;100
0;271;"jerrine";271;0;100
272;0;"jerrion";272;100;0
0;5;"jerriona";5;0;100
5;0;"jerrious";5;100;0
145;105;"jerris";250;58;42
0;6;"jerrisa";6;0;100
0;17;"jerrisha";17;0;100
10;0;"jerrison";10;100;0
150;0;"jerrit";150;100;0
0;6;"jerrita";6;0;100
153;0;"jerritt";153;100;0
42;0;"jerrius";42;100;0
0;77;"jerriyah";77;0;100
0;5;"jerrlyn";5;0;100
9197;10;"jerrod";9207;99.8913869881612;0.108613011838818
307;0;"jerrol";307;100;0
8434;0;"jerrold";8434;100;0
36;0;"jerroll";36;100;0
0;24;"jerrolyn";24;0;100
6;0;"jerrome";6;100;0
1633;0;"jerron";1633;100;0
11;0;"jerrud";11;100;0
609421;17298;"jerry";626719;97.2399113478289;2.76008865217107
0;7;"jerryca";7;0;100
48;0;"jerryd";48;100;0
0;148;"jerrye";148;0;100
147;6;"jerryl";153;96.078431372549;3.92156862745098
13;0;"jerrylee";13;100;0
0;5;"jerrylene";5;0;100
37;0;"jerryn";37;100;0
18;0;"jersain";18;100;0
0;107;"jersee";107;0;100
0;28;"jersei";28;0;100
21;0;"jersen";21;100;0
228;2708;"jersey";2936;7.76566757493188;92.2343324250681
0;177;"jersi";177;0;100
31;0;"jersiah";31;100;0
0;404;"jersie";404;0;100
1018;0;"jerson";1018;100;0
0;12;"jersy";12;0;100
5;0;"jertavious";5;100;0
26;0;"jeru";26;100;0
16;0;"jerud";16;100;0
60;217;"jerusalem";277;21.6606498194946;78.3393501805054
0;66;"jerusalen";66;0;100
0;1102;"jerusha";1102;0;100
5;0;"jervaughn";5;100;0
6;0;"jervin";6;100;0
282;0;"jervis";282;100;0
466;0;"jervon";466;100;0
12;0;"jervontae";12;100;0
56;0;"jervonte";56;100;0
7;0;"jerwan";7;100;0
11;0;"jerwin";11;100;0
116;0;"jery";116;100;0
18;0;"jeryd";18;100;0
0;5;"jeryiah";5;0;100
0;5;"jeryka";5;0;100
0;6;"jerykah";6;0;100
778;1029;"jeryl";1807;43.054786939679;56.945213060321
10;0;"jeryme";10;100;0
6;0;"jerymiah";6;100;0
131;61;"jeryn";192;68.2291666666667;31.7708333333333
0;313;"jerzee";313;0;100
0;6;"jerzei";6;0;100
10;324;"jerzey";334;2.9940119760479;97.0059880239521
0;308;"jerzi";308;0;100
0;490;"jerzie";490;0;100
120;128;"jerzy";248;48.3870967741936;51.6129032258064
126;0;"jes";126;100;0
0;48;"jesa";48;0;100
0;26;"jesabel";26;0;100
11;0;"jesai";11;100;0
165;0;"jesaiah";165;100;0
5;0;"jesaias";5;100;0
0;5;"jesalee";5;0;100
0;319;"jesalyn";319;0;100
0;32;"jesalynn";32;0;100
0;5;"jesara";5;0;100
0;5;"jescenia";5;0;100
0;5;"jescie";5;0;100
5;0;"jesco";5;100;0
376;0;"jese";376;100;0
52;0;"jesean";52;100;0
0;10;"jeseca";10;0;100
39;5;"jesee";44;88.6363636363636;11.3636363636364
0;7;"jeseka";7;0;100
0;6;"jesel";6;0;100
0;177;"jeselle";177;0;100
0;11;"jeselyn";11;0;100
6;4589;"jesenia";4595;0.130576713819369;99.8694232861806
0;91;"jesenya";91;0;100
11;0;"jeser";11;100;0
0;24;"jesha";24;0;100
10;0;"jeshaiah";10;100;0
28;0;"jeshaun";28;100;0
86;0;"jeshawn";86;100;0
0;21;"jeshia";21;0;100
10;0;"jeshon";10;100;0
2216;5;"jeshua";2221;99.7748761819;0.225123818099955
36;0;"jeshuah";36;100;0
54;0;"jeshurun";54;100;0
5;0;"jeshwa";5;100;0
38;547;"jesi";585;6.4957264957265;93.5042735042735
2267;219;"jesiah";2486;91.1906677393403;8.80933226065969
0;4677;"jesica";4677;0;100
0;5;"jesicah";5;0;100
0;121;"jesicca";121;0;100
26;38;"jesie";64;40.625;59.375
61;0;"jesiel";61;100;0
0;1262;"jesika";1262;0;100
0;18;"jesikah";18;0;100
0;87;"jesilyn";87;0;100
0;7;"jesiree";7;0;100
12;0;"jesiyah";12;100;0
0;5;"jeslee";5;0;100
0;10;"jesleen";10;0;100
0;18;"jeslene";18;0;100
0;46;"jesley";46;0;100
0;10;"jesli";10;0;100
0;80;"jeslie";80;0;100
0;98;"jeslin";98;0;100
0;193;"jesly";193;0;100
0;1268;"jeslyn";1268;0;100
0;192;"jeslynn";192;0;100
0;39;"jesmarie";39;0;100
0;12;"jesmin";12;0;100
0;55;"jesmine";55;0;100
62;0;"jeson";62;100;0
112;0;"jesper";112;100;0
22658;390;"jess";23048;98.3078792086081;1.69212079139188
5;4959;"jessa";4964;0.100725221595487;99.8992747784045
0;5;"jessabel";5;0;100
0;7;"jessabell";7;0;100
0;39;"jessabella";39;0;100
0;56;"jessabelle";56;0;100
0;179;"jessaca";179;0;100
0;138;"jessah";138;0;100
0;25;"jessalee";25;0;100
0;28;"jessalin";28;0;100
0;3291;"jessalyn";3291;0;100
0;816;"jessalynn";816;0;100
0;10;"jessalynne";10;0;100
0;13;"jessamae";13;0;100
0;5;"jessamarie";5;0;100
0;641;"jessamine";641;0;100
0;215;"jessamy";215;0;100
5;709;"jessamyn";714;0.700280112044818;99.2997198879552
0;5;"jessca";5;0;100
0;383;"jesscia";383;0;100
403012;11642;"jesse";414654;97.1923579659186;2.80764203408143
0;1498;"jesseca";1498;0;100
1586;302;"jessee";1888;84.0042372881356;15.9957627118644
0;5;"jesseica";5;0;100
463;0;"jessejames";463;100;0
0;170;"jesseka";170;0;100
10;169;"jessel";179;5.58659217877095;94.413407821229
77;0;"jesselee";77;100;0
0;45;"jesselin";45;0;100
0;15;"jessell";15;0;100
0;203;"jesselle";203;0;100
0;10;"jessely";10;0;100
0;500;"jesselyn";500;0;100
0;40;"jesselynn";40;0;100
325;0;"jessen";325;100;0
0;12;"jessena";12;0;100
0;5132;"jessenia";5132;0;100
0;140;"jessenya";140;0;100
22;0;"jesseray";22;100;0
51;0;"jesses";51;100;0
891;276;"jessey";1167;76.3496143958869;23.6503856041131
1284;6040;"jessi";7324;17.5314036045877;82.4685963954123
0;434;"jessia";434;0;100
1188;235;"jessiah";1423;83.4855938158819;16.5144061841181
0;23;"jessiana";23;0;100
0;5;"jessianna";5;0;100
0;10;"jessianne";10;0;100
0;139;"jessic";139;0;100
3576;1043396;"jessica";1046972;0.341556412205866;99.6584435877941
0;181;"jessicaann";181;0;100
0;60;"jessicaanne";60;0;100
0;295;"jessicah";295;0;100
0;34;"jessical";34;0;100
0;40;"jessicalee";40;0;100
0;126;"jessicalynn";126;0;100
0;16;"jessicamae";16;0;100
0;156;"jessicamarie";156;0;100
0;5;"jessican";5;0;100
0;5;"jessicanicole";5;0;100
0;24;"jessicarose";24;0;100
0;558;"jessicca";558;0;100
0;151;"jessice";151;0;100
0;348;"jessicia";348;0;100
0;38;"jessicka";38;0;100
0;14;"jessico";14;0;100
105543;145494;"jessie";251037;42.0428064388915;57.9571935611085
0;115;"jessieca";115;0;100
5;0;"jessiejames";5;100;0
17;0;"jessiel";17;100;0
0;7;"jessielynn";7;0;100
0;43;"jessiemae";43;0;100
0;5878;"jessika";5878;0;100
0;101;"jessikah";101;0;100
0;628;"jessilyn";628;0;100
0;104;"jessilynn";104;0;100
0;7;"jessimae";7;0;100
0;5;"jessimar";5;0;100
0;128;"jessina";128;0;100
0;33;"jessinia";33;0;100
0;5;"jessiqua";5;0;100
0;6;"jessiyah";6;0;100
0;23;"jesska";23;0;100
0;5;"jesslene";5;0;100
0;45;"jesslin";45;0;100
0;73;"jessly";73;0;100
0;2024;"jesslyn";2024;0;100
0;492;"jesslynn";492;0;100
0;11;"jessmarie";11;0;100
90;0;"jesson";90;100;0
0;7;"jesssica";7;0;100
5;0;"jessten";5;100;0
71;0;"jesstin";71;100;0
0;18;"jesstina";18;0;100
0;5;"jesstine";5;0;100
11;0;"jesston";11;100;0
0;18;"jessuly";18;0;100
419;0;"jessup";419;100;0
31;0;"jessus";31;100;0
4467;1783;"jessy";6250;71.472;28.528
0;1280;"jessyca";1280;0;100
0;434;"jessye";434;0;100
0;426;"jessyka";426;0;100
0;5;"jesteen";5;0;100
82;0;"jesten";82;100;0
0;5;"jestene";5;0;100
66;0;"jester";66;100;0
1124;0;"jestin";1124;100;0
0;353;"jestina";353;0;100
0;1013;"jestine";1013;0;100
0;29;"jestiny";29;0;100
454;0;"jeston";454;100;0
5;0;"jestyn";5;100;0
19;0;"jesu";19;100;0
102;0;"jesua";102;100;0
5;0;"jesualdo";5;100;0
5;0;"jesuan";5;100;0
0;5;"jesucita";5;0;100
13;0;"jesue";13;100;0
222682;2647;"jesus";225329;98.8252732670895;1.17472673291054
0;1879;"jesusa";1879;0;100
30;0;"jesusalberto";30;100;0
24;0;"jesusangel";24;100;0
46;0;"jesusantonio";46;100;0
5;0;"jesusdaniel";5;100;0
6;0;"jesusenrique";6;100;0
0;1467;"jesusita";1467;0;100
19;0;"jesusjr";19;100;0
65;0;"jesusmanuel";65;100;0
10;5;"jesy";15;66.6666666666667;33.3333333333333
0;84;"jesyca";84;0;100
0;94;"jesyka";94;0;100
2007;62;"jet";2069;97.0033832769454;2.99661672305462
0;135;"jetaime";135;0;100
0;142;"jetaun";142;0;100
0;5;"jete";5;0;100
674;0;"jeter";674;100;0
8;0;"jeth";8;100;0
5;0;"jethero";5;100;0
2769;0;"jethro";2769;100;0
11;0;"jethroe";11;100;0
47;0;"jetli";47;100;0
0;5;"jetlyn";5;0;100
5;0;"jetmir";5;100;0
0;5;"jetoi";5;0;100
35;0;"jeton";35;100;0
5;0;"jetsen";5;100;0
171;0;"jetson";171;100;0
12298;358;"jett";12656;97.1713021491782;2.82869785082174
0;2037;"jetta";2037;0;100
6;90;"jette";96;6.25;93.75
185;3168;"jettie";3353;5.51744706233224;94.4825529376678
6;0;"jetton";6;100;0
5;0;"jettrin";5;100;0
11;0;"jettsen";11;100;0
90;0;"jettson";90;100;0
6;248;"jetty";254;2.36220472440945;97.6377952755905
0;11;"jettye";11;0;100
0;49;"jetzabel";49;0;100
8;0;"jetzael";8;100;0
0;14;"jetzibe";14;0;100
8;0;"jetziel";8;100;0
28;0;"jeudy";28;100;0
0;26;"jeune";26;0;100
143;0;"jeury";143;100;0
0;78;"jevaeh";78;0;100
375;0;"jevan";375;100;0
160;0;"jevante";160;100;0
154;0;"jevaughn";154;100;0
68;0;"jevaun";68;100;0
0;10;"jeveah";10;0;100
83;0;"jeven";83;100;0
11;0;"jeveon";11;100;0
0;5;"jevette";5;0;100
911;0;"jevin";911;100;0
45;0;"jevion";45;100;0
0;5;"jevita";5;0;100
4658;91;"jevon";4749;98.0838071172878;1.91619288271215
0;5;"jevonda";5;0;100
8;0;"jevone";8;100;0
6;0;"jevonn";6;100;0
0;11;"jevonna";11;0;100
0;26;"jevonne";26;0;100
24;0;"jevonta";24;100;0
35;0;"jevontae";35;100;0
5;0;"jevontay";5;100;0
412;0;"jevonte";412;100;0
18;0;"jevyn";18;100;0
17;0;"jewan";17;100;0
5045;38596;"jewel";43641;11.5602300588896;88.4397699411104
0;74;"jeweldean";74;0;100
0;5;"jeweldene";5;0;100
0;59;"jeweldine";59;0;100
0;5;"jeweleah";5;0;100
0;26;"jewelean";26;0;100
0;15;"jewelee";15;0;100
0;398;"jewelene";398;0;100
0;425;"jewelia";425;0;100
10;14;"jewelian";24;41.6666666666667;58.3333333333333
0;264;"jeweliana";264;0;100
0;115;"jewelianna";115;0;100
0;55;"jewelie";55;0;100
0;10;"jeweliet";10;0;100
0;269;"jeweline";269;0;100
0;39;"jewelisa";39;0;100
0;30;"jewelissa";30;0;100
4515;28396;"jewell";32911;13.7188174166692;86.2811825833308
0;299;"jewelle";299;0;100
0;5;"jewellee";5;0;100
0;5;"jewellene";5;0;100
0;6;"jewellia";6;0;100
8;895;"jewels";903;0.8859357696567;99.1140642303433
0;5;"jewely";5;0;100
0;29;"jewelya";29;0;100
0;5;"jewelyn";5;0;100
0;9;"jewelyssa";9;0;100
47;213;"jewelz";260;18.0769230769231;81.9230769230769
176;0;"jewett";176;100;0
0;10;"jewl";10;0;100
0;32;"jewlia";32;0;100
21;0;"jewlian";21;100;0
0;15;"jewliana";15;0;100
6;0;"jewlius";6;100;0
0;10;"jewlz";10;0;100
62;0;"jex";62;100;0
31;0;"jexiel";31;100;0
5;0;"jexton";5;100;0
5;0;"jey";5;100;0
5;0;"jeyceon";5;100;0
26;0;"jeycob";26;100;0
0;92;"jeyda";92;0;100
79;0;"jeydan";79;100;0
365;0;"jeyden";365;100;0
0;86;"jeydi";86;0;100
44;0;"jeydon";44;100;0
0;30;"jeydy";30;0;100
15;0;"jeyko";15;100;0
0;184;"jeyla";184;0;100
0;44;"jeylah";44;0;100
22;6;"jeylan";28;78.5714285714286;21.4285714285714
6;5;"jeylani";11;54.5454545454545;45.4545454545455
0;5;"jeylanie";5;0;100
0;47;"jeyleen";47;0;100
5;12;"jeylen";17;29.4117647058824;70.5882352941177
0;11;"jeylene";11;0;100
0;62;"jeyli";62;0;100
0;11;"jeylianis";11;0;100
0;257;"jeylin";257;0;100
0;17;"jeyline";17;0;100
6;0;"jeylon";6;100;0
0;6;"jeyly";6;0;100
0;145;"jeymi";145;0;100
89;0;"jeyren";89;100;0
13;0;"jeysen";13;100;0
0;8;"jeyshangelise";8;0;100
489;0;"jeyson";489;100;0
0;504;"jezabel";504;0;100
0;31;"jezabell";31;0;100
0;52;"jezabella";52;0;100
0;140;"jezabelle";140;0;100
0;647;"jezebel";647;0;100
0;5;"jezebell";5;0;100
0;67;"jezebelle";67;0;100
0;163;"jezel";163;0;100
0;34;"jezell";34;0;100
0;320;"jezelle";320;0;100
0;6;"jezenia";6;0;100
0;5;"jezeniah";5;0;100
16;0;"jezer";16;100;0
351;25;"jeziah";376;93.3510638297872;6.64893617021277
255;0;"jeziel";255;100;0
0;15;"jezika";15;0;100
0;11;"jeziyah";11;0;100
0;5;"jezlin";5;0;100
0;124;"jezlyn";124;0;100
0;41;"jezlynn";41;0;100
36;0;"jezrael";36;100;0
518;161;"jezreel";679;76.2886597938144;23.7113402061856
0;15;"jezzel";15;0;100
0;5;"jezzelle";5;0;100
89;0;"jguadalupe";89;100;0
110;0;"jhace";110;100;0
0;78;"jhada";78;0;100
0;95;"jhade";95;0;100
78;0;"jhaden";78;100;0
26;0;"jhadiel";26;100;0
0;5;"jhaeda";5;0;100
28;0;"jhael";28;100;0
33;10;"jhai";43;76.7441860465116;23.2558139534884
33;0;"jhaiden";33;100;0
130;0;"jhair";130;100;0
5;0;"jhaki";5;100;0
0;6;"jhala";6;0;100
72;0;"jhalen";72;100;0
0;5;"jhalia";5;0;100
322;0;"jhalil";322;100;0
10;0;"jhalin";10;100;0
7;0;"jhalyn";7;100;0
56;0;"jhamal";56;100;0
10;0;"jhamar";10;100;0
180;0;"jhamari";180;100;0
6;0;"jhamarion";6;100;0
5;0;"jhamel";5;100;0
10;0;"jhamere";10;100;0
0;5;"jhamilet";5;0;100
161;0;"jhamir";161;100;0
0;6;"jhamya";6;0;100
162;5;"jhan";167;97.0059880239521;2.9940119760479
0;96;"jhana";96;0;100
0;147;"jhanae";147;0;100
0;5;"jhanai";5;0;100
15;0;"jhancarlos";15;100;0
0;275;"jhane";275;0;100
0;16;"jhanee";16;0;100
0;5;"jhanel";5;0;100
0;16;"jhanelle";16;0;100
0;5;"jhanet";5;0;100
0;19;"jhani";19;0;100
0;72;"jhania";72;0;100
0;5;"jhaniah";5;0;100
0;92;"jhaniya";92;0;100
0;31;"jhaniyah";31;0;100
0;10;"jhanna";10;0;100
0;126;"jhanvi";126;0;100
0;15;"jhanya";15;0;100
45;0;"jhared";45;100;0
20;0;"jhari";20;100;0
11;0;"jhariel";11;100;0
0;25;"jharline";25;0;100
264;0;"jhase";264;100;0
5;0;"jhasir";5;100;0
0;10;"jhasmin";10;0;100
0;12;"jhasmine";12;0;100
5;0;"jhavier";5;100;0
29;0;"jhavon";29;100;0
24;0;"jhayce";24;100;0
0;37;"jhayda";37;0;100
165;6;"jhayden";171;96.4912280701754;3.50877192982456
0;119;"jhayla";119;0;100
21;0;"jhaylen";21;100;0
12;0;"jhaziel";12;100;0
0;5;"jhena";5;0;100
0;11;"jhenae";11;0;100
0;265;"jhene";265;0;100
0;15;"jhenesis";15;0;100
0;5;"jhenifer";5;0;100
0;43;"jhenna";43;0;100
64;0;"jheremy";64;100;0
0;148;"jheri";148;0;100
0;53;"jherica";53;0;100
0;14;"jherika";14;0;100
0;10;"jherrica";10;0;100
8;0;"jheryl";8;100;0
18;0;"jhet";18;100;0
719;5;"jhett";724;99.3093922651934;0.69060773480663
0;16;"jhia";16;0;100
0;5;"jhiya";5;0;100
318;0;"jhoan";318;100;0
0;551;"jhoana";551;0;100
0;320;"jhoanna";320;0;100
5;0;"jhobany";5;100;0
67;0;"jhoel";67;100;0
11;0;"jhomar";11;100;0
2510;0;"jhon";2510;100;0
0;5;"jhonae";5;0;100
10;0;"jhonael";10;100;0
11;0;"jhonas";11;100;0
955;0;"jhonatan";955;100;0
801;0;"jhonathan";801;100;0
27;0;"jhonathon";27;100;0
7;0;"jhonattan";7;100;0
58;0;"jhonen";58;100;0
11;0;"jhonie";11;100;0
14;0;"jhoniel";14;100;0
0;5;"jhonna";5;0;100
11;0;"jhonnatan";11;100;0
0;7;"jhonni";7;0;100
163;16;"jhonnie";179;91.0614525139665;8.93854748603352
1515;0;"jhonny";1515;100;0
302;0;"jhony";302;100;0
172;78;"jhordan";250;68.8;31.2
29;0;"jhordy";29;100;0
15;101;"jhordyn";116;12.9310344827586;87.0689655172414
0;5;"jhori";5;0;100
0;127;"jhoselin";127;0;100
0;35;"jhoseline";35;0;100
0;200;"jhoselyn";200;0;100
0;5;"jhoselyne";5;0;100
6;0;"jhosep";6;100;0
12;0;"jhoseph";12;100;0
6;0;"jhoshua";6;100;0
12;0;"jhosmar";12;100;0
0;5;"jhosselyn";5;0;100
108;0;"jhostin";108;100;0
10;0;"jhosue";10;100;0
0;26;"jhournee";26;0;100
0;29;"jhourni";29;0;100
5;0;"jhovan";5;100;0
0;24;"jhovana";24;0;100
132;0;"jhovani";132;100;0
0;7;"jhovanna";7;0;100
25;0;"jhovanni";25;100;0
251;0;"jhovanny";251;100;0
431;0;"jhovany";431;100;0
7;0;"jhue";7;100;0
158;250;"ji";408;38.7254901960784;61.2745098039216
214;1185;"jia";1399;15.2966404574696;84.7033595425304
9;0;"jiaan";9;100;0
5;0;"jiacheng";5;100;0
0;23;"jiada";23;0;100
0;102;"jiah";102;0;100
12;0;"jiahao";12;100;0
0;5;"jiahna";5;0;100
34;0;"jiair";34;100;0
79;0;"jiaire";79;100;0
0;79;"jiali";79;0;100
0;5;"jialin";5;0;100
0;5;"jiamei";5;0;100
6;0;"jiaming";6;100;0
405;24;"jian";429;94.4055944055944;5.59440559440559
0;806;"jiana";806;0;100
0;16;"jianah";16;0;100
31;0;"jiancarlo";31;100;0
18;0;"jiancarlos";18;100;0
0;31;"jiani";31;0;100
0;2140;"jianna";2140;0;100
0;27;"jiannah";27;0;100
0;5;"jianne";5;0;100
125;114;"jianni";239;52.3012552301255;47.6987447698745
5;0;"jianny";5;100;0
0;7;"jiapsi";7;0;100
0;38;"jiaqi";38;0;100
5;0;"jiar";5;100;0
0;5;"jiara";5;0;100
19;0;"jiarui";19;100;0
0;13;"jiavanna";13;0;100
0;6;"jiaxin";6;0;100
0;11;"jiaya";11;0;100
21;74;"jiayi";95;22.1052631578947;77.8947368421053
0;6;"jiayue";6;0;100
29;0;"jibrael";29;100;0
17;0;"jibrail";17;100;0
279;0;"jibran";279;100;0
6;0;"jibreal";6;100;0
509;0;"jibreel";509;100;0
247;0;"jibri";247;100;0
0;5;"jibria";5;0;100
58;0;"jibriel";58;100;0
975;0;"jibril";975;100;0
0;11;"jicel";11;0;100
0;5;"jicela";5;0;100
47;0;"jidenna";47;100;0
86;18;"jie";104;82.6923076923077;17.3076923076923
0;5;"jiesha";5;0;100
0;18;"jieun";18;0;100
147;0;"jigar";147;100;0
5;0;"jiggs";5;100;0
11;0;"jigme";11;100;0
0;19;"jigna";19;0;100
68;0;"jihaad";68;100;0
1846;5;"jihad";1851;99.7298757428417;0.270124257158293
0;5;"jihae";5;0;100
56;552;"jihan";608;9.21052631578947;90.7894736842105
0;25;"jihanna";25;0;100
39;0;"jiho";39;100;0
10;0;"jihoo";10;100;0
13;0;"jihoon";13;100;0
0;5;"jihyun";5;0;100
6;0;"jikai";6;100;0
0;5;"jikayla";5;0;100
0;560;"jil";560;0;100
194;0;"jilberto";194;100;0
0;293;"jilda";293;0;100
15;0;"jildardo";15;100;0
0;5;"jileen";5;0;100
0;69;"jilene";69;0;100
584;0;"jiles";584;100;0
0;803;"jilian";803;0;100
0;33;"jiliana";33;0;100
0;30;"jilisa";30;0;100
0;7;"jilissa";7;0;100
502;207865;"jill";208367;0.240921067155548;99.7590789328444
0;6;"jilla";6;0;100
0;229;"jillaine";229;0;100
0;10;"jillan";10;0;100
0;110;"jillana";110;0;100
0;119;"jillane";119;0;100
0;126;"jillann";126;0;100
0;5;"jillanna";5;0;100
0;56;"jillanne";56;0;100
0;137;"jillayne";137;0;100
0;47;"jillean";47;0;100
0;138;"jilleen";138;0;100
0;35;"jillena";35;0;100
0;632;"jillene";632;0;100
0;7;"jillesa";7;0;100
0;12;"jillia";12;0;100
0;102;"jilliam";102;0;100
227;80575;"jillian";80802;0.280933640256429;99.7190663597436
0;202;"jilliana";202;0;100
0;149;"jilliane";149;0;100
0;337;"jilliann";337;0;100
0;102;"jillianna";102;0;100
0;472;"jillianne";472;0;100
0;66;"jillien";66;0;100
0;5;"jilliene";5;0;100
0;57;"jillienne";57;0;100
0;10;"jillinda";10;0;100
0;22;"jillion";22;0;100
0;118;"jillisa";118;0;100
0;5;"jillissa";5;0;100
0;33;"jilliyn";33;0;100
0;8;"jillmarie";8;0;100
0;291;"jillyan";291;0;100
0;171;"jillyn";171;0;100
0;12;"jillynn";12;0;100
0;5;"jilma";5;0;100
0;5;"jilyan";5;0;100
146437;765;"jim";147202;99.4803059741036;0.519694025896387
0;6;"jima";6;0;100
15;0;"jimal";15;100;0
0;5;"jimalee";5;0;100
23;0;"jimar";23;100;0
52;0;"jimari";52;100;0
29;0;"jimarion";29;100;0
0;53;"jimaya";53;0;100
23;0;"jimbo";23;100;0
6;0;"jimbob";6;100;0
0;101;"jimeka";101;0;100
105;0;"jimel";105;100;0
6;0;"jimell";6;100;0
0;6;"jimella";6;0;100
8;11273;"jimena";11281;0.0709156989628579;99.9290843010371
16;0;"jimenez";16;100;0
0;44;"jimenna";44;0;100
10;0;"jimere";10;100;0
0;77;"jimesha";77;0;100
0;5;"jimetta";5;0;100
0;11;"jimette";11;0;100
5;0;"jimey";5;100;0
1152;638;"jimi";1790;64.3575418994413;35.6424581005587
0;92;"jimia";92;0;100
0;5;"jimiah";5;0;100
0;5;"jimica";5;0;100
200;5;"jimie";205;97.5609756097561;2.4390243902439
0;22;"jimika";22;0;100
31;42;"jimin";73;42.4657534246575;57.5342465753425
5;0;"jimique";5;100;0
0;26;"jimisha";26;0;100
0;11;"jimiya";11;0;100
0;5;"jimiyah";5;0;100
22;0;"jimm";22;100;0
0;94;"jimma";94;0;100
17;0;"jimme";17;100;0
0;5;"jimmeka";5;0;100
22;0;"jimmel";22;100;0
9;0;"jimmer";9;100;0
0;12;"jimmesha";12;0;100
904;0;"jimmey";904;100;0
49;281;"jimmi";330;14.8484848484848;85.1515151515152
0;36;"jimmia";36;0;100
0;7;"jimmiah";7;0;100
0;5;"jimmica";5;0;100
111036;22154;"jimmie";133190;83.3666191155492;16.6333808844508
285390;2218;"jimmy";287608;99.2288114377903;0.771188562209674
0;28;"jimmya";28;0;100
22;496;"jimmye";518;4.24710424710425;95.7528957528958
79;0;"jimmylee";79;100;0
8;0;"jimon";8;100;0
12;0;"jimson";12;100;0
156;0;"jimy";156;100;0
0;70;"jimya";70;0;100
0;16;"jimyah";16;0;100
1053;359;"jin";1412;74.5750708215297;25.4249291784703
0;1954;"jina";1954;0;100
0;5;"jinah";5;0;100
0;19;"jinal";19;0;100
5;165;"jinan";170;2.94117647058824;97.0588235294118
0;5;"jinane";5;0;100
5;0;"jinay";5;100;0
0;5;"jinaya";5;0;100
0;5;"jinayah";5;0;100
0;32;"jincy";32;0;100
0;17;"jineane";17;0;100
0;31;"jineen";31;0;100
0;159;"jinelle";159;0;100
0;5;"jinessa";5;0;100
0;5;"jinette";5;0;100
10;125;"jing";135;7.40740740740741;92.5925925925926
0;462;"jinger";462;0;100
0;17;"jingyi";17;0;100
0;5;"jinhee";5;0;100
0;61;"jini";61;0;100
0;5;"jiniyah";5;0;100
0;5;"jinjer";5;0;100
11;0;"jinks";11;100;0
0;164;"jinna";164;0;100
0;10;"jinnah";10;0;100
0;5;"jinni";5;0;100
0;781;"jinnie";781;0;100
0;148;"jinnifer";148;0;100
0;815;"jinny";815;0;100
25;0;"jino";25;100;0
0;30;"jinora";30;0;100
24;0;"jinu";24;100;0
10;0;"jinwoo";10;100;0
0;176;"jinx";176;0;100
12;0;"jio";12;100;0
17;0;"jion";17;100;0
5;0;"jioni";5;100;0
0;28;"jionna";28;0;100
889;17;"jionni";906;98.1236203090508;1.87637969094923
7;0;"jionnie";7;100;0
28;0;"jionny";28;100;0
0;10;"jiovana";10;0;100
480;0;"jiovani";480;100;0
0;121;"jiovanna";121;0;100
1558;0;"jiovanni";1558;100;0
5;0;"jiovannie";5;100;0
385;0;"jiovanny";385;100;0
155;0;"jiovany";155;100;0
31;0;"jiovonni";31;100;0
14;0;"jiquan";14;100;0
5;0;"jiquez";5;100;0
0;5;"jira";5;0;100
22;178;"jirah";200;11;89
323;5;"jiraiya";328;98.4756097560976;1.52439024390244
6;0;"jiram";6;100;0
608;663;"jireh";1271;47.8363493312352;52.1636506687648
0;5;"jireth";5;0;100
16;0;"jiri";16;100;0
325;0;"jiro";325;100;0
0;10;"jiromi";10;0;100
6;0;"jiron";6;100;0
43;0;"jisaiah";43;100;0
0;367;"jisel";367;0;100
0;373;"jisela";373;0;100
0;116;"jisele";116;0;100
0;99;"jisell";99;0;100
0;69;"jisella";69;0;100
0;1957;"jiselle";1957;0;100
0;11;"jisha";11;0;100
65;0;"jishnu";65;100;0
11;0;"jisiah";11;100;0
0;11;"jisoo";11;0;100
0;460;"jissel";460;0;100
0;13;"jissela";13;0;100
0;11;"jissele";11;0;100
0;73;"jissell";73;0;100
0;350;"jisselle";350;0;100
45;10;"jissie";55;81.8181818181818;18.1818181818182
20;0;"jiten";20;100;0
10;0;"jitesh";10;100;0
30;0;"jitsuo";30;100;0
7;0;"jitu";7;100;0
0;30;"jitzel";30;0;100
0;13;"jiuliana";13;0;100
143;0;"jivan";143;100;0
12;0;"jivon";12;100;0
0;20;"jiwon";20;0;100
16;49;"jiwoo";65;24.6153846153846;75.3846153846154
0;1385;"jiya";1385;0;100
33;0;"jiyaan";33;100;0
0;183;"jiyah";183;0;100
20;0;"jiyan";20;100;0
0;10;"jiyana";10;0;100
0;5;"jiyanna";5;0;100
0;5;"jiyoung";5;0;100
0;6;"jiyu";6;0;100
0;130;"jizel";130;0;100
0;13;"jizele";13;0;100
0;19;"jizell";19;0;100
0;909;"jizelle";909;0;100
0;17;"jizzel";17;0;100
0;56;"jizzelle";56;0;100
484;0;"jj";484;100;0
6;0;"jjames";6;100;0
197;0;"jjesus";197;100;0
36;0;"jjuan";36;100;0
58;0;"jkai";58;100;0
13;0;"jkari";13;100;0
0;103;"jkayla";103;0;100
13;0;"jkhari";13;100;0
0;5;"jkia";5;0;100
0;7;"jkira";7;0;100
0;6;"jkiyah";6;0;100
57;0;"jkobe";57;100;0
5;0;"jkobi";5;100;0
173;0;"jkwon";173;100;0
0;6;"jkyla";6;0;100
32;0;"jl";32;100;0
0;199;"jla";199;0;100
0;59;"jlah";59;0;100
6;0;"jlan";6;100;0
0;10;"jlaya";10;0;100
0;11;"jlayah";11;0;100
0;5;"jlea";5;0;100
0;11;"jleah";11;0;100
0;62;"jlee";62;0;100
0;54;"jleigh";54;0;100
88;0;"jlen";88;100;0
0;5;"jliana";5;0;100
17;0;"jlin";17;100;0
0;31;"jlisa";31;0;100
0;18;"jliyah";18;0;100
67;0;"jlon";67;100;0
110;164;"jlyn";274;40.1459854014599;59.8540145985402
64;680;"jlynn";744;8.60215053763441;91.3978494623656
0;6;"jlyssa";6;0;100
5;0;"jm";5;100;0
45;0;"jmar";45;100;0
46;0;"jmarcus";46;100;0
203;0;"jmari";203;100;0
0;48;"jmarie";48;0;100
135;0;"jmarion";135;100;0
17;0;"jmauri";17;100;0
0;17;"jmaya";17;0;100
0;5;"jme";5;0;100
5;0;"jmere";5;100;0
0;12;"jmia";12;0;100
65;0;"jmichael";65;100;0
17;0;"jmir";17;100;0
0;42;"jmiyah";42;0;100
0;208;"jmya";208;0;100
0;11;"jmyah";11;0;100
0;5;"jmyiah";5;0;100
0;5;"jmyra";5;0;100
0;203;"jnae";203;0;100
0;150;"jnai";150;0;100
0;5;"jnaiya";5;0;100
0;5;"jnasia";5;0;100
0;5;"jnay";5;0;100
0;85;"jnaya";85;0;100
0;22;"jnia";22;0;100
0;29;"jniah";29;0;100
0;5;"jniaya";5;0;100
0;234;"jniya";234;0;100
0;234;"jniyah";234;0;100
11;0;"jno";11;100;0
0;178;"jnya";178;0;100
0;84;"jnyah";84;0;100
0;17;"jnyia";17;0;100
0;27;"jnyla";27;0;100
1803;178523;"jo";180326;0.999855816687555;99.0001441833124
10;30;"joa";40;25;75
655;0;"joab";655;100;0
986;0;"joachim";986;100;0
6;0;"joacim";6;100;0
713;0;"joah";713;100;0
143;0;"joahan";143;100;0
11;0;"joahn";11;100;0
0;6;"joahna";6;0;100
0;10;"joahnna";10;0;100
5;0;"joahua";5;100;0
98;0;"joakim";98;100;0
0;13;"joakima";13;0;100
11;0;"joakin";11;100;0
97;25;"joal";122;79.5081967213115;20.4918032786885
0;57;"joaly";57;0;100
5973;479400;"joan";485373;1.23059997156826;98.7694000284317
0;7272;"joana";7272;0;100
0;10;"joanah";10;0;100
0;79;"joanann";79;0;100
92;0;"joanathan";92;100;0
0;6;"joandaly";6;0;100
0;22;"joandra";22;0;100
5;0;"joandre";5;100;0
30;0;"joandri";30;100;0
59;0;"joandry";59;100;0
83;0;"joandy";83;100;0
0;1195;"joane";1195;0;100
5;0;"joanel";5;100;0
0;6;"joaneliz";6;0;100
0;73;"joanell";73;0;100
0;29;"joanelle";29;0;100
0;50;"joanetta";50;0;100
0;367;"joanette";367;0;100
160;0;"joangel";160;100;0
0;5;"joangela";5;0;100
0;586;"joani";586;0;100
0;5181;"joanie";5181;0;100
0;10;"joanita";10;0;100
0;236;"joanmarie";236;0;100
548;156264;"joann";156812;0.349463051297095;99.6505369487029
306;100773;"joanna";101079;0.302733505475915;99.6972664945241
0;359;"joannah";359;0;100
0;58;"joannamarie";58;0;100
504;211169;"joanne";211673;0.238103111875393;99.7618968881246
0;10;"joannette";10;0;100
0;1528;"joannie";1528;0;100
5;164;"joanny";169;2.9585798816568;97.0414201183432
470;0;"joanthan";470;100;0
5;0;"joanthon";5;100;0
100;0;"joanthony";100;100;0
5;59;"joany";64;7.8125;92.1875
1560;0;"joao";1560;100;0
6;0;"joaogabriel";6;100;0
8;0;"joaolucas";8;100;0
11;0;"joaopaulo";11;100;0
172;0;"joaopedro";172;100;0
127;0;"joaovictor";127;100;0
5;0;"joaovitor";5;100;0
689;0;"joaquim";689;100;0
26560;53;"joaquin";26613;99.8008492090332;0.199150790966821
0;428;"joaquina";428;0;100
165;0;"joas";165;100;0
259;0;"joash";259;100;0
5;0;"joason";5;100;0
31;0;"joathan";31;100;0
2878;0;"job";2878;100;0
12;0;"joban";12;100;0
0;30;"jobana";30;0;100
216;0;"jobani";216;100;0
62;0;"jobanny";62;100;0
265;0;"jobany";265;100;0
5;0;"jobari";5;100;0
1172;0;"jobe";1172;100;0
19;0;"joben";19;100;0
0;486;"jobeth";486;0;100
33;0;"jobey";33;100;0
6;42;"jobi";48;12.5;87.5
442;56;"jobie";498;88.7550200803213;11.2449799196787
93;0;"jobin";93;100;0
0;126;"jobina";126;0;100
0;7;"jobita";7;0;100
1116;68;"joby";1184;94.2567567567568;5.74324324324324
0;39;"jobyna";39;0;100
6;0;"joc";6;100;0
0;185;"jocabed";185;0;100
0;5;"jocabeth";5;0;100
0;55;"jocalyn";55;0;100
0;18;"jocalynn";18;0;100
0;15;"jocarol";15;0;100
0;10;"jocasta";10;0;100
10;0;"joce";10;100;0
0;209;"jocee";209;0;100
0;5;"joceleen";5;0;100
0;9;"jocelene";9;0;100
0;2513;"jocelin";2513;0;100
0;1522;"joceline";1522;0;100
0;6;"jocelinne";6;0;100
0;31;"jocell";31;0;100
0;5;"jocelle";5;0;100
0;55;"jocellyn";55;0;100
0;31;"jocely";31;0;100
351;102306;"jocelyn";102657;0.341915310207779;99.6580846897922
0;4043;"jocelyne";4043;0;100
0;5;"jocelynmarie";5;0;100
0;5651;"jocelynn";5651;0;100
0;551;"jocelynne";551;0;100
0;6;"jocene";6;0;100
6;0;"jocephus";6;100;0
0;59;"jocey";59;0;100
0;41;"joceyln";41;0;100
0;78;"jochebed";78;0;100
0;6;"jochelle";6;0;100
0;98;"joci";98;0;100
6;0;"jociah";6;100;0
0;588;"jocie";588;0;100
5;0;"jociel";5;100;0
0;10;"jocile";10;0;100
0;365;"jocilyn";365;0;100
0;72;"jocilynn";72;0;100
0;10;"jocinda";10;0;100
1089;0;"jock";1089;100;0
5;0;"jocko";5;100;0
0;628;"joclyn";628;0;100
0;142;"joclynn";142;0;100
341;0;"jocob";341;100;0
7;0;"jocoby";7;100;0
5;0;"jocqua";5;100;0
0;10;"jocqueline";10;0;100
13;0;"jocques";13;100;0
12;0;"jocquez";12;100;0
41;0;"jocqui";41;100;0
186;0;"jocsan";186;100;0
0;17;"jocylin";17;0;100
0;9;"jocylyn";9;0;100
17;95;"joda";112;15.1785714285714;84.8214285714286
27;0;"jodan";27;100;0
0;5;"jodana";5;0;100
0;11;"jodanna";11;0;100
5;0;"jodarius";5;100;0
12;34;"joddie";46;26.0869565217391;73.9130434782609
25;146;"jode";171;14.6198830409357;85.3801169590643
0;447;"jodean";447;0;100
0;14;"jodeane";14;0;100
318;332;"jodeci";650;48.9230769230769;51.0769230769231
33;3085;"jodee";3118;1.05837075048108;98.9416292495189
0;343;"jodeen";343;0;100
0;65;"jodel";65;0;100
0;813;"jodell";813;0;100
0;318;"jodelle";318;0;100
102;0;"joden";102;100;0
0;5;"jodena";5;0;100
0;957;"jodene";957;0;100
0;132;"jodette";132;0;100
93;50;"jodey";143;65.034965034965;34.965034965035
5;0;"jodhveer";5;100;0
914;79297;"jodi";80211;1.13949458303724;98.8605054169628
0;157;"jodiann";157;0;100
0;20;"jodianne";20;0;100
7;0;"jodice";7;100;0
3433;26952;"jodie";30385;11.2983379957216;88.7016620042784
5;0;"jodiel";5;100;0
0;76;"jodilyn";76;0;100
0;47;"jodilynn";47;0;100
0;12;"jodina";12;0;100
0;514;"jodine";514;0;100
0;13;"jodonna";13;0;100
31158;55675;"jody";86833;35.8826713346308;64.1173286653692
0;5;"jodyann";5;0;100
0;64;"jodye";64;0;100
0;5;"jodyne";5;0;100
435814;10983;"joe";446797;97.5418366730305;2.45816332696952
0;58;"joean";58;0;100
0;6;"joeana";6;0;100
306;0;"joeangel";306;100;0
0;1283;"joeann";1283;0;100
0;473;"joeanna";473;0;100
0;137;"joeanne";137;0;100
268;0;"joeanthony";268;100;0
41;0;"joeb";41;100;0
16;0;"joed";16;100;0
6;0;"joedon";6;100;0
180;15;"joedy";195;92.3076923076923;7.69230769230769
5;84;"joee";89;5.61797752808989;94.3820224719101
0;5;"joeen";5;0;100
0;397;"joei";397;0;100
0;10;"joeisha";10;0;100
261711;2543;"joel";264254;99.0376683039803;0.962331696019739
0;12;"joela";12;0;100
0;5;"joelaine";5;0;100
5;0;"joelan";5;100;0
0;21;"joele";21;0;100
0;106;"joelee";106;0;100
0;201;"joeleen";201;0;100
0;1121;"joelene";1121;0;100
0;201;"joeli";201;0;100
0;15;"joelia";15;0;100
0;196;"joelie";196;0;100
5;0;"joeliel";5;100;0
0;15;"joelina";15;0;100
0;78;"joeline";78;0;100
0;16;"joelis";16;0;100
0;36;"joelisa";36;0;100
0;5;"joelissa";5;0;100
0;41;"joeliz";41;0;100
969;1029;"joell";1998;48.4984984984985;51.5015015015015
0;3646;"joella";3646;0;100
366;12914;"joelle";13280;2.75602409638554;97.2439759036145
0;5338;"joellen";5338;0;100
0;17;"joelliane";17;0;100
0;41;"joellie";41;0;100
0;146;"joelly";146;0;100
0;861;"joellyn";861;0;100
5;0;"joelouis";5;100;0
0;1588;"joely";1588;0;100
0;706;"joelyn";706;0;100
0;5;"joelyne";5;0;100
0;210;"joelynn";210;0;100
0;73;"joelys";73;0;100
34;0;"joemar";34;100;0
13;0;"joemichael";13;100;0
0;12;"joemy";12;0;100
49;34;"joen";83;59.0361445783133;40.9638554216867
0;6;"joena";6;0;100
306;0;"joenathan";306;100;0
0;94;"joene";94;0;100
0;10;"joenell";10;0;100
144;0;"joeph";144;100;0
0;11;"joephine";11;0;100
13;0;"joequan";13;100;0
19;0;"joeray";19;100;0
12;0;"joerell";12;100;0
12;0;"joes";12;100;0
10;0;"joesef";10;100;0
2746;0;"joeseph";2746;100;0
0;18;"joesette";18;0;100
0;18;"joesha";18;0;100
398;0;"joesiah";398;100;0
6;0;"joesiyah";6;100;0
15398;12;"joesph";15410;99.9221284879948;0.0778715120051914
0;628;"joesphine";628;0;100
0;3532;"joetta";3532;0;100
0;2000;"joette";2000;0;100
5;0;"joevan";5;100;0
28;0;"joevani";28;100;0
59;0;"joevanni";59;100;0
23;0;"joevanny";23;100;0
29;0;"joevany";29;100;0
164;0;"joevon";164;100;0
51243;6238;"joey";57481;89.147718376507;10.852281623493
0;6;"joeylynn";6;0;100
0;5;"joezette";5;0;100
90;0;"joeziah";90;100;0
193;0;"joffre";193;100;0
77;0;"joffrey";77;100;0
19;0;"jofiel";19;100;0
0;5;"jogina";5;0;100
409;0;"joh";409;100;0
61;0;"johaan";61;100;0
29;0;"johah";29;100;0
10111;135;"johan";10246;98.6824126488386;1.31758735116143
11;6009;"johana";6020;0.182724252491694;99.8172757475083
0;5;"johanah";5;0;100
198;0;"johanan";198;100;0
27;0;"johandry";27;100;0
16;0;"johandy";16;100;0
4028;650;"johann";4678;86.1051731509192;13.8948268490808
129;48093;"johanna";48222;0.267512753514993;99.732487246485
0;2787;"johannah";2787;0;100
0;1423;"johanne";1423;0;100
1841;0;"johannes";1841;100;0
0;5;"johannie";5;0;100
42;278;"johanny";320;13.125;86.875
30;0;"johansel";30;100;0
23;0;"johansen";23;100;0
5;0;"johanson";5;100;0
111;0;"johanthan";111;100;0
50;66;"johany";116;43.1034482758621;56.8965517241379
11;0;"johao";11;100;0
5;0;"johar";5;100;0
0;62;"johara";62;0;100
166;273;"johari";439;37.8132118451025;62.1867881548975
0;12;"joharis";12;0;100
5;0;"johary";5;100;0
1935;0;"johathan";1935;100;0
114;0;"johathon";114;100;0
13;0;"johaun";13;100;0
35;0;"johel";35;100;0
11;0;"johhny";11;100;0
0;12;"johileny";12;0;100
82;0;"johm";82;100;0
4935219;20695;"john";4955914;99.5824180968435;0.417581903156512
6;2451;"johna";2457;0.244200244200244;99.7557997557998
6;0;"johnaaron";6;100;0
5;0;"johnadam";5;100;0
0;673;"johnae";673;0;100
6;0;"johnael";6;100;0
0;7;"johnah";7;0;100
0;10;"johnai";10;0;100
5;0;"johnalbert";5;100;0
5;0;"johnalexander";5;100;0
20;0;"johnallen";20;100;0
0;5;"johnalyn";5;0;100
6;0;"johnan";6;100;0
43;0;"johnandrew";43;100;0
0;59;"johnanna";59;0;100
10;0;"johnanthan";10;100;0
485;0;"johnanthony";485;100;0
32;0;"johnas";32;100;0
0;121;"johnasia";121;0;100
668;0;"johnatan";668;100;0
57;0;"johnatha";57;100;0
91709;349;"johnathan";92058;99.6208911773013;0.379108822698733
1298;0;"johnathen";1298;100;0
159;0;"johnathin";159;100;0
34;0;"johnathn";34;100;0
12;0;"johnatho";12;100;0
24681;52;"johnathon";24733;99.7897545789027;0.210245421097319
83;0;"johnathyn";83;100;0
243;0;"johnaton";243;100;0
91;0;"johnattan";91;100;0
41;0;"johnavan";41;100;0
26;0;"johnaven";26;100;0
17;0;"johnavin";17;100;0
103;0;"johnavon";103;100;0
0;152;"johnay";152;0;100
0;18;"johnaya";18;0;100
14;0;"johnbenedict";14;100;0
10;0;"johncarl";10;100;0
269;0;"johncarlo";269;100;0
467;0;"johncarlos";467;100;0
5;0;"johncarter";5;100;0
84;0;"johncharles";84;100;0
45;0;"johnchristian";45;100;0
118;0;"johnchristopher";118;100;0
0;222;"johnda";222;0;100
97;0;"johndaniel";97;100;0
1038;0;"johndavid";1038;100;0
0;7;"johndrea";7;0;100
63;5;"johne";68;92.6470588235294;7.35294117647059
0;20;"johnea";20;0;100
0;11;"johnecia";11;0;100
62;0;"johnedward";62;100;0
0;50;"johnee";50;0;100
0;11;"johneen";11;0;100
0;5;"johneice";5;0;100
0;164;"johneisha";164;0;100
0;10;"johneka";10;0;100
247;5;"johnel";252;98.015873015873;1.98412698412698
1199;355;"johnell";1554;77.1557271557272;22.8442728442728
0;150;"johnella";150;0;100
13;420;"johnelle";433;3.00230946882217;96.9976905311778
0;26;"johnene";26;0;100
71;0;"johneric";71;100;0
0;41;"johnese";41;0;100
0;279;"johnesha";279;0;100
0;55;"johneshia";55;0;100
0;29;"johnesia";29;0;100
0;5;"johnessa";5;0;100
16;0;"johnethan";16;100;0
0;3194;"johnetta";3194;0;100
0;2004;"johnette";2004;0;100
1514;6;"johney";1520;99.6052631578947;0.394736842105263
11;0;"johnfrancis";11;100;0
58;0;"johngabriel";58;100;0
541;0;"johnhenry";541;100;0
0;244;"johni";244;0;100
0;44;"johnia";44;0;100
0;11;"johniah";11;0;100
0;92;"johnica";92;0;100
0;226;"johnice";226;0;100
0;5;"johnicia";5;0;100
19987;4904;"johnie";24891;80.2980997147563;19.7019002852437
0;62;"johniece";62;0;100
46;0;"johniel";46;100;0
0;6;"johniesha";6;0;100
0;107;"johnika";107;0;100
0;55;"johnine";55;0;100
0;60;"johniqua";60;0;100
0;51;"johnique";51;0;100
0;37;"johnise";37;0;100
0;464;"johnisha";464;0;100
0;576;"johnita";576;0;100
0;5;"johnitta";5;0;100
0;96;"johniya";96;0;100
0;33;"johniyah";33;0;100
5;0;"johnjack";5;100;0
34;0;"johnjames";34;100;0
202;0;"johnjoseph";202;100;0
40;0;"johnlee";40;100;0
5;0;"johnlloyd";5;100;0
10;0;"johnlucas";10;100;0
5;0;"johnluis";5;100;0
318;0;"johnluke";318;100;0
5;0;"johnmarco";5;100;0
496;0;"johnmark";496;100;0
5;0;"johnmartin";5;100;0
77;0;"johnmatthew";77;100;0
2037;0;"johnmichael";2037;100;0
5;0;"johnmorgan";5;100;0
390;0;"johnn";390;100;0
0;9829;"johnna";9829;0;100
0;190;"johnnae";190;0;100
284;0;"johnnathan";284;100;0
10;0;"johnnathon";10;100;0
0;85;"johnnay";85;0;100
0;5;"johnneisha";5;0;100
10;0;"johnnel";10;100;0
72;0;"johnnell";72;100;0
0;19;"johnnesha";19;0;100
0;11;"johnnessa";11;0;100
0;399;"johnnetta";399;0;100
0;143;"johnnette";143;0;100
1122;0;"johnney";1122;100;0
11;199;"johnni";210;5.23809523809524;94.7619047619048
0;5;"johnnia";5;0;100
0;5;"johnnice";5;0;100
99635;47764;"johnnie";147399;67.5954382322811;32.4045617677189
0;9;"johnniemae";9;0;100
0;5;"johnniqua";5;0;100
0;63;"johnnisha";63;0;100
0;33;"johnnita";33;0;100
310050;3703;"johnny";313753;98.8197722412216;1.1802277587784
10;0;"johnnyangel";10;100;0
36;843;"johnnye";879;4.09556313993174;95.9044368600683
5;0;"johnnyjoe";5;100;0
15;0;"johnnylee";15;100;0
42;0;"johnnyray";42;100;0
6;0;"johnoliver";6;100;0
121;0;"johnothan";121;100;0
11;0;"johnovan";11;100;0
7;0;"johnparker";7;100;0
410;0;"johnpatrick";410;100;0
5146;0;"johnpaul";5146;100;0
30;0;"johnpeter";30;100;0
28;0;"johnphilip";28;100;0
11;0;"johnphillip";11;100;0
15;0;"johnray";15;100;0
18;0;"johnrichard";18;100;0
328;0;"johnrobert";328;100;0
72;0;"johnross";72;100;0
7;0;"johnrussell";7;100;0
92;0;"johnryan";92;100;0
5;0;"johnscott";5;100;0
29;0;"johnse";29;100;0
0;1254;"johnsie";1254;0;100
6293;22;"johnson";6315;99.6516231195566;0.348376880443389
453;0;"johnston";453;100;0
0;5;"johnsy";5;0;100
224;5;"johnta";229;97.8165938864629;2.18340611353712
307;7;"johntae";314;97.7707006369427;2.22929936305732
0;5;"johntavia";5;0;100
198;0;"johntavious";198;100;0
21;0;"johntavis";21;100;0
83;0;"johntavius";83;100;0
79;0;"johntay";79;100;0
172;0;"johnte";172;100;0
6;0;"johntel";6;100;0
6;0;"johntell";6;100;0
17;0;"johntez";17;100;0
792;0;"johnthan";792;100;0
473;0;"johnthomas";473;100;0
5;0;"johnthon";5;100;0
57;0;"johntrell";57;100;0
10;0;"johntyler";10;100;0
19;0;"johnvictor";19;100;0
10;0;"johnvincent";10;100;0
61;0;"johnwesley";61;100;0
206;0;"johnwilliam";206;100;0
3421;26;"johny";3447;99.2457209167392;0.754279083260807
0;6;"johnya";6;0;100
0;132;"johnye";132;0;100
0;6;"johnyla";6;0;100
16;0;"johon";16;100;0
0;109;"johonna";109;0;100
5;0;"johrdan";5;100;0
266;0;"johsua";266;100;0
35;0;"johua";35;100;0
5;0;"johusa";5;100;0
0;5;"johvanna";5;0;100
10;0;"johvanny";10;100;0
0;5460;"joi";5460;0;100
0;425;"joia";425;0;100
0;547;"joice";547;0;100
0;10;"joicy";10;0;100
242;2396;"joie";2638;9.17361637604246;90.8263836239575
0;6;"joielle";6;0;100
0;5;"joilyn";5;0;100
0;6;"joise";6;0;100
0;37;"joiya";37;0;100
0;19;"jojean";19;0;100
21;0;"joji";21;100;0
210;117;"jojo";327;64.2201834862385;35.7798165137615
123;0;"jojuan";123;100;0
5;0;"jokari";5;100;0
13;0;"joksan";13;100;0
0;79;"jola";79;0;100
0;259;"jolaine";259;0;100
201;134;"jolan";335;60;40
0;76;"jolana";76;0;100
0;1015;"jolanda";1015;0;100
0;197;"jolane";197;0;100
0;12;"jolani";12;0;100
0;57;"jolanta";57;0;100
0;5;"jolaoluwa";5;0;100
0;170;"jolayne";170;0;100
5;53;"jole";58;8.62068965517241;91.3793103448276
0;167;"jolea";167;0;100
0;111;"joleah";111;0;100
0;251;"jolean";251;0;100
0;5;"jolecia";5;0;100
0;2920;"jolee";2920;0;100
0;6411;"joleen";6411;0;100
0;109;"joleena";109;0;100
0;99;"joleene";99;0;100
0;29;"joleesa";29;0;100
0;30;"jolei";30;0;100
0;665;"joleigh";665;0;100
0;5;"joleigha";5;0;100
37;10;"jolen";47;78.7234042553192;21.2765957446809
0;1024;"jolena";1024;0;100
12;30678;"jolene";30690;0.0391006842619746;99.960899315738
0;6;"jolenna";6;0;100
0;6;"jolesa";6;0;100
0;7;"jolesha";7;0;100
0;15;"jolet";15;0;100
0;53;"joleta";53;0;100
0;28;"joleth";28;0;100
0;6;"joletha";6;0;100
0;33;"jolett";33;0;100
0;227;"joletta";227;0;100
0;644;"jolette";644;0;100
0;334;"joley";334;0;100
0;1098;"joli";1098;0;100
0;42;"jolia";42;0;100
5;0;"jolian";5;100;0
0;68;"joliana";68;0;100
0;36;"jolianna";36;0;100
0;62;"jolicia";62;0;100
0;10867;"jolie";10867;0;100
0;5;"jolieann";5;0;100
0;8;"joliee";8;0;100
0;12;"jolien";12;0;100
0;66;"joliene";66;0;100
0;63;"joliet";63;0;100
0;22;"joliette";22;0;100
42;367;"jolin";409;10.2689486552567;89.7310513447433
0;712;"jolina";712;0;100
0;1003;"jolinda";1003;0;100
0;2086;"joline";2086;0;100
0;742;"jolisa";742;0;100
0;54;"jolisha";54;0;100
0;362;"jolissa";362;0;100
0;121;"jolita";121;0;100
0;64;"joliyah";64;0;100
0;137;"jolleen";137;0;100
0;22;"jollene";22;0;100
0;5;"jollette";5;0;100
10;0;"jollie";10;100;0
338;114;"jolly";452;74.7787610619469;25.2212389380531
91;0;"jolon";91;100;0
0;81;"jolonda";81;0;100
0;1923;"jolyn";1923;0;100
0;86;"jolynda";86;0;100
0;186;"jolyne";186;0;100
0;4332;"jolynn";4332;0;100
0;474;"jolynne";474;0;100
31;0;"jolyon";31;100;0
0;5;"jolysa";5;0;100
0;124;"jolyssa";124;0;100
0;56;"jomaira";56;0;100
17;0;"jomal";17;100;0
0;53;"jomana";53;0;100
0;27;"jomanda";27;0;100
1703;0;"jomar";1703;100;0
0;35;"jomara";35;0;100
6;0;"jomarcus";6;100;0
276;59;"jomari";335;82.3880597014925;17.6119402985075
5;464;"jomarie";469;1.06609808102345;98.9339019189765
104;0;"jomarion";104;100;0
0;16;"jomaris";16;0;100
0;44;"jomary";44;0;100
0;75;"jomayra";75;0;100
5;0;"jomei";5;100;0
0;10;"jomeka";10;0;100
68;0;"jomel";68;100;0
93;0;"jomes";93;100;0
23;0;"jometh";23;100;0
0;5;"jomiah";5;0;100
0;9;"jomira";9;0;100
355;0;"jomo";355;100;0
165568;1250;"jon";166818;99.2506803822129;0.749319617787049
348;1640;"jona";1988;17.5050301810865;82.4949698189135
21;0;"jonadab";21;100;0
0;1040;"jonae";1040;0;100
363;0;"jonael";363;100;0
60165;545;"jonah";60710;99.1022895733817;0.89771042661835
12;0;"jonahan";12;100;0
8;0;"jonahel";8;100;0
31;0;"jonahs";31;100;0
188;0;"jonahtan";188;100;0
5;147;"jonai";152;3.28947368421053;96.7105263157895
0;10;"jonalee";10;0;100
0;211;"jonalyn";211;0;100
6;0;"jonam";6;100;0
202;0;"jonan";202;100;0
76;0;"jonanthan";76;100;0
154;0;"jonanthony";154;100;0
22610;28;"jonas";22638;99.8763141620285;0.123685837971552
0;198;"jonasia";198;0;100
3300;0;"jonatan";3300;100;0
35;0;"jonath";35;100;0
311;29;"jonatha";340;91.4705882352941;8.52941176470588
26;0;"jonatham";26;100;0
826983;3521;"jonathan";830504;99.5760405729533;0.423959427046709
60;0;"jonathandavid";60;100;0
11;0;"jonathanjames";11;100;0
7;0;"jonathanjoseph";7;100;0
25;0;"jonathanmichael";25;100;0
5;0;"jonathaon";5;100;0
1489;0;"jonathen";1489;100;0
101;0;"jonathin";101;100;0
25;0;"jonathn";25;100;0
5;0;"jonathna";5;100;0
64286;224;"jonathon";64510;99.6527670128662;0.347232987133778
277;0;"jonathyn";277;100;0
15;0;"jonaton";15;100;0
41;0;"jonattan";41;100;0
10;0;"jonatthan";10;100;0
235;0;"jonavan";235;100;0
105;0;"jonaven";105;100;0
106;0;"jonavin";106;100;0
126;0;"jonavon";126;100;0
0;151;"jonay";151;0;100
0;74;"jonaya";74;0;100
0;20;"jonaye";20;0;100
0;20;"jonbenet";20;0;100
238;0;"joncarlo";238;100;0
201;0;"joncarlos";201;100;0
6;0;"jonce";6;100;0
10;0;"jonchristopher";10;100;0
0;508;"jonda";508;0;100
20;0;"jondarius";20;100;0
297;0;"jondavid";297;100;0
0;5;"jondra";5;0;100
0;19;"jondrea";19;0;100
24;687;"jone";711;3.37552742616034;96.6244725738397
0;120;"jonea";120;0;100
0;23;"jonecia";23;0;100
0;295;"jonee";295;0;100
0;35;"joneen";35;0;100
0;5;"joneer";5;0;100
0;164;"joneisha";164;0;100
0;18;"joneka";18;0;100
323;328;"jonel";651;49.615975422427;50.384024577573
207;2452;"jonell";2659;7.78488153441143;92.2151184655886
0;95;"jonella";95;0;100
21;3148;"jonelle";3169;0.662669611864942;99.3373303881351
0;5;"jonene";5;0;100
99;0;"joneric";99;100;0
203;0;"jonerik";203;100;0
3163;12;"jones";3175;99.6220472440945;0.377952755905512
0;239;"jonesha";239;0;100
0;52;"joneshia";52;0;100
0;98;"jonessa";98;0;100
6;0;"jonesy";6;100;0
0;78;"jonet";78;0;100
22;0;"jonethan";22;100;0
6;0;"jonethen";6;100;0
0;901;"jonetta";901;0;100
0;1221;"jonette";1221;0;100
11;0;"joney";11;100;0
74;0;"jong";74;100;0
155;0;"jonh";155;100;0
75;0;"jonhatan";75;100;0
5;0;"jonhathan";5;100;0
7;0;"jonhenry";7;100;0
541;28079;"joni";28620;1.89028651292802;98.109713487072
0;95;"jonia";95;0;100
0;126;"joniah";126;0;100
12;0;"jonibek";12;100;0
0;628;"jonica";628;0;100
0;96;"jonice";96;0;100
0;11;"jonicia";11;0;100
44;1233;"jonie";1277;3.44557556773688;96.5544244322631
0;68;"joniece";68;0;100
398;0;"joniel";398;100;0
5;0;"joniell";5;100;0
0;31;"jonier";31;0;100
0;17;"joniesha";17;0;100
0;206;"jonika";206;0;100
0;21;"jonikka";21;0;100
0;5;"jonilee";5;0;100
0;45;"jonina";45;0;100
0;22;"jonine";22;0;100
0;89;"joniqua";89;0;100
0;427;"jonique";427;0;100
46;0;"jonis";46;100;0
0;76;"jonise";76;0;100
0;437;"jonisha";437;0;100
0;799;"jonita";799;0;100
22;0;"jonithan";22;100;0
0;148;"joniya";148;0;100
0;207;"joniyah";207;0;100
8;0;"jonjon";8;100;0
57;0;"jonluc";57;100;0
5;0;"jonluca";5;100;0
5;0;"jonlucas";5;100;0
133;0;"jonluke";133;100;0
0;5;"jonlyn";5;0;100
75;0;"jonmarc";75;100;0
10;0;"jonmark";10;100;0
5;0;"jonmatthew";5;100;0
1386;0;"jonmichael";1386;100;0
537;0;"jonn";537;100;0
0;5471;"jonna";5471;0;100
0;264;"jonnae";264;0;100
10;29;"jonnah";39;25.6410256410256;74.3589743589744
66;0;"jonnatan";66;100;0
1158;0;"jonnathan";1158;100;0
52;0;"jonnathon";52;100;0
0;29;"jonnay";29;0;100
0;82;"jonne";82;0;100
11;58;"jonnell";69;15.9420289855072;84.0579710144928
0;48;"jonnelle";48;0;100
0;16;"jonnesha";16;0;100
0;50;"jonnetta";50;0;100
0;160;"jonnette";160;0;100
5;0;"jonney";5;100;0
5;1214;"jonni";1219;0.410172272354389;99.5898277276456
0;6;"jonnica";6;0;100
3107;5648;"jonnie";8755;35.4882924043404;64.5117075956596
6;0;"jonniel";6;100;0
0;10;"jonnika";10;0;100
0;5;"jonnique";5;0;100
0;26;"jonnisha";26;0;100
0;26;"jonnita";26;0;100
3070;131;"jonny";3201;95.9075288972196;4.09247110278038
0;5;"jonnye";5;0;100
5;0;"jonoah";5;100;0
882;0;"jonothan";882;100;0
39;0;"jonothon";39;100;0
257;0;"jonovan";257;100;0
14;0;"jonpatrick";14;100;0
1508;0;"jonpaul";1508;100;0
10;0;"jonpierre";10;100;0
12;0;"jonquavious";12;100;0
10;0;"jonquel";10;100;0
28;0;"jonquez";28;100;0
55;214;"jonquil";269;20.4460966542751;79.5539033457249
7;0;"jonquin";7;100;0
5;0;"jonrobert";5;100;0
5;0;"jonross";5;100;0
6;0;"jonryan";6;100;0
16;0;"jonson";16;100;0
216;33;"jonta";249;86.7469879518072;13.2530120481928
796;179;"jontae";975;81.6410256410256;18.3589743589744
14;0;"jontarius";14;100;0
0;19;"jontasia";19;0;100
0;74;"jontavia";74;0;100
19;0;"jontavion";19;100;0
408;0;"jontavious";408;100;0
36;0;"jontavis";36;100;0
247;0;"jontavius";247;100;0
147;15;"jontay";162;90.7407407407407;9.25925925925926
0;5;"jontaya";5;0;100
5;0;"jontaye";5;100;0
1174;226;"jonte";1400;83.8571428571428;16.1428571428571
31;20;"jontel";51;60.7843137254902;39.2156862745098
0;5;"jontelle";5;0;100
0;6;"jonteria";6;0;100
117;0;"jontez";117;100;0
990;0;"jonthan";990;100;0
43;0;"jonthomas";43;100;0
0;29;"jontia";29;0;100
12;0;"jontre";12;100;0
192;0;"jontrell";192;100;0
77;34;"jontue";111;69.3693693693694;30.6306306306306
7;0;"jontyler";7;100;0
46;0;"jonuel";46;100;0
186;0;"jonus";186;100;0
5;0;"jonwesley";5;100;0
229;0;"jony";229;100;0
0;43;"jonya";43;0;100
0;28;"jonylah";28;0;100
5;10;"joo";15;33.3333333333333;66.6666666666667
29;134;"jood";163;17.7914110429448;82.2085889570552
362;37;"joon";399;90.7268170426065;9.27318295739348
0;41;"joory";41;0;100
5;0;"jooyoung";5;100;0
6;0;"jophiel";6;100;0
10;0;"jophy";10;100;0
5;199;"joplin";204;2.45098039215686;97.5490196078431
0;34;"joplyn";34;0;100
0;6;"joplynn";6;0;100
172;0;"joquan";172;100;0
5;0;"joquavious";5;100;0
0;10;"joquetta";10;0;100
11;0;"joquin";11;100;0
0;21;"joquita";21;0;100
0;82;"jora";82;0;100
31;36;"jorah";67;46.2686567164179;53.7313432835821
213;0;"joram";213;100;0
192;0;"joran";192;100;0
8;0;"jorawar";8;100;0
5;0;"joray";5;100;0
27;0;"jorda";27;100;0
25;0;"jordaan";25;100;0
30;0;"jordache";30;100;0
0;5;"jordae";5;0;100
0;5;"jordahn";5;0;100
0;6;"jordai";6;0;100
59;215;"jordain";274;21.5328467153285;78.4671532846715
364250;129262;"jordan";493512;73.807729092707;26.192270907293
0;3093;"jordana";3093;0;100
5;0;"jordanalexander";5;100;0
5;0;"jordanchristoph";5;100;0
7;160;"jordane";167;4.19161676646707;95.8083832335329
73;0;"jordani";73;100;0
0;11;"jordania";11;0;100
18;0;"jordanlee";18;100;0
0;5;"jordanmarie";5;0;100
11;0;"jordanmichael";11;100;0
54;1015;"jordann";1069;5.05144995322732;94.9485500467727
0;779;"jordanna";779;0;100
0;614;"jordanne";614;0;100
88;0;"jordanny";88;100;0
51;0;"jordano";51;100;0
385;0;"jordany";385;100;0
0;90;"jordayn";90;0;100
16;0;"jorddy";16;100;0
5;0;"jorde";5;100;0
0;5;"jordee";5;0;100
69;0;"jordell";69;100;0
6443;2265;"jorden";8708;73.9894350022967;26.0105649977033
0;7;"jordeyn";7;0;100
2554;171;"jordi";2725;93.7247706422018;6.27522935779816
0;27;"jordian";27;0;100
123;41;"jordie";164;75;25
2214;4134;"jordin";6348;34.8771266540643;65.1228733459357
0;6;"jordinn";6;0;100
6;267;"jordis";273;2.1978021978022;97.8021978021978
13299;1831;"jordon";15130;87.8982154659617;12.1017845340383
5;0;"jordun";5;100;0
4839;62;"jordy";4901;98.7349520506019;1.26504794939808
12;72;"jordyan";84;14.2857142857143;85.7142857142857
4841;49598;"jordyn";54439;8.89252190525175;91.1074780947482
0;311;"jordyne";311;0;100
93;3876;"jordynn";3969;2.34315948601663;97.6568405139834
0;214;"jordynne";214;0;100
0;33;"joree";33;0;100
0;106;"joreen";106;0;100
949;0;"jorel";949;100;0
461;0;"jorell";461;100;0
0;5;"jorelys";5;0;100
307;0;"joren";307;100;0
0;515;"jorene";515;0;100
0;36;"joretha";36;0;100
0;1033;"joretta";1033;0;100
220;25;"jorey";245;89.7959183673469;10.2040816326531
0;55;"jorga";55;0;100
11;0;"jorgan";11;100;0
127932;689;"jorge";128621;99.4643176464186;0.535682353581452
5;0;"jorgealberto";5;100;0
6;0;"jorgeantonio";6;100;0
5;0;"jorgedavid";5;100;0
5;0;"jorgejr";5;100;0
385;0;"jorgeluis";385;100;0
457;0;"jorgen";457;100;0
0;6;"jorgi";6;0;100
0;318;"jorgia";318;0;100
0;28;"jorgie";28;0;100
0;64;"jorgina";64;0;100
143;1919;"jori";2062;6.93501454898157;93.0649854510184
0;11;"joria";11;0;100
6;5;"joriah";11;54.5454545454545;45.4545454545455
321;32;"jorian";353;90.9348441926346;9.06515580736544
0;5;"joriann";5;0;100
0;5;"jorianna";5;0;100
14;1127;"jorie";1141;1.22699386503067;98.7730061349693
72;0;"joriel";72;100;0
7;0;"jorien";7;100;0
6;0;"jorim";6;100;0
45;0;"jorin";45;100;0
54;0;"joris";54;100;0
0;107;"jorita";107;0;100
0;2563;"jorja";2563;0;100
1156;0;"jorje";1156;100;0
0;40;"jorjia";40;0;100
0;5;"jorleny";5;0;100
0;35;"jorley";35;0;100
68;0;"jorma";68;100;0
52;0;"jorman";52;100;0
6;0;"jorn";6;100;0
5;0;"jorome";5;100;0
74;0;"joron";74;100;0
24;0;"jorrel";24;100;0
149;0;"jorrell";149;100;0
6;0;"jorren";6;100;0
0;10;"jorri";10;0;100
0;5;"jorrie";5;0;100
16;0;"jorrin";16;100;0
77;80;"jorryn";157;49.0445859872611;50.9554140127389
3010;516;"jory";3526;85.3658536585366;14.6341463414634
5;0;"joryel";5;100;0
0;13;"joryn";13;0;100
60;0;"jos";60;100;0
7;0;"josa";7;100;0
0;5;"josabet";5;0;100
0;17;"josabeth";17;0;100
15;0;"josael";15;100;0
351;0;"josafat";351;100;0
16;0;"josai";16;100;0
5;0;"josaia";5;100;0
319;0;"josaiah";319;100;0
35;0;"josaih";35;100;0
0;138;"josalin";138;0;100
0;10;"josalina";10;0;100
0;54;"josaline";54;0;100
0;1929;"josalyn";1929;0;100
0;6;"josalyne";6;0;100
0;676;"josalynn";676;0;100
10;0;"josan";10;100;0
0;10;"josann";10;0;100
0;81;"josanna";81;0;100
0;58;"josanne";58;0;100
11;0;"josaphat";11;100;0
0;6;"josaphina";6;0;100
0;154;"josaphine";154;0;100
5;0;"josbel";5;100;0
11;0;"joscar";11;100;0
0;243;"joscelin";243;0;100
0;84;"josceline";84;0;100
0;1997;"joscelyn";1997;0;100
0;117;"joscelyne";117;0;100
0;168;"joscelynn";168;0;100
0;56;"josclyn";56;0;100
553960;4132;"jose";558092;99.2596202776603;0.740379722339686
7;0;"josea";7;100;0
5;0;"joseadrian";5;100;0
159;0;"josealberto";159;100;0
39;0;"josealejandro";39;100;0
157;0;"josealfredo";157;100;0
233;0;"josean";233;100;0
65;0;"joseandres";65;100;0
1061;0;"joseangel";1061;100;0
727;0;"joseantonio";727;100;0
148;0;"josearmando";148;100;0
294;0;"josecarlos";294;100;0
21;0;"josecruz";21;100;0
147;0;"josedaniel";147;100;0
37;0;"josedavid";37;100;0
92;0;"josede";92;100;0
648;0;"josedejesus";648;100;0
5;0;"joseduardo";5;100;0
0;517;"josee";517;0;100
70;0;"joseeduardo";70;100;0
42;0;"joseenrique";42;100;0
8537;0;"josef";8537;100;0
0;3686;"josefa";3686;0;100
10;0;"josefernando";10;100;0
102;0;"joseff";102;100;0
35;13078;"josefina";13113;0.266910699306032;99.733089300694
0;522;"josefine";522;0;100
0;205;"josefita";205;0;100
45;0;"josefrancisco";45;100;0
5;0;"josegabriel";5;100;0
152;0;"joseguadalupe";152;100;0
143;0;"joseh";143;100;0
0;10;"josehine";10;0;100
16;0;"josehp";16;100;0
102;0;"josehua";102;100;0
0;5;"josei";5;0;100
5;0;"joseiah";5;100;0
11;0;"joseignacio";11;100;0
26;0;"josejavier";26;100;0
24;0;"josejesus";24;100;0
12;0;"josejr";12;100;0
242;0;"josejuan";242;100;0
152;0;"josejulian";152;100;0
76;0;"josel";76;100;0
0;5;"joselen";5;0;100
0;29;"joselene";29;0;100
0;3868;"joselin";3868;0;100
0;44;"joselina";44;0;100
0;3442;"joseline";3442;0;100
0;77;"joselinne";77;0;100
742;0;"joselito";742;100;0
0;190;"joselle";190;0;100
0;19;"josellyn";19;0;100
3860;0;"joseluis";3860;100;0
6;0;"joseluiz";6;100;0
0;60;"josely";60;0;100
5;16213;"joselyn";16218;0.030829942039709;99.9691700579603
0;1098;"joselyne";1098;0;100
0;1163;"joselynn";1163;0;100
0;125;"joselynne";125;0;100
1130;0;"josemanuel";1130;100;0
539;0;"josemaria";539;100;0
409;0;"josemiguel";409;100;0
21;0;"josen";21;100;0
0;31;"josenid";31;0;100
129;0;"josep";129;100;0
16;0;"josepablo";16;100;0
2537564;10320;"joseph";2547884;99.5949580122172;0.405041987782803
0;371;"josepha";371;0;100
5;0;"josephallen";5;100;0
5;0;"josephandrew";5;100;0
67;0;"josephanthony";67;100;0
15;0;"josephdaniel";15;100;0
32;0;"josephe";32;100;0
0;278;"josephene";278;0;100
0;5;"josephin";5;0;100
0;2532;"josephina";2532;0;100
932;281193;"josephine";282125;0.330350022153301;99.6696499778467
16;0;"josephjames";16;100;0
5;0;"josephjohn";5;100;0
10;0;"josephlee";10;100;0
97;0;"josephmichael";97;100;0
5;0;"josephpatrick";5;100;0
5;0;"josephpaul";5;100;0
5;0;"josephthomas";5;100;0
1136;0;"josephus";1136;100;0
12;0;"josephy";12;100;0
0;60;"josephyne";60;0;100
0;5;"josepine";5;0;100
0;5;"josera";5;0;100
55;0;"joseramon";55;100;0
6;0;"josericardo";6;100;0
19;0;"joseroberto";19;100;0
33;0;"joses";33;100;0
11;5;"joset";16;68.75;31.25
149;0;"joseth";149;100;0
0;32;"josett";32;0;100
0;513;"josetta";513;0;100
0;5970;"josette";5970;0;100
824;2489;"josey";3313;24.8717174766073;75.1282825233927
34;0;"josgar";34;100;0
8;0;"josgart";8;100;0
15923;0;"josh";15923;100;0
426;28;"josha";454;93.8325991189427;6.16740088105727
0;184;"joshalyn";184;0;100
0;39;"joshalynn";39;0;100
0;5;"joshanae";5;0;100
247;0;"joshau";247;100;0
208;0;"joshaua";208;100;0
56;0;"joshaun";56;100;0
508;0;"joshawa";508;100;0
126;0;"joshawn";126;100;0
0;14;"joshelin";14;0;100
0;56;"joshelyn";56;0;100
5;0;"joshep";5;100;0
24;0;"josheph";24;100;0
6;0;"josheua";6;100;0
10;0;"joshewa";10;100;0
152;0;"joshia";152;100;0
87;0;"joshiah";87;100;0
0;5;"joshie";5;0;100
0;5;"joshika";5;0;100
0;12;"joshitha";12;0;100
7;23;"joshlin";30;23.3333333333333;76.6666666666667
5;1188;"joshlyn";1193;0.419111483654652;99.5808885163453
0;569;"joshlynn";569;0;100
97;0;"joshoa";97;100;0
10;0;"joshoua";10;100;0
16;0;"joshton";16;100;0
96;0;"joshu";96;100;0
1193300;4903;"joshua";1198203;99.5908038955002;0.409196104499822
5;0;"joshuaa";5;100;0
11;0;"joshuaaaron";11;100;0
5;0;"joshuaalexander";5;100;0
6;0;"joshuaanthony";6;100;0
11;0;"joshuacaleb";11;100;0
11;0;"joshuadaniel";11;100;0
57;0;"joshuadavid";57;100;0
2762;0;"joshuah";2762;100;0
93;0;"joshuajames";93;100;0
5;0;"joshuajay";5;100;0
5;0;"joshuajohn";5;100;0
5;0;"joshuajoseph";5;100;0
146;0;"joshual";146;100;0
32;0;"joshualee";32;100;0
54;0;"joshuamichael";54;100;0
156;0;"joshuan";156;100;0
12;0;"joshuapaul";12;100;0
5;0;"joshuar";5;100;0
5;0;"joshuaray";5;100;0
5;0;"joshuarobert";5;100;0
17;0;"joshuaryan";17;100;0
1083;0;"joshue";1083;100;0
16;0;"joshuea";16;100;0
30;0;"joshuel";30;100;0
33;0;"joshuia";33;100;0
5;0;"joshula";5;100;0
171;0;"joshus";171;100;0
10;0;"joshusa";10;100;0
395;0;"joshuwa";395;100;0
59;0;"joshva";59;100;0
444;0;"joshwa";444;100;0
12;0;"joshya";12;100;0
0;889;"josi";889;0;100
114;5;"josia";119;95.7983193277311;4.20168067226891
93124;345;"josiah";93469;99.6308936652794;0.369106334720603
21;0;"josiaha";21;100;0
50;0;"josiahs";50;100;0
233;0;"josian";233;100;0
0;26;"josiana";26;0;100
0;73;"josiane";73;0;100
0;7;"josianna";7;0;100
0;15;"josianne";15;0;100
1886;0;"josias";1886;100;0
470;51147;"josie";51617;0.910552724877463;99.0894472751225
284;0;"josiel";284;100;0
0;17;"josielyn";17;0;100
0;11;"josielynn";11;0;100
0;5;"josiephene";5;0;100
0;937;"josiephine";937;0;100
10;0;"josif";10;100;0
12;0;"josiha";12;100;0
5;0;"josiiah";5;100;0
0;58;"josilin";58;0;100
0;1028;"josilyn";1028;0;100
0;5;"josilyne";5;0;100
0;219;"josilynn";219;0;100
81;0;"josimar";81;100;0
0;26;"josina";26;0;100
0;5;"josine";5;0;100
103;0;"josip";103;100;0
0;31;"josiphine";31;0;100
28;0;"josiya";28;100;0
380;0;"josiyah";380;100;0
6;0;"josje";6;100;0
5;0;"josjeph";5;100;0
22;0;"joskar";22;100;0
0;16;"joslen";16;0;100
0;6;"joslene";6;0;100
10;1280;"joslin";1290;0.775193798449612;99.2248062015504
0;28;"josline";28;0;100
28;9757;"joslyn";9785;0.286152273888605;99.7138477261114
0;71;"joslyne";71;0;100
0;2808;"joslynn";2808;0;100
0;134;"joslynne";134;0;100
15;0;"josman";15;100;0
567;0;"josmar";567;100;0
0;11;"josmarie";11;0;100
0;40;"josmary";40;0;100
5;0;"josmel";5;100;0
0;6;"josmine";6;0;100
33;0;"josniel";33;100;0
80;0;"joson";80;100;0
1483;0;"jospeh";1483;100;0
344;0;"josph";344;100;0
5;0;"josphe";5;100;0
0;244;"josphine";244;0;100
5;0;"josphua";5;100;0
291;174;"joss";465;62.5806451612903;37.4193548387097
0;66;"jossalin";66;0;100
0;331;"jossalyn";331;0;100
0;57;"jossalynn";57;0;100
10;0;"josse";10;100;0
0;731;"josselin";731;0;100
0;559;"josseline";559;0;100
0;2811;"josselyn";2811;0;100
0;165;"josselyne";165;0;100
0;56;"josselynn";56;0;100
0;80;"jossette";80;0;100
160;0;"jossiah";160;100;0
0;5;"jossica";5;0;100
17;1760;"jossie";1777;0.956668542487338;99.0433314575127
26;0;"jossiel";26;100;0
0;12;"jossiephine";12;0;100
0;86;"jossilyn";86;0;100
0;5;"jossilynn";5;0;100
5;0;"jossimar";5;100;0
0;87;"josslin";87;0;100
0;1747;"josslyn";1747;0;100
0;367;"josslynn";367;0;100
0;5;"josslynne";5;0;100
626;0;"jossue";626;100;0
0;11;"jossy";11;0;100
6;0;"jostein";6;100;0
266;0;"josten";266;100;0
593;0;"jostin";593;100;0
21;0;"joston";21;100;0
48;12;"jostyn";60;80;20
755;0;"josua";755;100;0
36;0;"josuah";36;100;0
46279;185;"josue";46464;99.6018422865014;0.398157713498623
126;0;"josuel";126;100;0
281;0;"josuha";281;100;0
5;0;"josuhe";5;100;0
0;72;"josy";72;0;100
270;0;"josyah";270;100;0
43;0;"josyiah";43;100;0
0;5;"josylin";5;0;100
7;0;"josziah";7;100;0
5;0;"jotaro";5;100;0
6;0;"jotavious";6;100;0
482;0;"jotham";482;100;0
15;0;"jothan";15;100;0
0;65;"joua";65;0;100
5;0;"jouan";5;100;0
0;6;"jouanna";6;0;100
74;133;"joud";207;35.7487922705314;64.2512077294686
0;6;"jouette";6;0;100
0;12;"joule";12;0;100
0;14;"joules";14;0;100
0;20;"joumana";20;0;100
169;36;"jourdain";205;82.4390243902439;17.5609756097561
1728;2252;"jourdan";3980;43.4170854271357;56.5829145728643
185;84;"jourden";269;68.7732342007435;31.2267657992565
81;146;"jourdin";227;35.6828193832599;64.3171806167401
144;16;"jourdon";160;90;10
126;599;"jourdyn";725;17.3793103448276;82.6206896551724
0;14;"jourdynn";14;0;100
0;40;"jouri";40;0;100
0;5;"journae";5;0;100
0;85;"journe";85;0;100
53;5400;"journee";5453;0.97194205024757;99.0280579497524
0;804;"journei";804;0;100
0;11;"journeigh";11;0;100
0;11;"journeii";11;0;100
1041;11007;"journey";12048;8.64043824701195;91.359561752988
0;1413;"journi";1413;0;100
6;1253;"journie";1259;0.476568705321684;99.5234312946783
0;41;"journiee";41;0;100
0;161;"journii";161;0;100
0;14;"journy";14;0;100
0;36;"journye";36;0;100
0;70;"joury";70;0;100
5;0;"jouse";5;100;0
431;0;"jousha";431;100;0
90;0;"joushua";90;100;0
5;0;"jovaan";5;100;0
166;0;"jovahn";166;100;0
11;0;"jovahni";11;100;0
5;0;"jovahny";5;100;0
8989;1079;"jovan";10068;89.2828764402066;10.7171235597934
0;1873;"jovana";1873;0;100
0;5;"jovanah";5;0;100
0;18;"jovanda";18;0;100
74;0;"jovane";74;100;0
5807;109;"jovani";5916;98.15753887762;1.84246112237999
0;5;"jovania";5;0;100
367;11;"jovanie";378;97.0899470899471;2.91005291005291
11;0;"jovaniel";11;100;0
7;0;"jovanii";7;100;0
0;55;"jovanka";55;0;100
109;6;"jovann";115;94.7826086956522;5.21739130434783
0;2966;"jovanna";2966;0;100
0;55;"jovannah";55;0;100
64;29;"jovanne";93;68.8172043010753;31.1827956989247
4821;156;"jovanni";4977;96.8655816757083;3.13441832429174
316;11;"jovannie";327;96.6360856269113;3.36391437308868
4283;16;"jovanny";4299;99.6278204233543;0.372179576645732
11;0;"jovanta";11;100;0
19;0;"jovantae";19;100;0
404;0;"jovante";404;100;0
4249;11;"jovany";4260;99.7417840375587;0.258215962441315
12;0;"jovar";12;100;0
5;0;"jovari";5;100;0
348;0;"jovaughn";348;100;0
129;0;"jovaun";129;100;0
18;0;"jovawn";18;100;0
111;0;"jove";111;100;0
0;117;"jovee";117;0;100
33;0;"jovel";33;100;0
6;0;"jovell";6;100;0
197;0;"joven";197;100;0
0;7;"jovetta";7;0;100
0;10;"jovette";10;0;100
0;37;"jovey";37;0;100
289;745;"jovi";1034;27.9497098646035;72.0502901353965
0;32;"jovia";32;0;100
0;12;"jovial";12;0;100
327;5;"jovian";332;98.4939759036145;1.50602409638554
0;38;"joviana";38;0;100
0;19;"jovianna";19;0;100
0;11;"jovianne";11;0;100
0;1547;"jovie";1547;0;100
0;5;"jovienne";5;0;100
128;0;"jovin";128;100;0
0;49;"jovina";49;0;100
5;3243;"jovita";3248;0.153940886699507;99.8460591133005
5;0;"jovohn";5;100;0
2527;289;"jovon";2816;89.7372159090909;10.2627840909091
0;55;"jovona";55;0;100
0;58;"jovonda";58;0;100
5;0;"jovone";5;100;0
78;5;"jovoni";83;93.9759036144578;6.02409638554217
17;0;"jovonie";17;100;0
22;5;"jovonn";27;81.4814814814815;18.5185185185185
0;422;"jovonna";422;0;100
28;177;"jovonne";205;13.6585365853659;86.3414634146341
152;0;"jovonni";152;100;0
28;6;"jovonnie";34;82.3529411764706;17.6470588235294
5;0;"jovonny";5;100;0
79;0;"jovonta";79;100;0
69;0;"jovontae";69;100;0
304;0;"jovonte";304;100;0
144;0;"jowan";144;100;0
0;107;"jowana";107;0;100
0;114;"jowanda";114;0;100
0;227;"jowanna";227;0;100
79;0;"jowel";79;100;0
641;5;"jowell";646;99.2260061919505;0.773993808049536
5;0;"jowen";5;100;0
0;5;"jowharah";5;0;100
5;0;"joxiel";5;100;0
2441;133218;"joy";135659;1.79936458325655;98.2006354167435
0;1624;"joya";1624;0;100
0;18;"joyace";18;0;100
0;24;"joyah";24;0;100
0;19;"joyal";19;0;100
0;12;"joyana";12;0;100
0;517;"joyann";517;0;100
0;608;"joyanna";608;0;100
0;276;"joyanne";276;0;100
2858;506562;"joyce";509420;0.561030191197833;99.4389698088022
0;277;"joyceann";277;0;100
0;47;"joycee";47;0;100
0;25;"joycelene";25;0;100
0;147;"joycelin";147;0;100
0;92;"joyceline";92;0;100
0;6400;"joycelyn";6400;0;100
0;500;"joycelynn";500;0;100
0;10;"joycene";10;0;100
0;483;"joycie";483;0;100
0;86;"joyclyn";86;0;100
0;86;"joydan";86;0;100
5;5;"joyden";10;50;50
8;3433;"joye";3441;0.2324905550712;99.7675094449288
0;5;"joyee";5;0;100
0;130;"joyel";130;0;100
0;89;"joyell";89;0;100
0;342;"joyelle";342;0;100
0;6;"joyetta";6;0;100
0;10;"joyette";10;0;100
0;19;"joyful";19;0;100
0;102;"joyia";102;0;100
0;188;"joyice";188;0;100
0;19;"joyl";19;0;100
0;33;"joyleen";33;0;100
0;369;"joylene";369;0;100
0;38;"joylin";38;0;100
0;364;"joylyn";364;0;100
0;512;"joylynn";512;0;100
0;5;"joylynne";5;0;100
0;15;"joymarie";15;0;100
0;5;"joynae";5;0;100
0;5;"joynell";5;0;100
5;0;"joyner";5;100;0
0;97;"joyous";97;0;100
0;5;"joyse";5;0;100
0;16;"joyzelle";16;0;100
17;0;"jozaiah";17;100;0
0;159;"jozalyn";159;0;100
0;70;"jozalynn";70;0;100
0;146;"jozee";146;0;100
1029;0;"jozef";1029;100;0
0;11;"jozefa";11;0;100
0;11;"jozelle";11;0;100
0;333;"jozelyn";333;0;100
0;96;"jozelynn";96;0;100
98;0;"jozeph";98;100;0
0;11;"jozephine";11;0;100
0;5;"jozett";5;0;100
0;11;"jozetta";11;0;100
0;490;"jozette";490;0;100
0;88;"jozey";88;0;100
0;140;"jozi";140;0;100
2653;5;"joziah";2658;99.8118886380737;0.18811136192626
0;843;"jozie";843;0;100
18;0;"joziel";18;100;0
0;20;"jozilyn";20;0;100
66;0;"joziyah";66;100;0
0;72;"jozlin";72;0;100
0;1066;"jozlyn";1066;0;100
0;5;"jozlyne";5;0;100
0;587;"jozlynn";587;0;100
0;12;"jozlynne";12;0;100
123;0;"jozsef";123;100;0
12;78;"jozy";90;13.3333333333333;86.6666666666667
34;0;"jozyah";34;100;0
0;17;"jozzlynn";17;0;100
73;0;"jp";73;100;0
543;0;"jquan";543;100;0
5;0;"jqwon";5;100;0
1493;0;"jr";1493;100;0
70;0;"jrake";70;100;0
0;5;"jraya";5;0;100
10;0;"jrayden";10;100;0
21;93;"jream";114;18.4210526315789;81.5789473684211
14;0;"jrew";14;100;0
19;0;"jron";19;100;0
43;9;"jru";52;82.6923076923077;17.3076923076923
264;44;"jrue";308;85.7142857142857;14.2857142857143
5;0;"jsai";5;100;0
0;6;"jsamine";6;0;100
115;0;"jsaon";115;100;0
269;0;"jsean";269;100;0
157;0;"jshaun";157;100;0
310;0;"jshawn";310;100;0
5;0;"jshin";5;100;0
101;0;"jshon";101;100;0
5;0;"jshun";5;100;0
72;0;"jsiah";72;100;0
71;0;"jsoeph";71;100;0
286;0;"json";286;100;0
0;11;"jssica";11;0;100
53;0;"jsutin";53;100;0
483;0;"jt";483;100;0
12;24;"ju";36;33.3333333333333;66.6666666666667
20;0;"jua";20;100;0
0;5;"juaita";5;0;100
5;0;"jual";5;100;0
340765;2733;"juan";343498;99.2043621796925;0.795637820307542
88;17079;"juana";17167;0.512611405603775;99.4873885943962
45;0;"juanalberto";45;100;0
42;0;"juanandres";42;100;0
166;0;"juanangel";166;100;0
391;0;"juanantonio";391;100;0
5;0;"juancarlo";5;100;0
3564;0;"juancarlos";3564;100;0
0;482;"juanda";482;0;100
0;13;"juandalynn";13;0;100
152;0;"juandaniel";152;100;0
167;0;"juandavid";167;100;0
216;0;"juandedios";216;100;0
607;0;"juandiego";607;100;0
32;0;"juane";32;100;0
0;260;"juanell";260;0;100
0;66;"juanelle";66;0;100
5;0;"juanenrique";5;100;0
0;16;"juanesha";16;0;100
8;0;"juanesteban";8;100;0
0;247;"juanetta";247;0;100
0;135;"juanette";135;0;100
11;0;"juanfelipe";11;100;0
5;0;"juanfernando";5;100;0
30;0;"juanfrancisco";30;100;0
0;488;"juanice";488;0;100
0;53;"juanika";53;0;100
0;6;"juaniqua";6;0;100
0;174;"juanisha";174;0;100
991;205178;"juanita";206169;0.480673622125538;99.5193263778745
1052;5;"juanito";1057;99.526963103122;0.473036896877956
0;62;"juanitta";62;0;100
80;0;"juanjesus";80;100;0
884;0;"juanjose";884;100;0
5;0;"juanjr";5;100;0
340;0;"juanluis";340;100;0
737;0;"juanmanuel";737;100;0
12;0;"juanmarcos";12;100;0
12;0;"juanmartin";12;100;0
189;0;"juanmiguel";189;100;0
0;138;"juanna";138;0;100
1610;0;"juanpablo";1610;100;0
11;0;"juanpedro";11;100;0
13;0;"juanramon";13;100;0
5;0;"juansebastian";5;100;0
5;0;"juante";5;100;0
0;21;"juantia";21;0;100
0;5;"juany";5;0;100
63;0;"juanya";63;100;0
5;0;"juanyae";5;100;0
57;0;"juanye";57;100;0
1375;0;"juaquin";1375;100;0
0;57;"juaquina";57;0;100
27;0;"juarez";27;100;0
0;5;"juaria";5;0;100
17;0;"juawan";17;100;0
0;11;"juawana";11;0;100
12;0;"juba";12;100;0
692;0;"jubal";692;100;0
34;0;"jubei";34;100;0
5;0;"jubentino";5;100;0
6;2029;"jubilee";2035;0.294840294840295;99.7051597051597
33;0;"jubril";33;100;0
610;0;"jud";610;100;0
240;145;"juda";385;62.3376623376623;37.6623376623377
0;77;"judaea";77;0;100
16881;464;"judah";17345;97.3248774863073;2.67512251369271
0;7;"judaline";7;0;100
0;11;"judalon";11;0;100
389;0;"judas";389;100;0
4814;0;"judd";4814;100;0
11;16;"juddie";27;40.7407407407407;59.2592592592593
157;0;"juddson";157;100;0
32135;1943;"jude";34078;94.2983743177416;5.70162568225835
96;314;"judea";410;23.4146341463415;76.5853658536585
0;5;"judeah";5;0;100
0;25;"judean";25;0;100
0;507;"judee";507;0;100
0;96;"judeen";96;0;100
0;5;"judell";5;0;100
18;0;"juden";18;100;0
0;143;"judene";143;0;100
0;159;"judeth";159;0;100
0;6;"judette";6;0;100
0;5;"judey";5;0;100
3046;0;"judge";3046;100;0
0;10258;"judi";10258;0;100
0;56;"judia";56;0;100
34;0;"judiah";34;100;0
0;87;"judiann";87;0;100
0;144;"judianne";144;0;100
0;5428;"judie";5428;0;100
6;0;"judiel";6;100;0
0;277;"judieth";277;0;100
0;6;"judilyn";6;0;100
0;5;"judilynn";5;0;100
0;93;"judine";93;0;100
0;510;"judit";510;0;100
0;5;"judite";5;0;100
1241;451363;"judith";452604;0.274191125133671;99.7258088748663
0;221;"judithann";221;0;100
0;5;"judithanne";5;0;100
0;104;"judithe";104;0;100
5;0;"judon";5;100;0
7;0;"judsen";7;100;0
11174;0;"judson";11174;100;0
0;11;"judtih";11;0;100
1094;381656;"judy";382750;0.285826257348138;99.7141737426519
0;335;"judyann";335;0;100
0;169;"judye";169;0;100
0;5;"judylynn";5;0;100
0;5;"judyne";5;0;100
0;902;"judyth";902;0;100
0;160;"judythe";160;0;100
816;639;"juel";1455;56.0824742268041;43.9175257731959
0;10;"juelene";10;0;100
14;0;"juelez";14;100;0
5;0;"juelian";5;100;0
60;12;"juell";72;83.3333333333333;16.6666666666667
0;5;"juella";5;0;100
16;53;"juelle";69;23.1884057971014;76.8115942028985
15;0;"juellz";15;100;0
11;0;"juels";11;100;0
2308;106;"juelz";2414;95.6089478044739;4.3910521955261
5;0;"juelze";5;100;0
88;0;"juergen";88;100;0
15;0;"jugraj";15;100;0
0;21;"juhee";21;0;100
0;349;"juhi";349;0;100
0;10;"juila";10;0;100
0;17;"juile";17;0;100
0;23;"juiliana";23;0;100
0;5;"juilianna";5;0;100
5;0;"juilo";5;100;0
55;0;"jujhar";55;100;0
446;5;"jujuan";451;98.8913525498891;1.10864745011086
0;11;"jula";11;0;100
10;0;"julain";10;100;0
0;697;"julaine";697;0;100
0;28;"julana";28;0;100
0;283;"julane";283;0;100
14;5;"julani";19;73.6842105263158;26.3157894736842
0;149;"julann";149;0;100
0;225;"julanne";225;0;100
0;33;"julayne";33;0;100
1250;1880;"jule";3130;39.9361022364217;60.0638977635783
0;116;"julea";116;0;100
0;232;"juleah";232;0;100
38;0;"julean";38;100;0
0;24;"juleana";24;0;100
0;34;"juleanna";34;0;100
0;2737;"julee";2737;0;100
0;5;"juleeanna";5;0;100
0;417;"juleen";417;0;100
0;9;"juleena";9;0;100
0;24;"juleesa";24;0;100
0;34;"juleidy";34;0;100
0;53;"juleigh";53;0;100
0;5;"juleimy";5;0;100
6;0;"julein";6;100;0
0;9;"juleisy";9;0;100
133;0;"julen";133;100;0
0;93;"julena";93;0;100
0;1692;"julene";1692;0;100
0;5;"julenny";5;0;100
0;10;"juleny";10;0;100
65;0;"juleon";65;100;0
0;10;"julep";10;0;100
8136;1248;"jules";9384;86.7007672634271;13.2992327365729
0;10;"julessa";10;0;100
0;63;"juletta";63;0;100
0;11;"julette";11;0;100
19;0;"juleus";19;100;0
0;75;"juley";75;0;100
108;11;"julez";119;90.7563025210084;9.2436974789916
0;6272;"juli";6272;0;100
1661;429619;"julia";431280;0.385132628454832;99.6148673715452
0;36;"juliaann";36;0;100
0;12;"juliaanne";12;0;100
0;26;"juliaette";26;0;100
0;5;"juliagrace";5;0;100
0;283;"juliah";283;0;100
0;117;"juliahna";117;0;100
0;5;"juliahnna";5;0;100
5;0;"juliam";5;100;0
0;5;"juliamae";5;0;100
0;31;"juliamarie";31;0;100
193830;3030;"julian";196860;98.4608351112466;1.53916488875343
49;54036;"juliana";54085;0.0905981325691042;99.9094018674309
0;119;"julianah";119;0;100
0;2142;"juliane";2142;0;100
37;97;"juliani";134;27.6119402985075;72.3880597014925
0;19;"julianie";19;0;100
0;5;"julianis";5;0;100
0;6;"julianita";6;0;100
31;7319;"juliann";7350;0.421768707482993;99.578231292517
26;42229;"julianna";42255;0.0615311797420424;99.938468820258
0;159;"juliannah";159;0;100
0;5;"juliannamarie";5;0;100
0;29305;"julianne";29305;0;100
5;31;"julianni";36;13.8888888888889;86.1111111111111
0;42;"juliannie";42;0;100
5;0;"julianno";5;100;0
0;91;"julianny";91;0;100
699;0;"juliano";699;100;0
0;121;"juliany";121;0;100
0;24;"julianys";24;0;100
0;29;"juliarose";29;0;100
90;0;"julias";90;100;0
0;193;"juliauna";193;0;100
0;10;"juliaunna";10;0;100
0;5;"julibeth";5;0;100
0;5;"julica";5;0;100
5;0;"julice";5;100;0
0;116;"julicia";116;0;100
1524;506653;"julie";508177;0.299895508848295;99.7001044911517
0;40;"juliea";40;0;100
6;0;"juliean";6;100;0
0;398;"julieana";398;0;100
0;3109;"julieann";3109;0;100
0;1409;"julieanna";1409;0;100
0;1686;"julieanne";1686;0;100
0;5;"juliella";5;0;100
0;6;"juliemarie";6;0;100
9883;182;"julien";10065;98.1917536015897;1.80824639841033
0;6;"juliena";6;0;100
0;454;"juliene";454;0;100
6;0;"julienn";6;100;0
0;23;"julienna";23;0;100
32;2548;"julienne";2580;1.24031007751938;98.7596899224806
0;30;"julieonna";30;0;100
113;0;"julies";113;100;0
0;33;"juliessa";33;0;100
0;27212;"juliet";27212;0;100
0;5638;"julieta";5638;0;100
0;53;"juliete";53;0;100
0;491;"julieth";491;0;100
0;579;"juliett";579;0;100
0;1348;"julietta";1348;0;100
0;24475;"juliette";24475;0;100
0;5;"julieza";5;0;100
0;5;"julin";5;0;100
0;399;"julina";399;0;100
0;5;"julinda";5;0;100
0;255;"juline";255;0;100
59114;422;"julio";59536;99.2911851652782;0.708814834721849
5;0;"julioalberto";5;100;0
425;0;"juliocesar";425;100;0
315;0;"julion";315;100;0
0;59;"juliona";59;0;100
0;170;"julionna";170;0;100
1624;0;"julious";1624;100;0
221;5;"julis";226;97.787610619469;2.21238938053097
0;4196;"julisa";4196;0;100
0;56;"julisha";56;0;100
0;41;"julisia";41;0;100
11;22948;"julissa";22959;0.0479114944030663;99.9520885055969
0;48;"julissia";48;0;100
0;180;"julita";180;0;100
0;11;"julitsa";11;0;100
0;50;"julitta";50;0;100
0;176;"julitza";176;0;100
56;0;"juliun";56;100;0
72945;405;"julius";73350;99.4478527607362;0.552147239263804
10;0;"juliuz";10;100;0
0;5;"julivette";5;0;100
0;5;"julixa";5;0;100
0;189;"juliya";189;0;100
0;105;"juliyah";105;0;100
37;0;"juliyan";37;100;0
0;42;"juliyana";42;0;100
0;5;"juliyanna";5;0;100
0;513;"juliza";513;0;100
0;62;"julizza";62;0;100
0;150;"jull";150;0;100
0;108;"jullia";108;0;100
2464;948;"jullian";3412;72.2157092614302;27.7842907385698
0;311;"julliana";311;0;100
0;150;"jullianna";150;0;100
0;16;"jullianne";16;0;100
0;451;"jullie";451;0;100
235;0;"jullien";235;100;0
0;23;"julliet";23;0;100
0;93;"julliette";93;0;100
0;139;"jullisa";139;0;100
0;55;"jullissa";55;0;100
19;0;"jullius";19;100;0
0;55;"jully";55;0;100
0;5;"julonda";5;0;100
868;0;"juluis";868;100;0
85;0;"julus";85;100;0
157;678;"july";835;18.8023952095808;81.1976047904192
0;163;"julya";163;0;100
313;0;"julyan";313;100;0
0;240;"julyana";240;0;100
0;116;"julyanna";116;0;100
0;23;"julye";23;0;100
28;0;"julyen";28;100;0
0;8;"julyn";8;0;100
0;15;"julynn";15;0;100
0;58;"julysa";58;0;100
0;877;"julyssa";877;0;100
105;0;"juma";105;100;0
135;0;"jumaane";135;100;0
6;0;"jumah";6;100;0
38;0;"jumal";38;100;0
0;14;"jumalay";14;0;100
0;29;"juman";29;0;100
0;390;"jumana";390;0;100
0;51;"jumanah";51;0;100
8;0;"jumanji";8;100;0
16;0;"jumanne";16;100;0
138;0;"jumar";138;100;0
5;0;"jumarcus";5;100;0
10;0;"jumari";10;100;0
21;0;"jumarion";21;100;0
19;0;"jumel";19;100;0
15;0;"jumoke";15;100;0
1178;97;"jun";1275;92.3921568627451;7.6078431372549
5;655;"juna";660;0.757575757575758;99.2424242424242
0;20;"junae";20;0;100
68;6;"junah";74;91.8918918918919;8.10810810810811
383;0;"junaid";383;100;0
7;0;"junathaen";7;100;0
10;0;"junathean";10;100;0
25;0;"junayd";25;100;0
3008;189649;"june";192657;1.5613240110663;98.4386759889337
0;5;"junea";5;0;100
0;26;"juneann";26;0;100
6;42;"juneau";48;12.5;87.5
0;343;"junell";343;0;100
0;186;"junella";186;0;100
0;222;"junelle";222;0;100
0;12;"junellen";12;0;100
0;22;"junerose";22;0;100
0;280;"junetta";280;0;100
0;268;"junette";268;0;100
0;5;"juneve";5;0;100
154;152;"jung";306;50.3267973856209;49.6732026143791
5;0;"jungwoo";5;100;0
10;0;"junhao";10;100;0
5;0;"junhee";5;100;0
5;0;"junho";5;100;0
17;68;"juni";85;20;80
0;708;"junia";708;0;100
0;5;"juniah";5;0;100
0;27;"juniata";27;0;100
0;229;"junice";229;0;100
44;0;"junichi";44;100;0
155;1150;"junie";1305;11.8773946360153;88.1226053639847
164;0;"juniel";164;100;0
18;0;"junies";18;100;0
0;5;"junietta";5;0;100
0;5;"junilla";5;0;100
39962;195;"junior";40157;99.5144059566203;0.485594043379735
1627;0;"junious";1627;100;0
41;4400;"juniper";4441;0.923215492006305;99.0767845079937
32;19;"junis";51;62.7450980392157;37.2549019607843
0;1313;"junita";1313;0;100
5;0;"junito";5;100;0
4901;0;"junius";4901;100;0
0;41;"juniya";41;0;100
0;20;"juniyah";20;0;100
10;0;"junjie";10;100;0
0;116;"junko";116;0;100
5;0;"junming";5;100;0
0;25;"junne";25;0;100
26;158;"junnie";184;14.1304347826087;85.8695652173913
155;582;"juno";737;21.0312075983718;78.9687924016282
8;0;"junor";8;100;0
6;0;"junot";6;100;0
6;0;"junpei";6;100;0
24;0;"junuis";24;100;0
41;0;"junus";41;100;0
10;0;"junxi";10;100;0
5;0;"juny";5;100;0
0;5;"junya";5;0;100
6;0;"junyi";6;100;0
5;0;"junyu";5;100;0
5;0;"junzhe";5;100;0
158;132;"jupiter";290;54.4827586206897;45.5172413793103
186;0;"juquan";186;100;0
0;5;"juquana";5;0;100
0;10;"jura";10;0;100
0;5;"jurany";5;0;100
0;6;"jurate";6;0;100
0;34;"jurea";34;0;100
15;0;"jurel";15;100;0
139;5;"jurell";144;96.5277777777778;3.47222222222222
27;0;"jurem";27;100;0
0;5;"jurene";5;0;100
0;10;"juretta";10;0;100
370;0;"jurgen";370;100;0
5;127;"juri";132;3.78787878787879;96.2121212121212
20;0;"juriah";20;100;0
12;0;"jurian";12;100;0
0;5;"juriana";5;0;100
0;42;"juridia";42;0;100
0;14;"jurie";14;0;100
50;0;"juriel";50;100;0
46;0;"juris";46;100;0
0;5;"jurita";5;0;100
0;5;"juritza";5;0;100
0;31;"jurlean";31;0;100
0;44;"jurlene";44;0;100
0;116;"jurline";116;0;100
7;2743;"jurnee";2750;0.254545454545455;99.7454545454545
0;62;"jurnei";62;0;100
5;175;"jurney";180;2.77777777777778;97.2222222222222
0;227;"jurni";227;0;100
0;164;"jurnie";164;0;100
0;5;"jurnii";5;0;100
64;0;"juron";64;100;0
69;0;"jurrell";69;100;0
20;0;"jurrien";20;100;0
6;106;"jury";112;5.35714285714286;94.6428571428571
11;0;"jushawn";11;100;0
260;0;"jushua";260;100;0
242;0;"jusiah";242;100;0
48;0;"jusin";48;100;0
143;0;"jusitn";143;100;0
10;0;"jussiah";10;100;0
0;6;"jussica";6;0;100
0;197;"justa";197;0;100
6;0;"justain";6;100;0
522;0;"justan";522;100;0
5;0;"justas";5;100;0
0;257;"justeen";257;0;100
0;10;"justeena";10;0;100
3946;5;"justen";3951;99.8734497595545;0.126550240445457
0;153;"justene";153;0;100
0;17;"justess";17;0;100
5;0;"justhin";5;100;0
5;17;"justi";22;22.7272727272727;77.2727272727273
45;0;"justian";45;100;0
6;0;"justic";6;100;0
16577;15152;"justice";31729;52.2455797535378;47.7544202464622
0;8;"justien";8;0;100
0;5;"justilia";5;0;100
769733;3791;"justin";773524;99.5099053164478;0.490094683552159
6;11673;"justina";11679;0.051374261494991;99.948625738505
5;0;"justinanthony";5;100;0
2401;37469;"justine";39870;6.02207173313268;93.9779282668673
0;5;"justinia";5;0;100
78;0;"justinian";78;100;0
5;0;"justiniano";5;100;0
11;0;"justinjames";11;100;0
13;0;"justinkyle";13;100;0
38;0;"justinlee";38;100;0
46;0;"justinmichael";46;100;0
75;0;"justinn";75;100;0
0;13;"justinne";13;0;100
1067;0;"justino";1067;100;0
27;0;"justinpaul";27;100;0
18;0;"justinray";18;100;0
5;0;"justinrobert";5;100;0
23;0;"justinryan";23;100;0
9;0;"justinthomas";9;100;0
10;0;"justion";10;100;0
1397;402;"justis";1799;77.6542523624236;22.3457476375764
60;224;"justise";284;21.1267605633803;78.8732394366197
18;141;"justiss";159;11.3207547169811;88.6792452830189
10;0;"justiz";10;100;0
99;0;"justn";99;100;0
1640;0;"justo";1640;100;0
2500;0;"juston";2500;100;0
129;0;"justun";129;100;0
7664;679;"justus";8343;91.8614407287546;8.13855927124535
0;10;"justy";10;0;100
498;1918;"justyce";2416;20.612582781457;79.387417218543
4166;152;"justyn";4318;96.479851783233;3.52014821676702
0;367;"justyna";367;0;100
0;552;"justyne";552;0;100
5;0;"justys";5;100;0
0;16;"justyse";16;0;100
38;0;"jusuf";38;100;0
6;0;"jusus";6;100;0
13;0;"jutin";13;100;0
0;33;"jutta";33;0;100
1167;0;"juvenal";1167;100;0
202;0;"juvencio";202;100;0
25;0;"juvens";25;100;0
0;26;"juventina";26;0;100
1479;0;"juventino";1479;100;0
0;53;"juvia";53;0;100
141;0;"juvon";141;100;0
10;0;"juvonte";10;100;0
47;0;"juwaan";47;100;0
5;0;"juwahn";5;100;0
0;16;"juwairiyah";16;0;100
3582;10;"juwan";3592;99.7216035634744;0.278396436525612
0;137;"juwana";137;0;100
0;16;"juwanda";16;0;100
66;0;"juwann";66;100;0
0;49;"juwanna";49;0;100
146;0;"juwaun";146;100;0
0;5;"juwayria";5;0;100
0;5;"juwayriya";5;0;100
5;0;"juwel";5;100;0
5;0;"juwell";5;100;0
10;0;"juwelz";10;100;0
342;0;"juwon";342;100;0
153;0;"juwuan";153;100;0
0;6;"juyne";6;0;100
5;0;"juztin";5;100;0
11;0;"jvante";11;100;0
29;0;"jvaughn";29;100;0
5;0;"jven";5;100;0
145;0;"jveon";145;100;0
11;0;"jvian";11;100;0
5;0;"jvier";5;100;0
200;0;"jvion";200;100;0
473;0;"jvon";473;100;0
5;0;"jvonn";5;100;0
6;0;"jvonne";6;100;0
7;0;"jvontae";7;100;0
45;0;"jvonte";45;100;0
330;0;"jw";330;100;0
136;31;"jwan";167;81.437125748503;18.562874251497
0;27;"jwana";27;0;100
23;0;"jwaun";23;100;0
5;0;"jwon";5;100;0
7;0;"jwuan";7;100;0
6;0;"jwyanza";6;100;0
0;72;"jya";72;0;100
0;22;"jyah";22;0;100
151;0;"jyair";151;100;0
249;0;"jyaire";249;100;0
0;53;"jyana";53;0;100
0;38;"jyanna";38;0;100
0;91;"jyasia";91;0;100
109;0;"jyden";109;100;0
62;0;"jye";62;100;0
0;10;"jyelle";10;0;100
0;5;"jyena";5;0;100
12;0;"jyheem";12;100;0
23;0;"jyheim";23;100;0
5;0;"jyhiem";5;100;0
0;5;"jyia";5;0;100
0;5;"jyiah";5;0;100
5;0;"jyion";5;100;0
0;38;"jykeria";38;0;100
0;389;"jyl";389;0;100
0;79;"jyla";79;0;100
84;0;"jylan";84;100;0
22;0;"jylen";22;100;0
0;23;"jylene";23;0;100
12;0;"jyler";12;100;0
64;0;"jyles";64;100;0
0;103;"jylian";103;0;100
11;0;"jylin";11;100;0
0;7;"jylisa";7;0;100
0;5;"jylissa";5;0;100
0;91;"jyll";91;0;100
0;244;"jyllian";244;0;100
23;0;"jylon";23;100;0
7;0;"jymari";7;100;0
0;20;"jyme";20;0;100
51;0;"jymere";51;100;0
82;0;"jymir";82;100;0
0;18;"jymme";18;0;100
5;0;"jymon";5;100;0
0;10;"jynae";10;0;100
0;15;"jynell";15;0;100
0;37;"jynelle";37;0;100
0;62;"jynesis";62;0;100
0;25;"jynessa";25;0;100
0;21;"jynia";21;0;100
0;12;"jyniah";12;0;100
0;7;"jynna";7;0;100
15;0;"jyon";15;100;0
0;5;"jyonna";5;0;100
0;228;"jyoti";228;0;100
0;34;"jyotsna";34;0;100
90;0;"jyquan";90;100;0
5;0;"jyquavious";5;100;0
45;0;"jyquez";45;100;0
0;107;"jyra";107;0;100
0;76;"jyrah";76;0;100
22;0;"jyran";22;100;0
44;0;"jyree";44;100;0
56;0;"jyrell";56;100;0
5;0;"jyrelle";5;100;0
83;0;"jyren";83;100;0
35;0;"jyrese";35;100;0
26;0;"jyrin";26;100;0
15;0;"jyrine";15;100;0
162;0;"jyron";162;100;0
6;0;"jysaiah";6;100;0
0;18;"jyselle";18;0;100
17;0;"jyshaun";17;100;0
22;0;"jyshawn";22;100;0
5;0;"jyshon";5;100;0
12;0;"jysiah";12;100;0
10;0;"jysir";10;100;0
39;0;"jyson";39;100;0
0;109;"jyssica";109;0;100
5;0;"jyvon";5;100;0
5;0;"jywon";5;100;0
5;0;"jyzaiah";5;100;0
0;49;"jyzelle";49;0;100
0;6;"jzabehl";6;0;100
6;0;"jziah";6;100;0
14;0;"jzon";14;100;0
131;781;"ka";912;14.3640350877193;85.6359649122807
21;0;"kaaden";21;100;0
0;5;"kaajal";5;0;100
0;43;"kaala";43;0;100
0;318;"kaaliyah";318;0;100
0;12;"kaalyn";12;0;100
82;0;"kaamil";82;100;0
0;10;"kaamilah";10;0;100
0;49;"kaamilya";49;0;100
616;0;"kaan";616;100;0
0;13;"kaara";13;0;100
0;6;"kaaran";6;0;100
23;0;"kaare";23;100;0
0;884;"kaaren";884;0;100
0;79;"kaari";79;0;100
0;89;"kaarin";89;0;100
0;17;"kaarina";17;0;100
5;0;"kaarlo";5;100;0
0;5;"kaaron";5;0;100
12;0;"kaashif";12;100;0
0;34;"kaashvi";34;0;100
0;331;"kaavya";331;0;100
0;5;"kaaya";5;0;100
0;6;"kaayla";6;0;100
0;117;"kabao";117;0;100
70;0;"kabe";70;100;0
86;0;"kabeer";86;100;0
25;0;"kabel";25;100;0
0;113;"kabella";113;0;100
6;0;"kaben";6;100;0
1515;0;"kabir";1515;100;0
114;0;"kable";114;100;0
0;61;"kabrea";61;0;100
0;5;"kabree";5;0;100
26;0;"kabren";26;100;0
0;7;"kabresha";7;0;100
0;15;"kabreyia";15;0;100
0;9;"kabri";9;0;100
0;257;"kabria";257;0;100
10;0;"kabriel";10;100;0
0;435;"kabrina";435;0;100
11;0;"kabron";11;100;0
5;0;"kabryn";5;100;0
995;20;"kace";1015;98.0295566502463;1.97044334975369
201;2061;"kacee";2262;8.88594164456233;91.1140583554377
0;6;"kacei";6;0;100
0;104;"kacelyn";104;0;100
0;33;"kacelynn";33;0;100
620;0;"kacen";620;100;0
26;0;"kaceon";26;100;0
12;0;"kaceson";12;100;0
33;0;"kaceton";33;100;0
1968;10268;"kacey";12236;16.0836874795685;83.9163125204315
5;0;"kaceyon";5;100;0
73;57;"kache";130;56.1538461538462;43.8461538461538
0;5;"kachelle";5;0;100
0;6;"kachet";6;0;100
0;296;"kachina";296;0;100
0;18;"kachiri";18;0;100
82;8935;"kaci";9017;0.909393368082511;99.0906066319175
0;274;"kacia";274;0;100
32;11839;"kacie";11871;0.269564484879117;99.7304355151209
56;0;"kacin";56;100;0
951;0;"kacper";951;100;0
923;4857;"kacy";5780;15.9688581314879;84.0311418685121
85;38;"kacyn";123;69.1056910569106;30.8943089430894
0;115;"kada";115;0;100
0;10;"kadaija";10;0;100
0;37;"kadaisha";37;0;100
0;52;"kadaja";52;0;100
0;76;"kadajah";76;0;100
436;7;"kadan";443;98.4198645598194;1.58013544018059
17;776;"kadance";793;2.1437578814628;97.8562421185372
137;0;"kadar";137;100;0
15;0;"kadari";15;100;0
22;0;"kadarian";22;100;0
15;0;"kadarion";15;100;0
71;0;"kadarious";71;100;0
964;0;"kadarius";964;100;0
155;0;"kadarrius";155;100;0
0;35;"kadasha";35;0;100
0;26;"kadashia";26;0;100
0;117;"kadasia";117;0;100
5;0;"kadavion";5;100;0
0;16;"kadaysha";16;0;100
0;5;"kadaysia";5;0;100
163;0;"kadden";163;100;0
0;37;"kaddie";37;0;100
0;10;"kaddy";10;0;100
15219;182;"kade";15401;98.8182585546393;1.18174144536069
10;0;"kadean";10;100;0
0;286;"kadedra";286;0;100
0;12;"kadedria";12;0;100
0;1000;"kadee";1000;0;100
0;15;"kadeedra";15;0;100
0;48;"kadeeja";48;0;100
0;46;"kadeejah";46;0;100
2421;0;"kadeem";2421;100;0
82;0;"kadeen";82;100;0
0;49;"kadeesha";49;0;100
0;163;"kadeidra";163;0;100
0;21;"kadeidre";21;0;100
0;10;"kadeija";10;0;100
0;15;"kadeijah";15;0;100
14;0;"kadein";14;100;0
0;120;"kadeisha";120;0;100
0;268;"kadeja";268;0;100
0;407;"kadejah";407;0;100
0;12;"kadejha";12;0;100
0;25;"kadejia";25;0;100
0;7;"kadejiah";7;0;100
5;0;"kadel";5;100;0
11;0;"kadell";11;100;0
0;62;"kadelyn";62;0;100
57032;1026;"kaden";58058;98.2328016810775;1.76719831892246
848;9603;"kadence";10451;8.11405607118936;91.8859439288106
12;0;"kadenn";12;100;0
0;5;"kadenze";5;0;100
20;0;"kader";20;100;0
0;5;"kadera";5;0;100
5;0;"kaderius";5;100;0
20;0;"kadesh";20;100;0
0;417;"kadesha";417;0;100
0;161;"kadeshia";161;0;100
0;91;"kadesia";91;0;100
0;6;"kadetra";6;0;100
0;5;"kadetria";5;0;100
0;130;"kadey";130;0;100
45;0;"kadeyn";45;100;0
0;5;"kadezha";5;0;100
0;15;"kadezia";15;0;100
0;899;"kadi";899;0;100
0;146;"kadia";146;0;100
44;87;"kadian";131;33.587786259542;66.412213740458
0;390;"kadiatou";390;0;100
0;32;"kadiatu";32;0;100
0;42;"kadidia";42;0;100
0;23;"kadidiatou";23;0;100
0;21;"kadidja";21;0;100
0;17;"kadidra";17;0;100
0;2505;"kadie";2505;0;100
0;22;"kadiedra";22;0;100
135;0;"kadien";135;100;0
0;279;"kadience";279;0;100
0;24;"kadiesha";24;0;100
0;510;"kadija";510;0;100
0;1411;"kadijah";1411;0;100
0;32;"kadijatou";32;0;100
0;47;"kadijatu";47;0;100
0;23;"kadijha";23;0;100
4765;178;"kadin";4943;96.398948007283;3.60105199271697
0;217;"kadince";217;0;100
274;0;"kadir";274;100;0
0;13;"kadira";13;0;100
6;0;"kadis";6;100;0
0;236;"kadisha";236;0;100
6;8;"kadison";14;42.8571428571429;57.1428571428571
0;16;"kadjah";16;0;100
38;0;"kadmiel";38;100;0
39;0;"kado";39;100;0
606;0;"kadon";606;100;0
0;82;"kadra";82;0;100
0;8;"kadraya";8;0;100
5;0;"kadren";5;100;0
8;5;"kadri";13;61.5384615384615;38.4615384615385
0;5;"kadria";5;0;100
288;11;"kadrian";299;96.3210702341137;3.67892976588629
0;12;"kadriana";12;0;100
0;10;"kadrianna";10;0;100
20;0;"kadrien";20;100;0
0;2682;"kady";2682;0;100
2699;1294;"kadyn";3993;67.5932882544453;32.4067117455547
6;833;"kadynce";839;0.715137067938021;99.284862932062
13;58;"kadynn";71;18.3098591549296;81.6901408450704
0;728;"kae";728;0;100
0;6;"kaebri";6;0;100
10;0;"kaecyn";10;100;0
22;0;"kaed";22;100;0
0;30;"kaeda";30;0;100
324;5;"kaedan";329;98.4802431610942;1.51975683890578
0;105;"kaedance";105;0;100
35;191;"kaede";226;15.4867256637168;84.5132743362832
4068;158;"kaeden";4226;96.2612399432087;3.73876005679129
13;469;"kaedence";482;2.69709543568465;97.3029045643154
345;5;"kaedin";350;98.5714285714286;1.42857142857143
5;0;"kaedn";5;100;0
544;0;"kaedon";544;100;0
1071;589;"kaedyn";1660;64.5180722891566;35.4819277108434
0;190;"kaedynce";190;0;100
5;16;"kaedynn";21;23.8095238095238;76.1904761904762
356;200;"kaegan";556;64.0287769784173;35.9712230215827
35;0;"kaegen";35;100;0
0;5;"kaeisha";5;0;100
3039;16;"kael";3055;99.4762684124386;0.523731587561375
0;6154;"kaela";6154;0;100
0;519;"kaelah";519;0;100
1328;401;"kaelan";1729;76.8074031231926;23.1925968768074
0;16;"kaelana";16;0;100
0;438;"kaelani";438;0;100
0;43;"kaele";43;0;100
0;104;"kaelea";104;0;100
0;7;"kaeleah";7;0;100
547;0;"kaeleb";547;100;0
0;1088;"kaelee";1088;0;100
0;76;"kaeleen";76;0;100
0;101;"kaelei";101;0;100
0;1278;"kaeleigh";1278;0;100
72;0;"kaelem";72;100;0
610;333;"kaelen";943;64.6871686108165;35.3128313891835
0;72;"kaelene";72;0;100
0;787;"kaeley";787;0;100
0;2088;"kaeli";2088;0;100
0;5;"kaelia";5;0;100
0;17;"kaeliana";17;0;100
58;0;"kaelib";58;100;0
0;661;"kaelie";661;0;100
0;17;"kaeliegh";17;0;100
842;2614;"kaelin";3456;24.3634259259259;75.6365740740741
0;12;"kaella";12;0;100
0;45;"kaelly";45;0;100
175;0;"kaelob";175;100;0
268;0;"kaelon";268;100;0
0;23;"kaeloni";23;0;100
26;0;"kaelub";26;100;0
53;0;"kaelum";53;100;0
0;819;"kaely";819;0;100
6;0;"kaelyb";6;100;0
77;13751;"kaelyn";13828;0.556841191784785;99.4431588082152
0;5;"kaelyne";5;0;100
0;3833;"kaelynn";3833;0;100
0;172;"kaelynne";172;0;100
5;0;"kaeman";5;100;0
7;0;"kaemen";7;100;0
295;0;"kaemon";295;100;0
5;0;"kaen";5;100;0
18;71;"kaena";89;20.2247191011236;79.7752808988764
61;0;"kaenan";61;100;0
10;0;"kaenon";10;100;0
241;0;"kaeo";241;100;0
6;0;"kaeon";6;100;0
7;0;"kaeron";7;100;0
0;5;"kaery";5;0;100
164;0;"kaesen";164;100;0
0;97;"kaesha";97;0;100
13;0;"kaeshawn";13;100;0
5;0;"kaeshon";5;100;0
21;0;"kaesin";21;100;0
548;0;"kaeson";548;100;0
5;0;"kaeston";5;100;0
139;30;"kaesyn";169;82.2485207100592;17.7514792899408
0;20;"kaethe";20;0;100
0;120;"kaetlin";120;0;100
0;531;"kaetlyn";531;0;100
0;16;"kaetlynn";16;0;100
7;0;"kaeto";7;100;0
13;0;"kaeveon";13;100;0
71;0;"kaevion";71;100;0
203;0;"kaevon";203;100;0
0;61;"kaeya";61;0;100
0;17;"kaeyla";17;0;100
0;16;"kaffie";16;0;100
0;106;"kafi";106;0;100
569;73;"kagan";642;88.6292834890966;11.3707165109034
1149;0;"kage";1149;100;0
490;17;"kagen";507;96.646942800789;3.35305719921105
5;0;"kager";5;100;0
0;14;"kagome";14;0;100
40;0;"kahaan";40;100;0
0;5;"kahala";5;0;100
8;0;"kahan";8;100;0
0;7;"kahana";7;0;100
0;5;"kahani";5;0;100
5;0;"kahanuola";5;100;0
386;7;"kahari";393;98.2188295165394;1.78117048346056
6;0;"kahdeem";6;100;0
0;8;"kahdejah";8;0;100
12;0;"kahden";12;100;0
0;60;"kahdijah";60;0;100
0;10;"kahea";10;0;100
0;338;"kahealani";338;0;100
307;0;"kaheem";307;100;0
20;0;"kaheim";20;100;0
22;0;"kahekili";22;100;0
0;11;"kahia";11;0;100
141;0;"kahiau";141;100;0
5;0;"kahiem";5;100;0
98;0;"kahil";98;100;0
0;5;"kahila";5;0;100
6;0;"kahir";6;100;0
22;0;"kahl";22;100;0
0;679;"kahla";679;0;100
15;1248;"kahlan";1263;1.18764845605701;98.812351543943
0;117;"kahlani";117;0;100
0;11;"kahlaya";11;0;100
109;0;"kahle";109;100;0
0;204;"kahlea";204;0;100
0;113;"kahleah";113;0;100
129;0;"kahleb";129;100;0
28;81;"kahlee";109;25.6880733944954;74.3119266055046
217;0;"kahleel";217;100;0
0;35;"kahleesi";35;0;100
0;15;"kahlei";15;0;100
0;5;"kahleia";5;0;100
21;0;"kahleil";21;100;0
66;0;"kahlel";66;100;0
67;267;"kahlen";334;20.059880239521;79.940119760479
40;6;"kahler";46;86.9565217391304;13.0434782608696
0;126;"kahley";126;0;100
0;5;"kahleya";5;0;100
95;347;"kahli";442;21.4932126696833;78.5067873303167
0;851;"kahlia";851;0;100
0;30;"kahliah";30;0;100
26;0;"kahlid";26;100;0
0;121;"kahlie";121;0;100
13;0;"kahliel";13;100;0
32;0;"kahlif";32;100;0
3549;0;"kahlil";3549;100;0
0;28;"kahlila";28;0;100
0;50;"kahlilah";50;0;100
5;0;"kahlill";5;100;0
59;11;"kahlin";70;84.2857142857143;15.7142857142857
0;16;"kahlina";16;0;100
0;5;"kahlis";5;0;100
0;81;"kahliya";81;0;100
0;152;"kahliyah";152;0;100
11;0;"kahlo";11;100;0
0;6;"kahloni";6;0;100
0;174;"kahlyn";174;0;100
0;26;"kahlynn";26;0;100
6;0;"kahmal";6;100;0
39;11;"kahmani";50;78;22
5;0;"kahmar";5;100;0
223;78;"kahmari";301;74.0863787375415;25.9136212624585
16;0;"kahmel";16;100;0
0;11;"kahmia";11;0;100
0;7;"kahmiah";7;0;100
0;10;"kahmila";10;0;100
5;0;"kahmir";5;100;0
0;24;"kahmiya";24;0;100
0;27;"kahmiyah";27;0;100
0;22;"kahmora";22;0;100
0;136;"kahmya";136;0;100
0;5;"kahmyah";5;0;100
0;5;"kahmyra";5;0;100
35;0;"kahn";35;100;0
186;5;"kahne";191;97.3821989528796;2.61780104712042
104;0;"kahner";104;100;0
0;22;"kahniya";22;0;100
0;8;"kahniyah";8;0;100
6;0;"kahnye";6;100;0
0;102;"kaho";102;0;100
11;0;"kahree";11;100;0
5;0;"kahreem";5;100;0
42;29;"kahri";71;59.1549295774648;40.8450704225352
0;5;"kahrin";5;0;100
152;0;"kahron";152;100;0
0;5;"kahryn";5;0;100
26;0;"kahseem";26;100;0
5;0;"kahtai";5;100;0
0;11;"kahyla";11;0;100
32841;5669;"kai";38510;85.2791482731758;14.7208517268242
35;9184;"kaia";9219;0.379650721336371;99.6203492786636
0;483;"kaiah";483;0;100
71;0;"kaian";71;100;0
0;158;"kaiana";158;0;100
0;6;"kaiann";6;0;100
0;71;"kaianna";71;0;100
0;11;"kaianne";11;0;100
13;0;"kaiba";13;100;0
0;7;"kaibree";7;0;100
6;0;"kaibren";6;100;0
0;91;"kaicee";91;0;100
84;0;"kaicen";84;100;0
0;6;"kaicey";6;0;100
0;5;"kaicy";5;0;100
12;5;"kaicyn";17;70.5882352941177;29.4117647058824
332;0;"kaid";332;100;0
0;412;"kaida";412;0;100
866;64;"kaidan";930;93.1182795698925;6.88172043010753
0;396;"kaidance";396;0;100
121;0;"kaide";121;100;0
0;42;"kaidee";42;0;100
31555;1341;"kaiden";32896;95.923516536965;4.07648346303502
249;2602;"kaidence";2851;8.73377762188706;91.2662223781129
16;0;"kaidenn";16;100;0
367;11;"kaidin";378;97.0899470899471;2.91005291005291
0;6;"kaidince";6;0;100
5;0;"kaido";5;100;0
502;0;"kaidon";502;100;0
0;5;"kaidra";5;0;100
0;18;"kaidy";18;0;100
1746;1099;"kaidyn";2845;61.3708260105448;38.6291739894552
6;329;"kaidynce";335;1.7910447761194;98.2089552238806
26;48;"kaidynn";74;35.1351351351351;64.8648648648649
5;0;"kaie";5;100;0
65;5;"kaiea";70;92.8571428571429;7.14285714285714
93;0;"kaiel";93;100;0
0;17;"kaielle";17;0;100
78;0;"kaien";78;100;0
0;92;"kaiesha";92;0;100
31;0;"kaif";31;100;0
6;12;"kaigan";18;33.3333333333333;66.6666666666667
350;5;"kaige";355;98.5915492957747;1.40845070422535
33;5;"kaigen";38;86.8421052631579;13.1578947368421
12;0;"kaihan";12;100;0
27;0;"kaii";27;100;0
6;0;"kaiicen";6;100;0
6;0;"kaiiden";6;100;0
7;0;"kaiis";7;100;0
0;862;"kaija";862;0;100
0;122;"kaijah";122;0;100
14;0;"kaikane";14;100;0
53;0;"kaikea";53;100;0
71;0;"kaikoa";71;100;0
5;0;"kaiky";5;100;0
548;36;"kail";584;93.8356164383562;6.16438356164384
0;13501;"kaila";13501;0;100
0;1926;"kailah";1926;0;100
0;5;"kailahni";5;0;100
320;444;"kailan";764;41.8848167539267;58.1151832460733
0;239;"kailana";239;0;100
59;13;"kailand";72;81.9444444444444;18.0555555555556
17;3281;"kailani";3298;0.515463917525773;99.4845360824742
0;30;"kailanie";30;0;100
0;16;"kailanni";16;0;100
0;6;"kailanny";6;0;100
0;92;"kailany";92;0;100
12;0;"kailar";12;100;0
44;0;"kailas";44;100;0
218;0;"kailash";218;100;0
0;32;"kailaya";32;0;100
0;12;"kailayah";12;0;100
22;694;"kaile";716;3.07262569832402;96.927374301676
0;733;"kailea";733;0;100
0;237;"kaileah";237;0;100
667;0;"kaileb";667;100;0
23;11388;"kailee";11411;0.201559898343703;99.7984401016563
0;10;"kaileeann";10;0;100
0;5;"kaileemarie";5;0;100
0;591;"kaileen";591;0;100
0;108;"kaileena";108;0;100
0;526;"kailei";526;0;100
0;61;"kaileia";61;0;100
0;2423;"kaileigh";2423;0;100
0;5;"kaileigha";5;0;100
655;664;"kailen";1319;49.6588324488249;50.3411675511751
0;74;"kailena";74;0;100
0;207;"kailene";207;0;100
5;0;"kaileo";5;100;0
411;21;"kailer";432;95.1388888888889;4.86111111111111
10;24593;"kailey";24603;0.0406454497419014;99.9593545502581
41;2621;"kaili";2662;1.54019534184823;98.4598046581518
0;142;"kailia";142;0;100
0;11;"kailiah";11;0;100
0;54;"kailiana";54;0;100
0;6;"kailianna";6;0;100
5;0;"kailib";5;100;0
0;1252;"kailie";1252;0;100
140;1091;"kailin";1231;11.3728675873274;88.6271324126726
0;27;"kailina";27;0;100
0;49;"kailiyah";49;0;100
0;11;"kailla";11;0;100
0;6;"kaille";6;0;100
25;0;"kaillou";25;100;0
0;89;"kailly";89;0;100
32;0;"kailo";32;100;0
14;0;"kailob";14;100;0
194;7;"kailon";201;96.5174129353234;3.48258706467662
0;88;"kailoni";88;0;100
7;5;"kailor";12;58.3333333333333;41.6666666666667
22;0;"kailub";22;100;0
5;0;"kailum";5;100;0
0;2094;"kaily";2094;0;100
0;21;"kailye";21;0;100
77;12456;"kailyn";12533;0.614378041969201;99.3856219580308
0;49;"kailyne";49;0;100
0;3661;"kailynn";3661;0;100
0;211;"kailynne";211;0;100
5;0;"kaimalu";5;100;0
11;0;"kaiman";11;100;0
674;63;"kaimana";737;91.4518317503392;8.54816824966079
92;10;"kaimani";102;90.1960784313726;9.80392156862745
0;6;"kaimarie";6;0;100
106;0;"kaimen";106;100;0
5;0;"kaimere";5;100;0
38;26;"kaimi";64;59.375;40.625
0;5;"kaimilani";5;0;100
5;0;"kaiming";5;100;0
12;0;"kaimipono";12;100;0
0;5;"kaimya";5;0;100
2650;0;"kain";2650;100;0
0;209;"kaina";209;0;100
6;0;"kainaan";6;100;0
0;7;"kainaat";7;0;100
500;0;"kainalu";500;100;0
482;0;"kainan";482;100;0
0;27;"kainani";27;0;100
0;73;"kainat";73;0;100
2137;0;"kaine";2137;100;0
736;0;"kainen";736;100;0
37;0;"kainin";37;100;0
1848;27;"kainoa";1875;98.56;1.44
64;0;"kainoah";64;100;0
50;0;"kainon";50;100;0
6;0;"kainyn";6;100;0
249;0;"kaio";249;100;0
44;0;"kaion";44;100;0
0;15;"kaiona";15;0;100
414;0;"kaipo";414;100;0
17;0;"kaique";17;100;0
0;1874;"kaira";1874;0;100
8;0;"kairaba";8;100;0
0;145;"kairah";145;0;100
25;0;"kairan";25;100;0
96;0;"kairav";96;100;0
57;6;"kaire";63;90.4761904761905;9.52380952380952
147;127;"kairee";274;53.6496350364963;46.3503649635037
60;0;"kairen";60;100;0
272;3388;"kairi";3660;7.43169398907104;92.568306010929
0;58;"kairie";58;0;100
741;11;"kairo";752;98.5372340425532;1.46276595744681
203;0;"kairon";203;100;0
126;0;"kairos";126;100;0
6;121;"kairy";127;4.7244094488189;95.2755905511811
50;10;"kairyn";60;83.3333333333333;16.6666666666667
175;0;"kais";175;100;0
0;544;"kaisa";544;0;100
37;0;"kaisan";37;100;0
8;0;"kaise";8;100;0
6;0;"kaisean";6;100;0
0;24;"kaisee";24;0;100
80;0;"kaisei";80;100;0
675;6;"kaisen";681;99.1189427312775;0.881057268722467
1276;5;"kaiser";1281;99.6096799375488;0.39032006245121
0;107;"kaisey";107;0;100
0;970;"kaisha";970;0;100
6;0;"kaishaun";6;100;0
52;0;"kaishawn";52;100;0
5;0;"kaishon";5;100;0
0;6;"kaishonta";6;0;100
5;0;"kaisin";5;100;0
0;94;"kaislee";94;0;100
0;14;"kaisleigh";14;0;100
0;519;"kaisley";519;0;100
0;40;"kaislyn";40;0;100
0;8;"kaislynn";8;0;100
2011;5;"kaison";2016;99.7519841269841;0.248015873015873
17;0;"kaiston";17;100;0
0;98;"kaisy";98;0;100
175;91;"kaisyn";266;65.7894736842105;34.2105263157895
0;7;"kait";7;0;100
0;31;"kaite";31;0;100
0;6;"kaitee";6;0;100
0;113;"kaitelyn";113;0;100
0;11;"kaitelynn";11;0;100
0;5;"kaitey";5;0;100
0;11;"kaithleen";11;0;100
0;5;"kaithlin";5;0;100
0;335;"kaithlyn";335;0;100
0;5;"kaithlynn";5;0;100
0;11;"kaiti";11;0;100
0;17;"kaitie";17;0;100
0;5;"kaitin";5;0;100
0;30;"kaitlain";30;0;100
0;1119;"kaitlan";1119;0;100
0;218;"kaitland";218;0;100
0;35;"kaitlee";35;0;100
0;11;"kaitleen";11;0;100
0;763;"kaitlen";763;0;100
0;22;"kaitley";22;0;100
75;56941;"kaitlin";57016;0.131542023291708;99.8684579767083
0;16;"kaitlind";16;0;100
0;188;"kaitlinn";188;0;100
0;7;"kaitlon";7;0;100
0;15;"kaitly";15;0;100
232;161297;"kaitlyn";161529;0.143627460084567;99.8563725399154
0;99;"kaitlynd";99;0;100
0;318;"kaitlyne";318;0;100
0;5;"kaitlynmarie";5;0;100
5;15690;"kaitlynn";15695;0.0318572793883402;99.9681427206117
0;929;"kaitlynne";929;0;100
651;0;"kaito";651;100;0
0;58;"kaitrin";58;0;100
0;12;"kaitryn";12;0;100
0;436;"kaity";436;0;100
0;127;"kaityln";127;0;100
0;41;"kaitylyn";41;0;100
0;17;"kaityn";17;0;100
0;339;"kaiulani";339;0;100
480;0;"kaius";480;100;0
5;0;"kaivan";5;100;0
78;0;"kaiven";78;100;0
7;0;"kaiveon";7;100;0
28;0;"kaivion";28;100;0
223;0;"kaivon";223;100;0
29;0;"kaiwen";29;100;0
33;5985;"kaiya";6018;0.548354935194417;99.4516450648056
0;704;"kaiyah";704;0;100
137;0;"kaiyan";137;100;0
0;86;"kaiyana";86;0;100
0;11;"kaiyanna";11;0;100
100;5;"kaiyden";105;95.2380952380952;4.76190476190476
6;0;"kaiyel";6;100;0
32;0;"kaiyen";32;100;0
0;165;"kaiyla";165;0;100
0;5;"kaiylee";5;0;100
71;0;"kaiyon";71;100;0
0;5;"kaiyonna";5;0;100
88;0;"kaiyu";88;100;0
0;5;"kaiza";5;0;100
308;0;"kaizen";308;100;0
258;0;"kaizer";258;100;0
0;93;"kaizlee";93;0;100
0;15;"kaizleigh";15;0;100
0;139;"kaizley";139;0;100
0;7;"kaizlyn";7;0;100
421;0;"kaj";421;100;0
0;570;"kaja";570;0;100
0;81;"kajah";81;0;100
0;369;"kajal";369;0;100
5;0;"kajana";5;100;0
11;0;"kajaun";11;100;0
29;0;"kaje";29;100;0
11;0;"kajetan";11;100;0
0;10;"kajia";10;0;100
0;6;"kajira";6;0;100
0;66;"kajol";66;0;100
26;0;"kajon";26;100;0
0;364;"kajsa";364;0;100
618;0;"kajuan";618;100;0
0;118;"kajuana";118;0;100
0;5;"kajun";5;0;100
12;0;"kajus";12;100;0
0;17;"kakisha";17;0;100
719;0;"kal";719;100;0
92;7530;"kala";7622;1.20703227499344;98.7929677250066
431;0;"kalab";431;100;0
66;0;"kaladin";66;100;0
5;12;"kalae";17;29.4117647058824;70.5882352941177
10;0;"kalaeb";10;100;0
0;778;"kalah";778;0;100
5;0;"kalahikiola";5;100;0
0;11;"kalahni";11;0;100
160;35;"kalai";195;82.051282051282;17.9487179487179
0;10;"kalaia";10;0;100
0;23;"kalaiah";23;0;100
0;5;"kalaijah";5;0;100
0;15;"kalaila";15;0;100
0;23;"kalaina";23;0;100
0;11;"kalaiya";11;0;100
0;23;"kalaiyah";23;0;100
0;6;"kalajah";6;0;100
1100;237;"kalan";1337;82.2737471952132;17.7262528047868
0;171;"kalana";171;0;100
0;201;"kalandra";201;0;100
0;12;"kalandria";12;0;100
1879;3387;"kalani";5266;35.681731864793;64.318268135207
0;92;"kalanie";92;0;100
0;5;"kalanii";5;0;100
0;12;"kalanni";12;0;100
0;55;"kalany";55;0;100
0;7;"kalashia";7;0;100
0;84;"kalasia";84;0;100
0;5;"kalauni";5;0;100
0;878;"kalaya";878;0;100
0;513;"kalayah";513;0;100
0;13;"kalayia";13;0;100
0;15;"kalayiah";15;0;100
0;91;"kalayla";91;0;100
0;52;"kalayna";52;0;100
0;32;"kalaysha";32;0;100
0;17;"kalayshia";17;0;100
0;171;"kalaysia";171;0;100
76;0;"kalden";76;100;0
5;0;"kalder";5;100;0
7123;226;"kale";7349;96.9247516668935;3.07524833310655
0;3220;"kalea";3220;0;100
176;0;"kaleab";176;100;0
0;2873;"kaleah";2873;0;100
0;25;"kaleaha";25;0;100
55;0;"kaleal";55;100;0
0;5;"kalean";5;0;100
0;6;"kaleana";6;0;100
72680;192;"kaleb";72872;99.7365243166099;0.263475683390054
0;72;"kalecia";72;0;100
212;0;"kaled";212;100;0
68;3726;"kalee";3794;1.79230363732209;98.2076963626779
0;75;"kaleea";75;0;100
0;88;"kaleeah";88;0;100
21;0;"kaleeb";21;100;0
0;5;"kaleece";5;0;100
26;0;"kaleef";26;100;0
13;0;"kaleek";13;100;0
455;0;"kaleel";455;100;0
0;5;"kaleela";5;0;100
361;0;"kaleem";361;100;0
0;46;"kaleema";46;0;100
0;5;"kaleemah";5;0;100
0;738;"kaleen";738;0;100
0;1873;"kaleena";1873;0;100
0;47;"kaleese";47;0;100
0;27;"kaleesha";27;0;100
0;158;"kaleesi";158;0;100
0;68;"kaleeya";68;0;100
0;101;"kaleeyah";101;0;100
178;1690;"kalei";1868;9.52890792291221;90.4710920770878
0;488;"kaleia";488;0;100
0;124;"kaleiah";124;0;100
6;15227;"kaleigh";15233;0.039388170419484;99.9606118295805
0;668;"kaleigha";668;0;100
32;0;"kaleil";32;100;0
0;7;"kaleila";7;0;100
0;5;"kaleina";5;0;100
0;8;"kaleinani";8;0;100
0;5;"kaleis";5;0;100
0;149;"kaleisha";149;0;100
0;38;"kaleiya";38;0;100
0;79;"kaleiyah";79;0;100
5;0;"kalek";5;100;0
2475;0;"kalel";2475;100;0
17;0;"kalell";17;100;0
743;0;"kalem";743;100;0
3977;1428;"kalen";5405;73.5800185013876;26.4199814986124
0;2141;"kalena";2141;0;100
0;719;"kalene";719;0;100
0;59;"kalenna";59;0;100
984;0;"kaleo";984;100;0
19;0;"kaleob";19;100;0
67;0;"kalep";67;100;0
53;0;"kaler";53;100;0
0;10;"kalesa";10;0;100
0;118;"kalese";118;0;100
0;271;"kalesha";271;0;100
0;32;"kaleshia";32;0;100
0;5;"kalesia";5;0;100
18;0;"kalet";18;100;0
0;12;"kaleta";12;0;100
59;0;"kaleth";59;100;0
0;6;"kaletha";6;0;100
133;0;"kalev";133;100;0
21;0;"kalex";21;100;0
0;5;"kalexy";5;0;100
25;12832;"kaley";12857;0.194446604962277;99.8055533950377
0;297;"kaleya";297;0;100
0;361;"kaleyah";361;0;100
605;22264;"kali";22869;2.64550264550265;97.3544973544974
0;4147;"kalia";4147;0;100
0;1663;"kaliah";1663;0;100
0;515;"kaliana";515;0;100
0;132;"kaliann";132;0;100
0;265;"kalianna";265;0;100
0;30;"kaliannah";30;0;100
0;66;"kalianne";66;0;100
1437;0;"kalib";1437;100;0
12;0;"kaliber";12;100;0
0;44;"kalice";44;0;100
0;242;"kalicia";242;0;100
172;0;"kalid";172;100;0
0;5036;"kalie";5036;0;100
0;20;"kaliea";20;0;100
0;22;"kalieah";22;0;100
199;0;"kalieb";199;100;0
0;5;"kaliece";5;0;100
0;17;"kaliee";17;0;100
182;0;"kalief";182;100;0
0;402;"kaliegh";402;0;100
86;0;"kaliel";86;100;0
0;6;"kaliese";6;0;100
0;10;"kaliesha";10;0;100
0;5;"kaliey";5;0;100
385;0;"kalif";385;100;0
0;81;"kalifa";81;0;100
0;5;"kalifah";5;0;100
11;0;"kaliff";11;100;0
0;13;"kalifornia";13;0;100
0;10;"kaliha";10;0;100
0;74;"kalii";74;0;100
173;67;"kalijah";240;72.0833333333333;27.9166666666667
191;0;"kalik";191;100;0
0;251;"kalika";251;0;100
1135;0;"kalil";1135;100;0
0;703;"kalila";703;0;100
0;351;"kalilah";351;0;100
5;0;"kalill";5;100;0
115;0;"kalim";115;100;0
0;130;"kalima";130;0;100
0;169;"kalimah";169;0;100
0;13;"kalimba";13;0;100
1716;1497;"kalin";3213;53.4080298786181;46.5919701213819
0;2955;"kalina";2955;0;100
0;5;"kalinah";5;0;100
0;388;"kalinda";388;0;100
0;27;"kaline";27;0;100
11;0;"kalino";11;100;0
0;5;"kaliona";5;0;100
0;5;"kalionna";5;0;100
0;108;"kaliope";108;0;100
0;32;"kaliopi";32;0;100
10;0;"kalip";10;100;0
10;0;"kaliph";10;100;0
183;0;"kaliq";183;100;0
45;0;"kalique";45;100;0
0;26;"kalirose";26;0;100
5;216;"kalis";221;2.26244343891403;97.737556561086
0;417;"kalisa";417;0;100
0;573;"kalise";573;0;100
0;5;"kalisee";5;0;100
0;1270;"kalisha";1270;0;100
0;15;"kalishia";15;0;100
0;46;"kalisi";46;0;100
0;30;"kaliska";30;0;100
0;972;"kalissa";972;0;100
0;6;"kalisse";6;0;100
0;2072;"kalista";2072;0;100
0;40;"kalita";40;0;100
89;0;"kalix";89;100;0
0;740;"kaliya";740;0;100
5;7623;"kaliyah";7628;0.0655479811221814;99.9344520188778
0;60;"kaliyan";60;0;100
0;31;"kaliyana";31;0;100
0;7;"kaliyanei";7;0;100
0;5;"kaliyanna";5;0;100
0;22;"kaliyha";22;0;100
6;0;"kaliym";6;100;0
0;6;"kalki";6;0;100
0;117;"kalkidan";117;0;100
0;256;"kalla";256;0;100
346;289;"kallan";635;54.4881889763779;45.511811023622
33;325;"kalle";358;9.21787709497207;90.7821229050279
0;5;"kallea";5;0;100
25;0;"kalleb";25;100;0
0;661;"kallee";661;0;100
0;16;"kalleen";16;0;100
0;531;"kalleigh";531;0;100
22;0;"kallel";22;100;0
1525;287;"kallen";1812;84.1611479028698;15.8388520971302
0;666;"kalley";666;0;100
0;4730;"kalli";4730;0;100
0;36;"kallia";36;0;100
0;6;"kalliann";6;0;100
0;9769;"kallie";9769;0;100
0;5;"kallieann";5;0;100
133;24;"kallin";157;84.7133757961784;15.2866242038217
0;6;"kallina";6;0;100
0;507;"kalliope";507;0;100
0;230;"kalliopi";230;0;100
0;30;"kallissa";30;0;100
0;771;"kallista";771;0;100
0;47;"kalliyah";47;0;100
0;39;"kalliyan";39;0;100
55;0;"kallon";55;100;0
114;0;"kallum";114;100;0
5;1285;"kally";1290;0.387596899224806;99.6124031007752
0;5;"kallye";5;0;100
0;330;"kallyn";330;0;100
0;53;"kallysta";53;0;100
1088;0;"kalman";1088;100;0
47;0;"kalmen";47;100;0
5;0;"kalmer";5;100;0
29;0;"kalo";29;100;0
1631;0;"kalob";1631;100;0
24;0;"kalobe";24;100;0
0;23;"kalolaine";23;0;100
860;17;"kalon";877;98.0615735461802;1.93842645381984
0;5;"kalona";5;0;100
0;16;"kalonda";16;0;100
17;293;"kaloni";310;5.48387096774194;94.5161290322581
0;5;"kalonie";5;0;100
145;0;"kalonji";145;100;0
0;6;"kalonni";6;0;100
10;0;"kalop";10;100;0
24;0;"kaloyan";24;100;0
5;0;"kalp";5;100;0
0;31;"kalpana";31;0;100
17;0;"kalpesh";17;100;0
0;85;"kalsey";85;0;100
0;5;"kaltrina";5;0;100
12;0;"kalu";12;100;0
637;0;"kalub";637;100;0
264;0;"kalum";264;100;0
5;0;"kalun";5;100;0
74;0;"kalup";74;100;0
118;0;"kalven";118;100;0
5533;0;"kalvin";5533;100;0
95;0;"kalvyn";95;100;0
0;437;"kaly";437;0;100
0;257;"kalya";257;0;100
0;56;"kalyah";56;0;100
133;0;"kalyan";133;100;0
0;39;"kalyana";39;0;100
0;217;"kalyani";217;0;100
0;5;"kalyann";5;0;100
0;6;"kalyanna";6;0;100
175;0;"kalyb";175;100;0
0;39;"kalyce";39;0;100
0;15;"kalyia";15;0;100
0;72;"kalyiah";72;0;100
6;0;"kalyl";6;100;0
371;7178;"kalyn";7549;4.91455821963174;95.0854417803683
0;182;"kalyna";182;0;100
0;32;"kalynda";32;0;100
0;37;"kalyne";37;0;100
33;3409;"kalynn";3442;0.958744915746659;99.0412550842534
0;271;"kalynne";271;0;100
0;12;"kalypso";12;0;100
0;59;"kalysa";59;0;100
0;169;"kalyse";169;0;100
0;14;"kalysia";14;0;100
0;738;"kalyssa";738;0;100
0;516;"kalysta";516;0;100
17;0;"kalyx";17;100;0
544;385;"kam";929;58.5575888051669;41.4424111948332
0;710;"kama";710;0;100
276;0;"kamaal";276;100;0
5;0;"kamaar";5;100;0
22;0;"kamaehu";22;100;0
37;0;"kamahao";37;100;0
5;0;"kamahl";5;100;0
18;0;"kamahri";18;100;0
42;0;"kamai";42;100;0
0;32;"kamaia";32;0;100
0;10;"kamaiah";10;0;100
0;198;"kamaile";198;0;100
0;28;"kamaira";28;0;100
5;0;"kamaire";5;100;0
0;155;"kamaiya";155;0;100
0;36;"kamaiyah";36;0;100
10;0;"kamaj";10;100;0
17;0;"kamakana";17;100;0
10;0;"kamakani";10;100;0
2590;25;"kamal";2615;99.0439770554493;0.956022944550669
0;1174;"kamala";1174;0;100
6;240;"kamalani";246;2.4390243902439;97.5609756097561
25;94;"kamalei";119;21.0084033613445;78.9915966386555
99;79;"kamali";178;55.6179775280899;44.3820224719101
0;6;"kamaliyah";6;0;100
17;0;"kamalu";17;100;0
29;0;"kaman";29;100;0
509;637;"kamani";1146;44.4153577661431;55.5846422338569
1273;24;"kamar";1297;98.1495759444873;1.85042405551272
12;1596;"kamara";1608;0.746268656716418;99.2537313432836
0;158;"kamarah";158;0;100
6;0;"kamarcus";6;100;0
182;5;"kamare";187;97.3262032085562;2.67379679144385
0;27;"kamarea";27;0;100
268;145;"kamaree";413;64.8910411622276;35.1089588377724
27;0;"kamaren";27;100;0
61;0;"kamareon";61;100;0
5925;3339;"kamari";9264;63.9572538860104;36.0427461139896
0;2397;"kamaria";2397;0;100
0;195;"kamariah";195;0;100
120;0;"kamarian";120;100;0
0;47;"kamariana";47;0;100
0;10;"kamarianna";10;0;100
179;406;"kamarie";585;30.5982905982906;69.4017094017094
28;0;"kamarien";28;100;0
87;102;"kamarii";189;46.031746031746;53.968253968254
0;21;"kamarin";21;0;100
14;0;"kamario";14;100;0
1638;6;"kamarion";1644;99.6350364963504;0.364963503649635
0;29;"kamariona";29;0;100
0;5;"kamarionna";5;0;100
5;0;"kamarious";5;100;0
10;0;"kamaris";10;100;0
91;0;"kamarius";91;100;0
0;147;"kamariya";147;0;100
0;86;"kamariyah";86;0;100
8;0;"kamariyon";8;100;0
190;10;"kamaron";200;95;5
48;0;"kamarr";48;100;0
0;59;"kamarra";59;0;100
0;8;"kamarrah";8;0;100
5;0;"kamarre";5;100;0
177;73;"kamarri";250;70.8;29.2
0;55;"kamarria";55;0;100
86;0;"kamarrion";86;100;0
0;123;"kamaryn";123;0;100
818;0;"kamau";818;100;0
0;6;"kamaura";6;0;100
565;256;"kamauri";821;68.8185140073082;31.1814859926918
0;22;"kamauria";22;0;100
22;11;"kamaurie";33;66.6666666666667;33.3333333333333
28;0;"kamaurion";28;100;0
109;5;"kamaury";114;95.6140350877193;4.3859649122807
0;1275;"kamaya";1275;0;100
0;142;"kamayah";142;0;100
0;17;"kamayia";17;0;100
0;5;"kamayla";5;0;100
0;10;"kambel";10;0;100
0;42;"kambell";42;0;100
0;5;"kambelle";5;0;100
0;602;"kamber";602;0;100
0;5;"kamberly";5;0;100
0;35;"kamberlyn";35;0;100
0;74;"kambra";74;0;100
0;61;"kambre";61;0;100
0;84;"kambrea";84;0;100
0;1174;"kambree";1174;0;100
0;25;"kambreigh";25;0;100
0;94;"kambrey";94;0;100
0;670;"kambri";670;0;100
0;1353;"kambria";1353;0;100
0;725;"kambrie";725;0;100
0;387;"kambry";387;0;100
0;23;"kambrya";23;0;100
12;113;"kambryn";125;9.6;90.4
14;0;"kamdan";14;100;0
7497;491;"kamden";7988;93.8532799198798;6.14672008012018
246;5;"kamdin";251;98.00796812749;1.99203187250996
389;0;"kamdon";389;100;0
2004;1428;"kamdyn";3432;58.3916083916084;41.6083916083916
0;26;"kamdynn";26;0;100
0;804;"kamea";804;0;100
0;63;"kameah";63;0;100
0;5;"kameal";5;0;100
0;39;"kamecia";39;0;100
0;89;"kamee";89;0;100
25;0;"kameel";25;100;0
0;156;"kameela";156;0;100
0;402;"kameelah";402;0;100
0;5;"kameera";5;0;100
0;45;"kameesha";45;0;100
0;16;"kameia";16;0;100
0;16;"kameika";16;0;100
0;11;"kameil";11;0;100
0;15;"kameira";15;0;100
0;303;"kameisha";303;0;100
0;288;"kameka";288;0;100
0;11;"kamekia";11;0;100
5;208;"kameko";213;2.34741784037559;97.6525821596244
491;0;"kamel";491;100;0
0;705;"kamela";705;0;100
0;26;"kamelah";26;0;100
0;287;"kamelia";287;0;100
17;0;"kamell";17;100;0
0;32;"kamella";32;0;100
0;6;"kamellia";6;0;100
11;0;"kamelo";11;100;0
0;5;"kamelya";5;0;100
371;0;"kamen";371;100;0
5;116;"kameo";121;4.13223140495868;95.8677685950413
5;0;"kameon";5;100;0
0;248;"kamera";248;0;100
424;186;"kameran";610;69.5081967213115;30.4918032786885
557;83;"kameren";640;87.03125;12.96875
0;109;"kameria";109;0;100
0;6;"kameriah";6;0;100
422;221;"kamerin";643;65.6298600311042;34.3701399688958
49;0;"kamerion";49;100;0
30206;3991;"kameron";34197;88.3293856186215;11.6706143813785
0;5;"kamerra";5;0;100
0;20;"kamery";20;0;100
674;1829;"kameryn";2503;26.927686775869;73.0723132241311
0;1105;"kamesha";1105;0;100
0;298;"kameshia";298;0;100
0;16;"kametra";16;0;100
0;23;"kametria";23;0;100
0;10;"kamey";10;0;100
0;37;"kameya";37;0;100
0;11;"kameyah";11;0;100
20;8458;"kami";8478;0.235904694503421;99.7640953054966
0;1314;"kamia";1314;0;100
0;1224;"kamiah";1224;0;100
0;16;"kamiaya";16;0;100
0;70;"kamica";70;0;100
0;1178;"kamie";1178;0;100
0;12;"kamielle";12;0;100
6;0;"kamien";6;100;0
0;19;"kamiera";19;0;100
0;17;"kamiesha";17;0;100
0;15;"kamijah";15;0;100
0;433;"kamika";433;0;100
0;41;"kamiko";41;0;100
1682;439;"kamil";2121;79.3022159358793;20.6977840641207
0;9240;"kamila";9240;0;100
0;4259;"kamilah";4259;0;100
0;184;"kamile";184;0;100
0;50;"kamili";50;0;100
0;179;"kamilia";179;0;100
0;68;"kamill";68;0;100
0;1613;"kamilla";1613;0;100
0;212;"kamillah";212;0;100
0;4149;"kamille";4149;0;100
0;39;"kamillia";39;0;100
0;27;"kamilly";27;0;100
121;0;"kamilo";121;100;0
0;20;"kamily";20;0;100
0;91;"kamilya";91;0;100
0;6;"kamilyah";6;0;100
63;0;"kamin";63;100;0
0;35;"kamina";35;0;100
0;27;"kamini";27;0;100
5;0;"kamion";5;100;0
85;0;"kamir";85;100;0
0;635;"kamira";635;0;100
0;271;"kamirah";271;0;100
0;5;"kamiria";5;0;100
18;0;"kamiron";18;100;0
0;51;"kamirra";51;0;100
0;63;"kamiryn";63;0;100
0;1128;"kamisha";1128;0;100
0;6;"kamishia";6;0;100
0;2217;"kamiya";2217;0;100
0;2553;"kamiyah";2553;0;100
0;6;"kamiyha";6;0;100
0;6;"kamiyla";6;0;100
0;22;"kamiylah";22;0;100
0;6;"kamiyra";6;0;100
0;68;"kamla";68;0;100
0;41;"kamlyn";41;0;100
5;0;"kamm";5;100;0
16;0;"kammeron";16;100;0
0;620;"kammi";620;0;100
0;859;"kammie";859;0;100
17;0;"kammron";17;100;0
0;655;"kammy";655;0;100
283;0;"kamon";283;100;0
130;227;"kamoni";357;36.4145658263305;63.5854341736695
0;52;"kamonie";52;0;100
10;0;"kamontae";10;100;0
88;0;"kamonte";88;100;0
0;10;"kamor";10;0;100
0;2301;"kamora";2301;0;100
0;294;"kamorah";294;0;100
0;18;"kamore";18;0;100
0;24;"kamoree";24;0;100
135;288;"kamori";423;31.9148936170213;68.0851063829787
0;129;"kamoria";129;0;100
9;0;"kamorian";9;100;0
10;62;"kamorie";72;13.8888888888889;86.1111111111111
25;0;"kamorion";25;100;0
0;45;"kamorra";45;0;100
0;5;"kamouri";5;0;100
0;66;"kampbell";66;0;100
0;59;"kamra";59;0;100
5;0;"kamraan";5;100;0
1850;10;"kamran";1860;99.4623655913979;0.537634408602151
0;377;"kamree";377;0;100
3522;466;"kamren";3988;88.3149448345035;11.6850551654965
0;52;"kamrey";52;0;100
0;972;"kamri";972;0;100
0;479;"kamrie";479;0;100
1036;432;"kamrin";1468;70.5722070844687;29.4277929155313
6105;290;"kamron";6395;95.4652071931196;4.53479280688038
5;0;"kamronbek";5;100;0
16;0;"kamrun";16;100;0
16;777;"kamry";793;2.01765447667087;97.9823455233291
3344;19083;"kamryn";22427;14.9105988317653;85.0894011682347
0;5;"kamryne";5;0;100
19;628;"kamrynn";647;2.93663060278207;97.0633693972179
0;5;"kamrynne";5;0;100
12;12;"kamsi";24;50;50
0;16;"kamsiyochi";16;0;100
102;49;"kamsiyochukwu";151;67.5496688741722;32.4503311258278
265;0;"kamuela";265;100;0
6;0;"kamuri";6;100;0
0;111;"kamy";111;0;100
0;2913;"kamya";2913;0;100
0;714;"kamyah";714;0;100
17;0;"kamyar";17;100;0
0;342;"kamyia";342;0;100
0;221;"kamyiah";221;0;100
0;5;"kamyjah";5;0;100
0;8;"kamyl";8;0;100
0;561;"kamyla";561;0;100
0;163;"kamylah";163;0;100
0;5;"kamyle";5;0;100
0;10;"kamylla";10;0;100
0;81;"kamylle";81;0;100
0;626;"kamyra";626;0;100
0;121;"kamyrah";121;0;100
0;6;"kamyree";6;0;100
0;34;"kamyri";34;0;100
0;45;"kamyria";45;0;100
0;6;"kamyrie";6;0;100
7;41;"kamyrn";48;14.5833333333333;85.4166666666667
46;5;"kamyron";51;90.1960784313726;9.80392156862745
6;0;"kan";6;100;0
18;723;"kana";741;2.42914979757085;97.5708502024291
531;0;"kanaan";531;100;0
0;113;"kanae";113;0;100
0;17;"kanah";17;0;100
193;83;"kanai";276;69.9275362318841;30.0724637681159
0;39;"kanaiya";39;0;100
0;5;"kanaiyah";5;0;100
0;5;"kanaja";5;0;100
0;10;"kanajah";10;0;100
0;46;"kanako";46;0;100
39;0;"kanaloa";39;100;0
6;0;"kanalu";6;100;0
11;5;"kaname";16;68.75;31.25
351;11;"kanan";362;96.9613259668508;3.03867403314917
5;762;"kanani";767;0.651890482398957;99.348109517601
44;0;"kanard";44;100;0
23;31;"kanari";54;42.5925925925926;57.4074074074074
0;23;"kanaria";23;0;100
0;30;"kanasha";30;0;100
0;122;"kanasia";122;0;100
103;0;"kanav";103;100;0
14;0;"kanavis";14;100;0
0;185;"kanaya";185;0;100
0;7;"kanchan";7;0;100
0;177;"kanda";177;0;100
0;6189;"kandace";6189;0;100
0;91;"kandance";91;0;100
0;77;"kandas";77;0;100
0;31;"kande";31;0;100
0;505;"kandee";505;0;100
156;0;"kanden";156;100;0
0;6;"kandence";6;0;100
0;5536;"kandi";5536;0;100
5;15;"kandia";20;25;75
0;6731;"kandice";6731;0;100
0;14;"kandida";14;0;100
0;1080;"kandie";1080;0;100
0;2725;"kandis";2725;0;100
0;256;"kandise";256;0;100
0;123;"kandiss";123;0;100
0;5;"kandle";5;0;100
140;0;"kandon";140;100;0
0;1341;"kandra";1341;0;100
0;25;"kandrea";25;0;100
0;10;"kandria";10;0;100
0;27;"kandus";27;0;100
5;5279;"kandy";5284;0.0946252838758516;99.9053747161242
0;1403;"kandyce";1403;0;100
7;0;"kandyn";7;100;0
0;5;"kandys";5;0;100
0;24;"kandyse";24;0;100
11406;24;"kane";11430;99.7900262467192;0.20997375328084
0;6;"kanea";6;0;100
0;50;"kanecia";50;0;100
0;16;"kanedra";16;0;100
0;482;"kaneesha";482;0;100
0;9;"kaneeshia";9;0;100
0;5;"kaneidra";5;0;100
5;0;"kaneil";5;100;0
0;1014;"kaneisha";1014;0;100
0;54;"kaneka";54;0;100
0;5;"kanella";5;0;100
357;0;"kanen";357;100;0
0;1752;"kanesha";1752;0;100
0;452;"kaneshia";452;0;100
0;27;"kanesia";27;0;100
0;43;"kanessa";43;0;100
0;6;"kanessha";6;0;100
0;32;"kanetha";32;0;100
0;11;"kanethia";11;0;100
0;89;"kanetra";89;0;100
0;5;"kanette";5;0;100
44;108;"kang";152;28.9473684210526;71.0526315789474
501;174;"kani";675;74.2222222222222;25.7777777777778
0;572;"kania";572;0;100
0;424;"kaniah";424;0;100
5;0;"kaniala";5;100;0
0;6;"kanica";6;0;100
5;0;"kanichi";5;100;0
0;12;"kaniece";12;0;100
117;0;"kaniel";117;100;0
23;0;"kaniela";23;100;0
0;259;"kaniesha";259;0;100
0;108;"kanija";108;0;100
0;254;"kanijah";254;0;100
0;5;"kanijha";5;0;100
0;1197;"kanika";1197;0;100
0;5;"kanila";5;0;100
0;18;"kanilah";18;0;100
295;0;"kanin";295;100;0
0;20;"kaniqua";20;0;100
0;7;"kanira";7;0;100
0;6;"kanisa";6;0;100
0;29;"kanise";29;0;100
11;0;"kanish";11;100;0
0;2575;"kanisha";2575;0;100
0;24;"kanishia";24;0;100
120;0;"kanishk";120;100;0
0;44;"kanishka";44;0;100
0;5;"kanissa";5;0;100
0;204;"kanita";204;0;100
0;30;"kanitha";30;0;100
0;125;"kanitra";125;0;100
0;2185;"kaniya";2185;0;100
0;1741;"kaniyah";1741;0;100
0;8;"kaniyha";8;0;100
0;11;"kaniylah";11;0;100
6;0;"kanji";6;100;0
0;168;"kanna";168;0;100
162;0;"kannan";162;100;0
162;0;"kannen";162;100;0
42;0;"kannin";42;100;0
2526;56;"kannon";2582;97.8311386522076;2.16886134779241
6;11;"kannyn";17;35.2941176470588;64.7058823529412
92;0;"kano";92;100;0
628;0;"kanoa";628;100;0
0;81;"kanoe";81;0;100
0;79;"kanoelani";79;0;100
0;5;"kanoi";5;0;100
969;145;"kanon";1114;86.983842010772;13.016157989228
0;5;"kanora";5;0;100
0;36;"kanosha";36;0;100
59;1045;"kansas";1104;5.34420289855072;94.6557971014493
49;0;"kanta";49;100;0
0;20;"kantina";20;0;100
101;0;"kanton";101;100;0
54;0;"kantrell";54;100;0
0;5;"kantrice";5;0;100
0;40;"kanwal";40;0;100
0;17;"kany";17;0;100
25;547;"kanya";572;4.37062937062937;95.6293706293706
18;0;"kanyae";18;100;0
0;120;"kanyah";120;0;100
5;0;"kanyan";5;100;0
0;5;"kanyatta";5;0;100
1304;24;"kanye";1328;98.1927710843374;1.80722891566265
27;5;"kanyen";32;84.375;15.625
0;146;"kanyia";146;0;100
0;47;"kanyiah";47;0;100
0;6;"kanyjah";6;0;100
0;185;"kanyla";185;0;100
0;47;"kanylah";47;0;100
1003;81;"kanyon";1084;92.5276752767528;7.47232472324723
0;5;"kanyra";5;0;100
0;12;"kanysha";12;0;100
430;244;"kao";674;63.7982195845697;36.2017804154303
0;23;"kaoir";23;0;100
0;5;"kaola";5;0;100
0;5;"kaolin";5;0;100
0;20;"kaomi";20;0;100
5;0;"kaon";5;100;0
0;5;"kaonou";5;0;100
49;752;"kaori";801;6.11735330836454;93.8826466916355
168;83;"kaoru";251;66.9322709163347;33.0677290836653
0;25;"kaory";25;0;100
31;0;"kaos";31;100;0
44;0;"kap";44;100;0
64;0;"kapena";64;100;0
134;0;"kapil";134;100;0
0;17;"kapiolani";17;0;100
5;0;"kapish";5;100;0
33;0;"kaplan";33;100;0
26;0;"kapone";26;100;0
178;0;"kapono";178;100;0
0;50;"kapree";50;0;100
0;11;"kapresha";11;0;100
10;710;"kapri";720;1.38888888888889;98.6111111111111
0;34;"kapria";34;0;100
0;373;"kaprice";373;0;100
0;5;"kapricia";5;0;100
0;38;"kaprisha";38;0;100
23;0;"kaptain";23;100;0
0;6;"kar";6;0;100
282;98052;"kara";98334;0.286777716761242;99.7132222832387
0;16;"karaann";16;0;100
0;15;"karabella";15;0;100
36;0;"karac";36;100;0
0;5;"karadyn";5;0;100
0;142;"karagan";142;0;100
0;12;"karagen";12;0;100
0;3116;"karah";3116;0;100
0;34;"karai";34;0;100
0;6;"karalea";6;0;100
0;1167;"karalee";1167;0;100
0;39;"karaleigh";39;0;100
0;26;"karalena";26;0;100
0;5;"karalin";5;0;100
0;126;"karalina";126;0;100
0;600;"karaline";600;0;100
0;1486;"karalyn";1486;0;100
0;89;"karalyne";89;0;100
0;637;"karalynn";637;0;100
0;17;"karalynne";17;0;100
722;0;"karam";722;100;0
0;16;"karamia";16;0;100
5;0;"karamo";5;100;0
5;0;"karamvir";5;100;0
1380;3450;"karan";4830;28.5714285714286;71.4285714285714
0;11;"karana";11;0;100
5;0;"karanbir";5;100;0
0;10;"karanda";10;0;100
67;0;"karandeep";67;100;0
15;0;"karanja";15;100;0
126;0;"karanveer";126;100;0
74;0;"karanvir";74;100;0
23;0;"karapet";23;100;0
51;0;"karar";51;100;0
387;0;"karas";387;100;0
0;5;"karaya";5;0;100
5;0;"karbon";5;100;0
7;0;"karcen";7;100;0
46;0;"karch";46;100;0
5;0;"karcher";5;100;0
15;91;"karcyn";106;14.1509433962264;85.8490566037736
0;7;"karcynn";7;0;100
16;0;"kardae";16;100;0
5;0;"kardale";5;100;0
11;0;"kardarius";11;100;0
6;0;"karde";6;100;0
119;0;"kardell";119;100;0
35;0;"karden";35;100;0
218;7;"karder";225;96.8888888888889;3.11111111111111
6;0;"kardier";6;100;0
29;0;"kardin";29;100;0
0;13;"kardyn";13;0;100
0;104;"kare";104;0;100
28;0;"kaream";28;100;0
0;5;"kareana";5;0;100
80;742;"karee";822;9.7323600973236;90.2676399026764
14620;198;"kareem";14818;98.6637872857336;1.33621271426643
0;771;"kareema";771;0;100
0;354;"kareemah";354;0;100
736;1289;"kareen";2025;36.3456790123457;63.6543209876543
0;1319;"kareena";1319;0;100
0;5;"kareese";5;0;100
0;5;"kareesha";5;0;100
11;0;"karega";11;100;0
517;1208;"karel";1725;29.9710144927536;70.0289855072464
0;314;"kareli";314;0;100
0;11;"karelia";11;0;100
0;5;"karelie";5;0;100
0;28;"karelin";28;0;100
0;29;"karelis";29;0;100
104;0;"karell";104;100;0
0;153;"karelly";153;0;100
0;1673;"karely";1673;0;100
0;135;"karelyn";135;0;100
0;50;"karelys";50;0;100
128;233;"karem";361;35.4570637119114;64.5429362880887
0;62;"karema";62;0;100
5;0;"kareme";5;100;0
2765;984969;"karen";987734;0.279933666351467;99.7200663336485
0;3379;"karena";3379;0;100
0;145;"karenann";145;0;100
0;35;"karenda";35;0;100
0;501;"karene";501;0;100
0;14;"karenina";14;0;100
0;32;"karenlee";32;0;100
0;20;"karenn";20;0;100
0;331;"karenna";331;0;100
0;26;"karensa";26;0;100
0;16;"karent";16;0;100
0;7;"kareny";7;0;100
0;17;"karenza";17;0;100
0;64;"karesa";64;0;100
0;5;"karese";5;0;100
0;112;"karesha";112;0;100
0;112;"karess";112;0;100
0;452;"karessa";452;0;100
0;18;"karesse";18;0;100
0;11;"karetha";11;0;100
584;2187;"karey";2771;21.0754240346445;78.9245759653555
0;11;"karhonda";11;0;100
640;58544;"kari";59184;1.08137334414707;98.9186266558529
0;409;"karia";409;0;100
0;369;"kariah";369;0;100
0;41;"karian";41;0;100
0;447;"kariana";447;0;100
0;789;"kariann";789;0;100
0;411;"karianna";411;0;100
0;997;"karianne";997;0;100
5;0;"karibe";5;100;0
0;45;"karicia";45;0;100
0;13;"karidee";13;0;100
0;5305;"karie";5305;0;100
17;53;"kariel";70;24.2857142857143;75.7142857142857
0;5;"karieliz";5;0;100
0;108;"karielle";108;0;100
0;16;"karielys";16;0;100
149;0;"kariem";149;100;0
10;0;"karif";10;100;0
0;292;"karigan";292;0;100
0;55;"karil";55;0;100
0;43;"karilee";43;0;100
0;885;"karilyn";885;0;100
0;107;"karilynn";107;0;100
4699;58;"karim";4757;98.7807441664915;1.21925583350851
0;1347;"karima";1347;0;100
0;556;"karimah";556;0;100
0;2151;"karime";2151;0;100
0;5;"karimen";5;0;100
140;28368;"karin";28508;0.491090220289042;99.508909779711
253;57395;"karina";57648;0.43887038578962;99.5611296142104
0;22;"karinah";22;0;100
0;92;"karinda";92;0;100
0;1151;"karine";1151;0;100
0;153;"karington";153;0;100
0;8;"karinn";8;0;100
0;577;"karinna";577;0;100
0;287;"karinne";287;0;100
71;5;"karion";76;93.4210526315789;6.57894736842105
0;5;"kariona";5;0;100
0;11;"karionna";11;0;100
75;5579;"karis";5654;1.326494517156;98.673505482844
0;2732;"karisa";2732;0;100
0;23;"karise";23;0;100
0;355;"karisha";355;0;100
0;929;"karishma";929;0;100
0;9;"karisia";9;0;100
0;1777;"karisma";1777;0;100
0;5;"karismah";5;0;100
0;75;"kariss";75;0;100
0;19275;"karissa";19275;0;100
0;14;"karissia";14;0;100
0;34;"karissma";34;0;100
0;142;"karista";142;0;100
0;197;"karita";197;0;100
0;39;"karitza";39;0;100
0;90;"kariya";90;0;100
0;209;"kariyah";209;0;100
0;11;"kariyana";11;0;100
0;1113;"karizma";1113;0;100
0;6;"karizmah";6;0;100
98754;913;"karl";99667;99.0839495520082;0.916050447991813
309;87716;"karla";88025;0.351036637318943;99.6489633626811
0;11;"karlah";11;0;100
39;0;"karlan";39;100;0
56;94;"karle";150;37.3333333333333;62.6666666666667
0;248;"karlea";248;0;100
0;16;"karleah";16;0;100
0;11694;"karlee";11694;0;100
0;2733;"karleen";2733;0;100
0;26;"karleena";26;0;100
0;193;"karlei";193;0;100
0;3952;"karleigh";3952;0;100
16;147;"karlen";163;9.8159509202454;90.1840490797546
0;260;"karlena";260;0;100
0;4105;"karlene";4105;0;100
0;21;"karlesha";21;0;100
0;112;"karletta";112;0;100
0;43;"karlette";43;0;100
0;7058;"karley";7058;0;100
0;10136;"karli";10136;0;100
0;11;"karlia";11;0;100
0;87;"karliah";87;0;100
0;5;"karlianys";5;0;100
0;9893;"karlie";9893;0;100
0;20;"karliee";20;0;100
341;441;"karlin";782;43.6061381074169;56.3938618925831
0;296;"karlina";296;0;100
0;47;"karline";47;0;100
72;0;"karlis";72;100;0
0;120;"karlisa";120;0;100
0;5;"karlise";5;0;100
0;156;"karlisha";156;0;100
0;86;"karlissa";86;0;100
0;82;"karlita";82;0;100
35;0;"karlito";35;100;0
0;18;"karliyah";18;0;100
819;0;"karlo";819;100;0
57;0;"karlon";57;100;0
1749;0;"karlos";1749;100;0
0;52;"karlotta";52;0;100
21;0;"karloz";21;100;0
5;0;"karlson";5;100;0
1490;0;"karlton";1490;100;0
5;10049;"karly";10054;0.0497314501690869;99.9502685498309
0;383;"karlye";383;0;100
0;5;"karlyee";5;0;100
7;0;"karlyle";7;100;0
7;2242;"karlyn";2249;0.311249444197421;99.6887505558026
0;13;"karlyne";13;0;100
0;341;"karlynn";341;0;100
0;8;"karlysia";8;0;100
11;0;"karm";11;100;0
123;5966;"karma";6089;2.02003613072754;97.9799638692725
0;152;"karmah";152;0;100
39;538;"karman";577;6.75909878682842;93.2409012131716
5;10;"karmani";15;33.3333333333333;66.6666666666667
0;22;"karmann";22;0;100
5;0;"karmari";5;100;0
20;121;"karmel";141;14.1843971631206;85.8156028368794
0;131;"karmela";131;0;100
21;0;"karmell";21;100;0
0;323;"karmella";323;0;100
365;0;"karmello";365;100;0
608;0;"karmelo";608;100;0
10;6008;"karmen";6018;0.166168162180126;99.8338318378199
0;27;"karmesha";27;0;100
0;7;"karmia";7;0;100
0;859;"karmin";859;0;100
0;108;"karmina";108;0;100
0;5;"karmindy";5;0;100
95;0;"karmine";95;100;0
0;5;"karmisha";5;0;100
5;185;"karmon";190;2.63157894736842;97.3684210526316
0;7;"karmoni";7;0;100
0;11;"karmya";11;0;100
0;1405;"karmyn";1405;0;100
44;0;"karmyne";44;100;0
0;42;"karmynn";42;0;100
5;164;"karn";169;2.9585798816568;97.0414201183432
6;523;"karna";529;1.13421550094518;98.8657844990548
0;135;"karne";135;0;100
0;5;"karnecia";5;0;100
0;27;"karneisha";27;0;100
5;0;"karnel";5;100;0
167;0;"karnell";167;100;0
0;43;"karnesha";43;0;100
0;17;"karneshia";17;0;100
0;80;"karnisha";80;0;100
80;0;"karo";80;100;0
1383;9227;"karol";10610;13.0348727615457;86.9651272384543
0;5;"karola";5;0;100
0;6;"karolann";6;0;100
0;947;"karole";947;0;100
0;180;"karolee";180;0;100
0;11;"karoleena";11;0;100
0;5;"karoleigh";5;0;100
0;14;"karolena";14;0;100
0;15;"karolin";15;0;100
0;3424;"karolina";3424;0;100
0;2946;"karoline";2946;0;100
10;0;"karolis";10;100;0
0;5;"karoll";5;0;100
0;5769;"karolyn";5769;0;100
0;125;"karolyna";125;0;100
0;211;"karolyne";211;0;100
0;250;"karolynn";250;0;100
2837;6208;"karon";9045;31.3653952459923;68.6346047540077
0;8;"karona";8;0;100
0;53;"karonda";53;0;100
0;968;"karra";968;0;100
0;792;"karrah";792;0;100
0;26;"karran";26;0;100
19;0;"karrar";19;100;0
6;0;"karras";6;100;0
0;6;"karre";6;0;100
28;0;"karreem";28;100;0
10;0;"karrell";10;100;0
15;0;"karrem";15;100;0
0;2177;"karren";2177;0;100
0;11;"karrena";11;0;100
0;4399;"karri";4399;0;100
0;21;"karriann";21;0;100
0;11;"karrianne";11;0;100
5;0;"karrick";5;100;0
0;9802;"karrie";9802;0;100
490;5;"karriem";495;98.989898989899;1.01010101010101
5;0;"karrien";5;100;0
0;433;"karrigan";433;0;100
0;367;"karrin";367;0;100
0;223;"karrina";223;0;100
0;51;"karrine";51;0;100
261;1211;"karrington";1472;17.7309782608696;82.2690217391304
0;148;"karris";148;0;100
0;245;"karrisa";245;0;100
0;355;"karrissa";355;0;100
7;52;"karrol";59;11.864406779661;88.135593220339
10;12;"karroll";22;45.4545454545455;54.5454545454545
164;376;"karron";540;30.3703703703704;69.6296296296296
39;0;"karrson";39;100;0
642;1200;"karry";1842;34.8534201954397;65.1465798045603
0;40;"karryn";40;0;100
16;0;"karsan";16;100;0
2212;1394;"karsen";3606;61.3422074320577;38.6577925679423
0;22;"karsha";22;0;100
158;32;"karsin";190;83.1578947368421;16.8421052631579
0;5;"karslyn";5;0;100
11555;1614;"karson";13169;87.7439441111702;12.2560558888298
2877;157;"karsten";3034;94.825313117996;5.17468688200396
10;5;"karstin";15;66.6666666666667;33.3333333333333
523;0;"karston";523;100;0
0;66;"karstyn";66;0;100
966;5118;"karsyn";6084;15.8777120315582;84.1222879684418
0;189;"karsynn";189;0;100
6;0;"kartar";6;100;0
42;0;"kartel";42;100;0
6;0;"kartell";6;100;0
12183;1803;"karter";13986;87.1085371085371;12.8914628914629
5;0;"kartez";5;100;0
1243;0;"karthik";1243;100;0
0;66;"karthika";66;0;100
178;0;"karthikeya";178;100;0
6;0;"karthikeyan";6;100;0
134;20;"kartier";154;87.012987012987;12.987012987013
395;0;"kartik";395;100;0
0;13;"kartika";13;0;100
46;0;"kartikeya";46;100;0
0;40;"kartina";40;0;100
0;5;"kartrina";5;0;100
6;0;"kartyr";6;100;0
16;0;"karun";16;100;0
0;118;"karuna";118;0;100
248;0;"karver";248;100;0
10;0;"karvin";10;100;0
1416;1924;"kary";3340;42.3952095808383;57.6047904191617
0;9;"karyah";9;0;100
0;5;"karyana";5;0;100
0;2106;"karyl";2106;0;100
0;36;"karyle";36;0;100
0;8;"karylle";8;0;100
21;0;"karym";21;100;0
0;1946;"karyme";1946;0;100
5;14068;"karyn";14073;0.0355290272152348;99.9644709727848
0;798;"karyna";798;0;100
0;21;"karyne";21;0;100
0;145;"karynn";145;0;100
0;51;"karynna";51;0;100
0;37;"karynne";37;0;100
0;431;"karys";431;0;100
0;130;"karysa";130;0;100
0;17;"karysma";17;0;100
0;72;"karyss";72;0;100
0;905;"karyssa";905;0;100
0;26;"karyzma";26;0;100
21;0;"kas";21;100;0
0;5;"kasa";5;0;100
30;0;"kasaan";30;100;0
0;6;"kasadee";6;0;100
0;5;"kasadie";5;0;100
0;22;"kasady";22;0;100
5;0;"kasahn";5;100;0
185;0;"kasai";185;100;0
38;0;"kasan";38;100;0
0;9264;"kasandra";9264;0;100
5;15;"kasani";20;25;75
0;229;"kasara";229;0;100
0;111;"kasarah";111;0;100
52;0;"kasaun";52;100;0
0;455;"kasaundra";455;0;100
143;0;"kasch";143;100;0
0;23;"kascha";23;0;100
2211;0;"kase";2211;100;0
0;13;"kasea";13;0;100
179;0;"kasean";179;100;0
0;365;"kasee";365;0;100
757;0;"kaseem";757;100;0
16;0;"kaseen";16;100;0
0;39;"kaselyn";39;0;100
0;32;"kaselynn";32;0;100
58;0;"kasem";58;100;0
5817;105;"kasen";5922;98.2269503546099;1.77304964539007
5;0;"kaser";5;100;0
18;0;"kaseton";18;100;0
11463;31935;"kasey";43398;26.4136596156505;73.5863403843495
6203;75;"kash";6278;98.8053520229372;1.19464797706276
0;1494;"kasha";1494;0;100
21;0;"kashad";21;100;0
0;135;"kashae";135;0;100
0;8;"kashaf";8;0;100
0;27;"kashala";27;0;100
35;0;"kashan";35;100;0
0;172;"kashana";172;0;100
0;41;"kashanda";41;0;100
0;5;"kashandra";5;0;100
0;53;"kashanna";53;0;100
0;5;"kashanta";5;0;100
0;51;"kashanti";51;0;100
0;182;"kashara";182;0;100
0;61;"kashari";61;0;100
332;0;"kashaun";332;100;0
0;79;"kashauna";79;0;100
0;5;"kashaunda";5;0;100
0;6;"kashaundra";6;0;100
990;78;"kashawn";1068;92.6966292134831;7.30337078651685
0;200;"kashawna";200;0;100
0;183;"kashay";183;0;100
0;209;"kashayla";209;0;100
69;0;"kashden";69;100;0
23;0;"kashdyn";23;100;0
38;40;"kashe";78;48.7179487179487;51.2820512820513
0;36;"kashea";36;0;100
107;0;"kasheem";107;100;0
5;0;"kasheen";5;100;0
0;183;"kasheena";183;0;100
0;5;"kashema";5;0;100
12;0;"kashen";12;100;0
0;84;"kashena";84;0;100
5;0;"kasher";5;100;0
5;0;"kashes";5;100;0
5;10;"kashi";15;33.3333333333333;66.6666666666667
0;602;"kashia";602;0;100
29;0;"kashief";29;100;0
844;0;"kashif";844;100;0
7;0;"kashiff";7;100;0
0;16;"kashika";16;0;100
0;39;"kashima";39;0;100
0;104;"kashina";104;0;100
0;94;"kashira";94;0;100
83;0;"kashis";83;100;0
0;136;"kashish";136;0;100
127;0;"kashius";127;100;0
0;48;"kashiya";48;0;100
12;16;"kashka";28;42.8571428571429;57.1428571428571
0;16;"kashlee";16;0;100
0;17;"kashley";17;0;100
0;191;"kashlyn";191;0;100
0;119;"kashlynn";119;0;100
5;0;"kashmeir";5;100;0
175;332;"kashmere";507;34.5167652859961;65.4832347140039
0;6;"kashmiere";6;0;100
213;404;"kashmir";617;34.5218800648298;65.4781199351702
0;5;"kashmira";5;0;100
200;0;"kashon";200;100;0
0;6;"kashona";6;0;100
0;148;"kashonda";148;0;100
0;7;"kashondra";7;0;100
0;36;"kashonna";36;0;100
59;0;"kashten";59;100;0
12;0;"kashtian";12;100;0
18;0;"kashtin";18;100;0
1171;5;"kashton";1176;99.5748299319728;0.425170068027211
92;10;"kashtyn";102;90.1960784313726;9.80392156862745
33;0;"kashun";33;100;0
0;37;"kashunda";37;0;100
114;0;"kashus";114;100;0
0;261;"kashvi";261;0;100
0;19;"kashya";19;0;100
49;0;"kashyap";49;100;0
0;17;"kashyia";17;0;100
0;39;"kashyra";39;0;100
26;2228;"kasi";2254;1.15350488021295;98.8464951197871
0;1523;"kasia";1523;0;100
12;197;"kasiah";209;5.74162679425837;94.2583732057416
12;0;"kasib";12;100;0
0;230;"kasidee";230;0;100
0;79;"kasidi";79;0;100
0;572;"kasidy";572;0;100
21;4098;"kasie";4119;0.509832483612527;99.4901675163875
23;0;"kasiem";23;100;0
654;0;"kasim";654;100;0
0;11;"kasima";11;0;100
5;0;"kasimer";5;100;0
40;0;"kasimir";40;100;0
5;0;"kasimu";5;100;0
245;0;"kasin";245;100;0
0;30;"kasinda";30;0;100
126;0;"kasir";126;100;0
0;28;"kasity";28;0;100
0;83;"kasiya";83;0;100
0;104;"kasiyah";104;0;100
0;51;"kaslyn";51;0;100
0;6;"kaslynn";6;0;100
24;0;"kasmer";24;100;0
0;6;"kasmin";6;0;100
0;10;"kasmine";10;0;100
18;0;"kasmir";18;100;0
0;146;"kasmira";146;0;100
8579;41;"kason";8620;99.5243619489559;0.475638051044084
0;874;"kasondra";874;0;100
0;19;"kasonya";19;0;100
108;0;"kaspar";108;100;0
6;0;"kaspen";6;100;0
715;0;"kasper";715;100;0
48;0;"kaspian";48;100;0
258;0;"kasra";258;100;0
55;0;"kass";55;100;0
0;76;"kassadee";76;0;100
0;188;"kassadi";188;0;100
0;95;"kassadie";95;0;100
0;281;"kassady";281;0;100
15;0;"kassan";15;100;0
0;13;"kassandr";13;0;100
16;31517;"kassandra";31533;0.0507404940855612;99.9492595059144
0;30;"kassandre";30;0;100
0;5;"kassandrea";5;0;100
0;5;"kassara";5;0;100
0;400;"kassaundra";400;0;100
0;16;"kassedy";16;0;100
0;18;"kassee";18;0;100
5;0;"kassel";5;100;0
208;0;"kassem";208;100;0
26;0;"kassen";26;100;0
5;652;"kassey";657;0.76103500761035;99.2389649923896
0;2034;"kassi";2034;0;100
0;689;"kassia";689;0;100
0;62;"kassiah";62;0;100
0;16;"kassiana";16;0;100
0;24;"kassiani";24;0;100
0;5;"kasside";5;0;100
0;587;"kassidee";587;0;100
0;28;"kassidey";28;0;100
0;1016;"kassidi";1016;0;100
0;319;"kassidie";319;0;100
319;17695;"kassidy";18014;1.77084489841235;98.2291551015877
0;6582;"kassie";6582;0;100
301;0;"kassim";301;100;0
0;140;"kassity";140;0;100
302;0;"kassius";302;100;0
77;0;"kasson";77;100;0
0;927;"kassondra";927;0;100
0;873;"kassy";873;0;100
0;23;"kassydi";23;0;100
144;0;"kasten";144;100;0
68;0;"kastiel";68;100;0
63;0;"kastin";63;100;0
42;5;"kastle";47;89.3617021276596;10.6382978723404
211;0;"kaston";211;100;0
5;0;"kastriot";5;100;0
16;5;"kastyn";21;76.1904761904762;23.8095238095238
0;76;"kasumi";76;0;100
0;11;"kasundra";11;0;100
0;55;"kasy";55;0;100
0;5;"kasydi";5;0;100
0;5;"kasye";5;0;100
637;153;"kasyn";790;80.6329113924051;19.3670886075949
0;27;"kat";27;0;100
0;53;"kata";53;0;100
80;0;"katai";80;100;0
0;186;"katalaya";186;0;100
0;18;"katalayah";18;0;100
0;71;"katalea";71;0;100
0;72;"kataleah";72;0;100
0;50;"kataleena";50;0;100
0;45;"kataleia";45;0;100
0;6;"kataleiya";6;0;100
0;124;"katalena";124;0;100
0;1101;"kataleya";1101;0;100
0;52;"kataleyah";52;0;100
0;120;"katalia";120;0;100
0;394;"katalin";394;0;100
0;3403;"katalina";3403;0;100
0;22;"kataliya";22;0;100
0;32;"kataliyah";32;0;100
0;6;"katalya";6;0;100
0;62;"katalyn";62;0;100
0;300;"katalyna";300;0;100
0;12;"katalynna";12;0;100
0;1198;"katana";1198;0;100
0;60;"katanna";60;0;100
0;116;"katanya";116;0;100
0;1021;"katara";1021;0;100
0;45;"katarena";45;0;100
5;6;"katari";11;45.4545454545455;54.5454545454545
0;5;"kataria";5;0;100
0;8168;"katarina";8168;0;100
0;10;"katarra";10;0;100
0;124;"kataryna";124;0;100
0;695;"katarzyna";695;0;100
0;417;"katasha";417;0;100
0;12;"katashia";12;0;100
0;11;"katasia";11;0;100
0;33;"katavia";33;0;100
5;0;"katavion";5;100;0
0;112;"kataya";112;0;100
87;72451;"kate";72538;0.119937136397474;99.8800628636025
0;5;"kateara";5;0;100
0;10;"katedra";10;0;100
0;637;"katee";637;0;100
0;62;"kateena";62;0;100
0;26;"kateisha";26;0;100
0;376;"katelan";376;0;100
0;659;"kateland";659;0;100
0;113;"katelee";113;0;100
0;164;"kateleen";164;0;100
0;21;"kateleigh";21;0;100
0;221;"katelen";221;0;100
0;5;"kateleya";5;0;100
0;8854;"katelin";8854;0;100
0;22;"katelina";22;0;100
0;69;"katelind";69;0;100
0;118;"kateline";118;0;100
0;163;"katelinn";163;0;100
0;5;"katelon";5;0;100
0;5;"katelund";5;0;100
0;85;"kately";85;0;100
161;130089;"katelyn";130250;0.123608445297505;99.8763915547025
0;274;"katelynd";274;0;100
0;549;"katelyne";549;0;100
11;29558;"katelynn";29569;0.0372011227975244;99.9627988772025
0;1331;"katelynne";1331;0;100
0;48;"katen";48;0;100
0;65;"katena";65;0;100
0;6;"katence";6;0;100
0;25;"katenia";25;0;100
5;0;"kater";5;100;0
0;551;"katera";551;0;100
0;5;"katerena";5;0;100
0;2161;"kateri";2161;0;100
0;242;"kateria";242;0;100
0;840;"katerin";840;0;100
0;6471;"katerina";6471;0;100
0;871;"katerine";871;0;100
0;11;"katerinne";11;0;100
0;240;"katerra";240;0;100
0;54;"katerria";54;0;100
0;128;"kateryn";128;0;100
0;79;"kateryna";79;0;100
0;177;"katesha";177;0;100
0;11;"kateshia";11;0;100
0;64;"katessa";64;0;100
0;2315;"katey";2315;0;100
0;38;"kath";38;0;100
0;394;"katha";394;0;100
0;4131;"kathaleen";4131;0;100
0;230;"kathalene";230;0;100
0;45;"kathaleya";45;0;100
0;21;"kathalia";21;0;100
0;121;"kathalina";121;0;100
0;36;"kathaline";36;0;100
0;29;"kathalyn";29;0;100
184;0;"kathan";184;100;0
0;82;"katharin";82;0;100
0;1864;"katharina";1864;0;100
11;38630;"katharine";38641;0.0284671721746332;99.9715328278254
0;1541;"katharyn";1541;0;100
0;38;"katharyne";38;0;100
0;5;"kathay";5;0;100
0;1075;"kathe";1075;0;100
0;169;"kathee";169;0;100
0;134;"katheen";134;0;100
0;47;"katheine";47;0;100
0;10;"kathelean";10;0;100
0;1230;"katheleen";1230;0;100
0;168;"kathelene";168;0;100
0;79;"katheline";79;0;100
0;238;"kathelyn";238;0;100
6;0;"kathen";6;100;0
0;17;"kather";17;0;100
0;15;"katheran";15;0;100
0;124;"katheren";124;0;100
0;492;"katherene";492;0;100
0;5;"katheriene";5;0;100
0;3273;"katherin";3273;0;100
0;1476;"katherina";1476;0;100
1813;615832;"katherine";617645;0.293534311781039;99.706465688219
0;147;"katherinne";147;0;100
0;200;"katherleen";200;0;100
0;15;"katherlene";15;0;100
0;21;"katherline";21;0;100
0;3273;"kathern";3273;0;100
0;21;"katherne";21;0;100
0;14469;"katheryn";14469;0;100
0;2032;"katheryne";2032;0;100
0;5;"katherynn";5;0;100
0;1600;"kathey";1600;0;100
0;10109;"kathi";10109;0;100
0;1292;"kathia";1292;0;100
0;17;"kathiana";17;0;100
0;15056;"kathie";15056;0;100
0;29;"kathileen";29;0;100
0;12;"kathina";12;0;100
5;0;"kathir";5;100;0
0;36;"kathiria";36;0;100
0;253;"kathlean";253;0;100
0;120;"kathlee";120;0;100
0;10;"kathleeen";10;0;100
1693;708960;"kathleen";710653;0.238231598262443;99.7617684017376
0;128;"kathleena";128;0;100
0;5;"kathleenann";5;0;100
0;523;"kathleene";523;0;100
0;6;"kathleenmary";6;0;100
0;85;"kathlen";85;0;100
0;37;"kathlena";37;0;100
0;3499;"kathlene";3499;0;100
0;12;"kathlin";12;0;100
0;11;"kathlina";11;0;100
0;221;"kathline";221;0;100
0;18;"kathllen";18;0;100
0;4975;"kathlyn";4975;0;100
0;68;"kathlyne";68;0;100
0;516;"kathlynn";516;0;100
0;6;"katholeen";6;0;100
0;5;"kathran";5;0;100
0;5;"kathrean";5;0;100
0;372;"kathreen";372;0;100
0;947;"kathren";947;0;100
0;179;"kathrene";179;0;100
0;1205;"kathrin";1205;0;100
0;777;"kathrina";777;0;100
0;15139;"kathrine";15139;0;100
0;30;"kathry";30;0;100
1087;441535;"kathryn";442622;0.245582009028019;99.754417990972
0;5;"kathrynann";5;0;100
0;5;"kathrynanne";5;0;100
0;5623;"kathryne";5623;0;100
0;456;"kathrynn";456;0;100
0;85;"kathrynne";85;0;100
739;333428;"kathy";334167;0.221146911574153;99.7788530884258
0;736;"kathya";736;0;100
0;171;"kathyann";171;0;100
0;6;"kathyanne";6;0;100
0;338;"kathye";338;0;100
0;5;"kathyern";5;0;100
0;129;"kathyjo";129;0;100
0;541;"kathyleen";541;0;100
0;18;"kathylene";18;0;100
0;16;"kathyn";16;0;100
0;29;"kathyren";29;0;100
0;21;"kathyria";21;0;100
0;6;"kathyrine";6;0;100
0;3160;"kathyrn";3160;0;100
0;10;"kathyrne";10;0;100
0;5;"kathyy";5;0;100
0;4725;"kati";4725;0;100
0;5398;"katia";5398;0;100
0;912;"katiana";912;0;100
0;27;"katiann";27;0;100
0;171;"katianna";171;0;100
0;104;"katianne";104;0;100
494;226258;"katie";226752;0.217859158904883;99.7821408410951
0;340;"katieann";340;0;100
0;10;"katieanne";10;0;100
0;73;"katiejo";73;0;100
0;11;"katielee";11;0;100
0;49;"katielyn";49;0;100
0;331;"katielynn";331;0;100
0;10;"katiemae";10;0;100
0;28;"katiemarie";28;0;100
0;16;"katiera";16;0;100
0;5;"katierra";5;0;100
0;5;"katija";5;0;100
0;39;"katika";39;0;100
0;18;"katilaya";18;0;100
0;155;"katilin";155;0;100
0;1718;"katilyn";1718;0;100
0;384;"katilynn";384;0;100
0;14;"katima";14;0;100
20;6;"katin";26;76.9230769230769;23.0769230769231
34;11233;"katina";11267;0.301766219934321;99.6982337800657
0;31;"katine";31;0;100
0;16;"katinia";16;0;100
0;17;"katinka";17;0;100
0;13;"katinna";13;0;100
0;67;"katira";67;0;100
0;525;"katiria";525;0;100
0;774;"katisha";774;0;100
0;5;"katishia";5;0;100
0;5;"katiuscia";5;0;100
0;32;"katiuska";32;0;100
0;121;"katiya";121;0;100
0;11;"katiyah";11;0;100
0;850;"katja";850;0;100
0;5;"katlain";5;0;100
0;27;"katlan";27;0;100
0;204;"katleen";204;0;100
0;75;"katlen";75;0;100
0;25;"katleyn";25;0;100
126;5334;"katlin";5460;2.30769230769231;97.6923076923077
0;27;"katline";27;0;100
5;18269;"katlyn";18274;0.0273612783189231;99.9726387216811
0;39;"katlynd";39;0;100
0;269;"katlyne";269;0;100
0;3930;"katlynn";3930;0;100
0;213;"katlynne";213;0;100
0;129;"katniss";129;0;100
447;0;"kato";447;100;0
40;0;"katon";40;100;0
0;52;"katona";52;0;100
0;34;"katonia";34;0;100
0;5;"katonna";5;0;100
0;292;"katonya";292;0;100
0;118;"katora";118;0;100
0;82;"katori";82;0;100
0;178;"katoria";178;0;100
0;32;"katosha";32;0;100
0;189;"katoya";189;0;100
0;6;"katravia";6;0;100
0;5;"katrea";5;0;100
0;63;"katrece";63;0;100
0;5;"katreen";5;0;100
0;289;"katreena";289;0;100
0;5;"katreina";5;0;100
418;43;"katrell";461;90.6724511930586;9.32754880694143
0;1422;"katrena";1422;0;100
0;217;"katrenia";217;0;100
0;5;"katrenna";5;0;100
0;24;"katresa";24;0;100
0;129;"katrese";129;0;100
0;16;"katri";16;0;100
0;103;"katria";103;0;100
0;203;"katriana";203;0;100
0;69;"katrianna";69;0;100
0;17;"katrica";17;0;100
0;2192;"katrice";2192;0;100
0;319;"katricia";319;0;100
0;5;"katriece";5;0;100
31;335;"katriel";366;8.46994535519126;91.5300546448087
0;18;"katrielle";18;0;100
0;16;"katrien";16;0;100
0;12;"katriena";12;0;100
0;1026;"katrin";1026;0;100
238;100257;"katrina";100495;0.23682770287079;99.7631722971292
0;15;"katrinamarie";15;0;100
0;897;"katrine";897;0;100
0;489;"katrinia";489;0;100
0;503;"katrinka";503;0;100
0;88;"katrinna";88;0;100
0;87;"katriona";87;0;100
0;5;"katrisa";5;0;100
0;191;"katrisha";191;0;100
33;0;"katron";33;100;0
0;335;"katryn";335;0;100
0;831;"katryna";831;0;100
0;5;"katsue";5;0;100
23;0;"katsuji";23;100;0
0;49;"katsuko";49;0;100
265;5;"katsumi";270;98.1481481481482;1.85185185185185
0;95;"kattaleya";95;0;100
0;191;"katti";191;0;100
0;67;"kattia";67;0;100
0;5248;"kattie";5248;0;100
0;15;"kattina";15;0;100
0;112;"kattleya";112;0;100
0;23;"kattrina";23;0;100
0;883;"katty";883;0;100
0;37;"kattya";37;0;100
0;194;"katura";194;0;100
0;253;"katurah";253;0;100
5;19957;"katy";19962;0.0250475904218014;99.9749524095782
0;2687;"katya";2687;0;100
0;64;"katyana";64;0;100
0;7;"katyann";7;0;100
0;10;"katyanna";10;0;100
0;11;"katybeth";11;0;100
0;473;"katye";473;0;100
0;29;"katylin";29;0;100
0;5;"katyln";5;0;100
0;15;"katylyn";15;0;100
0;12;"katylynn";12;0;100
0;11;"katyna";11;0;100
0;62;"katyra";62;0;100
0;15;"katyria";15;0;100
57;0;"kaua";57;100;0
5;0;"kauai";5;100;0
296;0;"kauan";296;100;0
0;11;"kaui";11;0;100
0;204;"kaula";204;0;100
132;6;"kaulana";138;95.6521739130435;4.34782608695652
32;0;"kaulder";32;100;0
83;0;"kaulin";83;100;0
5;0;"kauner";5;100;0
7;0;"kaung";7;100;0
16;82;"kauri";98;16.3265306122449;83.6734693877551
0;9;"kausar";9;0;100
0;5;"kausha";5;0;100
113;0;"kaushal";113;100;0
229;0;"kaushik";229;100;0
6;0;"kaustav";6;100;0
30;0;"kaustubh";30;100;0
0;10;"kava";10;0;100
6;0;"kavalli";6;100;0
765;0;"kavan";765;100;0
5;0;"kavanaugh";5;100;0
12;0;"kavante";12;100;0
128;0;"kavari";128;100;0
21;0;"kavarion";21;100;0
12;0;"kavaris";12;100;0
87;0;"kavaughn";87;100;0
0;5;"kavayah";5;0;100
0;33;"kaveah";33;0;100
5;0;"kaveen";5;100;0
6;0;"kaveer";6;100;0
5;0;"kaveesh";5;100;0
326;0;"kaveh";326;100;0
25;0;"kaveion";25;100;0
26;0;"kavell";26;100;0
732;0;"kaven";732;100;0
318;0;"kaveon";318;100;0
0;5;"kaveona";5;0;100
0;62;"kaveri";62;0;100
533;5;"kavi";538;99.0706319702602;0.929368029739777
0;28;"kavia";28;0;100
105;0;"kavian";105;100;0
40;0;"kavien";40;100;0
24;0;"kavik";24;100;0
19;0;"kavika";19;100;0
2560;0;"kavin";2560;100;0
0;76;"kavina";76;0;100
1002;0;"kavion";1002;100;0
0;5;"kaviona";5;0;100
33;0;"kavious";33;100;0
44;0;"kavir";44;100;0
13;0;"kavis";13;100;0
176;0;"kavish";176;100;0
0;6;"kavisha";6;0;100
0;769;"kavita";769;0;100
0;115;"kavitha";115;0;100
0;15;"kaviya";15;0;100
5;0;"kaviyon";5;100;0
0;5;"kavleen";5;0;100
2429;41;"kavon";2470;98.3400809716599;1.65991902834008
0;12;"kavona";12;0;100
0;6;"kavonda";6;0;100
10;0;"kavone";10;100;0
0;35;"kavonna";35;0;100
13;0;"kavonta";13;100;0
69;0;"kavontae";69;100;0
218;0;"kavonte";218;100;0
5;0;"kavy";5;100;0
6;1430;"kavya";1436;0.417827298050139;99.5821727019499
25;0;"kavyn";25;100;0
21;0;"kaw";21;100;0
25;5;"kawai";30;83.3333333333333;16.6666666666667
0;30;"kawaii";30;0;100
0;22;"kawailani";22;0;100
5;0;"kawaiola";5;100;0
513;15;"kawan";528;97.1590909090909;2.84090909090909
0;960;"kawana";960;0;100
0;423;"kawanda";423;0;100
0;22;"kawanis";22;0;100
0;551;"kawanna";551;0;100
0;48;"kawanza";48;0;100
37;0;"kawaski";37;100;0
17;0;"kawaun";17;100;0
5;0;"kawayne";5;100;0
0;78;"kawehi";78;0;100
10;116;"kawena";126;7.93650793650794;92.0634920634921
86;0;"kawhi";86;100;0
1060;0;"kawika";1060;100;0
27;0;"kawliga";27;100;0
159;0;"kawon";159;100;0
0;5;"kawona";5;0;100
0;10;"kawonna";10;0;100
0;21;"kawsar";21;0;100
0;11;"kawtar";11;0;100
0;146;"kawthar";146;0;100
0;26;"kawther";26;0;100
6;0;"kawuan";6;100;0
3810;98043;"kay";101853;3.74068510500427;96.2593148949957
523;8031;"kaya";8554;6.11409866729016;93.8859013327098
46;0;"kayaan";46;100;0
0;361;"kayah";361;0;100
0;6;"kayahna";6;0;100
0;81;"kayal";81;0;100
0;23;"kayala";23;0;100
159;12;"kayan";171;92.9824561403509;7.01754385964912
0;911;"kayana";911;0;100
0;102;"kayani";102;0;100
0;217;"kayann";217;0;100
0;926;"kayanna";926;0;100
0;5;"kayannah";5;0;100
0;23;"kayanne";23;0;100
0;13;"kayatana";13;0;100
0;5;"kaybre";5;0;100
0;247;"kaybree";247;0;100
0;32;"kaybri";32;0;100
0;40;"kaybrie";40;0;100
177;2773;"kayce";2950;6;94
240;7122;"kaycee";7362;3.2599837000815;96.7400162999185
341;32;"kaycen";373;91.4209115281501;8.57908847184987
104;0;"kayceon";104;100;0
0;16;"kaycey";16;0;100
0;1407;"kayci";1407;0;100
0;20;"kaycia";20;0;100
0;2120;"kaycie";2120;0;100
13;0;"kaycin";13;100;0
5;0;"kaycion";5;100;0
131;0;"kayd";131;100;0
0;331;"kayda";331;0;100
485;134;"kaydan";619;78.3521809369952;21.6478190630048
0;1414;"kaydance";1414;0;100
255;317;"kayde";572;44.5804195804196;55.4195804195804
0;2154;"kaydee";2154;0;100
42045;7121;"kayden";49166;85.5164137818818;14.4835862181182
384;14157;"kaydence";14541;2.64080874767898;97.359191252321
104;0;"kaydenn";104;100;0
0;5;"kaydens";5;0;100
0;68;"kaydense";68;0;100
0;11;"kaydenze";11;0;100
0;288;"kaydi";288;0;100
0;5;"kaydia";5;0;100
6;0;"kaydian";6;100;0
0;132;"kaydie";132;0;100
19;0;"kaydien";19;100;0
0;31;"kaydience";31;0;100
1036;514;"kaydin";1550;66.8387096774193;33.1612903225806
0;328;"kaydince";328;0;100
199;59;"kaydn";258;77.1317829457364;22.8682170542636
0;5;"kaydnce";5;0;100
1034;80;"kaydon";1114;92.818671454219;7.18132854578097
0;132;"kaydra";132;0;100
0;21;"kaydree";21;0;100
10;0;"kaydren";10;100;0
17;0;"kaydrian";17;100;0
0;6;"kaydrie";6;0;100
221;206;"kaydyn";427;51.7564402810305;48.2435597189695
0;120;"kaydynce";120;0;100
6;5;"kaydynn";11;54.5454545454545;45.4545454545455
503;13094;"kaye";13597;3.69934544384791;96.3006545561521
17;0;"kayeden";17;100;0
0;18;"kayedence";18;0;100
6;0;"kayedon";6;100;0
18;0;"kayel";18;100;0
0;350;"kayela";350;0;100
0;55;"kayelani";55;0;100
0;337;"kayelee";337;0;100
0;60;"kayeleigh";60;0;100
0;47;"kayelin";47;0;100
0;11;"kayella";11;0;100
0;5;"kayelle";5;0;100
0;22;"kayeloni";22;0;100
0;283;"kayelyn";283;0;100
0;318;"kayelynn";318;0;100
57;5;"kayen";62;91.9354838709677;8.06451612903226
0;6;"kayenat";6;0;100
0;11;"kayenne";11;0;100
0;10;"kayesha";10;0;100
0;5;"kayetta";5;0;100
0;14;"kaygan";14;0;100
12;0;"kayge";12;100;0
12;12;"kaygen";24;50;50
39;0;"kayhan";39;100;0
0;31;"kayhla";31;0;100
0;128;"kayia";128;0;100
462;67;"kayin";529;87.3345935727788;12.6654064272212
0;6;"kayisha";6;0;100
0;37;"kayja";37;0;100
0;17;"kayjah";17;0;100
5;0;"kayjuan";5;100;0
11;0;"kayke";11;100;0
6;0;"kayky";6;100;0
199;24;"kayl";223;89.237668161435;10.762331838565
565;334371;"kayla";334936;0.168688943559367;99.8313110564406
0;35;"kaylaa";35;0;100
0;173;"kaylaann";173;0;100
0;6;"kaylaanne";6;0;100
5;0;"kaylab";5;100;0
0;6;"kaylae";6;0;100
0;6003;"kaylah";6003;0;100
0;14;"kaylahni";14;0;100
0;5;"kaylalynn";5;0;100
0;5;"kaylamae";5;0;100
0;334;"kaylamarie";334;0;100
651;4227;"kaylan";4878;13.3456334563346;86.6543665436654
0;506;"kaylana";506;0;100
18;57;"kayland";75;24;76
0;21;"kaylanee";21;0;100
0;2532;"kaylani";2532;0;100
0;16;"kaylanicole";16;0;100
0;293;"kaylanie";293;0;100
0;15;"kaylanii";15;0;100
0;30;"kaylann";30;0;100
0;37;"kaylanna";37;0;100
0;5;"kaylanne";5;0;100
0;67;"kaylanni";67;0;100
0;10;"kaylannie";10;0;100
0;41;"kaylany";41;0;100
0;10;"kaylar";10;0;100
0;5;"kaylarae";5;0;100
0;6;"kaylauni";6;0;100
626;3833;"kayle";4459;14.0390222022875;85.9609777977125
0;2944;"kaylea";2944;0;100
0;527;"kayleah";527;0;100
0;92;"kaylean";92;0;100
0;110;"kayleana";110;0;100
0;77;"kayleann";77;0;100
0;74;"kayleanna";74;0;100
1961;0;"kayleb";1961;100;0
175;120919;"kaylee";121094;0.144515830676995;99.855484169323
0;14;"kayleeana";14;0;100
0;217;"kayleeann";217;0;100
0;14;"kayleeanna";14;0;100
0;14;"kayleeanne";14;0;100
0;5;"kayleeh";5;0;100
0;12;"kayleejo";12;0;100
0;5;"kayleemae";5;0;100
0;12;"kayleemarie";12;0;100
0;6907;"kayleen";6907;0;100
0;338;"kayleena";338;0;100
0;5;"kayleene";5;0;100
0;10;"kayleeonna";10;0;100
0;5;"kayleh";5;0;100
0;1812;"kaylei";1812;0;100
7;29114;"kayleigh";29121;0.0240376360701899;99.9759623639298
0;34;"kayleigha";34;0;100
0;22;"kayleighann";22;0;100
88;0;"kaylem";88;100;0
983;6293;"kaylen";7276;13.5101704233095;86.4898295766905
0;517;"kaylena";517;0;100
0;4627;"kaylene";4627;0;100
0;111;"kaylenn";111;0;100
107;123;"kayler";230;46.5217391304348;53.4782608695652
0;6;"kaylese";6;0;100
0;7953;"kayley";7953;0;100
0;6603;"kayli";6603;0;100
0;707;"kaylia";707;0;100
0;167;"kayliah";167;0;100
0;5;"kaylian";5;0;100
0;683;"kayliana";683;0;100
0;39;"kayliani";39;0;100
0;39;"kayliann";39;0;100
0;235;"kaylianna";235;0;100
0;5;"kaylianne";5;0;100
120;0;"kaylib";120;100;0
0;19720;"kaylie";19720;0;100
0;10;"kaylieann";10;0;100
0;50;"kayliee";50;0;100
0;358;"kayliegh";358;0;100
0;5;"kaylien";5;0;100
0;24;"kaylii";24;0;100
529;17409;"kaylin";17938;2.94904671646783;97.0509532835322
0;321;"kaylina";321;0;100
0;16;"kaylinda";16;0;100
0;124;"kayline";124;0;100
0;525;"kaylinn";525;0;100
0;13;"kaylis";13;0;100
0;11;"kaylisa";11;0;100
0;56;"kaylise";56;0;100
0;6;"kaylisha";6;0;100
0;39;"kaylissa";39;0;100
0;5;"kaylix";5;0;100
0;30;"kayliyah";30;0;100
0;192;"kaylla";192;0;100
0;5;"kaylle";5;0;100
0;6;"kayllie";6;0;100
0;518;"kayln";518;0;100
0;37;"kaylnn";37;0;100
10;0;"kaylo";10;100;0
309;0;"kaylob";309;100;0
1112;650;"kaylon";1762;63.1101021566402;36.8898978433598
0;337;"kayloni";337;0;100
0;30;"kaylonie";30;0;100
0;13;"kaylonni";13;0;100
0;25;"kaylonnie";25;0;100
334;572;"kaylor";906;36.8653421633554;63.1346578366446
179;0;"kaylub";179;100;0
88;0;"kaylum";88;100;0
21;0;"kaylup";21;100;0
0;416;"kayly";416;0;100
32;11244;"kaylyn";11276;0.283788577509755;99.7162114224902
0;72;"kaylyne";72;0;100
5;10482;"kaylynn";10487;0.0476780776199104;99.9523219223801
0;578;"kaylynne";578;0;100
137;21;"kayman";158;86.7088607594937;13.2911392405063
0;15;"kaymani";15;0;100
0;56;"kaymarie";56;0;100
0;5;"kayme";5;0;100
174;13;"kaymen";187;93.048128342246;6.95187165775401
0;5;"kaymi";5;0;100
0;5;"kaymiah";5;0;100
0;6;"kaymie";6;0;100
0;9;"kaymin";9;0;100
72;0;"kaymon";72;100;0
0;5;"kaymoni";5;0;100
97;0;"kayn";97;100;0
0;222;"kayna";222;0;100
66;0;"kaynan";66;100;0
1709;15;"kayne";1724;99.1299303944316;0.870069605568445
187;0;"kaynen";187;100;0
13;0;"kaynin";13;100;0
32;0;"kaynon";32;100;0
183;5;"kayo";188;97.3404255319149;2.65957446808511
143;0;"kayode";143;100;0
0;5;"kayoko";5;0;100
258;6;"kayon";264;97.7272727272727;2.27272727272727
0;286;"kayona";286;0;100
0;5;"kayoni";5;0;100
0;5;"kayonia";5;0;100
0;456;"kayonna";456;0;100
0;32;"kayori";32;0;100
5;552;"kayra";557;0.897666068222621;99.1023339317774
0;6;"kayrah";6;0;100
0;85;"kayren";85;0;100
0;26;"kayrene";26;0;100
0;24;"kayri";24;0;100
11;0;"kayro";11;100;0
233;66;"kayron";299;77.9264214046823;22.0735785953177
0;70;"kaysa";70;0;100
5;0;"kaysaan";5;100;0
164;0;"kaysan";164;100;0
18;0;"kaysar";18;100;0
5;0;"kaysaun";5;100;0
23;424;"kayse";447;5.14541387024608;94.8545861297539
0;134;"kaysea";134;0;100
58;0;"kaysean";58;100;0
0;360;"kaysee";360;0;100
2030;285;"kaysen";2315;87.6889848812095;12.3110151187905
15;0;"kayser";15;100;0
0;143;"kaysey";143;0;100
0;1201;"kaysha";1201;0;100
90;0;"kayshaun";90;100;0
369;0;"kayshawn";369;100;0
0;42;"kayshia";42;0;100
0;57;"kayshla";57;0;100
15;0;"kayshon";15;100;0
0;508;"kaysi";508;0;100
0;171;"kaysia";171;0;100
0;1130;"kaysie";1130;0;100
142;5;"kaysin";147;96.5986394557823;3.40136054421769
0;48;"kayslee";48;0;100
0;7;"kaysleigh";7;0;100
0;5;"kaysley";5;0;100
0;5;"kayslie";5;0;100
10;0;"kaysn";10;100;0
4894;180;"kayson";5074;96.4525029562475;3.54749704375246
27;0;"kaysten";27;100;0
50;0;"kayston";50;100;0
15;0;"kaysun";15;100;0
6;0;"kaysyn";6;100;0
0;5;"kayta";5;0;100
0;501;"kayte";501;0;100
0;388;"kaytee";388;0;100
0;80;"kaytelyn";80;0;100
0;86;"kaytelynn";86;0;100
0;26;"kayten";26;0;100
0;253;"kayti";253;0;100
0;592;"kaytie";592;0;100
0;25;"kaytin";25;0;100
0;87;"kaytlan";87;0;100
0;206;"kaytlen";206;0;100
0;3224;"kaytlin";3224;0;100
0;22;"kaytlinn";22;0;100
0;2593;"kaytlyn";2593;0;100
0;5;"kaytlyne";5;0;100
0;1256;"kaytlynn";1256;0;100
0;64;"kaytlynne";64;0;100
5;0;"kayto";5;100;0
103;149;"kayton";252;40.8730158730159;59.1269841269841
101;0;"kayvan";101;100;0
134;0;"kayven";134;100;0
128;0;"kayveon";128;100;0
7;0;"kayvien";7;100;0
27;0;"kayvin";27;100;0
262;0;"kayvion";262;100;0
1004;0;"kayvon";1004;100;0
0;5;"kayvonna";5;0;100
0;5;"kaywin";5;0;100
54;0;"kayzen";54;100;0
0;12;"kayzia";12;0;100
0;112;"kayzlee";112;0;100
0;16;"kayzlie";16;0;100
0;7;"kayzlyn";7;0;100
394;0;"kaz";394;100;0
0;290;"kazandra";290;0;100
0;60;"kazaria";60;0;100
0;17;"kazariah";17;0;100
47;0;"kazden";47;100;0
8;0;"kaze";8;100;0
36;0;"kazeem";36;100;0
49;0;"kazen";49;100;0
248;75;"kazi";323;76.7801857585139;23.2198142414861
0;317;"kazia";317;0;100
17;335;"kaziah";352;4.82954545454545;95.1704545454545
5;0;"kazier";5;100;0
101;0;"kazim";101;100;0
23;0;"kazimer";23;100;0
0;11;"kazimiera";11;0;100
54;0;"kazimierz";54;100;0
126;0;"kazimir";126;100;0
5;0;"kazir";5;100;0
0;45;"kaziya";45;0;100
0;138;"kaziyah";138;0;100
0;38;"kazlyn";38;0;100
0;20;"kazlynn";20;0;100
17;0;"kazmer";17;100;0
0;5;"kazmiera";5;0;100
52;0;"kazmir";52;100;0
0;26;"kazmira";26;0;100
0;63;"kazoua";63;0;100
5;5;"kazu";10;50;50
0;216;"kazue";216;0;100
11;0;"kazuhiro";11;100;0
336;0;"kazuki";336;100;0
0;398;"kazuko";398;0;100
171;0;"kazuma";171;100;0
111;22;"kazumi";133;83.4586466165414;16.5413533834586
757;0;"kazuo";757;100;0
67;0;"kazuto";67;100;0
48;0;"kazuya";48;100;0
0;18;"kazuye";18;0;100
0;11;"kazuyo";11;0;100
16;0;"kazuyoshi";16;100;0
10;0;"kazuyuki";10;100;0
11;0;"kazz";11;100;0
0;65;"kazzandra";65;0;100
1762;791;"kc";2553;69.0168429298864;30.9831570701136
0;5;"kcee";5;0;100
5;0;"kceon";5;100;0
24;0;"kci";24;100;0
0;35;"kd";35;0;100
186;0;"kden";186;100;0
0;15;"kdence";15;0;100
5;0;"kdrian";5;100;0
58;0;"kdyn";58;100;0
0;25;"kdynce";25;0;100
6;0;"kdynn";6;100;0
25;0;"ke";25;100;0
0;637;"kea";637;0;100
0;6;"keacha";6;0;100
95;0;"keaden";95;100;0
11;0;"keadon";11;100;0
0;10;"keadra";10;0;100
5;0;"keadrian";5;100;0
5;0;"keadyn";5;100;0
7374;1406;"keagan";8780;83.9863325740319;16.0136674259681
946;22;"keagen";968;97.7272727272727;2.27272727272727
268;88;"keaghan";356;75.2808988764045;24.7191011235955
0;7;"keaghlan";7;0;100
31;0;"keagin";31;100;0
201;0;"keagon";201;100;0
11;11;"keagyn";22;50;50
0;138;"keah";138;0;100
213;20;"keahi";233;91.4163090128755;8.58369098712446
0;14;"keahna";14;0;100
40;0;"keair";40;100;0
0;1805;"keaira";1805;0;100
0;56;"keairah";56;0;100
10;15;"keaire";25;40;60
0;408;"keairra";408;0;100
0;16;"keaisa";16;0;100
0;66;"keaisha";66;0;100
0;72;"keaja";72;0;100
0;88;"keajah";88;0;100
0;5;"keajia";5;0;100
46;0;"keaka";46;100;0
22;741;"keala";763;2.88335517693316;97.1166448230668
277;0;"kealan";277;100;0
0;5;"kealana";5;0;100
0;428;"kealani";428;0;100
0;55;"kealee";55;0;100
0;12;"kealeigh";12;0;100
17;0;"kealen";17;100;0
0;375;"kealey";375;0;100
0;65;"keali";65;0;100
0;34;"kealia";34;0;100
0;83;"kealie";83;0;100
206;0;"kealii";206;100;0
18;0;"kealin";18;100;0
0;5;"keally";5;0;100
32;36;"kealoha";68;47.0588235294118;52.9411764705882
0;5;"kealohi";5;0;100
0;88;"kealohilani";88;0;100
26;0;"kealon";26;100;0
0;422;"kealy";422;0;100
0;45;"kealyn";45;0;100
0;11;"kealynn";11;0;100
0;130;"keamber";130;0;100
0;10;"keambra";10;0;100
0;27;"keambria";27;0;100
850;0;"kean";850;100;0
0;2553;"keana";2553;0;100
0;43;"keanah";43;0;100
561;0;"keanan";561;100;0
0;17;"keanda";17;0;100
10;1364;"keandra";1374;0.727802037845706;99.2721979621543
10;0;"keandrae";10;100;0
2642;9;"keandre";2651;99.6605054696341;0.3394945303659
0;322;"keandrea";322;0;100
0;147;"keandria";147;0;100
1300;0;"keane";1300;100;0
134;0;"keanen";134;100;0
5;0;"keangelo";5;100;0
30;413;"keani";443;6.77200902934537;93.2279909706546
0;10;"keann";10;0;100
0;3439;"keanna";3439;0;100
0;22;"keannah";22;0;100
0;22;"keanne";22;0;100
276;0;"keano";276;100;0
153;0;"keanon";153;100;0
20;0;"keantae";20;100;0
5;0;"keantay";5;100;0
208;13;"keante";221;94.1176470588235;5.88235294117647
188;0;"keanthony";188;100;0
4718;202;"keanu";4920;95.8943089430894;4.10569105691057
0;5;"keanua";5;0;100
0;15;"keanya";15;0;100
26;0;"keaon";26;100;0
0;4642;"keara";4642;0;100
0;202;"kearah";202;0;100
0;5;"kearea";5;0;100
0;151;"keari";151;0;100
0;286;"kearia";286;0;100
0;73;"kearie";73;0;100
5;0;"kearius";5;100;0
0;5;"kearn";5;0;100
275;52;"kearney";327;84.0978593272171;15.9021406727829
0;759;"kearra";759;0;100
0;22;"kearrah";22;0;100
0;10;"kearria";10;0;100
0;5;"kearson";5;0;100
0;5;"kearstan";5;0;100
0;530;"kearsten";530;0;100
0;726;"kearstin";726;0;100
6;423;"kearston";429;1.3986013986014;98.6013986013986
0;253;"kearstyn";253;0;100
580;104;"keary";684;84.7953216374269;15.2046783625731
0;705;"keasha";705;0;100
16;0;"keashawn";16;100;0
0;82;"keashia";82;0;100
0;1567;"keasia";1567;0;100
0;14;"keasiah";14;0;100
10;0;"keason";10;100;0
200;0;"keaston";200;100;0
0;5;"keasya";5;0;100
22;0;"keatan";22;100;0
342;5;"keaten";347;98.5590778097983;1.44092219020173
228;0;"keath";228;100;0
5;0;"keathan";5;100;0
0;28;"keather";28;0;100
75;0;"keatin";75;100;0
16;6;"keating";22;72.7272727272727;27.2727272727273
18669;1132;"keaton";19801;94.2831170142922;5.71688298570779
62;0;"keats";62;100;0
86;164;"keatyn";250;34.4;65.6
76;0;"keaun";76;100;0
0;342;"keauna";342;0;100
0;230;"keaundra";230;0;100
117;0;"keaundre";117;100;0
0;6;"keaundrea";6;0;100
0;13;"keaundria";13;0;100
0;67;"keaunna";67;0;100
18;0;"keaunte";18;100;0
0;15;"keaura";15;0;100
0;6;"keauri";6;0;100
0;17;"keausha";17;0;100
39;0;"keaven";39;100;0
41;0;"keavin";41;100;0
18;0;"keavion";18;100;0
77;0;"keavon";77;100;0
102;0;"keawe";102;100;0
0;29;"keayla";29;0;100
5;0;"keayon";5;100;0
0;72;"keayra";72;0;100
0;5;"keaysia";5;0;100
0;16;"keazia";16;0;100
5;0;"keb";5;100;0
0;36;"keba";36;0;100
42;0;"kebba";42;100;0
0;5;"kebbie";5;0;100
13;0;"keben";13;100;0
84;0;"kebin";84;100;0
0;77;"kebra";77;0;100
0;6;"kebria";6;0;100
0;99;"kebrina";99;0;100
47;11;"kebron";58;81.0344827586207;18.9655172413793
0;48;"kecha";48;0;100
0;6;"kechelle";6;0;100
0;154;"kechia";154;0;100
0;3146;"kecia";3146;0;100
49;0;"kedan";49;100;0
482;0;"kedar";482;100;0
5;0;"kedarian";5;100;0
6;0;"kedarious";6;100;0
205;0;"kedarius";205;100;0
35;0;"kedarrius";35;100;0
119;0;"keddrick";119;100;0
0;6;"kededra";6;0;100
14;0;"kedeem";14;100;0
42;0;"keden";42;100;0
18;0;"kederick";18;100;0
0;17;"kedesha";17;0;100
0;5;"kedeshia";5;0;100
0;8;"kedisha";8;0;100
0;548;"kedra";548;0;100
5;0;"kedran";5;100;0
15;0;"kedrian";15;100;0
906;0;"kedric";906;100;0
2075;0;"kedrick";2075;100;0
57;0;"kedrin";57;100;0
145;5;"kedron";150;96.6666666666667;3.33333333333333
12;0;"kedryn";12;100;0
33;0;"kedus";33;100;0
5;0;"keduse";5;100;0
22;0;"kedwin";22;100;0
0;18;"kedzie";18;0;100
1406;10;"kee";1416;99.2937853107345;0.706214689265537
0;10;"keeaira";10;0;100
343;0;"keean";343;100;0
0;180;"keeana";180;0;100
0;69;"keeanna";69;0;100
0;64;"keeara";64;0;100
0;17;"keeba";17;0;100
0;12;"keecha";12;0;100
0;5;"keedah";5;0;100
66;0;"keedan";66;100;0
20;0;"keeden";20;100;0
5;0;"keedon";5;100;0
0;26;"keedra";26;0;100
13;0;"keedyn";13;100;0
658;0;"keefe";658;100;0
303;0;"keefer";303;100;0
32602;3151;"keegan";35753;91.1867535591419;8.81324644085811
282;0;"keegen";282;100;0
331;78;"keeghan";409;80.9290953545232;19.0709046454768
32;0;"keegin";32;100;0
17;0;"keegon";17;100;0
6;0;"keegun";6;100;0
0;5;"keeisha";5;0;100
0;5;"keekee";5;0;100
0;1012;"keela";1012;0;100
0;28;"keelah";28;0;100
2825;309;"keelan";3134;90.1403956604978;9.85960433950223
54;0;"keeland";54;100;0
0;6;"keelani";6;0;100
0;14;"keele";14;0;100
0;448;"keelee";448;0;100
0;371;"keeleigh";371;0;100
157;0;"keelen";157;100;0
38;0;"keeler";38;100;0
49;5811;"keeley";5860;0.83617747440273;99.1638225255973
0;1133;"keeli";1133;0;100
0;162;"keelia";162;0;100
0;1377;"keelie";1377;0;100
281;989;"keelin";1270;22.1259842519685;77.8740157480315
88;0;"keelon";88;100;0
21;12019;"keely";12040;0.174418604651163;99.8255813953488
214;755;"keelyn";969;22.0846233230134;77.9153766769866
5;63;"keelynn";68;7.35294117647059;92.6470588235294
0;57;"keema";57;0;100
0;5;"keemia";5;0;100
7;0;"keemo";7;100;0
5;0;"keemon";5;100;0
0;5;"keemora";5;0;100
0;6;"keemya";6;0;100
122;0;"keen";122;100;0
141;2127;"keena";2268;6.21693121693122;93.7830687830688
16369;329;"keenan";16698;98.0297041561864;1.97029584381363
419;0;"keene";419;100;0
1133;0;"keenen";1133;100;0
5;0;"keener";5;100;0
6;0;"keeng";6;100;0
5;0;"keenin";5;100;0
6;0;"keeno";6;100;0
551;0;"keenon";551;100;0
0;280;"keenya";280;0;100
0;17;"keenyah";17;0;100
5;0;"keenyn";5;100;0
118;0;"keeon";118;100;0
0;27;"keeona";27;0;100
0;745;"keera";745;0;100
0;6;"keerah";6;0;100
48;0;"keeran";48;100;0
5;76;"keerat";81;6.17283950617284;93.8271604938272
0;40;"keerica";40;0;100
11;0;"keeron";11;100;0
0;11;"keerra";11;0;100
0;89;"keerstin";89;0;100
0;32;"keertana";32;0;100
5;0;"keerthan";5;100;0
0;311;"keerthana";311;0;100
0;221;"keerthi";221;0;100
0;25;"keerti";25;0;100
136;0;"kees";136;100;0
0;27;"keesa";27;0;100
15;0;"keesean";15;100;0
0;2699;"keesha";2699;0;100
0;5;"keeshan";5;0;100
38;0;"keeshaun";38;100;0
193;0;"keeshawn";193;100;0
0;68;"keeshia";68;0;100
26;0;"keeshon";26;100;0
5;0;"keeson";5;100;0
5;0;"keeston";5;100;0
0;56;"keeta";56;0;100
10;0;"keetan";10;100;0
5;0;"keethan";5;100;0
796;0;"keeton";796;100;0
0;11;"keetra";11;0;100
0;423;"keeva";423;0;100
159;0;"keevan";159;100;0
66;0;"keeven";66;100;0
592;0;"keevin";592;100;0
5;0;"keevis";5;100;0
251;0;"keevon";251;100;0
0;85;"keeya";85;0;100
48;0;"keeyan";48;100;0
0;32;"keeyana";32;0;100
83;0;"keeyon";83;100;0
5;0;"kefentse";5;100;0
7;0;"keffer";7;100;0
0;5;"kefira";5;0;100
15;0;"kefren";15;100;0
3604;231;"kegan";3835;93.9765319426336;6.02346805736636
83;0;"keghan";83;100;0
0;5;"kehara";5;0;100
0;306;"kehaulani";306;0;100
0;7;"kehila";7;0;100
147;86;"kehinde";233;63.0901287553648;36.9098712446352
0;368;"kehlani";368;0;100
0;10;"kehley";10;0;100
0;21;"kehly";21;0;100
466;168;"kei";634;73.5015772870662;26.4984227129338
0;597;"keia";597;0;100
0;5;"keiah";5;0;100
0;81;"keiaira";81;0;100
0;5;"keiairra";5;0;100
0;5;"keiaja";5;0;100
0;10;"keiajah";10;0;100
277;0;"keian";277;100;0
0;1359;"keiana";1359;0;100
0;125;"keiandra";125;0;100
105;0;"keiandre";105;100;0
0;24;"keiani";24;0;100
0;5;"keiann";5;0;100
0;985;"keianna";985;0;100
0;1480;"keiara";1480;0;100
0;105;"keiarah";105;0;100
0;10;"keiari";10;0;100
0;355;"keiarra";355;0;100
5;0;"keiarriyen";5;100;0
0;85;"keiasha";85;0;100
0;196;"keiasia";196;0;100
0;16;"keiauna";16;0;100
0;13;"keica";13;0;100
0;60;"keicha";60;0;100
0;5;"keichia";5;0;100
0;7;"keicy";7;0;100
0;5;"keida";5;0;100
62;0;"keidan";62;100;0
260;0;"keiden";260;100;0
0;14;"keidi";14;0;100
12;0;"keidon";12;100;0
0;372;"keidra";372;0;100
11;0;"keidren";11;100;0
126;0;"keidrick";126;100;0
0;290;"keidy";290;0;100
39;0;"keidyn";39;100;0
0;179;"keiera";179;0;100
0;61;"keierra";61;0;100
25;0;"keif";25;100;0
1123;0;"keifer";1123;100;0
164;0;"keiffer";164;100;0
768;108;"keigan";876;87.6712328767123;12.3287671232877
79;0;"keigen";79;100;0
127;20;"keighan";147;86.3945578231292;13.6054421768707
0;12;"keighla";12;0;100
0;168;"keighley";168;0;100
0;58;"keighly";58;0;100
10;0;"keighton";10;100;0
76;0;"keigo";76;100;0
0;6;"keijah";6;0;100
136;0;"keiji";136;100;0
6;0;"keijon";6;100;0
136;0;"keijuan";136;100;0
0;5;"keikilani";5;0;100
0;965;"keiko";965;0;100
317;0;"keil";317;100;0
0;6389;"keila";6389;0;100
0;1361;"keilah";1361;0;100
981;43;"keilan";1024;95.80078125;4.19921875
0;414;"keilana";414;0;100
95;0;"keiland";95;100;0
5;2080;"keilani";2085;0.239808153477218;99.7601918465228
0;17;"keilanie";17;0;100
0;213;"keilany";213;0;100
0;10;"keile";10;0;100
12;0;"keileb";12;100;0
0;429;"keilee";429;0;100
0;20;"keileen";20;0;100
0;29;"keilei";29;0;100
0;204;"keileigh";204;0;100
195;31;"keilen";226;86.283185840708;13.716814159292
46;0;"keiler";46;100;0
0;468;"keiley";468;0;100
0;394;"keili";394;0;100
0;5;"keilia";5;0;100
0;5;"keiliana";5;0;100
0;11;"keiliany";11;0;100
0;20;"keilianys";20;0;100
0;25;"keilie";25;0;100
51;137;"keilin";188;27.1276595744681;72.8723404255319
0;480;"keilly";480;0;100
210;0;"keilon";210;100;0
0;2955;"keily";2955;0;100
179;810;"keilyn";989;18.0990899898888;81.9009100101112
0;98;"keilynn";98;0;100
34;115;"keimani";149;22.8187919463087;77.1812080536913
10;0;"keimar";10;100;0
0;7;"keimara";7;0;100
55;24;"keimari";79;69.620253164557;30.379746835443
51;0;"keimarion";51;100;0
0;6;"keimaya";6;0;100
0;11;"keimiyah";11;0;100
131;0;"keimon";131;100;0
30;24;"keimoni";54;55.5555555555556;44.4444444444444
0;105;"keimora";105;0;100
0;5;"keimy";5;0;100
0;117;"keimya";117;0;100
0;19;"keimyah";19;0;100
84;0;"kein";84;100;0
0;122;"keina";122;0;100
150;0;"keinan";150;100;0
5;0;"keiner";5;100;0
12;0;"keing";12;100;0
89;0;"keino";89;100;0
0;6;"keinya";6;0;100
2426;10;"keion";2436;99.5894909688013;0.410509031198686
0;869;"keiona";869;0;100
0;128;"keiondra";128;0;100
122;0;"keiondre";122;100;0
0;641;"keionna";641;0;100
55;0;"keiontae";55;100;0
5;0;"keiontay";5;100;0
74;0;"keionte";74;100;0
0;10;"keiora";10;0;100
0;224;"keiosha";224;0;100
930;64;"keir";994;93.5613682092555;6.43863179074447
7;27667;"keira";27674;0.025294500252945;99.974705499747
0;360;"keirah";360;0;100
0;5;"keiralee";5;0;100
0;6;"keiralyn";6;0;100
834;143;"keiran";977;85.3633572159673;14.6366427840328
51;5;"keiren";56;91.0714285714286;8.92857142857143
0;176;"keiri";176;0;100
0;5;"keirin";5;0;100
20;0;"keirnan";20;100;0
409;0;"keiron";409;100;0
0;1410;"keirra";1410;0;100
0;28;"keirrah";28;0;100
0;5;"keirslyn";5;0;100
0;118;"keirstan";118;0;100
0;1348;"keirsten";1348;0;100
0;541;"keirstin";541;0;100
0;156;"keirston";156;0;100
0;364;"keirstyn";364;0;100
0;1433;"keiry";1433;0;100
0;5;"keirya";5;0;100
0;47;"keiryn";47;0;100
0;391;"keisa";391;0;100
0;5;"keischa";5;0;100
175;0;"keisean";175;100;0
5;0;"keisel";5;100;0
18;0;"keiser";18;100;0
0;10;"keisey";10;0;100
0;11;"keish";11;0;100
44;21833;"keisha";21877;0.201124468620012;99.79887553138
0;76;"keishana";76;0;100
0;5;"keishanda";5;0;100
0;20;"keishanna";20;0;100
0;19;"keishara";19;0;100
352;0;"keishaun";352;100;0
0;38;"keishauna";38;0;100
708;63;"keishawn";771;91.8287937743191;8.17120622568093
0;81;"keishawna";81;0;100
0;11;"keisher";11;0;100
10;0;"keishi";10;100;0
0;258;"keishia";258;0;100
0;323;"keishla";323;0;100
250;0;"keishon";250;100;0
0;22;"keishona";22;0;100
0;12;"keishonna";12;0;100
35;0;"keishun";35;100;0
0;173;"keisi";173;0;100
108;0;"keison";108;100;0
0;7;"keissy";7;0;100
110;0;"keiston";110;100;0
148;0;"keisuke";148;100;0
0;405;"keisy";405;0;100
435;189;"keita";624;69.7115384615385;30.2884615384615
35;0;"keitaro";35;100;0
6;0;"keiten";6;100;0
433804;2216;"keith";436020;99.4917664327324;0.508233567267557
0;1449;"keitha";1449;0;100
689;0;"keithan";689;100;0
531;0;"keithen";531;100;0
5;0;"keither";5;100;0
5;0;"keithin";5;100;0
178;0;"keithon";178;100;0
18;0;"keithrick";18;100;0
0;30;"keitlyn";30;0;100
5;0;"keito";5;100;0
258;0;"keiton";258;100;0
0;93;"keitra";93;0;100
5;0;"keitric";5;100;0
5;0;"keitrick";5;100;0
0;11;"keity";11;0;100
0;5;"keiuna";5;0;100
0;6;"keiundra";6;0;100
0;64;"keiva";64;0;100
55;0;"keivan";55;100;0
37;0;"keiven";37;100;0
6;0;"keiveon";6;100;0
19;0;"keivin";19;100;0
5;0;"keivn";5;100;0
440;0;"keivon";440;100;0
8;0;"keivonte";8;100;0
25;0;"keiwan";25;100;0
10;0;"keiwon";10;100;0
0;42;"keiya";42;0;100
0;149;"keiyana";149;0;100
0;48;"keiyanna";48;0;100
0;6;"keiyara";6;0;100
132;0;"keiyon";132;100;0
0;5;"keiyona";5;0;100
0;29;"keiyonna";29;0;100
12;0;"keizer";12;100;0
0;57;"keja";57;0;100
15;0;"kejaun";15;100;0
5;0;"kejohn";5;100;0
64;0;"kejon";64;100;0
1544;0;"kejuan";1544;100;0
0;35;"kejuana";35;0;100
68;0;"kekai";68;100;0
0;10;"keke";10;0;100
5;23;"kekeli";28;17.8571428571429;82.1428571428571
1493;22;"kekoa";1515;98.5478547854785;1.45214521452145
196;0;"kel";196;100;0
0;899;"kela";899;0;100
5;0;"kelab";5;100;0
0;24;"kelah";24;0;100
0;12;"kelahni";12;0;100
0;23;"kelaia";23;0;100
0;183;"kelaiah";183;0;100
0;6;"kelaine";6;0;100
1578;0;"kelan";1578;100;0
0;41;"kelana";41;0;100
152;0;"keland";152;100;0
28;439;"kelani";467;5.99571734475375;94.0042826552463
0;26;"kelanie";26;0;100
0;10;"kelany";10;0;100
0;21;"kelaya";21;0;100
0;9;"kelayah";9;0;100
0;5;"kelbe";5;0;100
0;258;"kelbi";258;0;100
0;235;"kelbie";235;0;100
3804;1421;"kelby";5225;72.8038277511962;27.1961722488038
0;30;"kelce";30;0;100
0;7;"kelcea";7;0;100
0;704;"kelcee";704;0;100
0;5;"kelcei";5;0;100
692;2074;"kelcey";2766;25.0180766449747;74.9819233550253
0;2326;"kelci";2326;0;100
37;3146;"kelcie";3183;1.16242538485705;98.8375746151429
77;931;"kelcy";1008;7.63888888888889;92.3611111111111
0;209;"kelda";209;0;100
86;0;"keldan";86;100;0
206;0;"kelden";206;100;0
10;0;"keldin";10;100;0
531;0;"keldon";531;100;0
152;0;"keldric";152;100;0
760;0;"keldrick";760;100;0
5;0;"keldrin";5;100;0
8;0;"keldyn";8;100;0
89;75;"kele";164;54.2682926829268;45.7317073170732
0;21;"kelea";21;0;100
0;45;"keleah";45;0;100
472;230;"kelechi";702;67.2364672364672;32.7635327635328
6;0;"kelechukwu";6;100;0
0;5;"kelecia";5;0;100
0;317;"kelee";317;0;100
0;11;"keleen";11;0;100
0;6;"kelei";6;0;100
0;747;"keleigh";747;0;100
0;6;"kelela";6;0;100
179;25;"kelen";204;87.7450980392157;12.2549019607843
0;61;"kelena";61;0;100
0;44;"kelene";44;0;100
0;7;"keleni";7;0;100
0;5;"kelesha";5;0;100
0;22;"keley";22;0;100
49;4320;"keli";4369;1.12153810940719;98.8784618905928
0;893;"kelia";893;0;100
0;127;"keliah";127;0;100
25;0;"kelian";25;100;0
0;42;"keliana";42;0;100
0;5;"keliann";5;0;100
0;6;"kelianne";6;0;100
0;100;"kelicia";100;0;100
0;273;"kelie";273;0;100
250;0;"kelii";250;100;0
107;12;"kelijah";119;89.9159663865546;10.0840336134454
5;0;"kelik";5;100;0
0;28;"kelila";28;0;100
0;84;"kelilah";84;0;100
449;316;"kelin";765;58.6928104575163;41.3071895424837
0;184;"kelina";184;0;100
0;23;"kelinda";23;0;100
6;2320;"kelis";2326;0.257953568357696;99.7420464316423
0;25;"kelisa";25;0;100
0;506;"kelise";506;0;100
0;405;"kelisha";405;0;100
0;10;"kelisia";10;0;100
0;74;"kelissa";74;0;100
0;131;"kelita";131;0;100
0;184;"keliyah";184;0;100
229;0;"kell";229;100;0
0;392;"kella";392;0;100
30;0;"kellam";30;100;0
7826;451;"kellan";8277;94.551165881358;5.44883411864202
6;0;"kelland";6;100;0
88;0;"kellar";88;100;0
43;2302;"kelle";2345;1.83368869936034;98.1663113006397
0;35;"kellea";35;0;100
16;3703;"kellee";3719;0.43022317827373;99.5697768217263
0;653;"kelleen";653;0;100
0;5;"kellei";5;0;100
0;424;"kelleigh";424;0;100
14430;1177;"kellen";15607;92.4585122060614;7.54148779393862
0;425;"kellene";425;0;100
2775;315;"keller";3090;89.8058252427185;10.1941747572816
6092;45911;"kelley";52003;11.7147087668019;88.2852912331981
0;5;"kelleyann";5;0;100
0;16;"kelleye";16;0;100
300;74644;"kelli";74944;0.400298889837745;99.5997011101623
0;12;"kellia";12;0;100
6;15;"kellian";21;28.5714285714286;71.4285714285714
0;665;"kelliann";665;0;100
0;723;"kellianne";723;0;100
354;50525;"kellie";50879;0.695768391674365;99.3042316083256
0;48;"kellieann";48;0;100
0;45;"kellijo";45;0;100
694;89;"kellin";783;88.6334610472541;11.3665389527459
0;114;"kellina";114;0;100
0;6;"kelline";6;0;100
111;99;"kellis";210;52.8571428571429;47.1428571428571
0;5;"kellisa";5;0;100
0;10;"kellise";10;0;100
0;33;"kellisha";33;0;100
0;5;"kellissa";5;0;100
5;0;"kellogg";5;100;0
298;0;"kellon";298;100;0
0;13;"kellsea";13;0;100
0;434;"kellsey";434;0;100
0;18;"kellsi";18;0;100
0;521;"kellsie";521;0;100
0;14;"kellsy";14;0;100
42;0;"kellum";42;100;0
81178;470523;"kelly";551701;14.714129573809;85.285870426191
0;1813;"kellyann";1813;0;100
0;8;"kellyanna";8;0;100
0;567;"kellyanne";567;0;100
0;2347;"kellye";2347;0;100
0;13;"kellyjean";13;0;100
0;196;"kellyjo";196;0;100
0;10;"kellylynn";10;0;100
0;30;"kellymarie";30;0;100
154;1824;"kellyn";1978;7.78564206268959;92.2143579373104
0;15;"kellynn";15;0;100
5;0;"kelman";5;100;0
5;0;"kelmer";5;100;0
305;0;"kelon";305;100;0
0;160;"kelsa";160;0;100
0;223;"kelsay";223;0;100
0;91;"kelse";91;0;100
5;5510;"kelsea";5515;0.0906618313689937;99.909338168631
0;1686;"kelsee";1686;0;100
0;282;"kelsei";282;0;100
0;73;"kelseigh";73;0;100
94;0;"kelsen";94;100;0
5182;145451;"kelsey";150633;3.440149236887;96.559850763113
0;30;"kelseyann";30;0;100
0;5;"kelseyanne";5;0;100
0;139;"kelsha";139;0;100
0;9561;"kelsi";9561;0;100
0;17;"kelsia";17;0;100
345;18482;"kelsie";18827;1.83247463748871;98.1675253625113
238;0;"kelso";238;100;0
1131;0;"kelson";1131;100;0
40;0;"kelston";40;100;0
39;3036;"kelsy";3075;1.26829268292683;98.7317073170732
0;112;"kelsye";112;0;100
0;5;"kelsyn";5;0;100
5;0;"keltan";5;100;0
98;0;"kelten";98;100;0
0;66;"keltie";66;0;100
84;0;"keltin";84;100;0
5989;26;"kelton";6015;99.5677472984206;0.432252701579385
0;6;"keltsey";6;0;100
0;134;"kelty";134;0;100
23;0;"keltyn";23;100;0
6;0;"kelvan";6;100;0
113;0;"kelven";113;100;0
5;0;"kelveon";5;100;0
49213;304;"kelvin";49517;99.3860694307006;0.613930569299433
0;46;"kelvina";46;0;100
40;0;"kelvion";40;100;0
125;0;"kelvis";125;100;0
0;12;"kelvisha";12;0;100
313;0;"kelvon";313;100;0
11;0;"kelvontae";11;100;0
11;0;"kelvonte";11;100;0
5;0;"kelvy";5;100;0
227;0;"kelvyn";227;100;0
120;0;"kelwin";120;100;0
10;232;"kely";242;4.13223140495868;95.8677685950413
280;393;"kelyn";673;41.6047548291233;58.3952451708767
21;47;"kelynn";68;30.8823529411765;69.1176470588235
0;79;"kelyse";79;0;100
680;353;"kem";1033;65.8276863504356;34.1723136495644
0;185;"kema";185;0;100
5;0;"kemaj";5;100;0
274;0;"kemal";274;100;0
379;451;"kemani";830;45.6626506024096;54.3373493975904
0;5;"kemanie";5;0;100
478;0;"kemar";478;100;0
0;104;"kemara";104;0;100
0;8;"kemarah";8;0;100
7;0;"kemarcus";7;100;0
7;0;"kemare";7;100;0
16;0;"kemaree";16;100;0
17;0;"kemareon";17;100;0
1000;382;"kemari";1382;72.3589001447178;27.6410998552822
0;126;"kemaria";126;0;100
0;16;"kemariah";16;0;100
23;0;"kemarian";23;100;0
0;22;"kemarie";22;0;100
0;10;"kemarii";10;0;100
713;0;"kemarion";713;100;0
16;0;"kemarius";16;100;0
0;15;"kemariya";15;0;100
0;6;"kemariyah";6;0;100
5;0;"kemarley";5;100;0
27;0;"kemarri";27;100;0
52;0;"kemarrion";52;100;0
5;0;"kemarui";5;100;0
285;56;"kemauri";341;83.5777126099707;16.4222873900293
0;5;"kemauria";5;0;100
5;0;"kemaurie";5;100;0
26;0;"kemaurion";26;100;0
51;0;"kemaury";51;100;0
0;154;"kemaya";154;0;100
0;169;"kemba";169;0;100
0;169;"kember";169;0;100
0;39;"kemberley";39;0;100
0;6;"kemberli";6;0;100
0;1491;"kemberly";1491;0;100
0;5;"kemberlyn";5;0;100
0;6;"keme";6;0;100
0;5;"kemeisha";5;0;100
10;0;"kemel";10;100;0
0;21;"kemely";21;0;100
0;73;"kemesha";73;0;100
0;5;"kemeshia";5;0;100
71;6;"kemet";77;92.2077922077922;7.79220779220779
0;305;"kemi";305;0;100
0;87;"kemia";87;0;100
0;131;"kemiah";131;0;100
0;11;"kemilly";11;0;100
0;29;"kemily";29;0;100
0;19;"kemira";19;0;100
0;168;"kemisha";168;0;100
0;264;"kemiya";264;0;100
0;313;"kemiyah";313;0;100
0;6;"kemma";6;0;100
0;5;"kemmie";5;0;100
12;0;"kemmy";12;100;0
69;0;"kemo";69;100;0
479;0;"kemon";479;100;0
74;0;"kemond";74;100;0
13;0;"kemondre";13;100;0
5;0;"kemone";5;100;0
221;275;"kemoni";496;44.5564516129032;55.4435483870968
17;101;"kemonie";118;14.4067796610169;85.5932203389831
45;0;"kemonta";45;100;0
141;0;"kemontae";141;100;0
11;0;"kemontay";11;100;0
327;0;"kemonte";327;100;0
5;0;"kemontez";5;100;0
0;507;"kemora";507;0;100
0;47;"kemorah";47;0;100
9;5;"kemori";14;64.2857142857143;35.7142857142857
0;31;"kemoria";31;0;100
1199;0;"kemp";1199;100;0
1346;138;"kemper";1484;90.7008086253369;9.29919137466307
256;0;"kempton";256;100;0
5;0;"kemran";5;100;0
0;5;"kemry";5;0;100
389;0;"kemuel";389;100;0
0;530;"kemya";530;0;100
0;105;"kemyah";105;0;100
0;5;"kemyatta";5;0;100
0;47;"kemyia";47;0;100
0;15;"kemyiah";15;0;100
0;88;"kemyra";88;0;100
32581;25;"ken";32606;99.9233269950316;0.0766730049684107
16;1730;"kena";1746;0.916380297823597;99.0836197021764
21;0;"kenaan";21;100;0
0;1559;"kenadee";1559;0;100
0;5;"kenadey";5;0;100
0;1337;"kenadi";1337;0;100
0;1583;"kenadie";1583;0;100
0;526;"kenady";526;0;100
0;62;"kenae";62;0;100
0;8;"kenah";8;0;100
650;37;"kenai";687;94.6142649199418;5.38573508005822
0;5;"kenaja";5;0;100
0;5;"kenajah";5;0;100
0;5;"kenalee";5;0;100
3294;30;"kenan";3324;99.0974729241877;0.902527075812274
52;0;"kenaniah";52;100;0
0;11;"kenara";11;0;100
763;0;"kenard";763;100;0
0;6;"kenari";6;0;100
0;10;"kenaria";10;0;100
0;5;"kenasha";5;0;100
0;174;"kenasia";174;0;100
32;0;"kenay";32;100;0
0;42;"kenaya";42;0;100
0;5;"kenayah";5;0;100
102;0;"kenaz";102;100;0
0;12;"kenberly";12;0;100
5;22;"kency";27;18.5185185185185;81.4814814814815
0;2353;"kenda";2353;0;100
49;627;"kendahl";676;7.24852071005917;92.7514792899408
4400;8489;"kendal";12889;34.1376367445108;65.8623632554892
895;55;"kendale";950;94.2105263157895;5.78947368421053
33569;56631;"kendall";90200;37.2161862527716;62.7838137472284
0;15;"kendalle";15;0;100
0;166;"kendallyn";166;0;100
0;19;"kendallynn";19;0;100
0;784;"kendalyn";784;0;100
0;261;"kendalynn";261;0;100
213;0;"kendan";213;100;0
0;5;"kendar";5;0;100
5;0;"kendarion";5;100;0
213;0;"kendarious";213;100;0
934;0;"kendarius";934;100;0
131;0;"kendarrius";131;100;0
0;5;"kendasia";5;0;100
0;5;"kendayl";5;0;100
0;12;"kendee";12;0;100
770;790;"kendel";1560;49.3589743589744;50.6410256410256
4479;1818;"kendell";6297;71.1291090995712;28.8708909004288
5;191;"kendelle";196;2.55102040816327;97.4489795918367
0;10;"kendelyn";10;0;100
288;0;"kenden";288;100;0
16;0;"kender";16;100;0
0;5;"kendera";5;0;100
5;0;"kenderek";5;100;0
478;0;"kenderick";478;100;0
17;0;"kenderius";17;100;0
49;0;"kenderrick";49;100;0
0;528;"kendi";528;0;100
0;52;"kendia";52;0;100
13;0;"kendin";13;100;0
9;30;"kendis";39;23.0769230769231;76.9230769230769
0;16;"kendl";16;0;100
182;334;"kendle";516;35.2713178294574;64.7286821705426
0;5;"kendley";5;0;100
5;0;"kendly";5;100;0
6;0;"kendo";6;100;0
5;0;"kendol";5;100;0
753;0;"kendon";753;100;0
349;93975;"kendra";94324;0.370001272210678;99.6299987277893
11;0;"kendrae";11;100;0
0;426;"kendrah";426;0;100
0;10;"kendral";10;0;100
11;0;"kendrall";11;100;0
0;23;"kendralyn";23;0;100
0;17;"kendraya";17;0;100
249;64;"kendre";313;79.5527156549521;20.4472843450479
0;626;"kendrea";626;0;100
16;0;"kendred";16;100;0
0;5;"kendree";5;0;100
5;0;"kendrel";5;100;0
823;18;"kendrell";841;97.8596908442331;2.14030915576694
95;0;"kendrew";95;100;0
0;1041;"kendria";1041;0;100
0;22;"kendriana";22;0;100
0;28;"kendrianna";28;0;100
2121;0;"kendric";2121;100;0
0;5;"kendrica";5;0;100
16;0;"kendrich";16;100;0
27355;336;"kendrick";27691;98.7866093676646;1.21339063233542
0;34;"kendricka";34;0;100
82;0;"kendricks";82;100;0
0;10;"kendrie";10;0;100
18;0;"kendriel";18;100;0
279;0;"kendrik";279;100;0
0;6;"kendrika";6;0;100
464;29;"kendrix";493;94.1176470588235;5.88235294117647
5;0;"kendron";5;100;0
189;38;"kendry";227;83.2599118942731;16.7400881057269
0;5;"kendrya";5;0;100
64;0;"kendryck";64;100;0
30;0;"kendryk";30;100;0
5;0;"kendrys";5;100;0
10;0;"kendu";10;100;0
16;452;"kendy";468;3.41880341880342;96.5811965811966
109;4535;"kendyl";4644;2.34711455641688;97.6528854435831
0;39;"kendyle";39;0;100
19;1315;"kendyll";1334;1.42428785607196;98.575712143928
0;17;"kendylle";17;0;100
162;0;"kendyn";162;100;0
28;5;"kene";33;84.8484848484848;15.1515151515152
0;6;"keneasha";6;0;100
12;0;"kenechi";12;100;0
256;0;"kenechukwu";256;100;0
0;68;"kenecia";68;0;100
0;182;"kenedee";182;0;100
0;822;"kenedi";822;0;100
0;139;"kenedie";139;0;100
0;13;"kenedra";13;0;100
20;564;"kenedy";584;3.42465753424658;96.5753424657534
10;0;"keneen";10;100;0
0;37;"keneesha";37;0;100
0;528;"keneisha";528;0;100
0;6;"keneka";6;0;100
15;0;"kenenna";15;100;0
5;0;"kenenth";5;100;0
42;0;"kener";42;100;0
0;986;"kenesha";986;0;100
0;331;"keneshia";331;0;100
0;6;"kenesia";6;0;100
0;5;"kenessa";5;0;100
23;0;"kenet";23;100;0
0;11;"keneta";11;0;100
1382;0;"keneth";1382;100;0
0;87;"kenetha";87;0;100
0;19;"kenethia";19;0;100
0;140;"kenetra";140;0;100
0;17;"kenetta";17;0;100
0;5;"kenette";5;0;100
453;0;"keng";453;100;0
5;0;"kengi";5;100;0
66;0;"kengo";66;100;0
7;0;"kengston";7;100;0
78;205;"keni";283;27.5618374558304;72.4381625441696
12;7659;"kenia";7671;0.156433320297223;99.8435666797028
0;198;"keniah";198;0;100
275;0;"kenichi";275;100;0
10;0;"kenichiro";10;100;0
0;45;"kenicia";45;0;100
0;265;"kenidee";265;0;100
0;120;"kenidi";120;0;100
0;6;"kenidie";6;0;100
0;106;"kenidy";106;0;100
199;0;"keniel";199;100;0
0;94;"keniesha";94;0;100
0;12;"kenija";12;0;100
0;113;"kenijah";113;0;100
0;51;"kenika";51;0;100
5;0;"kenil";5;100;0
10;0;"kenin";10;100;0
0;5;"keniqua";5;0;100
0;165;"kenise";165;0;100
5;3931;"kenisha";3936;0.127032520325203;99.8729674796748
0;84;"kenishia";84;0;100
0;354;"kenita";354;0;100
1620;0;"kenith";1620;100;0
0;68;"kenitha";68;0;100
0;6;"kenithia";6;0;100
0;319;"kenitra";319;0;100
0;600;"keniya";600;0;100
0;611;"keniyah";611;0;100
0;5;"keniyha";5;0;100
0;50;"kenja";50;0;100
0;5;"kenjanae";5;0;100
3496;33;"kenji";3529;99.0648909039388;0.935109096061207
22;0;"kenjiro";22;100;0
37;0;"kenjuan";37;100;0
0;86;"kenlea";86;0;100
51;1513;"kenlee";1564;3.26086956521739;96.7391304347826
0;98;"kenlei";98;0;100
0;1485;"kenleigh";1485;0;100
976;5513;"kenley";6489;15.0408383418092;84.9591616581908
0;465;"kenli";465;0;100
0;481;"kenlie";481;0;100
10;0;"kenlin";10;100;0
73;412;"kenly";485;15.0515463917526;84.9484536082474
15;193;"kenlyn";208;7.21153846153846;92.7884615384615
0;85;"kenlynn";85;0;100
745;0;"kenn";745;100;0
198;9881;"kenna";10079;1.96448060323445;98.0355193967656
0;463;"kennadee";463;0;100
0;1607;"kennadi";1607;0;100
0;641;"kennadie";641;0;100
0;1552;"kennady";1552;0;100
0;6;"kennae";6;0;100
0;308;"kennah";308;0;100
1091;53;"kennan";1144;95.3671328671329;4.63286713286713
2659;0;"kennard";2659;100;0
0;14;"kennasia";14;0;100
0;5;"kennasyn";5;0;100
0;5;"kennay";5;0;100
0;6;"kennaya";6;0;100
0;129;"kenndra";129;0;100
12;0;"kenndrick";12;100;0
7;10;"kenndy";17;41.1764705882353;58.8235294117647
12;0;"kenne";12;100;0
0;6;"kennecia";6;0;100
0;135;"kennede";135;0;100
0;355;"kennedee";355;0;100
0;70;"kennedey";70;0;100
15;10453;"kennedi";10468;0.143293847917463;99.8567061520825
0;1196;"kennedie";1196;0;100
0;36;"kennedii";36;0;100
6410;62997;"kennedy";69407;9.23537971674327;90.7646202832567
0;63;"kenneisha";63;0;100
219;0;"kenneith";219;100;0
6;0;"kennell";6;100;0
231;0;"kennen";231;100;0
348;0;"kenner";348;100;0
0;366;"kennesha";366;0;100
0;71;"kenneshia";71;0;100
185;0;"kennet";185;100;0
1269192;5335;"kenneth";1274527;99.5814133400077;0.418586659992295
0;556;"kennetha";556;0;100
0;230;"kennethia";230;0;100
0;38;"kennetra";38;0;100
201;0;"kennett";201;100;0
0;202;"kennetta";202;0;100
0;163;"kennette";163;0;100
2482;5;"kenney";2487;99.7989545637314;0.201045436268597
10;243;"kenni";253;3.95256916996047;96.0474308300395
0;697;"kennia";697;0;100
0;46;"kenniah";46;0;100
0;65;"kennice";65;0;100
0;115;"kennidee";115;0;100
0;262;"kennidi";262;0;100
0;353;"kennidy";353;0;100
1298;283;"kennie";1581;82.0999367488931;17.9000632511069
58;0;"kenniel";58;100;0
424;0;"kennieth";424;100;0
0;5;"kennika";5;0;100
546;70;"kennis";616;88.6363636363636;11.3636363636364
0;19;"kennise";19;0;100
0;600;"kennisha";600;0;100
21;45;"kennison";66;31.8181818181818;68.1818181818182
0;157;"kennita";157;0;100
10458;5;"kennith";10463;99.9522125585396;0.0477874414603842
0;15;"kennitha";15;0;100
0;173;"kenniya";173;0;100
0;125;"kenniyah";125;0;100
0;12;"kennlee";12;0;100
0;117;"kennley";117;0;100
1653;25;"kennon";1678;98.5101311084624;1.48986889153754
2005;0;"kennth";2005;100;0
50283;505;"kenny";50788;99.0056706308577;0.994329369142317
0;575;"kennya";575;0;100
0;7;"kennyah";7;0;100
5;10;"kennyatta";15;33.3333333333333;66.6666666666667
0;5;"kennydi";5;0;100
6;0;"kennyel";6;100;0
0;15;"kennyetta";15;0;100
0;6;"kennysha";6;0;100
21;0;"kennyth";21;100;0
533;0;"keno";533;100;0
406;0;"kenon";406;100;0
0;106;"kenora";106;0;100
0;377;"kenosha";377;0;100
0;30;"kenra";30;0;100
887;0;"kenric";887;100;0
7;0;"kenrich";7;100;0
1179;0;"kenrick";1179;100;0
5;0;"kenrie";5;100;0
5;0;"kenron";5;100;0
51;0;"kenroy";51;100;0
64;0;"kenry";64;100;0
39;0;"kensei";39;100;0
13;0;"kensen";13;100;0
16;0;"kenseth";16;100;0
5;854;"kensey";859;0.582072176949942;99.4179278230501
0;6;"kensha";6;0;100
6;0;"kenshaun";6;100;0
75;0;"kenshawn";75;100;0
0;5;"kenshayla";5;0;100
0;5;"kenshia";5;0;100
246;0;"kenshin";246;100;0
11;0;"kenshiro";11;100;0
0;521;"kensi";521;0;100
0;767;"kensie";767;0;100
84;1817;"kensington";1901;4.41872698579695;95.581273014203
0;6;"kensingtyn";6;0;100
0;13;"kenslea";13;0;100
0;648;"kenslee";648;0;100
0;72;"kenslei";72;0;100
0;397;"kensleigh";397;0;100
208;4068;"kensley";4276;4.8643592142189;95.1356407857811
0;122;"kensli";122;0;100
0;306;"kenslie";306;0;100
5;90;"kensly";95;5.26315789473684;94.7368421052632
15;0;"kenso";15;100;0
345;0;"kenson";345;100;0
98;0;"kenston";98;100;0
33;0;"kensuke";33;100;0
0;96;"kensy";96;0;100
5;0;"kensyn";5;100;0
68189;171;"kent";68360;99.7498537156232;0.250146284376829
656;5;"kenta";661;99.2435703479576;0.75642965204236
26;0;"kentae";26;100;0
0;26;"kentara";26;0;100
5;0;"kentarious";5;100;0
72;0;"kentarius";72;100;0
331;0;"kentaro";331;100;0
0;25;"kentasia";25;0;100
0;35;"kentavia";35;0;100
46;0;"kentavion";46;100;0
665;0;"kentavious";665;100;0
32;0;"kentavis";32;100;0
185;0;"kentavius";185;100;0
12;0;"kentay";12;100;0
55;0;"kente";55;100;0
29;0;"kenten";29;100;0
0;21;"kenteria";21;0;100
5;0;"kenterious";5;100;0
10;0;"kenterrius";10;100;0
11;0;"kentez";11;100;0
17;0;"kentin";17;100;0
11;34;"kentlee";45;24.4444444444444;75.5555555555556
0;35;"kentleigh";35;0;100
62;82;"kentley";144;43.0555555555556;56.9444444444444
0;5;"kently";5;0;100
385;0;"kento";385;100;0
10338;0;"kenton";10338;100;0
0;39;"kentoria";39;0;100
0;33;"kentra";33;0;100
169;0;"kentrail";169;100;0
45;0;"kentral";45;100;0
12;0;"kentrall";12;100;0
31;0;"kentravion";31;100;0
154;0;"kentravious";154;100;0
10;0;"kentravius";10;100;0
21;0;"kentre";21;100;0
5;0;"kentreal";5;100;0
317;0;"kentrel";317;100;0
3210;66;"kentrell";3276;97.985347985348;2.01465201465201
16;0;"kentrelle";16;100;0
5;0;"kentrevious";5;100;0
28;0;"kentrez";28;100;0
0;22;"kentrice";22;0;100
0;6;"kentrina";6;0;100
5;0;"kentron";5;100;0
5;0;"kentwan";5;100;0
18;0;"kentyn";18;100;0
5;0;"kenuel";5;100;0
35;0;"kenward";35;100;0
187;0;"kenwood";187;100;0
203;5;"keny";208;97.5961538461538;2.40384615384615
2103;23808;"kenya";25911;8.1162440662267;91.8837559337733
146;565;"kenyada";711;20.5344585091421;79.4655414908579
18;6;"kenyae";24;75;25
0;367;"kenyah";367;0;100
841;10;"kenyan";851;98.8249118683901;1.17508813160987
0;357;"kenyana";357;0;100
0;222;"kenyanna";222;0;100
0;5;"kenyara";5;0;100
0;16;"kenyarda";16;0;100
9;10;"kenyari";19;47.3684210526316;52.6315789473684
301;820;"kenyata";1121;26.8510258697591;73.1489741302408
3116;4231;"kenyatta";7347;42.4118687899823;57.5881312100177
123;61;"kenyatte";184;66.8478260869565;33.1521739130435
0;5;"kenyce";5;0;100
21;0;"kenye";21;100;0
5;0;"kenyea";5;100;0
0;5;"kenyel";5;0;100
7;22;"kenyell";29;24.1379310344828;75.8620689655172
227;0;"kenyen";227;100;0
0;10;"kenyeta";10;0;100
128;2735;"kenyetta";2863;4.4708347886832;95.5291652113168
0;100;"kenyette";100;0;100
15;0;"kenyi";15;100;0
0;97;"kenyia";97;0;100
0;6;"kenyiah";6;0;100
17;0;"kenyin";17;100;0
0;5;"kenyjah";5;0;100
0;19;"kenyla";19;0;100
0;5;"kenylah";5;0;100
7540;187;"kenyon";7727;97.5799145852206;2.42008541477935
0;155;"kenyona";155;0;100
0;142;"kenyonna";142;0;100
5;26;"kenyota";31;16.1290322580645;83.8709677419355
20;130;"kenyotta";150;13.3333333333333;86.6666666666667
0;38;"kenysha";38;0;100
45;0;"kenyun";45;100;0
0;5;"kenz";5;0;100
0;479;"kenza";479;0;100
0;10;"kenze";10;0;100
0;390;"kenzee";390;0;100
125;0;"kenzel";125;100;0
49;0;"kenzell";49;100;0
0;159;"kenzey";159;0;100
20;2303;"kenzi";2323;0.86095566078347;99.1390443392165
0;5;"kenzia";5;0;100
418;15342;"kenzie";15760;2.65228426395939;97.3477157360406
0;508;"kenzington";508;0;100
0;5;"kenzingtyn";5;0;100
0;5;"kenzlea";5;0;100
0;729;"kenzlee";729;0;100
0;47;"kenzlei";47;0;100
0;412;"kenzleigh";412;0;100
0;754;"kenzley";754;0;100
0;161;"kenzli";161;0;100
0;352;"kenzlie";352;0;100
0;91;"kenzly";91;0;100
0;5;"kenzlyn";5;0;100
0;6;"kenzlynn";6;0;100
890;0;"kenzo";890;100;0
32;669;"kenzy";701;4.56490727532097;95.435092724679
0;5;"kenzye";5;0;100
184;0;"keo";184;100;0
0;15;"keoisha";15;0;100
0;47;"keoka";47;0;100
465;0;"keoki";465;100;0
512;31;"keola";543;94.2909760589319;5.70902394106814
0;5;"keolani";5;0;100
0;6;"keomi";6;0;100
7792;152;"keon";7944;98.0866062437059;1.91339375629406
65;3065;"keona";3130;2.07667731629393;97.9233226837061
0;87;"keonda";87;0;100
17;1102;"keondra";1119;1.51921358355675;98.4807864164433
22;0;"keondrae";22;100;0
5;0;"keondray";5;100;0
1331;0;"keondre";1331;100;0
0;5;"keondrea";5;0;100
0;102;"keondria";102;0;100
8;0;"keondric";8;100;0
67;0;"keondrick";67;100;0
523;0;"keone";523;100;0
2392;250;"keoni";2642;90.5374716124148;9.46252838758516
0;301;"keonia";301;0;100
0;5;"keonie";5;0;100
0;1763;"keonna";1763;0;100
22;0;"keonne";22;100;0
0;11;"keonni";11;0;100
0;5;"keonnie";5;0;100
412;64;"keonta";476;86.5546218487395;13.4453781512605
994;27;"keontae";1021;97.3555337904016;2.64446620959843
7;0;"keontai";7;100;0
325;5;"keontay";330;98.4848484848485;1.51515151515152
30;0;"keontaye";30;100;0
1395;55;"keonte";1450;96.2068965517241;3.79310344827586
12;0;"keontez";12;100;0
111;0;"keontre";111;100;0
0;16;"keonya";16;0;100
0;70;"keora";70;0;100
0;5;"keori";5;0;100
0;5;"keoria";5;0;100
0;5;"keorra";5;0;100
0;1884;"keosha";1884;0;100
0;209;"keoshia";209;0;100
6;0;"kepa";6;100;0
212;0;"kepler";212;100;0
10;5;"ker";15;66.6666666666667;33.3333333333333
0;3334;"kera";3334;0;100
0;18;"keragan";18;0;100
0;187;"kerah";187;0;100
0;5;"kerala";5;0;100
5;25;"keran";30;16.6666666666667;83.3333333333333
0;5;"kerani";5;0;100
16;0;"keraun";16;100;0
0;47;"kerbi";47;0;100
0;18;"kerbie";18;0;100
857;122;"kerby";979;87.538304392237;12.461695607763
0;6;"kerea";6;0;100
0;5;"keree";5;0;100
11;0;"kereem";11;100;0
0;7;"kereen";7;0;100
32;0;"kerek";32;100;0
35;0;"kerel";35;100;0
374;0;"kerem";374;100;0
0;3919;"keren";3919;0;100
0;36;"kerena";36;0;100
0;451;"kerensa";451;0;100
0;17;"keresa";17;0;100
324;31906;"keri";32230;1.00527458889234;98.9947254111077
0;455;"keria";455;0;100
0;6;"keriah";6;0;100
16;24;"kerian";40;40;60
0;153;"keriana";153;0;100
0;967;"keriann";967;0;100
0;133;"kerianna";133;0;100
0;790;"kerianne";790;0;100
79;0;"keric";79;100;0
0;5;"kerica";5;0;100
6;0;"kerick";6;100;0
0;320;"kerie";320;0;100
5;0;"keriel";5;100;0
0;443;"kerigan";443;0;100
0;16;"kerilee";16;0;100
0;355;"kerilyn";355;0;100
0;33;"kerilynn";33;0;100
212;0;"kerim";212;100;0
252;1318;"kerin";1570;16.0509554140127;83.9490445859873
0;219;"kerina";219;0;100
0;62;"kerington";62;0;100
60;0;"kerion";60;100;0
0;11;"keriona";11;0;100
0;24;"kerionna";24;0;100
0;50;"keris";50;0;100
0;55;"kerisa";55;0;100
0;146;"kerisha";146;0;100
0;491;"kerissa";491;0;100
0;20;"keristen";20;0;100
0;189;"kerith";189;0;100
0;7;"keriyah";7;0;100
10;0;"kerk";10;100;0
0;10;"kerl";10;0;100
0;12;"kerlin";12;0;100
0;102;"kerline";102;0;100
0;68;"kerly";68;0;100
0;5;"kerlyht";5;0;100
0;17;"kerlyn";17;0;100
0;39;"kerma";39;0;100
75;0;"kerman";75;100;0
11;0;"kermet";11;100;0
0;12;"kermina";12;0;100
16417;27;"kermit";16444;99.8358063731452;0.16419362685478
42;0;"kermith";42;100;0
261;0;"kermitt";261;100;0
6;0;"kermon";6;100;0
743;0;"kern";743;100;0
5;0;"kernell";5;100;0
248;0;"kerney";248;100;0
28;0;"kernie";28;100;0
6;0;"kernis";6;100;0
0;10;"kernisha";10;0;100
61;0;"kerolos";61;100;0
894;76;"keron";970;92.1649484536082;7.83505154639175
17;0;"kerr";17;100;0
0;1137;"kerra";1137;0;100
0;21;"kerrah";21;0;100
0;28;"kerre";28;0;100
5;0;"kerrell";5;100;0
0;15;"kerren";15;0;100
0;11;"kerrey";11;0;100
348;36870;"kerri";37218;0.935031436401741;99.0649685635983
0;180;"kerria";180;0;100
0;23;"kerrian";23;0;100
0;25;"kerriana";25;0;100
0;714;"kerriann";714;0;100
0;15;"kerrianna";15;0;100
0;523;"kerrianne";523;0;100
6;0;"kerric";6;100;0
694;0;"kerrick";694;100;0
104;8571;"kerrie";8675;1.19884726224784;98.8011527377522
78;2012;"kerrigan";2090;3.73205741626794;96.2679425837321
0;15;"kerrilee";15;0;100
0;107;"kerrilyn";107;0;100
0;76;"kerrilynn";76;0;100
10;1003;"kerrin";1013;0.987166831194472;99.0128331688055
168;698;"kerrington";866;19.3995381062356;80.6004618937644
132;18;"kerrion";150;88;12
0;44;"kerris";44;0;100
0;5;"kerrisa";5;0;100
0;15;"kerrissa";15;0;100
224;0;"kerron";224;100;0
49536;48506;"kerry";98042;50.5252850819037;49.4747149180963
0;333;"kerryann";333;0;100
0;28;"kerryanne";28;0;100
0;6;"kerrye";6;0;100
0;187;"kerryn";187;0;100
19;52;"kersey";71;26.7605633802817;73.2394366197183
0;31;"kersha";31;0;100
21;0;"kershaw";21;100;0
0;33;"kerstan";33;0;100
0;10;"kerstein";10;0;100
0;918;"kersten";918;0;100
0;62;"kersti";62;0;100
0;69;"kerstie";69;0;100
0;2516;"kerstin";2516;0;100
0;11;"kerstine";11;0;100
0;68;"kerston";68;0;100
0;6;"kersty";6;0;100
0;426;"kerstyn";426;0;100
230;0;"kert";230;100;0
0;33;"kertina";33;0;100
11;0;"kertis";11;100;0
0;9;"kertrina";9;0;100
22;0;"kerven";22;100;0
148;0;"kervens";148;100;0
1409;0;"kervin";1409;100;0
10;0;"kervins";10;100;0
2388;0;"kerwin";2388;100;0
17;0;"kerwyn";17;100;0
60;76;"kery";136;44.1176470588235;55.8823529411765
0;66;"keryl";66;0;100
0;320;"keryn";320;0;100
0;6;"kerynn";6;0;100
0;33;"kes";33;0;100
0;135;"kesa";135;0;100
39;0;"kesan";39;100;0
0;6;"kesar";6;0;100
35;0;"kesaun";35;100;0
0;6;"kescha";6;0;100
1123;0;"kesean";1123;100;0
5;5204;"kesha";5209;0.0959877135726627;99.9040122864273
0;39;"keshae";39;0;100
57;0;"keshan";57;100;0
0;193;"keshana";193;0;100
0;27;"keshanda";27;0;100
0;11;"keshandra";11;0;100
0;78;"keshanna";78;0;100
0;5;"keshante";5;0;100
0;43;"keshanti";43;0;100
0;145;"keshara";145;0;100
0;5;"kesharia";5;0;100
2156;51;"keshaun";2207;97.6891708201178;2.31082917988219
0;251;"keshauna";251;0;100
0;5;"keshaunna";5;0;100
955;0;"keshav";955;100;0
6;0;"keshava";6;100;0
5496;342;"keshawn";5838;94.141829393628;5.85817060637205
0;460;"keshawna";460;0;100
0;10;"keshawnda";10;0;100
0;5;"keshawndra";5;0;100
0;36;"keshawnna";36;0;100
0;58;"keshay";58;0;100
0;68;"keshayla";68;0;100
0;22;"keshea";22;0;100
0;5;"keshera";5;0;100
0;11;"keshi";11;0;100
6;5381;"keshia";5387;0.111379246333766;99.8886207536662
0;6;"keshira";6;0;100
1135;48;"keshon";1183;95.9425190194421;4.0574809805579
0;117;"keshona";117;0;100
0;157;"keshonda";157;0;100
0;22;"keshondra";22;0;100
21;0;"keshone";21;100;0
0;124;"keshonna";124;0;100
581;7;"keshun";588;98.8095238095238;1.19047619047619
0;30;"keshuna";30;0;100
0;13;"keshundra";13;0;100
0;17;"keshunna";17;0;100
0;12;"keshyra";12;0;100
0;221;"kesi";221;0;100
0;661;"kesia";661;0;100
0;53;"kesiah";53;0;100
0;5;"kesiha";5;0;100
0;70;"keslee";70;0;100
0;34;"kesleigh";34;0;100
212;0;"kesler";212;100;0
62;575;"kesley";637;9.73312401883831;90.2668759811617
0;212;"keslie";212;0;100
0;5;"kesly";5;0;100
0;80;"keslyn";80;0;100
0;22;"keslynn";22;0;100
30;0;"keson";30;100;0
0;63;"kess";63;0;100
0;398;"kessa";398;0;100
0;18;"kessandra";18;0;100
0;16;"kessia";16;0;100
0;48;"kessiah";48;0;100
0;67;"kessie";67;0;100
336;72;"kessler";408;82.3529411764706;17.6470588235294
0;18;"kessley";18;0;100
0;17;"kesslyn";17;0;100
8;0;"kesten";8;100;0
328;0;"kester";328;100;0
49;0;"kestin";49;100;0
620;0;"keston";620;100;0
0;23;"kestra";23;0;100
5;185;"kestrel";190;2.63157894736842;97.3684210526316
22;0;"kestutis";22;100;0
6;0;"kestyn";6;100;0
6;0;"kesuan";6;100;0
0;128;"keta";128;0;100
347;0;"ketan";347;100;0
0;74;"ketara";74;0;100
35;0;"ketch";35;100;0
31;0;"ketcher";31;100;0
0;5;"keteria";5;0;100
0;18;"ketha";18;0;100
136;0;"kethan";136;100;0
0;5;"ketherine";5;0;100
0;5;"kethia";5;0;100
0;6;"kethry";6;0;100
0;50;"ketia";50;0;100
94;0;"ketih";94;100;0
0;63;"ketina";63;0;100
0;10;"ketisha";10;0;100
6;0;"keton";6;100;0
0;255;"ketra";255;0;100
16;0;"ketrell";16;100;0
11;0;"ketric";11;100;0
74;0;"ketrick";74;100;0
0;105;"ketrina";105;0;100
27;0;"ketron";27;100;0
0;226;"ketsia";226;0;100
0;7;"ketsy";7;0;100
0;5;"ketta";5;0;100
0;34;"ketti";34;0;100
0;129;"ketty";129;0;100
0;179;"ketura";179;0;100
0;3123;"keturah";3123;0;100
0;5;"ketzalli";5;0;100
0;85;"ketzaly";85;0;100
0;109;"ketzia";109;0;100
0;10;"ketziah";10;0;100
0;53;"keuna";53;0;100
0;195;"keundra";195;0;100
45;0;"keundre";45;100;0
0;24;"keunna";24;0;100
5;0;"keunta";5;100;0
14;0;"keunte";14;100;0
0;1147;"keva";1147;0;100
0;6;"kevaeh";6;0;100
106;0;"keval";106;100;0
3395;48;"kevan";3443;98.605866976474;1.39413302352599
0;17;"kevana";17;0;100
0;15;"kevanna";15;0;100
93;0;"kevante";93;100;0
6;0;"kevari";6;100;0
5;0;"kevaris";5;100;0
302;0;"kevaughn";302;100;0
51;0;"kevaun";51;100;0
5;0;"keveen";5;100;0
0;16;"kevelyn";16;0;100
8542;130;"keven";8672;98.5009225092251;1.49907749077491
196;0;"keveon";196;100;0
5;0;"kever";5;100;0
10;11;"kevi";21;47.6190476190476;52.3809523809524
0;237;"kevia";237;0;100
52;0;"kevian";52;100;0
0;64;"keviana";64;0;100
0;39;"kevianna";39;0;100
1162930;5312;"kevin";1168242;99.5452996896191;0.454700310380897
0;420;"kevina";420;0;100
5;0;"kevinanthony";5;100;0
5;0;"kevinchristophe";5;100;0
12;0;"kevine";12;100;0
0;11;"kevinisha";11;0;100
6;0;"kevinjohn";6;100;0
15;0;"kevinjoseph";15;100;0
6;0;"kevinkhang";6;100;0
5;0;"kevinmatthew";5;100;0
33;0;"kevinmichael";33;100;0
24;0;"kevinn";24;100;0
21;0;"kevins";21;100;0
949;5;"kevion";954;99.4758909853249;0.524109014675052
0;44;"keviona";44;0;100
0;93;"kevionna";93;0;100
5;0;"kevious";5;100;0
245;0;"kevis";245;100;0
0;49;"kevisha";49;0;100
11;0;"keviyon";11;100;0
5;0;"kevlin";5;100;0
20;0;"kevn";20;100;0
4978;56;"kevon";5034;98.8875645609853;1.1124354390147
0;113;"kevona";113;0;100
0;5;"kevonda";5;0;100
0;5;"kevondra";5;0;100
21;0;"kevondre";21;100;0
8;0;"kevondrick";8;100;0
20;0;"kevone";20;100;0
26;0;"kevonn";26;100;0
0;289;"kevonna";289;0;100
43;6;"kevonne";49;87.7551020408163;12.2448979591837
170;0;"kevonta";170;100;0
387;0;"kevontae";387;100;0
70;0;"kevontay";70;100;0
648;0;"kevonte";648;100;0
5;0;"kevontre";5;100;0
82;0;"kevork";82;100;0
5;0;"kevrick";5;100;0
66;0;"kevron";66;100;0
1997;240;"kevyn";2237;89.2713455520787;10.7286544479213
14;0;"kevyon";14;100;0
331;0;"kewan";331;100;0
0;171;"kewana";171;0;100
0;125;"kewanda";125;0;100
0;5;"kewania";5;0;100
0;256;"kewanna";256;0;100
56;0;"kewaun";56;100;0
19;0;"kewin";19;100;0
259;0;"kewon";259;100;0
19;0;"kewuan";19;100;0
0;23;"kexin";23;0;100
146;10;"key";156;93.5897435897436;6.41025641025641
0;1712;"keya";1712;0;100
139;0;"keyaan";139;100;0
0;101;"keyah";101;0;100
0;46;"keyahna";46;0;100
5;0;"keyair";5;100;0
0;900;"keyaira";900;0;100
0;53;"keyairah";53;0;100
0;138;"keyairra";138;0;100
0;5;"keyajah";5;0;100
0;33;"keyala";33;0;100
1058;7;"keyan";1065;99.3427230046948;0.657276995305164
0;3661;"keyana";3661;0;100
0;117;"keyanah";117;0;100
0;27;"keyanda";27;0;100
0;205;"keyandra";205;0;100
171;0;"keyandre";171;100;0
0;5;"keyandrea";5;0;100
0;269;"keyani";269;0;100
0;5;"keyania";5;0;100
0;3256;"keyanna";3256;0;100
0;39;"keyannah";39;0;100
0;52;"keyanni";52;0;100
0;13;"keyanta";13;0;100
147;6;"keyante";153;96.078431372549;3.92156862745098
0;1630;"keyara";1630;0;100
0;246;"keyarah";246;0;100
5;126;"keyari";131;3.81679389312977;96.1832061068702
0;62;"keyaria";62;0;100
0;12;"keyarie";12;0;100
0;334;"keyarra";334;0;100
0;129;"keyasha";129;0;100
0;24;"keyashia";24;0;100
0;451;"keyasia";451;0;100
0;115;"keyatta";115;0;100
43;0;"keyaun";43;100;0
0;217;"keyauna";217;0;100
0;31;"keyawna";31;0;100
20;0;"keydan";20;100;0
242;0;"keyden";242;100;0
0;107;"keydi";107;0;100
35;0;"keydon";35;100;0
0;35;"keydra";35;0;100
11;0;"keydren";11;100;0
0;42;"keydy";42;0;100
5;0;"keye";5;100;0
74;0;"keyen";74;100;0
0;879;"keyera";879;0;100
0;5;"keyerah";5;0;100
0;27;"keyeria";27;0;100
0;292;"keyerra";292;0;100
0;67;"keyetta";67;0;100
356;11;"keygan";367;97.0027247956403;2.99727520435967
0;12;"keyhla";12;0;100
0;68;"keyia";68;0;100
0;27;"keyiana";27;0;100
0;11;"keyilah";11;0;100
6;0;"keyin";6;100;0
109;0;"keyion";109;100;0
0;10;"keyiona";10;0;100
0;102;"keyira";102;0;100
0;13;"keyisha";13;0;100
58;0;"keyjuan";58;100;0
0;6928;"keyla";6928;0;100
0;87;"keylah";87;0;100
780;43;"keylan";823;94.775212636695;5.22478736330498
11;0;"keyland";11;100;0
0;81;"keylani";81;0;100
0;5;"keylanie";5;0;100
0;106;"keyle";106;0;100
0;5;"keylea";5;0;100
0;1348;"keylee";1348;0;100
0;64;"keyleen";64;0;100
0;25;"keylei";25;0;100
0;188;"keyleigh";188;0;100
249;178;"keylen";427;58.3138173302108;41.6861826697892
128;0;"keyler";128;100;0
0;21;"keyley";21;0;100
0;931;"keyli";931;0;100
0;5;"keyliana";5;0;100
0;18;"keylianis";18;0;100
0;215;"keylie";215;0;100
245;672;"keylin";917;26.7175572519084;73.2824427480916
0;12;"keylli";12;0;100
0;37;"keylly";37;0;100
402;0;"keylon";402;100;0
131;0;"keylor";131;100;0
0;244;"keyly";244;0;100
0;35;"keylyn";35;0;100
86;124;"keymani";210;40.9523809523809;59.0476190476191
10;0;"keymar";10;100;0
0;5;"keymara";5;0;100
127;33;"keymari";160;79.375;20.625
80;0;"keymarion";80;100;0
0;10;"keymaya";10;0;100
0;10;"keymi";10;0;100
0;8;"keymia";8;0;100
0;56;"keymiah";56;0;100
0;5;"keymiyah";5;0;100
151;0;"keymon";151;100;0
13;0;"keymond";13;100;0
37;77;"keymoni";114;32.4561403508772;67.5438596491228
5;0;"keymonie";5;100;0
20;0;"keymonte";20;100;0
0;120;"keymora";120;0;100
0;46;"keymya";46;0;100
0;429;"keyna";429;0;100
314;0;"keynan";314;100;0
22;0;"keynen";22;100;0
22;0;"keyner";22;100;0
0;6;"keynia";6;0;100
0;11;"keyniah";11;0;100
51;0;"keynon";51;100;0
0;5;"keynu";5;0;100
15;0;"keyo";15;100;0
0;53;"keyoka";53;0;100
5214;101;"keyon";5315;98.0997177798683;1.9002822201317
0;2842;"keyona";2842;0;100
0;53;"keyonah";53;0;100
0;52;"keyonce";52;0;100
0;175;"keyonda";175;0;100
0;378;"keyondra";378;0;100
327;0;"keyondre";327;100;0
0;15;"keyondria";15;0;100
21;0;"keyone";21;100;0
5;108;"keyoni";113;4.42477876106195;95.5752212389381
0;366;"keyonia";366;0;100
0;15;"keyonie";15;0;100
7;0;"keyonis";7;100;0
29;0;"keyonn";29;100;0
0;3409;"keyonna";3409;0;100
27;0;"keyonne";27;100;0
0;64;"keyonni";64;0;100
0;11;"keyonnia";11;0;100
0;18;"keyonnie";18;0;100
219;102;"keyonta";321;68.2242990654206;31.7757009345794
364;13;"keyontae";377;96.551724137931;3.44827586206897
5;0;"keyontai";5;100;0
72;0;"keyontay";72;100;0
487;21;"keyonte";508;95.8661417322835;4.13385826771654
0;6;"keyora";6;0;100
0;338;"keyosha";338;0;100
0;33;"keyoshia";33;0;100
0;798;"keyra";798;0;100
0;9;"keyrah";9;0;100
0;5;"keyren";5;0;100
0;457;"keyri";457;0;100
0;5;"keyria";5;0;100
0;32;"keyrin";32;0;100
206;0;"keyron";206;100;0
0;12;"keyrra";12;0;100
0;95;"keyry";95;0;100
0;54;"keysa";54;0;100
5;0;"keysan";5;100;0
241;0;"keysean";241;100;0
6;0;"keyser";6;100;0
0;1766;"keysha";1766;0;100
0;5;"keyshana";5;0;100
0;15;"keyshanna";15;0;100
646;0;"keyshaun";646;100;0
0;18;"keyshauna";18;0;100
3729;24;"keyshawn";3753;99.3605115907274;0.639488409272582
0;109;"keyshawna";109;0;100
0;260;"keyshia";260;0;100
0;83;"keyshla";83;0;100
338;0;"keyshon";338;100;0
0;6;"keyshona";6;0;100
0;16;"keyshonda";16;0;100
7;0;"keyshone";7;100;0
140;0;"keyshun";140;100;0
0;184;"keysi";184;0;100
0;5;"keysia";5;0;100
45;0;"keyson";45;100;0
0;17;"keystal";17;0;100
0;7;"keystle";7;0;100
66;0;"keyston";66;100;0
11;0;"keyten";11;100;0
59;0;"keyth";59;100;0
703;0;"keyton";703;100;0
0;78;"keyuana";78;0;100
0;5;"keyuanna";5;0;100
55;0;"keyun";55;100;0
0;168;"keyuna";168;0;100
0;64;"keyundra";64;0;100
0;174;"keyunna";174;0;100
10;5;"keyunta";15;66.6666666666667;33.3333333333333
11;0;"keyuntae";11;100;0
21;0;"keyur";21;100;0
0;5;"keyva";5;0;100
50;0;"keyvan";50;100;0
5;0;"keyveon";5;100;0
82;0;"keyvin";82;100;0
24;0;"keyvion";24;100;0
559;0;"keyvon";559;100;0
0;15;"keyvonna";15;0;100
13;0;"keyvonte";13;100;0
52;0;"keywan";52;100;0
0;11;"keywana";11;0;100
0;15;"keywanda";15;0;100
0;41;"keywanna";41;0;100
5;0;"keywaun";5;100;0
95;0;"keywon";95;100;0
10;0;"kez";10;100;0
0;12;"keza";12;0;100
0;27;"kezaria";27;0;100
0;1900;"kezia";1900;0;100
73;2808;"keziah";2881;2.53384241582784;97.4661575841722
5;0;"kezion";5;100;0
0;5;"keziya";5;0;100
0;108;"keziyah";108;0;100
0;5;"kezzie";5;0;100
0;9;"kezzy";9;0;100
5;0;"kfir";5;100;0
88;5;"kha";93;94.6236559139785;5.37634408602151
111;0;"khaalid";111;100;0
48;0;"khaaliq";48;100;0
35;5;"khaalis";40;87.5;12.5
24;0;"khabir";24;100;0
16;0;"khachik";16;100;0
11;0;"khadafi";11;100;0
0;26;"khadajah";26;0;100
57;0;"khadar";57;100;0
5;0;"khadarius";5;100;0
25;0;"khade";25;100;0
0;25;"khadedra";25;0;100
0;234;"khadeeja";234;0;100
0;179;"khadeejah";179;0;100
78;0;"khadeem";78;100;0
0;13;"khadeidra";13;0;100
0;7;"khadeijah";7;0;100
0;6;"khadeisha";6;0;100
0;181;"khadeja";181;0;100
0;279;"khadejah";279;0;100
0;7;"khadejha";7;0;100
0;11;"khadejia";11;0;100
255;0;"khaden";255;100;0
0;5;"khadence";5;0;100
23;0;"khader";23;100;0
0;25;"khadesha";25;0;100
0;13;"khadeshia";13;0;100
0;25;"khadesia";25;0;100
0;6;"khadi";6;0;100
0;19;"khadidiatou";19;0;100
0;36;"khadidja";36;0;100
0;15;"khadidra";15;0;100
0;3423;"khadija";3423;0;100
7;6323;"khadijah";6330;0.110584518167457;99.8894154818325
0;27;"khadijat";27;0;100
0;57;"khadijatou";57;0;100
0;50;"khadijha";50;0;100
0;8;"khadijia";8;0;100
0;5;"khadijiah";5;0;100
157;0;"khadim";157;100;0
23;0;"khadin";23;100;0
145;0;"khadir";145;100;0
0;5;"khadisah";5;0;100
0;29;"khadisha";29;0;100
0;5;"khadiyah";5;0;100
0;37;"khadjah";37;0;100
0;10;"khadjiah";10;0;100
0;47;"khadra";47;0;100
0;165;"khady";165;0;100
50;0;"khadyn";50;100;0
57;0;"khael";57;100;0
0;12;"khaelyn";12;0;100
0;5;"khaelynn";5;0;100
10;0;"khafre";10;100;0
7;0;"khahlil";7;100;0
1296;239;"khai";1535;84.4299674267101;15.5700325732899
0;41;"khaia";41;0;100
175;0;"khaiden";175;100;0
110;0;"khaidyn";110;100;0
25;0;"khail";25;100;0
0;406;"khaila";406;0;100
0;23;"khailah";23;0;100
0;79;"khailee";79;0;100
17;0;"khailen";17;100;0
0;48;"khailey";48;0;100
10;0;"khailil";10;100;0
0;39;"khailyn";39;0;100
0;14;"khailynn";14;0;100
0;18;"khaina";18;0;100
63;0;"khair";63;100;0
0;44;"khaira";44;0;100
0;5;"khairah";5;0;100
11;0;"khairee";11;100;0
389;5;"khairi";394;98.7309644670051;1.26903553299492
11;0;"khairo";11;100;0
5;0;"khairy";5;100;0
0;27;"khaiya";27;0;100
0;281;"khala";281;0;100
17;0;"khalan";17;100;0
21;270;"khalani";291;7.21649484536082;92.7835051546392
0;81;"khalaya";81;0;100
0;6;"khalayah";6;0;100
173;0;"khale";173;100;0
0;244;"khalea";244;0;100
0;295;"khaleah";295;0;100
19;0;"khaleal";19;100;0
676;0;"khaleb";676;100;0
1862;0;"khaled";1862;100;0
78;25;"khalee";103;75.7281553398058;24.2718446601942
157;0;"khaleed";157;100;0
0;11;"khaleedah";11;0;100
84;0;"khaleef";84;100;0
819;0;"khaleel";819;100;0
0;107;"khaleelah";107;0;100
64;0;"khaleem";64;100;0
36;0;"khaleeq";36;100;0
0;7;"khalees";7;0;100
0;1497;"khaleesi";1497;0;100
0;23;"khaleesia";23;0;100
0;5;"khaleesy";5;0;100
7;10;"khalei";17;41.1764705882353;58.8235294117647
0;6;"khaleia";6;0;100
0;17;"khaleigh";17;0;100
20;0;"khaleil";20;100;0
183;0;"khalel";183;100;0
0;5;"khalema";5;0;100
148;5;"khalen";153;96.7320261437908;3.26797385620915
7;0;"khaleo";7;100;0
0;87;"khalessi";87;0;100
0;17;"khaley";17;0;100
0;31;"khaleya";31;0;100
0;11;"khaleyah";11;0;100
167;0;"khalfani";167;100;0
491;667;"khali";1158;42.4006908462867;57.5993091537133
7;2366;"khalia";2373;0.294985250737463;99.7050147492625
0;1003;"khaliah";1003;0;100
5;0;"khalial";5;100;0
175;0;"khalib";175;100;0
5931;0;"khalid";5931;100;0
0;58;"khalida";58;0;100
0;67;"khalidah";67;0;100
0;63;"khalie";63;0;100
40;0;"khalief";40;100;0
5;0;"khaliek";5;100;0
112;0;"khaliel";112;100;0
1421;0;"khalif";1421;100;0
174;0;"khalifa";174;100;0
20;0;"khalifah";20;100;0
0;6;"khalii";6;0;100
6;0;"khalijah";6;100;0
194;0;"khalik";194;100;0
0;7;"khalika";7;0;100
16230;138;"khalil";16368;99.1568914956012;0.843108504398827
0;259;"khalila";259;0;100
0;1530;"khalilah";1530;0;100
0;6;"khaliliah";6;0;100
6;0;"khalill";6;100;0
7;0;"khalim";7;100;0
0;5;"khalimah";5;0;100
131;6;"khalin";137;95.6204379562044;4.37956204379562
0;34;"khalina";34;0;100
596;0;"khaliq";596;100;0
37;0;"khalique";37;100;0
15;65;"khalis";80;18.75;81.25
0;11;"khalisa";11;0;100
0;6;"khalisah";6;0;100
0;94;"khalise";94;0;100
0;54;"khalisha";54;0;100
0;7;"khalisi";7;0;100
0;321;"khaliya";321;0;100
0;1080;"khaliyah";1080;0;100
18;0;"khaliyl";18;100;0
0;5;"khalli";5;0;100
87;0;"khallid";87;100;0
0;5;"khallie";5;0;100
5;0;"khallil";5;100;0
168;0;"khalon";168;100;0
0;19;"khaloni";19;0;100
0;10;"khalya";10;0;100
52;0;"khalyl";52;100;0
5;43;"khalyn";48;10.4166666666667;89.5833333333333
0;11;"khalynn";11;0;100
43;6;"kham";49;87.7551020408163;12.2448979591837
30;0;"khamal";30;100;0
631;325;"khamani";956;66.0041841004184;33.9958158995816
51;0;"khamar";51;100;0
0;18;"khamara";18;0;100
6;0;"khamare";6;100;0
1286;370;"khamari";1656;77.6570048309179;22.3429951690821
0;52;"khamaria";52;0;100
81;0;"khamarion";81;100;0
8;0;"khamaron";8;100;0
75;5;"khamauri";80;93.75;6.25
0;27;"khamaya";27;0;100
69;0;"khambrel";69;100;0
13;0;"khamden";13;100;0
5;0;"khamel";5;100;0
148;0;"khameron";148;100;0
0;69;"khamia";69;0;100
0;27;"khamiah";27;0;100
0;58;"khamil";58;0;100
0;103;"khamila";103;0;100
0;5;"khamilah";5;0;100
0;8;"khamilla";8;0;100
0;112;"khamille";112;0;100
35;0;"khamir";35;100;0
0;7;"khamira";7;0;100
5;0;"khamisi";5;100;0
0;137;"khamiya";137;0;100
0;130;"khamiyah";130;0;100
5;0;"khamon";5;100;0
55;34;"khamoni";89;61.7977528089888;38.2022471910112
0;97;"khamora";97;0;100
56;0;"khamren";56;100;0
116;0;"khamron";116;100;0
41;54;"khamryn";95;43.1578947368421;56.8421052631579
0;257;"khamya";257;0;100
0;31;"khamyah";31;0;100
0;5;"khamyla";5;0;100
0;6;"khamyra";6;0;100
291;0;"khan";291;100;0
5;0;"khance";5;100;0
0;47;"khandi";47;0;100
0;34;"khandice";34;0;100
0;5;"khandis";5;0;100
0;5;"khandra";5;0;100
25;0;"khane";25;100;0
979;0;"khang";979;100;0
407;293;"khanh";700;58.1428571428571;41.8571428571429
125;22;"khani";147;85.0340136054422;14.9659863945578
0;30;"khania";30;0;100
0;134;"khaniya";134;0;100
0;85;"khaniyah";85;0;100
0;6;"khansa";6;0;100
0;29;"khanya";29;0;100
34;0;"khanye";34;100;0
29;0;"khaos";29;100;0
0;650;"khara";650;0;100
5;0;"kharan";5;100;0
5;0;"khare";5;100;0
68;0;"kharee";68;100;0
44;0;"khareem";44;100;0
2440;605;"khari";3045;80.1313628899836;19.8686371100164
5;170;"kharis";175;2.85714285714286;97.1428571428571
0;325;"kharisma";325;0;100
0;58;"kharissa";58;0;100
0;98;"kharizma";98;0;100
0;6;"kharla";6;0;100
0;19;"kharlee";19;0;100
0;5;"kharley";5;0;100
0;34;"kharli";34;0;100
0;52;"kharlie";52;0;100
0;396;"kharma";396;0;100
0;23;"kharmen";23;0;100
0;6;"kharmin";6;0;100
0;19;"kharmyn";19;0;100
209;0;"kharon";209;100;0
29;0;"kharson";29;100;0
0;5;"kharsyn";5;0;100
216;48;"kharter";264;81.8181818181818;18.1818181818182
872;0;"khary";872;100;0
5;0;"khase";5;100;0
10;0;"khaseem";10;100;0
5;0;"khash";5;100;0
12;0;"khasim";12;100;0
63;0;"khasir";63;100;0
7;0;"khason";7;100;0
0;48;"khassidy";48;0;100
0;5;"khatia";5;0;100
11;0;"khattab";11;100;0
10;0;"khawaja";10;100;0
0;13;"khawla";13;0;100
0;5;"khawlah";5;0;100
0;198;"khaya";198;0;100
349;18;"khayden";367;95.0953678474115;4.90463215258856
0;5;"khaydence";5;0;100
11;0;"khaydin";11;100;0
5;0;"khayir";5;100;0
0;787;"khayla";787;0;100
0;25;"khaylah";25;0;100
0;5;"khaylani";5;0;100
0;76;"khaylee";76;0;100
0;5;"khaylie";5;0;100
89;0;"khayman";89;100;0
5;0;"khayr";5;100;0
257;0;"khayree";257;100;0
234;0;"khayri";234;100;0
0;12;"khayriyyah";12;0;100
5;0;"khaysen";5;100;0
10;0;"khayyam";10;100;0
117;6;"khaza";123;95.1219512195122;4.8780487804878
7;0;"khazi";7;100;0
0;5;"khea";5;0;100
0;15;"khedra";15;0;100
8;0;"kheelan";8;100;0
0;11;"kheira";11;0;100
31;0;"khelan";31;100;0
0;29;"khelani";29;0;100
5;0;"khelen";5;100;0
0;5;"kheli";5;0;100
0;58;"khelsea";58;0;100
0;25;"khelsey";25;0;100
8;0;"khemani";8;100;0
5;0;"khemari";5;100;0
0;16;"khenadi";16;0;100
7;0;"khenan";7;100;0
0;5;"khendal";5;0;100
0;11;"khendra";11;0;100
5;0;"kheng";5;100;0
0;24;"khennedi";24;0;100
0;6;"khepri";6;0;100
0;6;"kheri";6;0;100
0;395;"kherington";395;0;100
0;50;"kherrington";50;0;100
14;0;"khevin";14;100;0
0;5;"kheyla";5;0;100
204;21;"khi";225;90.6666666666667;9.33333333333333
0;756;"khia";756;0;100
0;23;"khiabet";23;0;100
0;6;"khiala";6;0;100
52;0;"khian";52;100;0
0;355;"khiana";355;0;100
0;5;"khiandra";5;0;100
0;148;"khianna";148;0;100
0;387;"khiara";387;0;100
5;5;"khiari";10;50;50
124;0;"khiem";124;100;0
0;119;"khila";119;0;100
32;0;"khilan";32;100;0
0;113;"khilee";113;0;100
0;16;"khileigh";16;0;100
19;0;"khilen";19;100;0
0;140;"khiley";140;0;100
29;34;"khilyn";63;46.031746031746;53.968253968254
0;43;"khilynn";43;0;100
11;0;"khimani";11;100;0
0;5;"khimora";5;0;100
5;0;"khine";5;100;0
44;0;"khing";44;100;0
14;0;"khingston";14;100;0
0;276;"khira";276;0;100
113;0;"khiree";113;100;0
10;0;"khirey";10;100;0
12;0;"khiri";12;100;0
5;0;"khiron";5;100;0
0;10;"khirsten";10;0;100
1046;7;"khiry";1053;99.335232668566;0.664767331433998
15;0;"khiryn";15;100;0
0;26;"khisha";26;0;100
0;271;"khiya";271;0;100
0;47;"khiyah";47;0;100
66;0;"khiyan";66;100;0
46;0;"khiyon";46;100;0
77;0;"khizar";77;100;0
24;0;"khizer";24;100;0
19;34558;"khloe";34577;0.054949822136102;99.9450501778639
0;19;"khloeann";19;0;100
0;1096;"khloee";1096;0;100
0;75;"khloei";75;0;100
0;5;"khloemae";5;0;100
0;6;"khloemarie";6;0;100
0;640;"khloey";640;0;100
0;145;"khloi";145;0;100
0;710;"khloie";710;0;100
0;10;"khloii";10;0;100
0;6;"khloye";6;0;100
45;0;"khmari";45;100;0
0;5;"khmya";5;0;100
670;0;"khoa";670;100;0
19;0;"khobe";19;100;0
8;0;"khodee";8;100;0
6;19;"khodi";25;24;76
59;0;"khoen";59;100;0
510;11;"khoi";521;97.8886756238004;2.11132437619962
35;0;"khol";35;100;0
10;0;"kholby";10;100;0
74;466;"khole";540;13.7037037037037;86.2962962962963
0;12;"kholee";12;0;100
0;5;"kholette";5;0;100
0;5;"kholie";5;0;100
5;0;"kholten";5;100;0
57;0;"kholton";57;100;0
26;0;"khonner";26;100;0
8;0;"khonor";8;100;0
0;23;"khora";23;0;100
11;0;"khorey";11;100;0
91;312;"khori";403;22.5806451612903;77.4193548387097
0;9;"khorie";9;0;100
54;0;"khory";54;100;0
9;0;"khotan";9;100;0
0;30;"khou";30;0;100
5;6;"khouri";11;45.4545454545455;54.5454545454545
116;0;"khoury";116;100;0
285;46;"khris";331;86.1027190332326;13.8972809667674
0;5;"khrishna";5;0;100
0;5;"khrissa";5;0;100
0;228;"khrista";228;0;100
0;45;"khristal";45;0;100
5;0;"khristan";5;100;0
0;153;"khristen";153;0;100
0;146;"khristi";146;0;100
2160;484;"khristian";2644;81.6944024205749;18.3055975794251
0;31;"khristiana";31;0;100
0;144;"khristie";144;0;100
0;103;"khristin";103;0;100
0;1248;"khristina";1248;0;100
0;612;"khristine";612;0;100
5;0;"khriston";5;100;0
2112;0;"khristopher";2112;100;0
0;332;"khristy";332;0;100
184;0;"khriz";184;100;0
0;28;"khrysta";28;0;100
0;351;"khrystal";351;0;100
0;29;"khrysten";29;0;100
101;15;"khrystian";116;87.0689655172414;12.9310344827586
0;12;"khrystin";12;0;100
0;94;"khrystina";94;0;100
0;23;"khrystine";23;0;100
42;0;"khrystopher";42;100;0
0;26;"khrystyn";26;0;100
0;65;"khrystyna";65;0;100
0;97;"khrystyne";97;0;100
40;0;"khuong";40;100;0
43;0;"khup";43;100;0
40;0;"khurram";40;100;0
0;37;"khusbu";37;0;100
120;0;"khush";120;100;0
21;0;"khushal";21;100;0
0;48;"khushboo";48;0;100
0;133;"khushbu";133;0;100
0;1171;"khushi";1171;0;100
0;14;"khushpreet";14;0;100
54;0;"khy";54;100;0
0;303;"khya";303;0;100
6;0;"khyair";6;100;0
5;0;"khyaire";5;100;0
60;0;"khyan";60;100;0
0;11;"khyana";11;0;100
0;17;"khyara";17;0;100
0;11;"khyati";11;0;100
16;0;"khyber";16;100;0
47;0;"khyden";47;100;0
91;0;"khye";91;100;0
0;42;"khyia";42;0;100
10;0;"khyier";10;100;0
5;0;"khyion";5;100;0
26;0;"khyir";26;100;0
0;850;"khyla";850;0;100
0;59;"khylah";59;0;100
246;5;"khylan";251;98.00796812749;1.99203187250996
19;6;"khylar";25;76;24
297;24;"khyle";321;92.5233644859813;7.47663551401869
0;683;"khylee";683;0;100
0;106;"khylei";106;0;100
0;124;"khyleigh";124;0;100
181;0;"khylen";181;100;0
336;67;"khyler";403;83.3746898263027;16.6253101736973
0;98;"khyli";98;0;100
0;10;"khylia";10;0;100
0;445;"khylie";445;0;100
5;0;"khylige";5;100;0
22;0;"khylil";22;100;0
108;36;"khylin";144;75;25
56;0;"khylon";56;100;0
0;7;"khylynn";7;0;100
5;5;"khymani";10;50;50
5;0;"khymari";5;100;0
8;0;"khymir";8;100;0
6;0;"khyng";6;100;0
35;0;"khyon";35;100;0
0;357;"khyra";357;0;100
56;0;"khyran";56;100;0
108;0;"khyre";108;100;0
948;10;"khyree";958;98.9561586638831;1.04384133611691
10;0;"khyrell";10;100;0
162;0;"khyren";162;100;0
239;7;"khyri";246;97.1544715447154;2.84552845528455
185;31;"khyrie";216;85.6481481481482;14.3518518518519
78;0;"khyrin";78;100;0
120;0;"khyron";120;100;0
22;0;"khysen";22;100;0
59;0;"khyson";59;100;0
375;98;"ki";473;79.2811839323467;20.7188160676533
170;7495;"kia";7665;2.21787345075016;97.7821265492498
440;0;"kiaan";440;100;0
0;39;"kiabeth";39;0;100
25;0;"kiaeem";25;100;0
233;2847;"kiah";3080;7.56493506493506;92.4350649350649
0;431;"kiahna";431;0;100
0;14;"kiahnna";14;0;100
0;35;"kiahra";35;0;100
20;0;"kiai";20;100;0
0;503;"kiaira";503;0;100
0;22;"kiairra";22;0;100
0;64;"kiaja";64;0;100
0;46;"kiajah";46;0;100
20;0;"kial";20;100;0
0;211;"kiala";211;0;100
0;5;"kialani";5;0;100
0;78;"kialee";78;0;100
0;45;"kialey";45;0;100
0;10;"kiali";10;0;100
0;6;"kialie";6;0;100
0;6;"kialyn";6;0;100
91;0;"kiam";91;100;0
0;12;"kiamani";12;0;100
0;5;"kiamara";5;0;100
0;39;"kiamber";39;0;100
5;0;"kiambu";5;100;0
0;103;"kiamesha";103;0;100
0;7;"kiamora";7;0;100
7179;86;"kian";7265;98.8162422573985;1.18375774260151
19;23626;"kiana";23645;0.0803552548107422;99.9196447451893
0;273;"kianah";273;0;100
0;7;"kianalee";7;0;100
0;944;"kiandra";944;0;100
249;0;"kiandre";249;100;0
0;18;"kiandrea";18;0;100
0;61;"kiandria";61;0;100
0;46;"kiane";46;0;100
0;37;"kianga";37;0;100
30;1009;"kiani";1039;2.88739172281039;97.1126082771896
0;5;"kiania";5;0;100
0;16;"kianie";16;0;100
0;15;"kiann";15;0;100
0;7630;"kianna";7630;0;100
0;237;"kiannah";237;0;100
0;41;"kianne";41;0;100
0;194;"kianni";194;0;100
0;40;"kianny";40;0;100
80;0;"kiano";80;100;0
8;0;"kiansh";8;100;0
0;5;"kianta";5;0;100
428;182;"kiante";610;70.1639344262295;29.8360655737705
0;7;"kianti";7;0;100
11;0;"kianu";11;100;0
0;44;"kiany";44;0;100
221;46892;"kiara";47113;0.46908496593297;99.530915034067
0;1141;"kiarah";1141;0;100
0;22;"kiaralee";22;0;100
0;84;"kiaraliz";84;0;100
0;5;"kiaralyn";5;0;100
6;0;"kiaran";6;100;0
5;26;"kiare";31;16.1290322580645;83.8709677419355
40;369;"kiari";409;9.7799511002445;90.2200488997555
0;162;"kiaria";162;0;100
5;0;"kiaron";5;100;0
0;3640;"kiarra";3640;0;100
0;199;"kiarrah";199;0;100
0;5;"kiarri";5;0;100
0;5;"kiary";5;0;100
5;0;"kias";5;100;0
0;175;"kiasha";175;0;100
0;385;"kiasia";385;0;100
0;9;"kiata";9;0;100
0;435;"kiauna";435;0;100
0;35;"kiaundra";35;0;100
0;31;"kiaunna";31;0;100
0;23;"kiaura";23;0;100
0;5;"kiava";5;0;100
0;18;"kiawana";18;0;100
0;5;"kiawna";5;0;100
0;754;"kiaya";754;0;100
0;5;"kiayah";5;0;100
0;16;"kiayana";16;0;100
0;5;"kiayanna";5;0;100
0;26;"kiayla";26;0;100
0;6;"kiayra";6;0;100
5;0;"kiazer";5;100;0
6;0;"kiba";6;100;0
0;5;"kibbie";5;0;100
0;27;"kibibi";27;0;100
19;0;"kibwe";19;100;0
0;7;"kicha";7;0;100
0;5;"kichelle";5;0;100
0;12;"kicia";12;0;100
20;0;"kid";20;100;0
0;50;"kida";50;0;100
0;93;"kidada";93;0;100
10;0;"kidane";10;100;0
0;5;"kidata";5;0;100
17;0;"kidd";17;100;0
0;11;"kiden";11;0;100
0;16;"kidist";16;0;100
6;0;"kidron";6;100;0
532;0;"kidus";532;100;0
121;5;"kie";126;96.031746031746;3.96825396825397
0;10;"kiea";10;0;100
5;0;"kiean";5;100;0
0;145;"kieana";145;0;100
0;5;"kieandra";5;0;100
0;189;"kieanna";189;0;100
0;766;"kieara";766;0;100
0;11;"kiearah";11;0;100
0;244;"kiearra";244;0;100
0;5;"kieasha";5;0;100
0;18;"kieayla";18;0;100
6;0;"kieden";6;100;0
11;0;"kiedis";11;100;0
12;0;"kief";12;100;0
1873;0;"kiefer";1873;100;0
166;0;"kieffer";166;100;0
133;5;"kiegan";138;96.3768115942029;3.6231884057971
0;5;"kieisha";5;0;100
2409;30;"kiel";2439;98.769987699877;1.230012300123
0;276;"kiela";276;0;100
0;10;"kielah";10;0;100
88;0;"kielan";88;100;0
0;465;"kiele";465;0;100
0;150;"kielee";150;0;100
0;33;"kieleigh";33;0;100
57;0;"kieler";57;100;0
0;263;"kieley";263;0;100
0;66;"kieli";66;0;100
5;0;"kielin";5;100;0
0;787;"kiely";787;0;100
5;71;"kielyn";76;6.57894736842105;93.4210526315789
0;48;"kielynn";48;0;100
376;0;"kien";376;100;0
300;0;"kienan";300;100;0
0;65;"kienna";65;0;100
90;0;"kieon";90;100;0
0;50;"kieona";50;0;100
0;41;"kieonna";41;0;100
422;11;"kier";433;97.459584295612;2.54041570438799
19;19378;"kiera";19397;0.0979532917461463;99.9020467082538
0;379;"kierah";379;0;100
0;5;"kieralyn";5;0;100
11929;1420;"kieran";13349;89.3624990636003;10.6375009363997
38;0;"kierce";38;100;0
35;0;"kiere";35;100;0
396;118;"kieren";514;77.0428015564202;22.9571984435798
0;31;"kieria";31;0;100
34;0;"kierian";34;100;0
0;6;"kieriana";6;0;100
0;5;"kierica";5;0;100
32;17;"kierin";49;65.3061224489796;34.6938775510204
1427;535;"kiernan";1962;72.7319062181447;27.2680937818553
0;35;"kierney";35;0;100
650;0;"kieron";650;100;0
18;15138;"kierra";15156;0.118764845605701;99.8812351543943
0;216;"kierrah";216;0;100
380;94;"kierre";474;80.168776371308;19.831223628692
0;73;"kierria";73;0;100
5;0;"kierron";5;100;0
0;5;"kiersa";5;0;100
0;10;"kiersen";10;0;100
0;5;"kierslyn";5;0;100
5;0;"kierson";5;100;0
0;22;"kiersta";22;0;100
0;470;"kierstan";470;0;100
5;14281;"kiersten";14286;0.0349993000139997;99.965000699986
0;34;"kiersti";34;0;100
0;15;"kierstie";15;0;100
0;3213;"kierstin";3213;0;100
13;826;"kierston";839;1.54946364719905;98.450536352801
0;8;"kiersty";8;0;100
0;2225;"kierstyn";2225;0;100
0;107;"kierstynn";107;0;100
0;24;"kiersyn";24;0;100
17;182;"kieryn";199;8.5427135678392;91.4572864321608
0;21;"kiesa";21;0;100
0;5;"kiesel";5;0;100
0;2621;"kiesha";2621;0;100
40;0;"kieshawn";40;100;0
0;38;"kieshia";38;0;100
6;0;"kieston";6;100;0
329;0;"kiet";329;100;0
2835;0;"kieth";2835;100;0
0;145;"kieu";145;0;100
74;0;"kiev";74;100;0
0;26;"kieva";26;0;100
6;0;"kievan";6;100;0
11;0;"kievon";11;100;0
0;47;"kieya";47;0;100
0;18;"kieyana";18;0;100
0;122;"kiffany";122;0;100
0;5;"kiffin";5;0;100
0;24;"kihana";24;0;100
0;71;"kihanna";71;0;100
0;51;"kihara";51;0;100
5;0;"kiheem";5;100;0
6;0;"kihry";6;100;0
0;7;"kiiara";7;0;100
17;0;"kiichi";17;100;0
46;0;"kiing";46;100;0
0;113;"kiira";113;0;100
0;5;"kiirsten";5;0;100
0;13;"kiisha";13;0;100
0;30;"kija";30;0;100
0;16;"kijafa";16;0;100
0;44;"kijah";44;0;100
264;137;"kijana";401;65.8354114713217;34.1645885286783
21;0;"kijani";21;100;0
33;0;"kijon";33;100;0
297;0;"kijuan";297;100;0
0;76;"kijuana";76;0;100
0;10;"kika";10;0;100
25;984;"kiki";1009;2.47770069375619;97.5222993062438
72;42;"kiko";114;63.1578947368421;36.8421052631579
0;7;"kiku";7;0;100
0;297;"kikue";297;0;100
0;26;"kikuko";26;0;100
0;6;"kikumi";6;0;100
0;95;"kikuye";95;0;100
0;31;"kikuyo";31;0;100
0;13;"kikyo";13;0;100
5;872;"kila";877;0.570125427594071;99.4298745724059
0;372;"kilah";372;0;100
69;0;"kilan";69;100;0
0;5;"kilana";5;0;100
0;98;"kilani";98;0;100
6;0;"kilbourne";6;100;0
5;0;"kilburn";5;100;0
6;0;"kilby";6;100;0
1053;0;"kile";1053;100;0
0;79;"kilea";79;0;100
0;43;"kileah";43;0;100
5;0;"kilean";5;100;0
0;1710;"kilee";1710;0;100
0;118;"kileen";118;0;100
0;20;"kilei";20;0;100
0;638;"kileigh";638;0;100
22;0;"kilen";22;100;0
5;0;"kiler";5;100;0
1097;18275;"kiley";19372;5.66281230642164;94.3371876935784
0;6;"kileyann";6;0;100
6;109;"kili";115;5.21739130434783;94.7826086956522
0;34;"kilia";34;0;100
1169;21;"kilian";1190;98.2352941176471;1.76470588235294
0;258;"kilie";258;0;100
39;0;"kilik";39;100;0
0;5;"kiliyah";5;0;100
0;11;"killashandra";11;0;100
0;11;"killeen";11;0;100
7096;463;"killian";7559;93.8748511707898;6.12514882921021
24;0;"killion";24;100;0
5;0;"killis";5;100;0
14;0;"kilmer";14;100;0
55;0;"kilo";55;100;0
0;16;"kilolo";16;0;100
0;21;"kily";21;0;100
5;0;"kilyan";5;100;0
17;123;"kilyn";140;12.1428571428571;87.8571428571429
0;293;"kilynn";293;0;100
34866;179446;"kim";214312;16.2688043599985;83.7311956400015
0;277;"kima";277;0;100
0;5;"kimaada";5;0;100
24;0;"kimahri";24;100;0
0;14;"kimaka";14;0;100
0;6;"kimako";6;0;100
0;326;"kimala";326;0;100
0;32;"kimalee";32;0;100
0;35;"kimana";35;0;100
0;56;"kimanh";56;0;100
1488;1257;"kimani";2745;54.207650273224;45.792349726776
0;18;"kimann";18;0;100
43;0;"kimar";43;100;0
0;567;"kimara";567;0;100
0;13;"kimarah";13;0;100
0;14;"kimaree";14;0;100
238;429;"kimari";667;35.6821589205397;64.3178410794603
0;66;"kimaria";66;0;100
0;168;"kimarie";168;0;100
13;0;"kimario";13;100;0
62;0;"kimarion";62;100;0
7;0;"kimarley";7;100;0
0;5;"kimarri";5;0;100
0;18;"kimary";18;0;100
0;5;"kimatha";5;0;100
15;0;"kimathi";15;100;0
0;5;"kimauri";5;0;100
0;793;"kimaya";793;0;100
0;19;"kimayah";19;0;100
0;85;"kimba";85;0;100
56;5;"kimbal";61;91.8032786885246;8.19672131147541
0;5;"kimbala";5;0;100
1910;140;"kimball";2050;93.1707317073171;6.82926829268293
11;0;"kimbel";11;100;0
10;0;"kimbell";10;100;0
0;152;"kimbella";152;0;100
0;35;"kimbelry";35;0;100
0;433;"kimbely";433;0;100
343;7599;"kimber";7942;4.31881138252329;95.6811886174767
0;11;"kimbereley";11;0;100
0;2301;"kimberely";2301;0;100
0;62;"kimberl";62;0;100
0;149;"kimberla";149;0;100
0;6;"kimberland";6;0;100
0;1219;"kimberle";1219;0;100
0;531;"kimberlea";531;0;100
0;17419;"kimberlee";17419;0;100
0;18;"kimberlei";18;0;100
0;697;"kimberleigh";697;0;100
235;37825;"kimberley";38060;0.617446137677352;99.3825538623227
0;3857;"kimberli";3857;0;100
0;3628;"kimberlie";3628;0;100
0;1059;"kimberlin";1059;0;100
0;19;"kimberlina";19;0;100
0;6;"kimberline";6;0;100
0;184;"kimberlly";184;0;100
4263;833311;"kimberly";837574;0.508969953699613;99.4910300463004
0;393;"kimberlyann";393;0;100
0;46;"kimberlyanne";46;0;100
0;70;"kimberlye";70;0;100
0;3534;"kimberlyn";3534;0;100
0;780;"kimberlynn";780;0;100
0;5;"kimberlyy";5;0;100
0;532;"kimbery";532;0;100
0;5;"kimberyl";5;0;100
0;5;"kimbie";5;0;100
0;5;"kimbla";5;0;100
588;226;"kimble";814;72.2358722358722;27.7641277641278
0;10;"kimbler";10;0;100
0;157;"kimblery";157;0;100
0;573;"kimbley";573;0;100
0;135;"kimbly";135;0;100
0;6;"kimblyn";6;0;100
0;1226;"kimbra";1226;0;100
0;36;"kimbre";36;0;100
0;72;"kimbree";72;0;100
5;5;"kimbrell";10;50;50
0;78;"kimbrely";78;0;100
0;75;"kimbria";75;0;100
0;5;"kimbrielle";5;0;100
0;5;"kimbrley";5;0;100
0;44;"kimbrly";44;0;100
0;6;"kimby";6;0;100
0;5;"kimchi";5;0;100
0;61;"kimeka";61;0;100
0;20;"kimeko";20;0;100
0;320;"kimela";320;0;100
0;5;"kimella";5;0;100
0;11;"kimely";11;0;100
0;28;"kimera";28;0;100
0;603;"kimerly";603;0;100
0;43;"kimery";43;0;100
0;322;"kimesha";322;0;100
0;114;"kimetha";114;0;100
0;19;"kimetra";19;0;100
0;10;"kimette";10;0;100
160;1702;"kimi";1862;8.59291084854995;91.4070891514501
0;453;"kimia";453;0;100
0;65;"kimiah";65;0;100
0;401;"kimie";401;0;100
0;104;"kimika";104;0;100
0;1649;"kimiko";1649;0;100
0;96;"kimila";96;0;100
0;10;"kimilee";10;0;100
0;20;"kimily";20;0;100
0;15;"kimimela";15;0;100
0;93;"kimimila";93;0;100
0;30;"kimira";30;0;100
0;181;"kimisha";181;0;100
0;6;"kimitra";6;0;100
0;297;"kimiya";297;0;100
0;121;"kimiyah";121;0;100
0;103;"kimiye";103;0;100
0;96;"kimiyo";96;0;100
0;154;"kimla";154;0;100
0;17;"kimlee";17;0;100
0;102;"kimley";102;0;100
0;39;"kimly";39;0;100
0;10;"kimlyn";10;0;100
96;392;"kimm";488;19.672131147541;80.327868852459
0;225;"kimmarie";225;0;100
0;77;"kimmberly";77;0;100
0;83;"kimmerly";83;0;100
0;5;"kimmesha";5;0;100
0;23;"kimmey";23;0;100
0;220;"kimmi";220;0;100
131;1228;"kimmie";1359;9.63944076526858;90.3605592347314
0;7;"kimmika";7;0;100
0;115;"kimmora";115;0;100
0;6;"kimmori";6;0;100
277;1030;"kimmy";1307;21.1935730680949;78.8064269319051
0;28;"kimmya";28;0;100
821;0;"kimo";821;100;0
126;0;"kimon";126;100;0
0;11;"kimona";11;0;100
0;5;"kimone";5;0;100
233;159;"kimoni";392;59.4387755102041;40.5612244897959
0;5;"kimonie";5;0;100
5;0;"kimonte";5;100;0
0;7488;"kimora";7488;0;100
0;287;"kimorah";287;0;100
0;10;"kimoralee";10;0;100
0;26;"kimore";26;0;100
0;11;"kimoree";11;0;100
0;75;"kimori";75;0;100
0;56;"kimoria";56;0;100
0;24;"kimorra";24;0;100
125;35;"kimothy";160;78.125;21.875
0;5;"kimoya";5;0;100
0;220;"kimra";220;0;100
61;0;"kimsey";61;100;0
0;5;"kimura";5;0;100
0;5;"kimverly";5;0;100
0;8;"kimwana";8;0;100
0;685;"kimya";685;0;100
0;60;"kimyada";60;0;100
0;100;"kimyah";100;0;100
0;153;"kimyata";153;0;100
0;330;"kimyatta";330;0;100
0;130;"kimyetta";130;0;100
0;6;"kimyia";6;0;100
0;57;"kimyra";57;0;100
242;6;"kin";248;97.5806451612903;2.41935483870968
0;1299;"kina";1299;0;100
0;11;"kinadee";11;0;100
0;5;"kinady";5;0;100
132;0;"kinan";132;100;0
0;33;"kinara";33;0;100
34;0;"kinard";34;100;0
0;73;"kinaya";73;0;100
0;25;"kinberli";25;0;100
0;18;"kinberlin";18;0;100
0;350;"kinberly";350;0;100
171;0;"kincade";171;100;0
344;0;"kincaid";344;100;0
0;255;"kinda";255;0;100
0;309;"kindal";309;0;100
45;581;"kindall";626;7.18849840255591;92.8115015974441
0;6;"kindalyn";6;0;100
5;66;"kindel";71;7.04225352112676;92.9577464788732
52;174;"kindell";226;23.0088495575221;76.9911504424779
10;0;"kinden";10;100;0
0;10;"kinder";10;0;100
37;482;"kindle";519;7.12909441233141;92.8709055876686
0;3845;"kindra";3845;0;100
0;5;"kindrea";5;0;100
101;89;"kindred";190;53.1578947368421;46.8421052631579
5;0;"kindric";5;100;0
89;0;"kindrick";89;100;0
0;5;"kindsay";5;0;100
0;82;"kindsey";82;0;100
11;0;"kindu";11;100;0
0;26;"kindy";26;0;100
0;46;"kindyl";46;0;100
0;8;"kine";8;0;100
0;127;"kinesha";127;0;100
0;10;"kineshia";10;0;100
0;60;"kineta";60;0;100
20471;10;"king";20481;99.9511742590694;0.0488257409306186
0;187;"kinga";187;0;100
6;0;"kingamir";6;100;0
5;0;"kinganthony";5;100;0
18;0;"kingcharles";18;100;0
136;0;"kingdavid";136;100;0
93;0;"kingdom";93;100;0
32;0;"kingdon";32;100;0
18;0;"kingelijah";18;100;0
10;0;"kingg";10;100;0
12;0;"kingisaiah";12;100;0
88;0;"kingjames";88;100;0
11;0;"kingjoseph";11;100;0
31;0;"kingjosiah";31;100;0
6;0;"kingman";6;100;0
11;0;"kingmessiah";11;100;0
12;0;"kingmichael";12;100;0
76;51;"kingslee";127;59.8425196850394;40.1574803149606
0;20;"kingsleigh";20;0;100
3622;723;"kingsley";4345;83.3601841196778;16.6398158803222
53;0;"kingsly";53;100;0
17;0;"kingsolomon";17;100;0
57;0;"kingson";57;100;0
19;0;"kingstan";19;100;0
314;0;"kingsten";314;100;0
148;0;"kingstin";148;100;0
20654;111;"kingston";20765;99.4654466650614;0.534553334938599
10;0;"kingstun";10;100;0
163;0;"kingstyn";163;100;0
5;0;"kingzion";5;100;0
7;0;"kingzley";7;100;0
6;0;"kingzton";6;100;0
0;5;"kini";5;0;100
0;5;"kiniah";5;0;100
0;5;"kiniesha";5;0;100
0;10;"kinika";10;0;100
0;124;"kinisha";124;0;100
0;12;"kinita";12;0;100
0;11;"kiniya";11;0;100
0;18;"kiniyah";18;0;100
0;87;"kinjal";87;0;100
5;0;"kinji";5;100;0
17;0;"kinkade";17;100;0
0;43;"kinlea";43;0;100
0;1783;"kinlee";1783;0;100
0;33;"kinlei";33;0;100
0;1394;"kinleigh";1394;0;100
297;13855;"kinley";14152;2.09864330130017;97.9013566986998
0;25;"kinli";25;0;100
0;74;"kinlie";74;0;100
0;57;"kinly";57;0;100
0;37;"kinlyn";37;0;100
0;26;"kinlynn";26;0;100
0;25;"kinna";25;0;100
5;0;"kinnard";5;100;0
0;16;"kinnedi";16;0;100
0;77;"kinnedy";77;0;100
0;5;"kinneret";5;0;100
175;0;"kinneth";175;100;0
354;0;"kinney";354;100;0
369;5;"kinnick";374;98.6631016042781;1.33689839572193
0;26;"kinnidi";26;0;100
0;11;"kinnidy";11;0;100
159;5;"kinnie";164;96.9512195121951;3.04878048780488
21;0;"kinnith";21;100;0
0;253;"kinnley";253;0;100
7;0;"kinnon";7;100;0
20;0;"kinny";20;100;0
198;0;"kino";198;100;0
0;5;"kinsasha";5;0;100
0;22;"kinsee";22;0;100
0;5;"kinsely";5;0;100
96;0;"kinser";96;100;0
295;6893;"kinsey";7188;4.10406232609905;95.8959376739009
6;116;"kinshasa";122;4.91803278688525;95.0819672131148
0;5;"kinshasha";5;0;100
0;139;"kinsie";139;0;100
0;11;"kinsington";11;0;100
0;62;"kinslea";62;0;100
0;2063;"kinslee";2063;0;100
0;49;"kinslei";49;0;100
0;799;"kinsleigh";799;0;100
230;25;"kinsler";255;90.1960784313726;9.80392156862745
116;18317;"kinsley";18433;0.629306135734823;99.3706938642652
0;20;"kinsli";20;0;100
0;202;"kinslie";202;0;100
0;57;"kinsly";57;0;100
10;0;"kinson";10;100;0
120;0;"kinston";120;100;0
73;14;"kinta";87;83.9080459770115;16.0919540229885
213;12;"kinte";225;94.6666666666667;5.33333333333333
5;0;"kintrell";5;100;0
0;21;"kinue";21;0;100
0;8;"kinuko";8;0;100
0;5;"kinverli";5;0;100
0;5;"kinverlin";5;0;100
0;342;"kinya";342;0;100
0;10;"kinyada";10;0;100
0;22;"kinyata";22;0;100
0;45;"kinyatta";45;0;100
0;38;"kinyetta";38;0;100
15;0;"kinyon";15;100;0
0;319;"kinza";319;0;100
0;111;"kinze";111;0;100
0;216;"kinzee";216;0;100
20;0;"kinzer";20;100;0
0;361;"kinzey";361;0;100
0;260;"kinzi";260;0;100
0;1357;"kinzie";1357;0;100
0;6;"kinzington";6;0;100
0;685;"kinzlee";685;0;100
0;187;"kinzleigh";187;0;100
5;0;"kinzler";5;100;0
0;1201;"kinzley";1201;0;100
0;25;"kinzli";25;0;100
0;95;"kinzlie";95;0;100
0;65;"kinzly";65;0;100
0;183;"kinzy";183;0;100
5;0;"kio";5;100;0
0;13;"kioka";13;0;100
0;5;"kioko";5;0;100
0;43;"kiomara";43;0;100
0;5;"kiomi";5;0;100
0;6;"kiomy";6;0;100
745;0;"kion";745;100;0
0;1578;"kiona";1578;0;100
0;17;"kionah";17;0;100
0;136;"kiondra";136;0;100
96;0;"kiondre";96;100;0
31;0;"kione";31;100;0
0;119;"kioni";119;0;100
0;5;"kionia";5;0;100
0;1127;"kionna";1127;0;100
38;15;"kionne";53;71.6981132075472;28.3018867924528
11;0;"kiontae";11;100;0
206;16;"kionte";222;92.7927927927928;7.20720720720721
0;118;"kiora";118;0;100
0;6;"kiori";6;0;100
0;175;"kiosha";175;0;100
6;0;"kiotti";6;100;0
175;65;"kiowa";240;72.9166666666667;27.0833333333333
7648;154;"kip";7802;98.0261471417585;1.97385285824148
7;0;"kipchoge";7;100;0
0;5;"kipenie";5;0;100
27;0;"kipley";27;100;0
5;0;"kiplin";5;100;0
309;0;"kipling";309;100;0
2128;5;"kipp";2133;99.7655883731833;0.23441162681669
95;0;"kipper";95;100;0
0;52;"kippi";52;0;100
11;33;"kippie";44;25;75
166;102;"kippy";268;61.9402985074627;38.0597014925373
33;0;"kipten";33;100;0
12;0;"kiptin";12;100;0
798;0;"kipton";798;100;0
580;17;"kiptyn";597;97.1524288107203;2.84757118927973
27;33689;"kira";33716;0.0800806738640408;99.919919326136
0;860;"kirah";860;0;100
0;20;"kiralee";20;0;100
0;45;"kiralyn";45;0;100
0;40;"kiralynn";40;0;100
2142;1738;"kiran";3880;55.2061855670103;44.7938144329897
0;55;"kirana";55;0;100
0;114;"kirandeep";114;0;100
0;5;"kiranjot";5;0;100
0;6;"kirara";6;0;100
0;26;"kirat";26;0;100
0;5;"kirbee";5;0;100
0;191;"kirbi";191;0;100
0;212;"kirbie";212;0;100
13971;3497;"kirby";17468;79.980535836959;20.019464163041
97;5;"kire";102;95.0980392156863;4.90196078431373
106;16;"kiree";122;86.8852459016393;13.1147540983607
0;5;"kireina";5;0;100
135;33;"kiren";168;80.3571428571429;19.6428571428571
0;865;"kiri";865;0;100
0;19;"kiria";19;0;100
0;36;"kiriaki";36;0;100
10;0;"kiriakos";10;100;0
10;5;"kirian";15;66.6666666666667;33.3333333333333
0;79;"kiriana";79;0;100
0;19;"kirianna";19;0;100
0;46;"kirie";46;0;100
137;0;"kiril";137;100;0
331;0;"kirill";331;100;0
338;372;"kirin";710;47.6056338028169;52.3943661971831
0;5;"kirina";5;0;100
0;5;"kirisa";5;0;100
0;31;"kiristen";31;0;100
67406;197;"kirk";67603;99.7085928139284;0.291407186071624
71;0;"kirke";71;100;0
41;0;"kirklan";41;100;0
2082;12;"kirkland";2094;99.4269340974212;0.573065902578797
11;0;"kirklen";11;100;0
97;0;"kirklin";97;100;0
24;44;"kirklyn";68;35.2941176470588;64.7058823529412
25;0;"kirkpatrick";25;100;0
35;0;"kirkwood";35;100;0
23;0;"kiro";23;100;0
20;0;"kirollos";20;100;0
23;0;"kirolos";23;100;0
258;0;"kiron";258;100;0
17;0;"kiros";17;100;0
0;25;"kirpa";25;0;100
0;2214;"kirra";2214;0;100
0;82;"kirrah";82;0;100
0;5;"kirsey";5;0;100
0;47;"kirsha";47;0;100
0;88;"kirsi";88;0;100
0;264;"kirsta";264;0;100
0;478;"kirstan";478;0;100
0;32;"kirstee";32;0;100
0;68;"kirstein";68;0;100
211;52568;"kirsten";52779;0.399780215616059;99.6002197843839
0;5;"kirstey";5;0;100
0;1010;"kirsti";1010;0;100
0;20;"kirstian";20;0;100
0;4150;"kirstie";4150;0;100
0;26;"kirstien";26;0;100
0;8744;"kirstin";8744;0;100
0;126;"kirstina";126;0;100
0;126;"kirstine";126;0;100
0;228;"kirston";228;0;100
6;0;"kirstopher";6;100;0
0;945;"kirsty";945;0;100
0;2263;"kirstyn";2263;0;100
0;11;"kirstynn";11;0;100
0;11;"kirsy";11;0;100
3617;0;"kirt";3617;100;0
145;0;"kirtan";145;100;0
0;10;"kirtana";10;0;100
0;6;"kirthana";6;0;100
5;0;"kirthik";5;100;0
0;69;"kirti";69;0;100
122;0;"kirtis";122;100;0
12;0;"kirtland";12;100;0
12;0;"kirtley";12;100;0
46;0;"kirtus";46;100;0
152;0;"kirubel";152;100;0
5;0;"kirwin";5;100;0
20;0;"kiry";20;100;0
0;11;"kirya";11;0;100
17;56;"kiryn";73;23.2876712328767;76.7123287671233
0;5;"kirynn";5;0;100
0;577;"kisa";577;0;100
5;0;"kisan";5;100;0
0;17;"kisara";17;0;100
0;74;"kischa";74;0;100
63;0;"kisean";63;100;0
53;0;"kiser";53;100;0
5;15;"kish";20;25;75
12;6616;"kisha";6628;0.181050090525045;99.818949909475
959;0;"kishan";959;100;0
0;89;"kishana";89;0;100
0;5;"kishanna";5;0;100
5;21;"kishara";26;19.2307692307692;80.7692307692308
141;0;"kishaun";141;100;0
0;17;"kishauna";17;0;100
326;10;"kishawn";336;97.0238095238095;2.97619047619048
0;38;"kishawna";38;0;100
0;6;"kishea";6;0;100
16;0;"kishen";16;100;0
0;5;"kisher";5;0;100
0;273;"kishia";273;0;100
0;19;"kishina";19;0;100
0;5;"kishla";5;0;100
0;5;"kishma";5;0;100
262;20;"kishon";282;92.9078014184397;7.09219858156028
0;5;"kishonna";5;0;100
30;0;"kishore";30;100;0
7;0;"kishun";7;100;0
0;5;"kisia";5;0;100
0;14;"kiska";14;0;100
0;169;"kismet";169;0;100
11;0;"kison";11;100;0
0;68;"kissa";68;0;100
0;29;"kissey";29;0;100
0;5;"kissha";5;0;100
0;13;"kissiah";13;0;100
0;100;"kissie";100;0;100
0;136;"kissy";136;0;100
0;79;"kista";79;0;100
0;29;"kisten";29;0;100
0;7;"kistin";7;0;100
0;5;"kistina";5;0;100
0;25;"kisty";25;0;100
0;42;"kiswana";42;0;100
0;5;"kiswanna";5;0;100
2722;1247;"kit";3969;68.5815066767448;31.4184933232552
0;164;"kita";164;0;100
126;0;"kitai";126;100;0
0;1148;"kitana";1148;0;100
0;34;"kitanna";34;0;100
0;146;"kitara";146;0;100
0;94;"kitiara";94;0;100
0;60;"kitina";60;0;100
155;11;"kito";166;93.3734939759036;6.62650602409639
0;46;"kitra";46;0;100
7;0;"kitrick";7;100;0
0;264;"kitrina";264;0;100
0;6;"kitsia";6;0;100
5;0;"kitson";5;100;0
0;10;"kitsy";10;0;100
122;179;"kitt";301;40.531561461794;59.468438538206
0;54;"kitten";54;0;100
0;130;"kitti";130;0;100
0;1675;"kittie";1675;0;100
0;11087;"kitty";11087;0;100
0;12;"kittye";12;0;100
16;0;"kitwana";16;100;0
0;5;"kitza";5;0;100
0;6;"kitzi";6;0;100
0;344;"kitzia";344;0;100
0;27;"kitzie";27;0;100
0;13;"kitzya";13;0;100
0;7;"kiuna";7;0;100
24;710;"kiva";734;3.26975476839237;96.7302452316076
6;0;"kivan";6;100;0
303;0;"kiven";303;100;0
20;0;"kivin";20;100;0
62;0;"kivon";62;100;0
97;0;"kiwan";97;100;0
0;260;"kiwana";260;0;100
0;44;"kiwanda";44;0;100
47;0;"kiwane";47;100;0
0;19;"kiwanis";19;0;100
0;98;"kiwanna";98;0;100
5;0;"kiwon";5;100;0
37;0;"kix";37;100;0
23;3516;"kiya";3539;0.649901102006216;99.3500988979938
56;0;"kiyaan";56;100;0
0;1759;"kiyah";1759;0;100
0;5;"kiyami";5;0;100
1048;28;"kiyan";1076;97.3977695167286;2.60223048327138
0;1376;"kiyana";1376;0;100
0;50;"kiyanah";50;0;100
0;81;"kiyani";81;0;100
0;6;"kiyann";6;0;100
0;692;"kiyanna";692;0;100
0;10;"kiyanni";10;0;100
6;0;"kiyansh";6;100;0
0;315;"kiyara";315;0;100
0;5;"kiyarah";5;0;100
0;20;"kiyari";20;0;100
0;6;"kiyarra";6;0;100
0;12;"kiyasha";12;0;100
5;0;"kiyel";5;100;0
0;5;"kiyelle";5;0;100
35;0;"kiyen";35;100;0
0;247;"kiyla";247;0;100
0;67;"kiylah";67;0;100
5;0;"kiylan";5;100;0
11;0;"kiyle";11;100;0
0;161;"kiylee";161;0;100
16;0;"kiyler";16;100;0
0;6;"kiylie";6;0;100
0;102;"kiyo";102;0;100
0;855;"kiyoko";855;0;100
6;779;"kiyomi";785;0.764331210191083;99.2356687898089
391;0;"kiyon";391;100;0
0;145;"kiyona";145;0;100
0;238;"kiyonna";238;0;100
0;35;"kiyono";35;0;100
0;6;"kiyora";6;0;100
1138;10;"kiyoshi";1148;99.1289198606272;0.871080139372822
70;0;"kiyoto";70;100;0
0;88;"kiyra";88;0;100
0;10;"kiyrah";10;0;100
0;6;"kiyuana";6;0;100
0;39;"kiz";39;0;100
105;0;"kizer";105;100;0
0;7;"kizi";7;0;100
0;20;"kiziah";20;0;100
0;42;"kizmet";42;0;100
0;5;"kizuwanda";5;0;100
0;5;"kizze";5;0;100
0;24;"kizzey";24;0;100
0;70;"kizzi";70;0;100
0;1482;"kizzie";1482;0;100
12;2325;"kizzy";2337;0.513478818998716;99.4865211810013
97;0;"kj";97;100;0
10;0;"kjay";10;100;0
350;0;"kjell";350;100;0
0;305;"kjersten";305;0;100
0;249;"kjersti";249;0;100
0;243;"kjerstin";243;0;100
0;94;"kjirsten";94;0;100
27;0;"kjon";27;100;0
78;0;"kjuan";78;100;0
0;240;"kla";240;0;100
0;6;"klah";6;0;100
0;144;"klair";144;0;100
0;175;"klaira";175;0;100
0;1213;"klaire";1213;0;100
0;6;"klairissa";6;0;100
0;70;"klani";70;0;100
0;1995;"klara";1995;0;100
0;56;"klare";56;0;100
0;247;"klarisa";247;0;100
0;2573;"klarissa";2573;0;100
0;26;"klarity";26;0;100
0;11;"klariza";11;0;100
66;6;"klark";72;91.6666666666667;8.33333333333333
0;27;"klarke";27;0;100
0;11;"klarrisa";11;0;100
0;6;"klarrissa";6;0;100
0;15;"klarysa";15;0;100
0;202;"klaryssa";202;0;100
0;920;"klaudia";920;0;100
900;0;"klaus";900;100;0
839;0;"klay";839;100;0
0;7;"klayre";7;0;100
91;0;"klayten";91;100;0
2103;0;"klayton";2103;100;0
0;172;"klea";172;0;100
0;16;"kleah";16;0;100
5;0;"kleb";5;100;0
119;0;"kleber";119;100;0
0;353;"klee";353;0;100
0;265;"kleigh";265;0;100
233;0;"klein";233;100;0
0;51;"kleo";51;0;100
0;12;"kleopatra";12;0;100
90;0;"klever";90;100;0
10;0;"klevis";10;100;0
0;34;"klhoe";34;0;100
5;0;"klifton";5;100;0
211;0;"kline";211;100;0
746;0;"klint";746;100;0
575;0;"klinton";575;100;0
0;6;"klisha";6;0;100
0;44;"kliyah";44;0;100
0;2840;"kloe";2840;0;100
0;647;"kloee";647;0;100
0;45;"kloei";45;0;100
0;5;"kloeigh";5;0;100
0;1480;"kloey";1480;0;100
0;112;"klohe";112;0;100
0;7;"klohee";7;0;100
0;48;"klohie";48;0;100
0;71;"kloi";71;0;100
0;946;"kloie";946;0;100
0;5;"kloni";5;0;100
0;11;"klorissa";11;0;100
5;0;"kloud";5;100;0
0;123;"klover";123;0;100
0;5;"klowey";5;0;100
0;6;"klowi";6;0;100
0;30;"klowie";30;0;100
0;10;"kloye";10;0;100
5;0;"klutch";5;100;0
0;10;"klyda";10;0;100
87;0;"klyde";87;100;0
297;0;"klye";297;100;0
0;113;"klyn";113;0;100
0;557;"klynn";557;0;100
10;0;"kmani";10;100;0
142;128;"kmari";270;52.5925925925926;47.4074074074074
0;31;"kmarie";31;0;100
84;0;"kmarion";84;100;0
11;0;"kmauri";11;100;0
0;5;"kmaya";5;0;100
0;5;"kmiya";5;0;100
0;49;"kmiyah";49;0;100
0;33;"kmora";33;0;100
0;199;"kmya";199;0;100
0;11;"kmyah";11;0;100
0;5;"kneisha";5;0;100
0;8;"knesha";8;0;100
0;6;"knia";6;0;100
0;5;"knicole";5;0;100
379;0;"knight";379;100;0
10;30;"knightley";40;25;75
18;7;"knightly";25;72;28
27;0;"knighton";27;100;0
10;0;"kniko";10;100;0
0;12;"knisha";12;0;100
27;0;"knixon";27;100;0
0;56;"kniya";56;0;100
0;83;"kniyah";83;0;100
14;0;"knoa";14;100;0
136;0;"knoah";136;100;0
5;0;"knoel";5;100;0
0;29;"knoelle";29;0;100
53;0;"knolan";53;100;0
6;0;"knoll";6;100;0
0;12;"knova";12;0;100
863;18;"knowledge";881;97.9568671963678;2.04313280363224
21;0;"knowlton";21;100;0
8694;57;"knox";8751;99.3486458690435;0.651354130956462
11;0;"knoxley";11;100;0
28;0;"knoxton";28;100;0
5;0;"knoxville";5;100;0
159;0;"knoxx";159;100;0
55;0;"knut";55;100;0
636;0;"knute";636;100;0
0;49;"knya";49;0;100
0;47;"knyla";47;0;100
0;8;"knylah";8;0;100
57;10;"ko";67;85.0746268656716;14.9253731343284
1365;143;"koa";1508;90.5172413793103;9.48275862068965
184;0;"koah";184;100;0
195;0;"koal";195;100;0
22;0;"koalii";22;100;0
6;0;"koalton";6;100;0
15;0;"koamalu";15;100;0
42;0;"koan";42;100;0
7;0;"koba";7;100;0
21;0;"kobain";21;100;0
11;0;"kobby";11;100;0
15358;278;"kobe";15636;98.2220516756204;1.77794832437964
216;27;"kobee";243;88.8888888888889;11.1111111111111
5;0;"kobei";5;100;0
122;0;"koben";122;100;0
555;0;"kobey";555;100;0
1289;618;"kobi";1907;67.5930781331935;32.4069218668065
1350;265;"kobie";1615;83.5913312693499;16.4086687306502
8;0;"kobimtochukwu";8;100;0
52;0;"kobin";52;100;0
18;0;"kobina";18;100;0
5285;62;"koby";5347;98.8404712923135;1.15952870768655
75;0;"kobyn";75;100;0
1970;182;"koda";2152;91.542750929368;8.45724907063197
147;0;"kodah";147;100;0
5;0;"kodan";5;100;0
58;0;"kode";58;100;0
278;304;"kodee";582;47.766323024055;52.233676975945
107;0;"koden";107;100;0
677;11;"kodey";688;98.4011627906977;1.59883720930233
2385;2555;"kodi";4940;48.2793522267206;51.7206477732793
493;0;"kodiak";493;100;0
1200;1043;"kodie";2243;53.4997770842621;46.5002229157379
5;0;"kodjo";5;100;0
21680;720;"kody";22400;96.7857142857143;3.21428571428571
5;0;"kodyn";5;100;0
12;0;"koebe";12;100;0
5;0;"koedy";5;100;0
86;0;"koehn";86;100;0
0;7;"koemi";7;0;100
2699;10;"koen";2709;99.6308600959764;0.369139904023625
0;5;"koesha";5;0;100
0;25;"koey";25;0;100
10;0;"koffi";10;100;0
1188;5;"kofi";1193;99.5808885163453;0.419111483654652
16;0;"kogan";16;100;0
29;0;"koh";29;100;0
78;0;"kohan";78;100;0
0;128;"kohana";128;0;100
0;34;"koharu";34;0;100
140;0;"kohei";140;100;0
2565;29;"kohen";2594;98.8820354664611;1.11796453353894
1589;0;"kohl";1589;100;0
27;0;"kohlby";27;100;0
90;0;"kohle";90;100;0
0;5;"kohlee";5;0;100
102;0;"kohler";102;100;0
25;0;"kohlman";25;100;0
14;0;"kohlson";14;100;0
5;0;"kohlston";5;100;0
22;0;"kohlten";22;100;0
375;0;"kohlton";375;100;0
111;0;"kohner";111;100;0
18;0;"kohyn";18;100;0
405;225;"koi";630;64.2857142857143;35.7142857142857
145;0;"koichi";145;100;0
15;0;"kojak";15;100;0
452;0;"koji";452;100;0
6;0;"kojiro";6;100;0
270;0;"kojo";270;100;0
0;5;"kokeeta";5;0;100
0;6;"koketa";6;0;100
123;0;"koki";123;100;0
0;35;"koko";35;0;100
0;5;"kokomi";5;0;100
0;11;"kokoro";11;0;100
5;0;"kokou";5;100;0
157;0;"kol";157;100;0
13;0;"kolade";13;100;0
43;0;"kolawole";43;100;0
1224;37;"kolbe";1261;97.065820777161;2.93417922283902
61;58;"kolbee";119;51.2605042016807;48.7394957983193
47;0;"kolben";47;100;0
230;22;"kolbey";252;91.2698412698413;8.73015873015873
250;614;"kolbi";864;28.9351851851852;71.0648148148148
371;863;"kolbie";1234;30.064829821718;69.935170178282
16;0;"kolbin";16;100;0
10178;1063;"kolby";11241;90.5435459478694;9.45645405213059
7;0;"kolbyn";7;100;0
220;0;"kolden";220;100;0
8;0;"koldyn";8;100;0
7575;40;"kole";7615;99.4747209455023;0.525279054497702
14;0;"koleby";14;100;0
0;10;"kolee";10;0;100
0;233;"koleen";233;0;100
0;5;"koleigh";5;0;100
177;0;"koleman";177;100;0
0;46;"kolene";46;0;100
112;0;"koleson";112;100;0
0;19;"koleta";19;0;100
300;0;"koleton";300;100;0
0;276;"kolette";276;0;100
0;6;"koley";6;0;100
13;8;"koli";21;61.9047619047619;38.0952380952381
0;5;"kolia";5;0;100
0;42;"kolie";42;0;100
1729;0;"kolin";1729;100;0
0;64;"kolina";64;0;100
0;1016;"kolleen";1016;0;100
100;0;"kollen";100;100;0
0;19;"kollette";19;0;100
10;0;"kollier";10;100;0
2379;5;"kollin";2384;99.7902684563758;0.209731543624161
17;163;"kollins";180;9.44444444444444;90.5555555555556
158;12;"kollyn";170;92.9411764705882;7.05882352941176
0;98;"kollyns";98;0;100
163;0;"kolsen";163;100;0
311;0;"kolson";311;100;0
24;0;"kolsten";24;100;0
160;0;"kolston";160;100;0
26;0;"kolsyn";26;100;0
1511;0;"kolt";1511;100;0
220;0;"koltan";220;100;0
4259;0;"kolten";4259;100;0
552;0;"kolter";552;100;0
687;0;"koltin";687;100;0
11563;0;"kolton";11563;100;0
748;5;"koltyn";753;99.33598937583;0.664010624169987
5;0;"koltynn";5;100;0
23;0;"kolvin";23;100;0
14;6;"kolya";20;70;30
175;0;"kolyn";175;100;0
0;631;"komal";631;0;100
0;23;"komalpreet";23;0;100
27;0;"komari";27;100;0
0;10;"komeka";10;0;100
0;5;"komora";5;0;100
294;133;"kona";427;68.8524590163934;31.1475409836066
44;0;"konan";44;100;0
6;0;"konar";6;100;0
16;0;"konata";16;100;0
0;41;"konda";41;0;100
11;0;"kondwani";11;100;0
28;0;"koner";28;100;0
0;8;"konesha";8;0;100
0;29;"koneta";29;0;100
935;0;"kong";935;100;0
18;0;"kongcheng";18;100;0
264;0;"kongmeng";264;100;0
7;0;"kongmong";7;100;0
52;0;"kongpheng";52;100;0
0;282;"koni";282;0;100
0;54;"konica";54;0;100
0;5;"konika";5;0;100
0;7;"konisha";7;0;100
5;5;"konley";10;50;50
137;5;"konnar";142;96.4788732394366;3.52112676056338
4661;134;"konner";4795;97.2054223149114;2.79457768508863
0;207;"konni";207;0;100
0;1078;"konnie";1078;0;100
4476;89;"konnor";4565;98.0503833515882;1.94961664841183
0;5;"konny";5;0;100
6;0;"kono";6;100;0
226;0;"konor";226;100;0
3378;0;"konrad";3378;100;0
0;303;"konstance";303;0;100
29;0;"konstandinos";29;100;0
421;0;"konstantin";421;100;0
0;444;"konstantina";444;0;100
336;6;"konstantine";342;98.2456140350877;1.75438596491228
6;0;"konstantino";6;100;0
1721;0;"konstantinos";1721;100;0
30;0;"konstanty";30;100;0
6;0;"kontar";6;100;0
0;10;"kontina";10;0;100
0;5;"kontrina";5;0;100
6;0;"konur";6;100;0
6;62;"konya";68;8.82352941176471;91.1764705882353
8;0;"konyae";8;100;0
21;0;"konye";21;100;0
0;5;"kookie";5;0;100
10;0;"koon";10;100;0
2220;193;"kooper";2413;92.0016576875259;7.9983423124741
5;0;"koorosh";5;100;0
5;0;"koosha";5;100;0
0;10;"kopelyn";10;0;100
0;6;"kopelynn";6;0;100
5;0;"kor";5;100;0
0;4044;"kora";4044;0;100
0;482;"korah";482;0;100
0;231;"koraima";231;0;100
0;753;"koral";753;0;100
0;65;"koralee";65;0;100
0;15;"koraleigh";15;0;100
0;19;"koralie";19;0;100
0;159;"koraline";159;0;100
0;99;"koralyn";99;0;100
0;6;"koralyne";6;0;100
0;92;"koralynn";92;0;100
531;10;"koran";541;98.1515711645102;1.84842883548983
110;0;"koray";110;100;0
0;73;"korayma";73;0;100
394;0;"korban";394;100;0
1580;0;"korben";1580;100;0
6624;112;"korbin";6736;98.3372921615202;1.66270783847981
6;0;"korbon";6;100;0
94;12;"korby";106;88.6792452830189;11.3207547169811
2026;469;"korbyn";2495;81.2024048096192;18.7975951903808
0;6;"korbynn";6;0;100
400;0;"kord";400;100;0
161;0;"kordae";161;100;0
53;0;"kordai";53;100;0
38;0;"kordale";38;100;0
5;0;"kordan";5;100;0
20;0;"kordarius";20;100;0
13;0;"korday";13;100;0
103;0;"korde";103;100;0
111;0;"kordel";111;100;0
0;52;"kordelia";52;0;100
1475;0;"kordell";1475;100;0
5;0;"korden";5;100;0
20;0;"kordero";20;100;0
72;0;"kore";72;100;0
0;241;"korea";241;0;100
14;0;"korede";14;100;0
231;374;"koree";605;38.1818181818182;61.8181818181818
5;0;"koreem";5;100;0
0;654;"koreen";654;0;100
0;90;"koreena";90;0;100
6;0;"korei";6;100;0
227;1519;"koren";1746;13.0011454753723;86.9988545246277
0;456;"korena";456;0;100
0;205;"korene";205;0;100
5;0;"koreon";5;100;0
0;6;"koressa";6;0;100
0;14;"koretta";14;0;100
10816;1316;"korey";12132;89.1526541378174;10.8473458621827
11;0;"koreyon";11;100;0
1296;11546;"kori";12842;10.0918859990656;89.9081140009344
17;0;"korian";17;100;0
0;95;"koriana";95;0;100
0;32;"koriann";32;0;100
0;83;"korianna";83;0;100
0;29;"korianne";29;0;100
422;2052;"korie";2474;17.0573969280517;82.9426030719483
0;5;"korilyn";5;0;100
0;16;"korilynn";16;0;100
85;1123;"korin";1208;7.0364238410596;92.9635761589404
0;2421;"korina";2421;0;100
0;264;"korine";264;0;100
0;60;"korinn";60;0;100
0;390;"korinna";390;0;100
0;1173;"korinne";1173;0;100
5;0;"korinthian";5;100;0
76;0;"korion";76;100;0
0;5;"korionna";5;0;100
0;357;"korissa";357;0;100
0;12;"korla";12;0;100
0;6;"korlee";6;0;100
0;5;"korlyn";5;0;100
5;0;"kornel";5;100;0
0;39;"kornelia";39;0;100
46;0;"kornelius";46;100;0
21;0;"kornell";21;100;0
130;0;"koron";130;100;0
0;560;"korra";560;0;100
0;44;"korrah";44;0;100
0;10;"korren";10;0;100
113;0;"korrey";113;100;0
6;543;"korri";549;1.09289617486339;98.9071038251366
30;719;"korrie";749;4.00534045393858;95.9946595460614
10;0;"korrigan";10;100;0
0;528;"korrin";528;0;100
0;366;"korrina";366;0;100
0;518;"korrine";518;0;100
6;0;"korrion";6;100;0
360;12;"korry";372;96.7741935483871;3.2258064516129
0;290;"korryn";290;0;100
0;6;"korsica";6;0;100
467;0;"kort";467;100;0
0;5;"kortana";5;0;100
587;0;"kortez";587;100;0
12;0;"kortlan";12;100;0
132;0;"kortland";132;100;0
10;0;"kortlin";10;100;0
0;201;"kortlyn";201;0;100
0;86;"kortlynn";86;0;100
0;69;"kortne";69;0;100
0;650;"kortnee";650;0;100
0;41;"kortnei";41;0;100
436;5254;"kortney";5690;7.66256590509666;92.3374340949033
0;1173;"kortni";1173;0;100
0;767;"kortnie";767;0;100
0;82;"kortny";82;0;100
130;0;"korver";130;100;0
160;0;"korvin";160;100;0
5;0;"korvyn";5;100;0
10;0;"korwin";10;100;0
13924;1245;"kory";15169;91.792471487903;8.20752851209704
0;697;"koryn";697;0;100
0;27;"koryna";27;0;100
0;6;"koryne";6;0;100
0;401;"korynn";401;0;100
0;140;"korynne";140;0;100
72;0;"kosei";72;100;0
0;113;"kosha";113;0;100
12;0;"kosi";12;100;0
0;5;"kosisochi";5;0;100
67;77;"kosisochukwu";144;46.5277777777778;53.4722222222222
277;0;"kosta";277;100;0
10;0;"kostandinos";10;100;0
240;0;"kostantinos";240;100;0
5;0;"kostanty";5;100;0
336;0;"kostas";336;100;0
5;0;"kosten";5;100;0
185;0;"koston";185;100;0
46;0;"kosuke";46;100;0
450;42;"kota";492;91.4634146341463;8.53658536585366
163;0;"kotaro";163;100;0
6;0;"kothan";6;100;0
0;5;"kother";5;0;100
0;5;"koti";5;0;100
0;20;"kotina";20;0;100
0;5;"kotomi";5;0;100
0;5;"kotryna";5;0;100
454;30;"koty";484;93.801652892562;6.19834710743802
686;33;"kou";719;95.4102920723227;4.58970792767733
63;0;"koua";63;100;0
5;0;"kouhei";5;100;0
22;0;"kouki";22;100;0
0;55;"koula";55;0;100
82;0;"kouper";82;100;0
0;5;"kouri";5;0;100
164;0;"kourosh";164;100;0
0;17;"kourteney";17;0;100
94;0;"kourtland";94;100;0
0;262;"kourtlyn";262;0;100
0;90;"kourtlynn";90;0;100
0;5;"kourtne";5;0;100
0;649;"kourtnee";649;0;100
0;142;"kourtnei";142;0;100
780;13269;"kourtney";14049;5.55199658338672;94.4480034166133
0;761;"kourtni";761;0;100
0;668;"kourtnie";668;0;100
0;51;"kourtny";51;0;100
62;0;"koury";62;100;0
16;0;"koushik";16;100;0
5;0;"kousuke";5;100;0
27;0;"kouta";27;100;0
0;29;"kouture";29;0;100
0;6;"kova";6;0;100
5;0;"kovan";5;100;0
27;0;"kove";27;100;0
95;0;"koven";95;100;0
10;0;"kovi";10;100;0
5;0;"kovid";5;100;0
14;0;"kovin";14;100;0
11;0;"kovu";11;100;0
7;0;"kowan";7;100;0
0;20;"kowana";20;0;100
0;7;"kowanda";7;0;100
0;5;"kowanna";5;0;100
194;0;"kowen";194;100;0
0;38;"kowsar";38;0;100
727;34;"koy";761;95.5321944809461;4.46780551905388
0;71;"koya";71;0;100
0;7;"koyasha";7;0;100
16;0;"koye";16;100;0
22;0;"krag";22;100;0
5925;0;"kraig";5925;100;0
494;6;"kramer";500;98.8;1.2
6;0;"krash";6;100;0
70;0;"kratos";70;100;0
109;0;"kraven";109;100;0
16;0;"kray";16;100;0
5;0;"krayson";5;100;0
78;0;"krayton";78;100;0
0;5;"krea";5;0;100
141;292;"kree";433;32.5635103926097;67.4364896073903
277;0;"kreed";277;100;0
0;5;"kreelynn";5;0;100
0;5;"kreena";5;0;100
914;0;"kreg";914;100;0
393;0;"kregg";393;100;0
180;0;"kreig";180;100;0
13;0;"kreigh";13;100;0
39;0;"kreighton";39;100;0
0;20;"kreindy";20;0;100
5;0;"krenar";5;100;0
0;77;"kresha";77;0;100
5;0;"kreshnik";5;100;0
0;5;"kressida";5;0;100
0;160;"kresta";160;0;100
5;0;"kresten";5;100;0
59;0;"kreston";59;100;0
844;0;"krew";844;100;0
16;0;"krey";16;100;0
10;0;"kreyton";10;100;0
0;6;"kricia";6;0;100
0;40;"kricket";40;0;100
5;0;"kriday";5;100;0
43;0;"krieg";43;100;0
12;0;"krik";12;100;0
54;0;"krikor";54;100;0
5;0;"krillin";5;100;0
17;116;"krimson";133;12.781954887218;87.218045112782
0;17;"krimsyn";17;0;100
0;11;"krin";11;0;100
0;114;"krina";114;0;100
0;112;"kripa";112;0;100
13910;13475;"kris";27385;50.7942304181121;49.2057695818879
0;205;"krisa";205;0;100
0;176;"krisalyn";176;0;100
0;25;"krisalynn";25;0;100
0;59;"krisan";59;0;100
0;6;"krisana";6;0;100
0;267;"krisandra";267;0;100
0;436;"krisann";436;0;100
0;32;"krisanna";32;0;100
0;297;"krisanne";297;0;100
43;0;"krischan";43;100;0
0;10;"krischelle";10;0;100
0;6;"kriscinda";6;0;100
22;0;"krisean";22;100;0
0;29;"kriselda";29;0;100
0;23;"kriselle";23;0;100
0;51;"krisette";51;0;100
3377;10;"krish";3387;99.7047534691467;0.295246530853262
0;1804;"krisha";1804;0;100
7;0;"krishaan";7;100;0
10;0;"krishal";10;100;0
376;0;"krishan";376;100;0
0;162;"krishana";162;0;100
0;18;"krishanda";18;0;100
59;0;"krishang";59;100;0
0;5;"krishani";5;0;100
0;10;"krishanna";10;0;100
0;5;"krishara";5;0;100
41;6;"krishaun";47;87.2340425531915;12.7659574468085
0;83;"krishauna";83;0;100
98;0;"krishav";98;100;0
154;12;"krishawn";166;92.7710843373494;7.2289156626506
0;72;"krishawna";72;0;100
57;0;"krishay";57;100;0
0;6;"krisheena";6;0;100
0;5;"krishell";5;0;100
0;37;"krishelle";37;0;100
5;0;"krishen";5;100;0
28;12;"krishi";40;70;30
0;40;"krishika";40;0;100
5;0;"krishil";5;100;0
0;5;"krishina";5;0;100
324;0;"krishiv";324;100;0
0;19;"krishma";19;0;100
16;0;"krishn";16;100;0
1858;1764;"krishna";3622;51.2976256212038;48.7023743787962
16;0;"krishnan";16;100;0
5;0;"krishnav";5;100;0
71;0;"krishon";71;100;0
0;5;"krishona";5;0;100
0;28;"krishonda";28;0;100
5;0;"krishtian";5;100;0
0;7;"krishuna";7;0;100
0;5;"krishunna";5;0;100
0;5;"krishvi";5;0;100
0;146;"krisi";146;0;100
0;17;"krisia";17;0;100
0;52;"krisie";52;0;100
0;11;"krisily";11;0;100
0;6;"krisina";6;0;100
0;96;"krisinda";96;0;100
0;5;"krisit";5;0;100
0;16;"krisley";16;0;100
0;28;"krislin";28;0;100
0;1204;"krislyn";1204;0;100
0;502;"krislynn";502;0;100
13;94;"krisna";107;12.1495327102804;87.8504672897196
5;0;"krisopher";5;100;0
5;0;"krispin";5;100;0
543;377;"kriss";920;59.0217391304348;40.9782608695652
0;907;"krissa";907;0;100
0;59;"krissandra";59;0;100
0;341;"krissi";341;0;100
0;92;"krissia";92;0;100
0;422;"krissie";422;0;100
0;7;"krissinda";7;0;100
0;5;"krisslyn";5;0;100
0;11;"krisstina";11;0;100
10;0;"krisstopher";10;100;0
0;2097;"krissy";2097;0;100
165;37;"krist";202;81.6831683168317;18.3168316831683
148;73197;"krista";73345;0.201786079487354;99.7982139205127
0;10;"kristabel";10;0;100
0;45;"kristabella";45;0;100
0;24;"kristabelle";24;0;100
43;0;"kristafer";43;100;0
0;16;"kristah";16;0;100
66;237;"kristain";303;21.7821782178218;78.2178217821782
0;11899;"kristal";11899;0;100
0;33;"kristalee";33;0;100
0;5;"kristalle";5;0;100
0;584;"kristalyn";584;0;100
0;147;"kristalynn";147;0;100
0;6;"kristamarie";6;0;100
619;5529;"kristan";6148;10.0683148991542;89.9316851008458
0;41;"kristana";41;0;100
0;52;"kristanna";52;0;100
0;6;"kristanne";6;0;100
69;0;"kristapher";69;100;0
0;35;"kristara";35;0;100
0;29;"kristasia";29;0;100
0;621;"kriste";621;0;100
0;500;"kristee";500;0;100
0;1321;"kristeen";1321;0;100
0;377;"kristeena";377;0;100
0;2653;"kristel";2653;0;100
0;7;"kristela";7;0;100
0;186;"kristell";186;0;100
0;30;"kristella";30;0;100
0;261;"kristelle";261;0;100
2099;217373;"kristen";219472;0.956386236057447;99.0436137639425
0;752;"kristena";752;0;100
0;1008;"kristene";1008;0;100
5;0;"kristepher";5;100;0
36;16;"krister";52;69.2307692307692;30.7692307692308
0;22;"kristey";22;0;100
0;6;"kristhel";6;0;100
25;0;"kristhian";25;100;0
138;76345;"kristi";76483;0.180432252918949;99.8195677470811
0;417;"kristia";417;0;100
18473;6632;"kristian";25105;73.5829516032663;26.4170483967337
0;2589;"kristiana";2589;0;100
0;114;"kristiane";114;0;100
0;206;"kristiann";206;0;100
0;1096;"kristianna";1096;0;100
0;323;"kristianne";323;0;100
31;0;"kristiano";31;100;0
44;38269;"kristie";38313;0.114843525696239;99.8851564743038
0;5;"kristieann";5;0;100
41;264;"kristien";305;13.4426229508197;86.5573770491803
0;5;"kristiena";5;0;100
28;0;"kristifer";28;100;0
0;10;"kristiina";10;0;100
33;0;"kristijan";33;100;0
0;5;"kristijo";5;0;100
0;10;"kristil";10;0;100
0;6;"kristilee";6;0;100
0;59;"kristilyn";59;0;100
0;10;"kristilynn";10;0;100
1634;178907;"kristin";180541;0.90505757694928;99.0949424230507
352;135145;"kristina";135497;0.259784349468992;99.740215650531
0;39;"kristinamarie";39;0;100
185;83833;"kristine";84018;0.220190911471351;99.7798090885287
0;5;"kristinejoy";5;0;100
0;244;"kristinia";244;0;100
0;5;"kristinn";5;0;100
0;17;"kristinna";17;0;100
163;5;"kristion";168;97.0238095238095;2.97619047619048
0;25;"kristiona";25;0;100
219;0;"kristjan";219;100;0
0;6;"kristjana";6;0;100
0;95;"kristl";95;0;100
0;892;"kristle";892;0;100
0;55;"kristlyn";55;0;100
0;5;"kristlynn";5;0;100
0;22;"kristn";22;0;100
0;10;"kristna";10;0;100
0;11;"kristne";11;0;100
31;0;"kristo";31;100;0
11;0;"kristobal";11;100;0
264;0;"kristof";264;100;0
9;0;"kristofe";9;100;0
9456;0;"kristofer";9456;100;0
437;0;"kristoff";437;100;0
3833;0;"kristoffer";3833;100;0
6;0;"kristofferson";6;100;0
805;0;"kristofor";805;100;0
7;0;"kristoher";7;100;0
0;255;"kristol";255;0;100
514;720;"kriston";1234;41.6531604538088;58.3468395461912
21;0;"kristoper";21;100;0
5;0;"kristopfer";5;100;0
58;0;"kristoph";58;100;0
60918;297;"kristopher";61215;99.5148247978437;0.485175202156334
11;0;"kristophor";11;100;0
43;0;"kristos";43;100;0
5;0;"kristupas";5;100;0
179;70222;"kristy";70401;0.254257752020568;99.7457422479794
15;5;"kristyan";20;75;25
0;115;"kristyana";115;0;100
0;54;"kristyann";54;0;100
0;68;"kristyanna";68;0;100
0;5;"kristyanne";5;0;100
0;43;"kristye";43;0;100
0;211;"kristyl";211;0;100
0;15;"kristyle";15;0;100
0;7;"kristylee";7;0;100
0;8706;"kristyn";8706;0;100
0;717;"kristyna";717;0;100
0;396;"kristyne";396;0;100
0;81;"krisy";81;0;100
20;0;"krisztian";20;100;0
0;27;"krisztina";27;0;100
0;181;"krithi";181;0;100
205;0;"krithik";205;100;0
0;158;"krithika";158;0;100
6;0;"krithin";6;100;0
5;0;"krithvik";5;100;0
0;344;"kriti";344;0;100
0;161;"kritika";161;0;100
6;0;"kritin";6;100;0
0;5;"kritina";5;0;100
0;14;"kritzia";14;0;100
0;91;"kriya";91;0;100
17;0;"kriyansh";17;100;0
25;0;"kriz";25;100;0
0;410;"krizia";410;0;100
5;0;"kriztian";5;100;0
23;0;"kroix";23;100;0
119;0;"kron";119;100;0
5;0;"kronos";5;100;0
5;0;"kros";5;100;0
81;12;"krosby";93;87.0967741935484;12.9032258064516
314;0;"kross";314;100;0
223;0;"kroy";223;100;0
84;0;"krrish";84;100;0
10;0;"krsna";10;100;0
112;0;"kru";112;100;0
256;0;"krue";256;100;0
16;0;"kruise";16;100;0
5;0;"kruize";5;100;0
43;0;"krunal";43;100;0
0;403;"krupa";403;0;100
31;0;"kruse";31;100;0
5;0;"krush";5;100;0
0;6;"krushi";6;0;100
0;7;"krustal";7;0;100
0;39;"kruthi";39;0;100
0;109;"kruti";109;0;100
1174;27;"kruz";1201;97.751873438801;2.248126561199
246;5;"kruze";251;98.00796812749;1.99203187250996
0;5;"krya";5;0;100
5;36;"krymson";41;12.1951219512195;87.8048780487805
0;7;"krynn";7;0;100
11;47;"krys";58;18.9655172413793;81.0344827586207
0;6;"krysha";6;0;100
0;75;"krysia";75;0;100
0;20;"kryslin";20;0;100
0;74;"kryslyn";74;0;100
0;47;"kryslynn";47;0;100
0;64;"kryssa";64;0;100
0;6514;"krysta";6514;0;100
0;5;"krystabella";5;0;100
0;10;"krystah";10;0;100
190;73986;"krystal";74176;0.256147540983607;99.7438524590164
0;24;"krystalann";24;0;100
0;170;"krystale";170;0;100
0;22;"krystalee";22;0;100
0;33;"krystalin";33;0;100
0;10;"krystalina";10;0;100
0;5;"krystaline";5;0;100
0;170;"krystall";170;0;100
0;74;"krystalle";74;0;100
0;5;"krystallee";5;0;100
0;10;"krystallyn";10;0;100
0;12;"krystallynn";12;0;100
0;5;"krystalmae";5;0;100
0;5;"krystalmarie";5;0;100
0;5;"krystalrose";5;0;100
0;445;"krystalyn";445;0;100
0;237;"krystalynn";237;0;100
0;5;"krystalynne";5;0;100
0;397;"krystan";397;0;100
0;10;"kryste";10;0;100
0;5;"krysteen";5;0;100
0;79;"krysteena";79;0;100
0;1049;"krystel";1049;0;100
0;46;"krystell";46;0;100
0;191;"krystelle";191;0;100
0;3973;"krysten";3973;0;100
0;92;"krystena";92;0;100
0;793;"krysti";793;0;100
1369;479;"krystian";1848;74.0800865800866;25.9199134199134
0;377;"krystiana";377;0;100
0;91;"krystianna";91;0;100
0;521;"krystie";521;0;100
0;41;"krystil";41;0;100
0;3108;"krystin";3108;0;100
0;4718;"krystina";4718;0;100
0;927;"krystine";927;0;100
0;150;"krystl";150;0;100
44;12938;"krystle";12982;0.338930827299338;99.6610691727007
0;110;"krystn";110;0;100
15;0;"krystof";15;100;0
163;0;"krystofer";163;100;0
5;0;"krystoffer";5;100;0
0;117;"krystol";117;0;100
0;18;"kryston";18;0;100
675;0;"krystopher";675;100;0
0;33;"krysty";33;0;100
0;88;"krystyl";88;0;100
0;711;"krystyn";711;0;100
0;1641;"krystyna";1641;0;100
0;96;"krystyne";96;0;100
5;0;"kryton";5;100;0
0;5;"kryztal";5;0;100
452;0;"krzysztof";452;100;0
0;5;"ksandra";5;0;100
65;0;"ksean";65;100;0
0;377;"ksenia";377;0;100
0;88;"kseniya";88;0;100
0;9;"ksha";9;0;100
34;0;"kshaun";34;100;0
265;0;"kshawn";265;100;0
5;0;"kshon";5;100;0
6;0;"kson";6;100;0
0;12;"kt";12;0;100
0;5;"ktherine";5;0;100
0;6;"ktina";6;0;100
27;6;"ku";33;81.8181818181818;18.1818181818182
24;0;"kuan";24;100;0
98;0;"kuba";98;100;0
0;15;"kubra";15;0;100
5;0;"kubrick";5;100;0
5;0;"kudura";5;100;0
81;0;"kue";81;100;0
8;0;"kuhao";8;100;0
0;5;"kuhu";5;0;100
0;10;"kuiana";10;0;100
16;0;"kujtim";16;100;0
6;0;"kujuan";6;100;0
0;10;"kula";10;0;100
95;0;"kule";95;100;0
0;12;"kulia";12;0;100
583;0;"kullen";583;100;0
6;0;"kullin";6;100;0
5;0;"kullyn";5;100;0
0;30;"kulsoom";30;0;100
0;39;"kulsum";39;0;100
0;28;"kum";28;0;100
42;0;"kumail";42;100;0
0;5;"kumani";5;0;100
292;0;"kumar";292;100;0
31;111;"kumari";142;21.830985915493;78.169014084507
18;0;"kumasi";18;100;0
0;32;"kumba";32;0;100
0;5;"kumi";5;0;100
0;78;"kumiko";78;0;100
65;0;"kunaal";65;100;0
1216;0;"kunal";1216;100;0
0;5;"kundana";5;0;100
46;13;"kunga";59;77.9661016949153;22.0338983050847
0;5;"kuniko";5;0;100
91;0;"kunio";91;100;0
50;0;"kunj";50;100;0
10;0;"kuno";10;100;0
5;0;"kunsh";5;100;0
303;8;"kunta";311;97.427652733119;2.57234726688103
6;0;"kuntakinte";6;100;0
26;0;"kunte";26;100;0
10;0;"kuol";10;100;0
5;0;"kupaa";5;100;0
104;0;"kuper";104;100;0
62;0;"kupono";62;100;0
0;59;"kura";59;0;100
36;0;"kuran";36;100;0
5;0;"kurby";5;100;0
18;0;"kurdt";18;100;0
0;5;"kurie";5;0;100
0;7;"kurissa";7;0;100
213;0;"kurk";213;100;0
144;0;"kuron";144;100;0
11;0;"kurosh";11;100;0
12;0;"kurry";12;100;0
0;281;"kursten";281;0;100
0;5;"kursti";5;0;100
0;45;"kurstie";45;0;100
0;463;"kurstin";463;0;100
0;23;"kurston";23;0;100
0;19;"kursty";19;0;100
0;100;"kurstyn";100;0;100
85138;196;"kurt";85334;99.7703142944196;0.229685705580425
5;0;"kurth";5;100;0
0;5;"kurtina";5;0;100
17663;25;"kurtis";17688;99.8586612392583;0.141338760741746
0;27;"kurtisha";27;0;100
245;0;"kurtiss";245;100;0
5;0;"kurtlin";5;100;0
0;5;"kurtlyn";5;0;100
28;0;"kurtus";28;100;0
0;7;"kurumi";7;0;100
1046;0;"kush";1046;100;0
24;0;"kushagra";24;100;0
394;0;"kushal";394;100;0
0;23;"kushana";23;0;100
0;85;"kushi";85;0;100
7;0;"kushtrim";7;100;0
0;16;"kutana";16;0;100
0;52;"kutina";52;0;100
55;0;"kutler";55;100;0
403;0;"kutter";403;100;0
0;172;"kuuipo";172;0;100
0;152;"kuulei";152;0;100
5;0;"kuwan";5;100;0
0;5;"kuwana";5;0;100
0;5;"kuwanda";5;0;100
0;5;"kuwanna";5;0;100
12;0;"kuyper";12;100;0
69;0;"kuzey";69;100;0
21;0;"kvaughn";21;100;0
84;0;"kveon";84;100;0
10;0;"kvin";10;100;0
83;0;"kvion";83;100;0
355;0;"kvon";355;100;0
594;0;"kwabena";594;100;0
8;0;"kwabene";8;100;0
11;0;"kwadjo";11;100;0
216;0;"kwadwo";216;100;0
416;0;"kwaku";416;100;0
63;0;"kwali";63;100;0
5;0;"kwamae";5;100;0
19;0;"kwamain";19;100;0
142;0;"kwamaine";142;100;0
130;0;"kwamane";130;100;0
5;0;"kwamayne";5;100;0
3553;38;"kwame";3591;98.9417989417989;1.05820105820106
22;0;"kwamel";22;100;0
34;0;"kwami";34;100;0
5;0;"kwamin";5;100;0
486;27;"kwan";513;94.7368421052632;5.26315789473684
0;157;"kwana";157;0;100
0;29;"kwanda";29;0;100
211;0;"kwane";211;100;0
0;23;"kwanesha";23;0;100
5;0;"kwang";5;100;0
0;5;"kwaniqua";5;0;100
0;41;"kwanisha";41;0;100
0;43;"kwanita";43;0;100
0;27;"kwanna";27;0;100
18;0;"kwante";18;100;0
42;227;"kwanza";269;15.6133828996283;84.3866171003718
5;29;"kwanzaa";34;14.7058823529412;85.2941176470588
5;0;"kwanze";5;100;0
5;0;"kwashawn";5;100;0
633;0;"kwasi";633;100;0
5;0;"kwaun";5;100;0
0;5;"kwayera";5;0;100
0;20;"kween";20;0;100
49;0;"kweisi";49;100;0
69;0;"kweku";69;100;0
210;11;"kweli";221;95.0226244343891;4.97737556561086
24;0;"kwentin";24;100;0
7;0;"kwenton";7;100;0
736;0;"kwesi";736;100;0
5;0;"kwincy";5;100;0
0;10;"kwinn";10;0;100
61;0;"kwinton";61;100;0
14;0;"kwmaine";14;100;0
26;0;"kwmane";26;100;0
5;0;"kwok";5;100;0
34;0;"kwon";34;100;0
5;0;"kwuan";5;100;0
0;67;"kwynn";67;0;100
1228;123;"ky";1351;90.8956328645448;9.10436713545522
13;4677;"kya";4690;0.277185501066098;99.7228144989339
27;2280;"kyah";2307;1.1703511053316;98.8296488946684
178;0;"kyair";178;100;0
0;370;"kyaira";370;0;100
0;5;"kyairah";5;0;100
313;5;"kyaire";318;98.4276729559748;1.57232704402516
0;5;"kyairra";5;0;100
0;6;"kyaisha";6;0;100
0;6;"kyajah";6;0;100
71;0;"kyal";71;100;0
0;40;"kyala";40;0;100
10;0;"kyale";10;100;0
0;5;"kyalee";5;0;100
5;0;"kyalo";5;100;0
2908;138;"kyan";3046;95.4694681549573;4.53053184504268
0;1997;"kyana";1997;0;100
0;36;"kyanah";36;0;100
0;165;"kyandra";165;0;100
61;0;"kyandre";61;100;0
0;164;"kyani";164;0;100
5;319;"kyann";324;1.54320987654321;98.4567901234568
0;1741;"kyanna";1741;0;100
0;57;"kyannah";57;0;100
0;301;"kyanne";301;0;100
17;5;"kyante";22;77.2727272727273;22.7272727272727
0;2974;"kyara";2974;0;100
0;191;"kyarah";191;0;100
0;36;"kyari";36;0;100
0;18;"kyaria";18;0;100
0;219;"kyarra";219;0;100
0;40;"kyasha";40;0;100
0;17;"kyashia";17;0;100
0;696;"kyasia";696;0;100
0;44;"kyauna";44;0;100
18;0;"kyaw";18;100;0
122;0;"kyce";122;100;0
81;0;"kycen";81;100;0
0;5;"kycia";5;0;100
0;5;"kyda";5;0;100
58;0;"kydan";58;100;0
982;23;"kyden";1005;97.7114427860697;2.28855721393035
19;0;"kydin";19;100;0
39;0;"kydon";39;100;0
3268;254;"kye";3522;92.7881885292447;7.21181147075525
0;6;"kyeana";6;0;100
5;0;"kyeden";5;100;0
13;0;"kyeem";13;100;0
0;10;"kyeesha";10;0;100
16;0;"kyeir";16;100;0
0;231;"kyeisha";231;0;100
212;5;"kyel";217;97.6958525345622;2.30414746543779
0;58;"kyela";58;0;100
10;0;"kyelan";10;100;0
5;0;"kyelar";5;100;0
13;0;"kyele";13;100;0
0;25;"kyelee";25;0;100
0;11;"kyeleigh";11;0;100
11;0;"kyeler";11;100;0
28;0;"kyell";28;100;0
0;52;"kyelle";52;0;100
0;6;"kyelynn";6;0;100
105;0;"kyen";105;100;0
21;0;"kyeon";21;100;0
11;0;"kyer";11;100;0
0;589;"kyera";589;0;100
7;0;"kyere";7;100;0
0;18;"kyeria";18;0;100
10;0;"kyeron";10;100;0
0;346;"kyerra";346;0;100
0;11;"kyersten";11;0;100
0;5;"kyerstin";5;0;100
0;760;"kyesha";760;0;100
0;129;"kyeshia";129;0;100
29;0;"kyeson";29;100;0
0;16;"kyha";16;0;100
61;0;"kyheem";61;100;0
29;0;"kyheim";29;100;0
0;11;"kyhia";11;0;100
5;0;"kyhiem";5;100;0
10;0;"kyhir";10;100;0
0;5;"kyhlee";5;0;100
67;28;"kyi";95;70.5263157894737;29.4736842105263
0;923;"kyia";923;0;100
0;312;"kyiah";312;0;100
85;0;"kyian";85;100;0
0;54;"kyiana";54;0;100
0;24;"kyianna";24;0;100
0;22;"kyiara";22;0;100
14;0;"kyier";14;100;0
0;146;"kyiesha";146;0;100
0;26;"kyila";26;0;100
0;133;"kyilee";133;0;100
138;0;"kyion";138;100;0
5;0;"kyir";5;100;0
0;109;"kyira";109;0;100
5;0;"kyiren";5;100;0
0;216;"kyisha";216;0;100
0;17;"kyja";17;0;100
0;27;"kyjah";27;0;100
6;0;"kyjaun";6;100;0
453;0;"kyjuan";453;100;0
81;0;"kyl";81;100;0
29;38043;"kyla";38072;0.076171464593402;99.9238285354066
0;11;"kylaa";11;0;100
0;4746;"kylah";4746;0;100
0;5;"kylamarie";5;0;100
6089;796;"kylan";6885;88.4386347131445;11.5613652868555
0;16;"kylana";16;0;100
435;0;"kyland";435;100;0
0;122;"kylani";122;0;100
1450;665;"kylar";2115;68.5579196217494;31.4420803782506
0;17;"kylara";17;0;100
0;8;"kylasia";8;0;100
0;23;"kylaya";23;0;100
0;6;"kylayah";6;0;100
475858;8591;"kyle";484449;98.2266451164106;1.7733548835894
0;1473;"kylea";1473;0;100
0;713;"kyleah";713;0;100
5;0;"kylealexander";5;100;0
19;0;"kyleanthony";19;100;0
441;45681;"kylee";46122;0.956159750227657;99.0438402497723
0;114;"kyleeann";114;0;100
5;0;"kyleek";5;100;0
0;5;"kyleemarie";5;0;100
0;971;"kyleen";971;0;100
0;87;"kyleena";87;0;100
0;7;"kyleerae";7;0;100
0;5;"kyleerose";5;0;100
0;962;"kylei";962;0;100
0;10;"kyleia";10;0;100
6;17363;"kyleigh";17369;0.0345443030686856;99.9654556969313
0;90;"kyleigha";90;0;100
0;6;"kyleighann";6;0;100
10;0;"kylel";10;100;0
5;0;"kylem";5;100;0
11;0;"kylematthew";11;100;0
2594;477;"kylen";3071;84.4676001302507;15.5323998697493
0;51;"kylena";51;0;100
5;0;"kylend";5;100;0
0;1649;"kylene";1649;0;100
13;17;"kylenn";30;43.3333333333333;56.6666666666667
5;0;"kyleon";5;100;0
10;0;"kylepatrick";10;100;0
28027;1696;"kyler";29723;94.2939810920836;5.70601890791643
0;5;"kylese";5;0;100
0;5;"kylesha";5;0;100
76;1528;"kyley";1604;4.73815461346633;95.2618453865337
0;2011;"kyli";2011;0;100
0;912;"kylia";912;0;100
0;330;"kyliah";330;0;100
110;7;"kylian";117;94.017094017094;5.98290598290598
0;136;"kyliana";136;0;100
0;10;"kyliann";10;0;100
0;32;"kylianna";32;0;100
0;48;"kylianne";48;0;100
0;5;"kylicia";5;0;100
437;104514;"kylie";104951;0.416384789092053;99.583615210908
0;155;"kylieann";155;0;100
0;5;"kylieanna";5;0;100
0;7;"kylieanne";7;0;100
0;504;"kyliee";504;0;100
0;447;"kyliegh";447;0;100
0;16;"kyliejo";16;0;100
0;11;"kyliemarie";11;0;100
6;0;"kylier";6;100;0
0;11;"kylierae";11;0;100
0;14;"kylierose";14;0;100
0;61;"kylii";61;0;100
20;0;"kylik";20;100;0
73;0;"kylil";73;100;0
1101;981;"kylin";2082;52.8818443804035;47.1181556195965
0;61;"kylina";61;0;100
0;154;"kylinn";154;0;100
0;5;"kylis";5;0;100
0;10;"kylise";10;0;100
0;26;"kylisha";26;0;100
0;16;"kylissa";16;0;100
0;131;"kyliyah";131;0;100
0;47;"kylla";47;0;100
70;5;"kylle";75;93.3333333333333;6.66666666666667
10;0;"kyller";10;100;0
90;0;"kyllian";90;100;0
0;199;"kyllie";199;0;100
298;7;"kylo";305;97.7049180327869;2.29508196721311
1012;0;"kylon";1012;100;0
392;5;"kylor";397;98.7405541561713;1.25944584382872
5;0;"kylun";5;100;0
0;22;"kyly";22;0;100
70;300;"kylyn";370;18.9189189189189;81.0810810810811
13;896;"kylynn";909;1.43014301430143;98.5698569856986
0;49;"kylynne";49;0;100
173;1297;"kym";1470;11.7687074829932;88.2312925170068
3068;771;"kymani";3839;79.9166449596249;20.0833550403751
5;0;"kymanie";5;100;0
11;0;"kymar";11;100;0
0;55;"kymara";55;0;100
247;150;"kymari";397;62.2166246851385;37.7833753148615
0;10;"kymarie";10;0;100
38;0;"kymarion";38;100;0
5;0;"kymarley";5;100;0
5;0;"kymauri";5;100;0
0;5;"kymaya";5;0;100
0;5;"kymbella";5;0;100
0;865;"kymber";865;0;100
0;5;"kymberle";5;0;100
0;853;"kymberlee";853;0;100
0;21;"kymberleigh";21;0;100
0;106;"kymberley";106;0;100
0;581;"kymberli";581;0;100
0;185;"kymberlie";185;0;100
0;2981;"kymberly";2981;0;100
0;97;"kymberlyn";97;0;100
0;33;"kymberlynn";33;0;100
0;10;"kymbra";10;0;100
0;8;"kymbre";8;0;100
0;42;"kymbree";42;0;100
0;11;"kymbria";11;0;100
5;0;"kymeir";5;100;0
24;0;"kymel";24;100;0
0;6;"kymera";6;0;100
78;0;"kymere";78;100;0
0;29;"kymesha";29;0;100
0;5;"kymeshia";5;0;100
0;110;"kymia";110;0;100
0;109;"kymiah";109;0;100
27;0;"kymier";27;100;0
5;0;"kymiere";5;100;0
170;0;"kymir";170;100;0
0;40;"kymira";40;0;100
0;10;"kymisha";10;0;100
0;5;"kymiyah";5;0;100
0;49;"kymm";49;0;100
37;0;"kymon";37;100;0
136;63;"kymoni";199;68.3417085427136;31.6582914572864
0;638;"kymora";638;0;100
0;74;"kymorah";74;0;100
0;10;"kymori";10;0;100
0;11;"kymorra";11;0;100
0;6;"kymya";6;0;100
0;1026;"kyna";1026;0;100
0;240;"kynadee";240;0;100
0;203;"kynadi";203;0;100
0;63;"kynadie";63;0;100
365;0;"kynan";365;100;0
0;9;"kynara";9;0;100
0;29;"kynda";29;0;100
0;105;"kyndahl";105;0;100
117;4007;"kyndal";4124;2.83705140640155;97.1629485935985
182;4902;"kyndall";5084;3.57985837922895;96.420141620771
0;16;"kyndalyn";16;0;100
23;416;"kyndel";439;5.23917995444191;94.7608200455581
40;478;"kyndell";518;7.72200772200772;92.2779922779923
6;0;"kynden";6;100;0
0;6;"kynder";6;0;100
0;5;"kyndi";5;0;100
0;7;"kyndl";7;0;100
12;471;"kyndle";483;2.48447204968944;97.5155279503106
0;2355;"kyndra";2355;0;100
0;10;"kyndrah";10;0;100
25;0;"kyndrick";25;100;0
0;5;"kyndyl";5;0;100
0;223;"kynedi";223;0;100
0;5;"kyneisha";5;0;100
0;67;"kynesha";67;0;100
0;6;"kyneshia";6;0;100
562;0;"kyng";562;100;0
5;0;"kyngsten";5;100;0
213;0;"kyngston";213;100;0
0;52;"kynia";52;0;100
0;30;"kyniah";30;0;100
0;6;"kynidee";6;0;100
0;80;"kynisha";80;0;100
0;98;"kynlea";98;0;100
0;3318;"kynlee";3318;0;100
0;106;"kynlei";106;0;100
0;1171;"kynleigh";1171;0;100
0;383;"kynley";383;0;100
0;294;"kynli";294;0;100
0;438;"kynlie";438;0;100
0;27;"kynna";27;0;100
0;6;"kynnadee";6;0;100
0;146;"kynnadi";146;0;100
0;5;"kynnady";5;0;100
0;6;"kynndal";6;0;100
0;813;"kynnedi";813;0;100
0;398;"kynnedy";398;0;100
0;6;"kynnidi";6;0;100
0;27;"kynnlee";27;0;100
0;10;"kynnleigh";10;0;100
0;6;"kynnlie";6;0;100
0;23;"kynsey";23;0;100
0;91;"kynsie";91;0;100
0;12;"kynslea";12;0;100
0;981;"kynslee";981;0;100
0;44;"kynslei";44;0;100
0;222;"kynsleigh";222;0;100
0;411;"kynsley";411;0;100
0;67;"kynsli";67;0;100
0;217;"kynslie";217;0;100
5;0;"kyntrell";5;100;0
0;167;"kynzee";167;0;100
0;163;"kynzi";163;0;100
0;614;"kynzie";614;0;100
0;502;"kynzlee";502;0;100
0;6;"kynzlei";6;0;100
0;143;"kynzleigh";143;0;100
0;76;"kynzley";76;0;100
0;60;"kynzli";60;0;100
0;131;"kynzlie";131;0;100
100;0;"kyo";100;100;0
6;0;"kyohei";6;100;0
0;11;"kyoka";11;0;100
0;211;"kyoko";211;0;100
0;41;"kyomi";41;0;100
516;0;"kyon";516;100;0
0;220;"kyona";220;0;100
0;6;"kyondra";6;0;100
0;62;"kyong";62;0;100
0;10;"kyonia";10;0;100
0;404;"kyonna";404;0;100
5;0;"kyonne";5;100;0
8;0;"kyonte";8;100;0
0;10;"kyosha";10;0;100
5;0;"kyosuke";5;100;0
10;6;"kyper";16;62.5;37.5
5;0;"kypten";5;100;0
5;0;"kyptin";5;100;0
147;0;"kypton";147;100;0
23;34278;"kyra";34301;0.0670534386752573;99.9329465613247
0;1844;"kyrah";1844;0;100
0;12;"kyralee";12;0;100
0;5;"kyralynn";5;0;100
2280;128;"kyran";2408;94.6843853820598;5.3156146179402
490;35;"kyre";525;93.3333333333333;6.66666666666667
0;5;"kyrea";5;0;100
4516;669;"kyree";5185;87.0973963355834;12.9026036644166
13;0;"kyreece";13;100;0
7;0;"kyreek";7;100;0
36;0;"kyreem";36;100;0
108;0;"kyreese";108;100;0
19;0;"kyrei";19;100;0
5;0;"kyrein";5;100;0
5;0;"kyrek";5;100;0
90;0;"kyrel";90;100;0
599;0;"kyrell";599;100;0
1936;78;"kyren";2014;96.1271102284012;3.87288977159881
0;97;"kyrene";97;0;100
5;0;"kyreon";5;100;0
287;0;"kyrese";287;100;0
0;5;"kyresha";5;0;100
0;5;"kyrha";5;0;100
242;403;"kyri";645;37.5193798449612;62.4806201550388
0;706;"kyria";706;0;100
0;38;"kyriah";38;0;100
0;123;"kyriaki";123;0;100
136;0;"kyriakos";136;100;0
242;5;"kyrian";247;97.9757085020243;2.02429149797571
0;128;"kyriana";128;0;100
0;84;"kyrianna";84;0;100
11;0;"kyric";11;100;0
4077;3211;"kyrie";7288;55.9412733260154;44.0587266739846
25;7;"kyriee";32;78.125;21.875
0;21;"kyriel";21;0;100
0;112;"kyrielle";112;0;100
11;0;"kyrien";11;100;0
5;0;"kyrii";5;100;0
18;0;"kyril";18;100;0
189;0;"kyrillos";189;100;0
1106;126;"kyrin";1232;89.7727272727273;10.2272727272727
36;0;"kyrion";36;100;0
17;0;"kyrique";17;100;0
34;0;"kyris";34;100;0
159;0;"kyro";159;100;0
65;0;"kyrollos";65;100;0
3644;0;"kyron";3644;100;0
20;0;"kyrone";20;100;0
67;0;"kyros";67;100;0
0;217;"kyrra";217;0;100
0;18;"kyrrah";18;0;100
0;13;"kyrsha";13;0;100
0;5;"kyrsta";5;0;100
0;128;"kyrstal";128;0;100
0;62;"kyrstan";62;0;100
0;1958;"kyrsten";1958;0;100
0;40;"kyrsti";40;0;100
0;60;"kyrstie";60;0;100
0;1273;"kyrstin";1273;0;100
0;32;"kyrstle";32;0;100
0;20;"kyrston";20;0;100
0;194;"kyrstyn";194;0;100
72;0;"kyrus";72;100;0
22;0;"kyryn";22;100;0
0;183;"kysa";183;0;100
18;0;"kysan";18;100;0
5;0;"kyse";5;100;0
85;0;"kysean";85;100;0
32;0;"kyseem";32;100;0
594;0;"kysen";594;100;0
184;0;"kyser";184;100;0
0;411;"kysha";411;0;100
0;5;"kyshana";5;0;100
219;0;"kyshaun";219;100;0
399;0;"kyshawn";399;100;0
0;7;"kyshawna";7;0;100
0;35;"kyshia";35;0;100
79;0;"kyshon";79;100;0
0;5;"kysia";5;0;100
39;0;"kysin";39;100;0
31;0;"kysir";31;100;0
3926;0;"kyson";3926;100;0
0;22;"kystal";22;0;100
5;0;"kystin";5;100;0
78;0;"kyston";78;100;0
0;5;"kytalin";5;0;100
0;11;"kytana";11;0;100
5;0;"kyten";5;100;0
19;0;"kyton";19;100;0
0;72;"kytzia";72;0;100
54;0;"kyu";54;100;0
0;5;"kyuana";5;0;100
27;86;"kyung";113;23.8938053097345;76.1061946902655
25;0;"kyus";25;100;0
55;0;"kyuss";55;100;0
22;0;"kyvan";22;100;0
33;0;"kyven";33;100;0
21;0;"kyvin";21;100;0
5;0;"kyvion";5;100;0
129;0;"kyvon";129;100;0
31;0;"kywan";31;100;0
0;5;"kywanna";5;0;100
11;0;"kywaun";11;100;0
28;0;"kywon";28;100;0
7;0;"kywuan";7;100;0
0;11;"kyya";11;0;100
6;0;"kyzar";6;100;0
70;0;"kyzen";70;100;0
551;0;"kyzer";551;100;0
12;0;"kyzier";12;100;0
5;0;"kyzin";5;100;0
5;0;"kyzir";5;100;0
300;1442;"la";1742;17.2215843857635;82.7784156142365
0;53;"laaibah";53;0;100
151;10;"laakea";161;93.7888198757764;6.2111801242236
0;5;"laangela";5;0;100
5;0;"laanthony";5;100;0
0;236;"laasia";236;0;100
0;342;"laasya";342;0;100
569;0;"laban";569;100;0
0;40;"labarbara";40;0;100
170;0;"labaron";170;100;0
179;0;"labarron";179;100;0
0;103;"labella";103;0;100
0;55;"labelle";55;0;100
0;248;"laberta";248;0;100
62;0;"labib";62;100;0
0;44;"labiba";44;0;100
43;0;"labon";43;100;0
5;0;"laborn";5;100;0
81;0;"labradford";81;100;0
216;0;"labrandon";216;100;0
0;5;"labraya";5;0;100
0;201;"labrea";201;0;100
0;14;"labree";14;0;100
0;38;"labreeska";38;0;100
0;94;"labrenda";94;0;100
0;117;"labresha";117;0;100
0;10;"labreshia";10;0;100
0;5;"labreya";5;0;100
0;5;"labreyah";5;0;100
0;424;"labria";424;0;100
105;0;"labrian";105;100;0
0;111;"labrina";111;0;100
0;75;"labrisha";75;0;100
0;5;"labritney";5;0;100
0;105;"labrittany";105;0;100
0;18;"labrittney";18;0;100
400;0;"labron";400;100;0
25;0;"labryan";25;100;0
23;0;"labryant";23;100;0
23;0;"labyron";23;100;0
5;0;"lacalvin";5;100;0
0;22;"lacandice";22;0;100
0;6;"lacandis";6;0;100
0;62;"lacara";62;0;100
0;12;"lacarla";12;0;100
29;0;"lacarlos";29;100;0
0;5;"lacasha";5;0;100
0;6;"lacasta";6;0;100
0;5;"lacci";5;0;100
16;387;"lace";403;3.97022332506203;96.029776674938
56;0;"lacedric";56;100;0
0;2476;"lacee";2476;0;100
0;10;"lacei";10;0;100
0;5;"lacelyn";5;0;100
5;0;"lacen";5;100;0
1442;50152;"lacey";51594;2.79489863162383;97.2051013683762
0;64;"lachae";64;0;100
0;24;"lachaka";24;0;100
0;6;"lachan";6;0;100
0;39;"lachana";39;0;100
0;328;"lachanda";328;0;100
0;496;"lachandra";496;0;100
0;10;"lachanta";10;0;100
0;18;"lachante";18;0;100
0;5;"lachara";5;0;100
101;0;"lacharles";101;100;0
0;12;"lachasity";12;0;100
0;6;"lachaun";6;0;100
0;10;"lachaundra";10;0;100
0;6;"lachay";6;0;100
0;109;"lache";109;0;100
0;10;"lachel";10;0;100
0;155;"lachele";155;0;100
0;189;"lachell";189;0;100
0;2391;"lachelle";2391;0;100
0;11;"lacher";11;0;100
0;156;"lacheryl";156;0;100
0;7;"lachic";7;0;100
0;105;"lachina";105;0;100
0;5;"lachisa";5;0;100
0;5;"lachisha";5;0;100
2771;136;"lachlan";2907;95.3216374269006;4.67836257309941
11;0;"lachlann";11;100;0
0;60;"lachlyn";60;0;100
0;45;"lachon";45;0;100
0;44;"lachonda";44;0;100
0;10;"lachone";10;0;100
0;5;"lachonne";5;0;100
0;11;"lachrisa";11;0;100
0;143;"lachrisha";143;0;100
0;97;"lachrista";97;0;100
0;5;"lachristy";5;0;100
0;5;"lachundra";5;0;100
0;14;"lachyna";14;0;100
0;9093;"laci";9093;0;100
0;50;"lacia";50;0;100
0;24;"laciana";24;0;100
0;5;"laciann";5;0;100
42;10098;"lacie";10140;0.414201183431953;99.585798816568
0;922;"lacinda";922;0;100
0;297;"lacole";297;0;100
0;123;"laconda";123;0;100
0;5;"lacondra";5;0;100
0;41;"laconia";41;0;100
0;97;"laconya";97;0;100
0;139;"lacora";139;0;100
86;0;"lacorey";86;100;0
0;27;"lacoria";27;0;100
0;7;"lacorsha";7;0;100
20;0;"lacory";20;100;0
0;5;"lacorya";5;0;100
0;250;"lacosta";250;0;100
0;48;"lacourtney";48;0;100
0;155;"lacoya";155;0;100
0;122;"lacreasha";122;0;100
0;392;"lacrecia";392;0;100
0;24;"lacree";24;0;100
0;13;"lacreesha";13;0;100
0;16;"lacreisha";16;0;100
0;20;"lacresa";20;0;100
0;1177;"lacresha";1177;0;100
0;189;"lacreshia";189;0;100
0;162;"lacresia";162;0;100
0;17;"lacreta";17;0;100
0;932;"lacretia";932;0;100
0;22;"lacricia";22;0;100
0;408;"lacrisha";408;0;100
0;12;"lacrissa";12;0;100
0;19;"lacrista";19;0;100
0;256;"lacrystal";256;0;100
6;0;"lacurtis";6;100;0
6210;19345;"lacy";25555;24.3005282723537;75.6994717276463
0;119;"lacye";119;0;100
0;10;"lacynda";10;0;100
0;10;"lacynthia";10;0;100
21;0;"lad";21;100;0
0;85;"lada";85;0;100
0;13;"ladacia";13;0;100
0;12;"ladaesha";12;0;100
0;61;"ladaija";61;0;100
0;45;"ladaijah";45;0;100
424;0;"ladainian";424;100;0
0;336;"ladaisha";336;0;100
0;6;"ladaisia";6;0;100
0;126;"ladaja";126;0;100
0;76;"ladajah";76;0;100
0;16;"ladajia";16;0;100
292;10;"ladale";302;96.6887417218543;3.3112582781457
47;0;"ladamian";47;100;0
75;0;"ladamien";75;100;0
42;0;"ladamion";42;100;0
0;183;"ladan";183;0;100
0;320;"ladana";320;0;100
96;0;"ladanian";96;100;0
32;0;"ladaniel";32;100;0
8;0;"ladanien";8;100;0
0;5;"ladanna";5;0;100
16;0;"ladante";16;100;0
0;5;"ladara";5;0;100
0;26;"ladaria";26;0;100
352;0;"ladarian";352;100;0
121;0;"ladarien";121;100;0
330;0;"ladarion";330;100;0
417;0;"ladarious";417;100;0
19;0;"ladaris";19;100;0
4213;0;"ladarius";4213;100;0
63;0;"ladarrell";63;100;0
160;0;"ladarren";160;100;0
106;0;"ladarrian";106;100;0
12;0;"ladarrien";12;100;0
12;0;"ladarrin";12;100;0
154;0;"ladarrion";154;100;0
77;0;"ladarrious";77;100;0
34;0;"ladarris";34;100;0
1127;0;"ladarrius";1127;100;0
62;0;"ladarryl";62;100;0
10;0;"ladaruis";10;100;0
14;0;"ladaryl";14;100;0
0;316;"ladasha";316;0;100
0;79;"ladashia";79;0;100
0;239;"ladasia";239;0;100
5;0;"ladaveon";5;100;0
0;86;"ladavia";86;0;100
5;0;"ladavian";5;100;0
5;0;"ladavid";5;100;0
117;0;"ladavion";117;100;0
0;1568;"ladawn";1568;0;100
0;284;"ladawna";284;0;100
0;17;"ladaya";17;0;100
0;5;"ladayja";5;0;100
5;0;"ladaynian";5;100;0
0;161;"ladaysha";161;0;100
0;5;"ladaysia";5;0;100
0;6;"ladazia";6;0;100
1157;0;"ladd";1157;100;0
1638;92;"laddie";1730;94.6820809248555;5.31791907514451
16;0;"laddy";16;100;0
5;568;"ladean";573;0.87260034904014;99.1273996509599
0;280;"ladeana";280;0;100
0;13;"ladeane";13;0;100
0;15;"ladeanna";15;0;100
0;21;"ladedra";21;0;100
0;49;"ladeidra";49;0;100
0;5;"ladeidre";5;0;100
0;279;"ladeja";279;0;100
0;25;"ladejah";25;0;100
1000;433;"ladell";1433;69.7836706210747;30.2163293789253
0;140;"ladelle";140;0;100
0;11;"ladema";11;0;100
87;0;"laden";87;100;0
0;430;"ladena";430;0;100
0;220;"ladene";220;0;100
0;10;"ladenna";10;0;100
20;0;"laderek";20;100;0
7;0;"ladereon";7;100;0
6;0;"laderian";6;100;0
6;0;"laderick";6;100;0
12;0;"laderion";12;100;0
12;0;"laderious";12;100;0
61;0;"laderius";61;100;0
5;0;"laderrian";5;100;0
0;13;"laderrica";13;0;100
436;0;"laderrick";436;100;0
0;46;"laderricka";46;0;100
22;0;"laderrion";22;100;0
52;0;"laderrius";52;100;0
0;65;"ladesha";65;0;100
0;19;"ladessa";19;0;100
0;32;"ladestiny";32;0;100
0;54;"ladetra";54;0;100
0;11;"ladia";11;0;100
0;178;"ladiamond";178;0;100
0;11;"ladie";11;0;100
0;5;"ladijah";5;0;100
5;0;"ladimer";5;100;0
0;179;"ladina";179;0;100
0;82;"ladine";82;0;100
18;0;"ladislado";18;100;0
76;0;"ladislao";76;100;0
212;0;"ladislaus";212;100;0
82;0;"ladislav";82;100;0
0;23;"ladislava";23;0;100
1160;323;"ladon";1483;78.2198246797033;21.7801753202967
0;721;"ladona";721;0;100
0;5;"ladonda";5;0;100
0;48;"ladonia";48;0;100
0;5;"ladonja";5;0;100
0;10;"ladonn";10;0;100
0;21197;"ladonna";21197;0;100
0;126;"ladonne";126;0;100
0;10;"ladonnia";10;0;100
22;0;"ladonta";22;100;0
7;0;"ladontae";7;100;0
5;0;"ladontay";5;100;0
170;0;"ladonte";170;100;0
0;215;"ladonya";215;0;100
0;549;"ladora";549;0;100
0;225;"ladoris";225;0;100
32;0;"ladre";32;100;0
0;89;"ladrea";89;0;100
0;5;"ladreama";5;0;100
0;5;"ladreka";5;0;100
0;24;"ladrena";24;0;100
8;0;"ladrick";8;100;0
0;21;"ladrina";21;0;100
10;0;"ladson";10;100;0
0;1754;"lady";1754;0;100
0;99;"ladye";99;0;100
0;6;"laeh";6;0;100
0;10;"laeisha";10;0;100
0;5;"laeken";5;0;100
0;104;"laekyn";104;0;100
642;1833;"lael";2475;25.9393939393939;74.0606060606061
0;1276;"laela";1276;0;100
0;284;"laelah";284;0;100
0;136;"laelani";136;0;100
0;105;"laelia";105;0;100
0;5;"laella";5;0;100
0;91;"laelle";91;0;100
0;6;"laeloni";6;0;100
0;49;"laelyn";49;0;100
0;59;"laelynn";59;0;100
0;41;"laena";41;0;100
0;33;"laerica";33;0;100
0;34;"laesha";34;0;100
0;359;"laetitia";359;0;100
44;0;"laeton";44;100;0
5;10;"laetyn";15;33.3333333333333;66.6666666666667
0;5;"laeuna";5;0;100
0;5;"laeyah";5;0;100
0;17;"lafarrah";17;0;100
0;6;"lafaun";6;0;100
0;88;"lafawn";88;0;100
0;11;"lafay";11;0;100
0;308;"lafaye";308;0;100
4407;21;"lafayette";4428;99.5257452574526;0.474254742547425
609;0;"lafe";609;100;0
0;274;"lafern";274;0;100
0;46;"laferne";46;0;100
5;0;"lafeyette";5;100;0
6;0;"lafiamma";6;100;0
9;10;"lafon";19;47.3684210526316;52.6315789473684
0;693;"lafonda";693;0;100
0;45;"lafondra";45;0;100
0;10;"lafonya";10;0;100
5;0;"lafonzo";5;100;0
0;10;"lafoya";10;0;100
0;5;"lafran";5;0;100
29;60;"lafrance";89;32.5842696629214;67.4157303370787
0;34;"lafrances";34;0;100
0;5;"lafrancine";5;0;100
0;111;"lafreda";111;0;100
5;0;"lafrederick";5;100;0
26;0;"lafredrick";26;100;0
0;12;"lagail";12;0;100
7;0;"lagarius";7;100;0
0;10;"lagatha";10;0;100
0;134;"lagena";134;0;100
0;16;"lagenia";16;0;100
0;7;"lagertha";7;0;100
0;425;"lagina";425;0;100
17;0;"lagrand";17;100;0
21;0;"lagregory";21;100;0
0;17;"lagreta";17;0;100
0;96;"lagretta";96;0;100
26;0;"laguan";26;100;0
0;66;"laguana";66;0;100
0;29;"laguanda";29;0;100
0;28;"laguisha";28;0;100
0;27;"laguita";27;0;100
0;5;"lah";5;0;100
0;31;"lahana";31;0;100
0;98;"lahari";98;0;100
0;208;"lahela";208;0;100
0;5;"lahla";5;0;100
0;342;"lahna";342;0;100
0;5;"lahni";5;0;100
0;1312;"lahoma";1312;0;100
0;5;"lahonda";5;0;100
25;232;"lai";257;9.72762645914397;90.272373540856
0;316;"laia";316;0;100
0;190;"laiah";190;0;100
0;105;"laiana";105;0;100
0;43;"laianna";43;0;100
0;571;"laiba";571;0;100
0;10;"laibah";10;0;100
0;32;"laicee";32;0;100
0;18;"laicey";18;0;100
0;5;"laici";5;0;100
0;5;"laida";5;0;100
204;0;"laiden";204;100;0
0;5;"laidy";5;0;100
22;0;"laif";22;100;0
0;21;"laighla";21;0;100
0;5;"laighton";5;0;100
0;39;"laihla";39;0;100
16;0;"laik";16;100;0
0;10;"laika";10;0;100
10;0;"laike";10;100;0
230;1261;"laiken";1491;15.4258886653253;84.5741113346747
0;47;"laikin";47;0;100
0;92;"laiklyn";92;0;100
0;27;"laiklynn";27;0;100
6;918;"laikyn";924;0.649350649350649;99.3506493506494
0;91;"laikynn";91;0;100
23;32403;"laila";32426;0.0709307345956948;99.9290692654043
0;48;"lailaa";48;0;100
0;4739;"lailah";4739;0;100
0;7;"lailamarie";7;0;100
0;61;"lailana";61;0;100
0;23;"lailanee";23;0;100
0;1118;"lailani";1118;0;100
0;107;"lailanie";107;0;100
0;6;"lailanni";6;0;100
0;118;"lailany";118;0;100
0;6;"lailarose";6;0;100
0;108;"lailee";108;0;100
0;5;"laileen";5;0;100
0;5;"laileigh";5;0;100
0;12;"lailene";12;0;100
0;46;"lailey";46;0;100
0;22;"laili";22;0;100
0;5;"lailiana";5;0;100
0;70;"lailie";70;0;100
0;204;"lailoni";204;0;100
0;36;"lailonie";36;0;100
0;5;"lailonnie";5;0;100
0;42;"laily";42;0;100
0;124;"lailyn";124;0;100
0;103;"lailynn";103;0;100
45;0;"laim";45;100;0
0;38;"laima";38;0;100
365;20;"lain";385;94.8051948051948;5.19480519480519
0;2819;"laina";2819;0;100
0;10;"lainah";10;0;100
1441;2974;"laine";4415;32.638731596829;67.361268403171
0;866;"lainee";866;0;100
0;7672;"lainey";7672;0;100
0;318;"laini";318;0;100
0;1662;"lainie";1662;0;100
0;165;"lainy";165;0;100
0;5;"laiona";5;0;100
0;32;"laionna";32;0;100
0;106;"laira";106;0;100
1845;0;"laird";1845;100;0
0;5;"lairen";5;0;100
0;10;"lais";10;0;100
0;219;"laisa";219;0;100
0;2311;"laisha";2311;0;100
6;0;"laison";6;100;0
0;12;"laissa";12;0;100
8;0;"laiten";8;100;0
1847;0;"laith";1847;100;0
83;0;"laithan";83;100;0
38;0;"laithen";38;100;0
18;0;"laiton";18;100;0
5;132;"laityn";137;3.64963503649635;96.3503649635037
0;273;"laiya";273;0;100
0;397;"laiyah";397;0;100
0;16;"laiyana";16;0;100
0;5;"laiyanna";5;0;100
0;189;"laiyla";189;0;100
0;67;"laiylah";67;0;100
0;327;"laiza";327;0;100
5;0;"lajace";5;100;0
0;164;"lajada";164;0;100
0;18;"lajae";18;0;100
96;0;"lajarvis";96;100;0
0;27;"lajasmine";27;0;100
0;5;"lajauna";5;0;100
10;0;"lajaune";10;100;0
26;0;"lajavion";26;100;0
0;17;"lajaya";17;0;100
5;0;"lajayceon";5;100;0
0;37;"lajayla";37;0;100
0;400;"lajean";400;0;100
0;106;"lajeana";106;0;100
0;21;"lajeanna";21;0;100
0;12;"lajeanne";12;0;100
0;12;"lajerrica";12;0;100
0;53;"lajessica";53;0;100
0;29;"lajeune";29;0;100
0;17;"lajla";17;0;100
37;0;"lajohn";37;100;0
0;11;"lajoi";11;0;100
0;6;"lajoia";6;0;100
30;0;"lajon";30;100;0
0;259;"lajoy";259;0;100
0;91;"lajoya";91;0;100
0;321;"lajoyce";321;0;100
1052;739;"lajuan";1791;58.7381351200447;41.2618648799553
0;1874;"lajuana";1874;0;100
0;92;"lajuanda";92;0;100
92;0;"lajuane";92;100;0
0;74;"lajuanna";74;0;100
0;428;"lajune";428;0;100
277;44;"lakai";321;86.2928348909657;13.7071651090343
0;22;"lakaia";22;0;100
0;16;"lakaii";16;0;100
0;24;"lakaila";24;0;100
0;113;"lakaisha";113;0;100
0;44;"lakaiya";44;0;100
0;16;"lakala";16;0;100
0;40;"lakan";40;0;100
0;79;"lakara";79;0;100
16;0;"lakari";16;100;0
0;308;"lakasha";308;0;100
0;95;"lakashia";95;0;100
0;11;"lakay";11;0;100
0;176;"lakaya";176;0;100
10;0;"lakayden";10;100;0
0;1280;"lakayla";1280;0;100
0;27;"lakaysha";27;0;100
2210;465;"lake";2675;82.6168224299065;17.3831775700935
0;182;"lakea";182;0;100
0;5;"lakeah";5;0;100
0;272;"lakeasha";272;0;100
0;6;"lakeashia";6;0;100
0;28;"lakeba";28;0;100
0;51;"lakecha";51;0;100
0;86;"lakechia";86;0;100
0;629;"lakecia";629;0;100
0;53;"lakeda";53;0;100
0;16;"lakedia";16;0;100
0;240;"lakedra";240;0;100
0;28;"lakedria";28;0;100
5;0;"lakedrick";5;100;0
6;7;"lakee";13;46.1538461538462;53.8461538461538
0;8;"lakeea";8;0;100
0;5;"lakeela";5;0;100
133;0;"lakeem";133;100;0
0;35;"lakeema";35;0;100
0;71;"lakeena";71;0;100
0;1370;"lakeesha";1370;0;100
0;28;"lakeeshia";28;0;100
0;183;"lakeeta";183;0;100
0;5;"lakeetha";5;0;100
0;13;"lakeeva";13;0;100
0;16;"lakeeya";16;0;100
0;519;"lakeia";519;0;100
0;26;"lakeicha";26;0;100
0;5;"lakeida";5;0;100
0;152;"lakeidra";152;0;100
0;24;"lakeila";24;0;100
0;40;"lakeira";40;0;100
0;122;"lakeisa";122;0;100
0;44;"lakeish";44;0;100
36;12798;"lakeisha";12834;0.280504908835905;99.7194950911641
0;121;"lakeishia";121;0;100
0;292;"lakeita";292;0;100
634;0;"lakeith";634;100;0
0;917;"lakeitha";917;0;100
0;193;"lakeithia";193;0;100
0;7;"lakeitra";7;0;100
0;25;"lakeiya";25;0;100
5;0;"lakel";5;100;0
0;65;"lakela";65;0;100
13;0;"lakelan";13;100;0
33;5;"lakeland";38;86.8421052631579;13.1578947368421
0;18;"lakelee";18;0;100
0;10;"lakeley";10;0;100
0;28;"lakelia";28;0;100
5;0;"lakell";5;100;0
0;6;"lakelsha";6;0;100
0;108;"lakely";108;0;100
5;651;"lakelyn";656;0.76219512195122;99.2378048780488
0;304;"lakelynn";304;0;100
0;36;"lakema";36;0;100
0;5;"lakemia";5;0;100
1152;4678;"laken";5830;19.7598627787307;80.2401372212693
0;85;"lakena";85;0;100
0;30;"lakenda";30;0;100
0;2284;"lakendra";2284;0;100
0;259;"lakendria";259;0;100
31;0;"lakendric";31;100;0
813;0;"lakendrick";813;100;0
0;17;"lakenia";17;0;100
0;1677;"lakenya";1677;0;100
0;5;"lakenzi";5;0;100
0;75;"lakenzie";75;0;100
55;0;"laker";55;100;0
0;98;"lakera";98;0;100
0;259;"lakeria";259;0;100
0;41;"lakerria";41;0;100
0;5;"lakersha";5;0;100
0;106;"lakesa";106;0;100
0;7;"lakesh";7;0;100
6;8168;"lakesha";8174;0.0734034744311231;99.9265965255689
0;5;"lakeshea";5;0;100
0;16;"lakeshi";16;0;100
0;4708;"lakeshia";4708;0;100
0;559;"lakesia";559;0;100
0;11;"lakesiha";11;0;100
0;10;"lakeska";10;0;100
0;29;"lakessa";29;0;100
0;5;"lakessha";5;0;100
0;629;"laketa";629;0;100
0;303;"laketha";303;0;100
0;126;"lakethia";126;0;100
0;141;"laketia";141;0;100
0;146;"laketra";146;0;100
0;6;"laketria";6;0;100
0;188;"laketta";188;0;100
0;111;"lakeva";111;0;100
0;257;"lakevia";257;0;100
0;10;"lakey";10;0;100
0;1211;"lakeya";1211;0;100
0;8;"lakeyah";8;0;100
0;5;"lakeycha";5;0;100
0;21;"lakeyda";21;0;100
0;5;"lakeydra";5;0;100
0;178;"lakeyia";178;0;100
0;20;"lakeyla";20;0;100
0;53;"lakeyn";53;0;100
0;54;"lakeysa";54;0;100
0;1225;"lakeysha";1225;0;100
0;108;"lakeyshia";108;0;100
0;29;"lakeysia";29;0;100
0;97;"lakeyta";97;0;100
21;0;"lakhi";21;100;0
0;72;"lakhia";72;0;100
11;0;"laki";11;100;0
0;2632;"lakia";2632;0;100
0;120;"lakiah";120;0;100
0;6;"lakiara";6;0;100
0;5;"lakiaya";5;0;100
0;11;"lakicha";11;0;100
0;21;"lakicia";21;0;100
0;22;"lakida";22;0;100
0;119;"lakie";119;0;100
0;30;"lakiea";30;0;100
0;35;"lakiera";35;0;100
0;1897;"lakiesha";1897;0;100
0;5;"lakieshia";5;0;100
0;28;"lakieta";28;0;100
6;0;"lakieth";6;100;0
0;36;"lakietha";36;0;100
0;10;"lakika";10;0;100
0;19;"lakila";19;0;100
41;0;"lakim";41;100;0
0;61;"lakima";61;0;100
0;19;"lakimberly";19;0;100
356;1699;"lakin";2055;17.323600973236;82.676399026764
0;178;"lakina";178;0;100
0;94;"lakindra";94;0;100
6;0;"laking";6;100;0
0;5;"lakinia";5;0;100
0;27;"lakinya";27;0;100
0;5;"lakinzi";5;0;100
0;448;"lakira";448;0;100
0;263;"lakisa";263;0;100
0;14;"lakischa";14;0;100
0;38;"lakish";38;0;100
12;12307;"lakisha";12319;0.0974105040993587;99.9025894959006
0;397;"lakishia";397;0;100
0;11;"lakisia";11;0;100
0;38;"lakiska";38;0;100
0;6;"lakissa";6;0;100
0;6;"lakissia";6;0;100
0;5;"lakista";5;0;100
0;1628;"lakita";1628;0;100
0;84;"lakitha";84;0;100
0;5;"lakitia";5;0;100
0;5;"lakitra";5;0;100
0;5;"lakitsha";5;0;100
0;25;"lakitta";25;0;100
0;36;"lakiva";36;0;100
0;650;"lakiya";650;0;100
0;277;"lakiyah";277;0;100
0;11;"lakizzy";11;0;100
0;25;"lakken";25;0;100
0;5;"lakley";5;0;100
0;13;"laklyn";13;0;100
0;12;"laklynn";12;0;100
120;65;"lakoda";185;64.8648648648649;35.1351351351351
0;12;"lakosha";12;0;100
1234;1358;"lakota";2592;47.608024691358;52.391975308642
0;10;"lakotah";10;0;100
0;11;"lakoya";11;0;100
0;6;"lakreisha";6;0;100
0;264;"lakresha";264;0;100
0;24;"lakreshia";24;0;100
0;327;"lakrisha";327;0;100
0;57;"lakrista";57;0;100
0;38;"lakrystal";38;0;100
157;0;"laksh";157;100;0
0;10;"laksha";10;0;100
5;0;"lakshan";5;100;0
0;11;"lakshana";11;0;100
0;5;"lakshita";5;0;100
10;0;"lakshman";10;100;0
0;684;"lakshmi";684;0;100
0;5;"lakshmy";5;0;100
52;35;"lakshya";87;59.7701149425287;40.2298850574713
0;5;"laksmi";5;0;100
6;0;"lakwan";6;100;0
0;5;"lakwanzaa";5;0;100
0;236;"lakya";236;0;100
0;56;"lakyah";56;0;100
5;0;"lakye";5;100;0
0;91;"lakyia";91;0;100
0;117;"lakyla";117;0;100
53;2007;"lakyn";2060;2.57281553398058;97.4271844660194
0;7;"lakyna";7;0;100
0;5;"lakyndra";5;0;100
0;214;"lakynn";214;0;100
0;322;"lakyra";322;0;100
0;5;"lakyrah";5;0;100
0;6;"lakyria";6;0;100
0;162;"lakysha";162;0;100
0;6;"lakyshia";6;0;100
18;5;"lal";23;78.2608695652174;21.7391304347826
0;1518;"lala";1518;0;100
0;396;"lalah";396;0;100
0;54;"lalaina";54;0;100
0;74;"lalaine";74;0;100
0;5;"lalainia";5;0;100
0;60;"lalana";60;0;100
0;211;"lalani";211;0;100
0;81;"lalania";81;0;100
0;79;"lalanya";79;0;100
0;5;"lalar";5;0;100
0;22;"lale";22;0;100
0;5;"laleah";5;0;100
0;57;"laleh";57;0;100
0;5;"lalelei";5;0;100
0;291;"lalena";291;0;100
0;5;"lalenia";5;0;100
0;5;"laleta";5;0;100
0;35;"lali";35;0;100
0;260;"lalia";260;0;100
0;17;"laliah";17;0;100
0;10;"laliana";10;0;100
0;5;"lalicia";5;0;100
0;6;"lalie";6;0;100
0;34;"lalinda";34;0;100
0;8;"laline";8;0;100
0;92;"lalisa";92;0;100
0;10;"lalisha";10;0;100
5;0;"lalit";5;100;0
0;733;"lalita";733;0;100
5;0;"lalith";5;100;0
0;70;"lalitha";70;0;100
0;6;"laliyah";6;0;100
0;256;"lalla";256;0;100
0;14;"lallah";14;0;100
0;230;"lallie";230;0;100
496;0;"lalo";496;100;0
0;78;"laloni";78;0;100
0;85;"lalonnie";85;0;100
503;59;"lam";562;89.5017793594306;10.4982206405694
0;396;"lama";396;0;100
6;0;"lamaar";6;100;0
0;82;"lamae";82;0;100
7;0;"lamaine";7;100;0
0;23;"lamaiya";23;0;100
0;5;"lamaiyah";5;0;100
69;0;"lamaj";69;100;0
25;0;"laman";25;100;0
0;364;"lamanda";364;0;100
0;26;"lamani";26;0;100
5;0;"lamanuel";5;100;0
32338;1057;"lamar";33395;96.834855517293;3.16514448270699
0;341;"lamara";341;0;100
13;0;"lamarc";13;100;0
104;0;"lamarco";104;100;0
2751;0;"lamarcus";2751;100;0
38;0;"lamare";38;100;0
0;11;"lamarea";11;0;100
48;0;"lamareon";48;100;0
267;143;"lamari";410;65.1219512195122;34.8780487804878
0;383;"lamaria";383;0;100
0;22;"lamariah";22;0;100
58;0;"lamarian";58;100;0
0;13;"lamariana";13;0;100
0;8;"lamarianna";8;0;100
0;6;"lamarie";6;0;100
546;0;"lamario";546;100;0
940;0;"lamarion";940;100;0
38;0;"lamarious";38;100;0
14;0;"lamaris";14;100;0
188;0;"lamarius";188;100;0
0;21;"lamariya";21;0;100
0;11;"lamariyah";11;0;100
490;0;"lamark";490;100;0
153;0;"lamarkus";153;100;0
49;0;"lamarquis";49;100;0
5;0;"lamarqus";5;100;0
2781;30;"lamarr";2811;98.9327641408751;1.06723585912487
0;5;"lamarra";5;0;100
0;39;"lamarria";39;0;100
32;0;"lamarrion";32;100;0
56;0;"lamart";56;100;0
5;0;"lamarus";5;100;0
7;0;"lamauri";7;100;0
0;584;"lamaya";584;0;100
0;27;"lamayah";27;0;100
0;7;"lamayia";7;0;100
5;0;"lamb";5;100;0
3285;0;"lambert";3285;100;0
308;0;"lamberto";308;100;0
47;0;"lambros";47;100;0
0;5;"lamea";5;0;100
0;22;"lameca";22;0;100
0;22;"lamecca";22;0;100
16;0;"lamech";16;100;0
0;22;"lamecia";22;0;100
33;0;"lameek";33;100;0
0;63;"lameeka";63;0;100
6;0;"lameen";6;100;0
5;0;"lameer";5;100;0
0;359;"lamees";359;0;100
0;5;"lameese";5;0;100
0;35;"lameika";35;0;100
5;0;"lameir";5;100;0
0;184;"lameisha";184;0;100
0;480;"lameka";480;0;100
0;80;"lamekia";80;0;100
317;0;"lamel";317;100;0
42;0;"lamell";42;100;0
0;5;"lamera";5;0;100
68;0;"lamere";68;100;0
0;15;"lameria";15;0;100
0;92;"lamerle";92;0;100
0;15;"lamesa";15;0;100
0;5;"lamese";5;0;100
0;579;"lamesha";579;0;100
0;161;"lameshia";161;0;100
0;57;"lametra";57;0;100
0;96;"lametria";96;0;100
0;6;"lametrice";6;0;100
0;5;"lameya";5;0;100
0;1163;"lamia";1163;0;100
0;281;"lamiah";281;0;100
0;63;"lamica";63;0;100
304;0;"lamichael";304;100;0
15;0;"lamicheal";15;100;0
5;0;"lamiek";5;100;0
28;0;"lamier";28;100;0
0;59;"lamija";59;0;100
0;372;"lamika";372;0;100
189;0;"lamin";189;100;0
203;0;"lamine";203;100;0
226;0;"lamir";226;100;0
0;84;"lamira";84;0;100
0;163;"lamiracle";163;0;100
0;7;"lamirah";7;0;100
0;5;"lamirra";5;0;100
0;110;"lamis";110;0;100
0;15;"lamisa";15;0;100
0;343;"lamisha";343;0;100
0;625;"lamiya";625;0;100
0;611;"lamiyah";611;0;100
323;83;"lamoine";406;79.5566502463054;20.4433497536946
1431;0;"lamon";1431;100;0
0;385;"lamona";385;0;100
719;0;"lamond";719;100;0
0;72;"lamonda";72;0;100
6;0;"lamondo";6;100;0
74;0;"lamondre";74;100;0
144;0;"lamone";144;100;0
18;42;"lamoni";60;30;70
6;1662;"lamonica";1668;0.359712230215827;99.6402877697842
0;6;"lamonique";6;0;100
23338;165;"lamont";23503;99.2979619623027;0.702038037697315
226;0;"lamonta";226;100;0
241;0;"lamontae";241;100;0
46;0;"lamontay";46;100;0
3245;0;"lamonte";3245;100;0
42;0;"lamontez";42;100;0
5;0;"lamontray";5;100;0
28;0;"lamontre";28;100;0
49;0;"lamor";49;100;0
0;15;"lamora";15;0;100
0;5;"lamoria";5;0;100
272;0;"lamorris";272;100;0
200;0;"lamount";200;100;0
28;0;"lamour";28;100;0
139;75;"lamoyne";214;64.9532710280374;35.0467289719626
6;0;"lamuel";6;100;0
0;1777;"lamya";1777;0;100
0;262;"lamyah";262;0;100
0;202;"lamyia";202;0;100
0;54;"lamyiah";54;0;100
0;11;"lamyla";11;0;100
0;109;"lamyra";109;0;100
0;5;"lamyrah";5;0;100
271;759;"lan";1030;26.3106796116505;73.6893203883495
15;50083;"lana";50098;0.0299413150225558;99.9700586849774
0;25;"lanadia";25;0;100
0;2630;"lanae";2630;0;100
0;5;"lanaea";5;0;100
0;11;"lanaeya";11;0;100
0;319;"lanah";319;0;100
0;430;"lanai";430;0;100
0;36;"lanaia";36;0;100
0;5;"lanaija";5;0;100
0;8;"lanaijah";8;0;100
0;46;"lanaisha";46;0;100
0;187;"lanaiya";187;0;100
0;35;"lanaiyah";35;0;100
0;58;"lanaja";58;0;100
0;43;"lanajah";43;0;100
0;5;"lanajia";5;0;100
0;29;"lananh";29;0;100
339;0;"lanard";339;100;0
0;11;"lanaria";11;0;100
0;6;"lanarose";6;0;100
0;56;"lanasha";56;0;100
0;11;"lanashia";11;0;100
0;381;"lanasia";381;0;100
0;49;"lanautica";49;0;100
0;6;"lanavia";6;0;100
0;562;"lanay";562;0;100
0;1220;"lanaya";1220;0;100
0;204;"lanayah";204;0;100
0;14;"lanaye";14;0;100
0;20;"lanayia";20;0;100
0;5;"lanayja";5;0;100
0;33;"lanaysha";33;0;100
0;5;"lanayshia";5;0;100
0;68;"lanaysia";68;0;100
0;6;"lanazia";6;0;100
5;0;"lancaster";5;100;0
102838;345;"lance";103183;99.6656425961641;0.334357403835903
572;0;"lancelot";572;100;0
191;0;"lancer";191;100;0
5;0;"lanceton";5;100;0
5;0;"lancing";5;100;0
31;0;"lancy";31;100;0
0;639;"landa";639;0;100
2091;5;"landan";2096;99.7614503816794;0.238549618320611
5;0;"landdon";5;100;0
0;8;"landee";8;0;100
5;0;"landel";5;100;0
6;0;"landell";6;100;0
22729;181;"landen";22910;99.2099519860323;0.7900480139677
5;0;"landenn";5;100;0
846;0;"lander";846;100;0
77;0;"landers";77;100;0
0;109;"landi";109;0;100
2363;16;"landin";2379;99.3274485077764;0.672551492223623
2100;261;"landis";2361;88.9453621346887;11.0546378653113
297;0;"lando";297;100;0
145318;777;"landon";146095;99.4681542831719;0.531845716828091
15;0;"landonn";15;100;0
0;420;"landra";420;0;100
0;33;"landrea";33;0;100
11;534;"landree";545;2.01834862385321;97.9816513761468
27;292;"landrey";319;8.46394984326019;91.5360501567398
0;726;"landri";726;0;100
0;28;"landria";28;0;100
23;0;"landric";23;100;0
6;0;"landrick";6;100;0
0;664;"landrie";664;0;100
5;0;"landris";5;100;0
120;0;"landrum";120;100;0
3996;3337;"landry";7333;54.4933860630029;45.5066139369971
23;0;"landun";23;100;0
10;0;"landus";10;100;0
591;239;"landy";830;71.2048192771084;28.7951807228916
8454;871;"landyn";9325;90.6595174262735;9.34048257372654
120;33;"landynn";153;78.4313725490196;21.5686274509804
5;0;"landyon";5;100;0
35587;3716;"lane";39303;90.5452509986515;9.4547490013485
0;515;"lanea";515;0;100
0;98;"laneah";98;0;100
0;7;"lanease";7;0;100
0;5;"lanece";5;0;100
0;143;"lanecia";143;0;100
0;16;"lanedra";16;0;100
0;831;"lanee";831;0;100
0;10;"laneeka";10;0;100
0;41;"laneesha";41;0;100
0;82;"laneice";82;0;100
0;11;"laneigh";11;0;100
0;11;"laneika";11;0;100
0;5;"laneise";5;0;100
0;616;"laneisha";616;0;100
0;6;"laneita";6;0;100
0;180;"laneka";180;0;100
0;5;"lanekia";5;0;100
5;28;"lanel";33;15.1515151515152;84.8484848484848
0;17;"lanelda";17;0;100
349;2117;"lanell";2466;14.1524736415247;85.8475263584753
0;1517;"lanelle";1517;0;100
0;5;"lanena";5;0;100
0;10;"lanequa";10;0;100
0;12;"lanequia";12;0;100
0;5;"lanesa";5;0;100
0;54;"lanese";54;0;100
0;900;"lanesha";900;0;100
0;225;"laneshia";225;0;100
0;25;"lanesia";25;0;100
0;495;"lanessa";495;0;100
0;21;"lanet";21;0;100
0;183;"laneta";183;0;100
0;90;"lanetra";90;0;100
0;130;"lanett";130;0;100
0;1064;"lanetta";1064;0;100
0;4979;"lanette";4979;0;100
0;5;"laneva";5;0;100
336;10155;"laney";10491;3.20274521018015;96.7972547898198
0;114;"laneya";114;0;100
0;8;"laneyah";8;0;100
16;0;"lanford";16;100;0
519;6;"lang";525;98.8571428571429;1.14285714285714
1049;10;"langdon";1059;99.0557129367328;0.944287063267233
5;0;"lange";5;100;0
81;0;"langford";81;100;0
149;487;"langley";636;23.4276729559748;76.5723270440252
4420;255;"langston";4675;94.5454545454545;5.45454545454545
0;17;"langstyn";17;0;100
6;0;"lanham";6;100;0
172;6530;"lani";6702;2.56639809012235;97.4336019098777
0;844;"lania";844;0;100
0;699;"laniah";699;0;100
0;6;"laniakea";6;0;100
0;43;"laniaya";43;0;100
0;12;"lanica";12;0;100
0;358;"lanice";358;0;100
0;26;"lanicia";26;0;100
0;6;"lanicka";6;0;100
35;4609;"lanie";4644;0.753660637381568;99.2463393626184
0;539;"laniece";539;0;100
998;111;"lanier";1109;89.9909828674482;10.0090171325518
0;116;"laniesha";116;0;100
0;13;"lanieya";13;0;100
0;59;"lanija";59;0;100
0;124;"lanijah";124;0;100
0;467;"lanika";467;0;100
0;16;"lanikai";16;0;100
0;11;"lanikki";11;0;100
0;111;"lanina";111;0;100
0;87;"laniqua";87;0;100
0;266;"lanique";266;0;100
178;58;"lanis";236;75.4237288135593;24.5762711864407
0;75;"lanisa";75;0;100
0;586;"lanise";586;0;100
0;1239;"lanisha";1239;0;100
0;15;"lanishia";15;0;100
0;92;"lanissa";92;0;100
0;3646;"lanita";3646;0;100
0;196;"lanitra";196;0;100
0;2740;"laniya";2740;0;100
0;2712;"laniyah";2712;0;100
0;11;"laniyha";11;0;100
0;5;"laniyia";5;0;100
10;0;"lank";10;100;0
61;0;"lankford";61;100;0
15;0;"lann";15;100;0
0;1926;"lanna";1926;0;100
0;197;"lannah";197;0;100
6;0;"lanndon";6;100;0
5;0;"lannes";5;100;0
0;5;"lannetta";5;0;100
0;560;"lannette";560;0;100
33;0;"lanney";33;100;0
0;16;"lanni";16;0;100
1845;1438;"lannie";3283;56.1985988425221;43.8014011574779
18;0;"lanning";18;100;0
127;28;"lannis";155;81.9354838709677;18.0645161290323
10;0;"lannon";10;100;0
9549;67;"lanny";9616;99.3032445923461;0.69675540765391
0;8;"lanor";8;0;100
0;2063;"lanora";2063;0;100
0;289;"lanore";289;0;100
7;0;"lanoris";7;100;0
146;0;"lanorris";146;100;0
21;0;"lansana";21;100;0
512;0;"lansing";512;100;0
122;0;"lanson";122;100;0
6;0;"lanston";6;100;0
0;10;"lanta";10;0;100
0;5;"lantanya";5;0;100
10;0;"lanty";10;100;0
537;0;"lantz";537;100;0
0;5;"lanvy";5;0;100
16;0;"lanxton";16;100;0
5;41;"lany";46;10.8695652173913;89.1304347826087
0;796;"lanya";796;0;100
0;385;"lanyah";385;0;100
5;0;"lanyard";5;100;0
0;5;"lanye";5;0;100
0;256;"lanyia";256;0;100
0;142;"lanyiah";142;0;100
0;10;"lanyjah";10;0;100
0;81;"lanyla";81;0;100
0;10;"lanylah";10;0;100
0;5;"lanyra";5;0;100
33;0;"lanz";33;100;0
32;0;"lao";32;100;0
0;5;"laoma";5;0;100
5;139;"laparis";144;3.47222222222222;96.5277777777778
0;5;"lapatra";5;0;100
57;0;"lapatrick";57;100;0
10;0;"lapaul";10;100;0
0;5;"lapearl";5;0;100
5;0;"laphonso";5;100;0
0;246;"laporcha";246;0;100
0;133;"laporche";133;0;100
0;5;"laporchea";5;0;100
0;74;"laporchia";74;0;100
0;107;"laporscha";107;0;100
0;118;"laporsche";118;0;100
0;6;"laporschia";6;0;100
0;731;"laporsha";731;0;100
0;21;"laporshe";21;0;100
0;83;"laporshia";83;0;100
0;219;"laportia";219;0;100
0;27;"lapreal";27;0;100
0;208;"laprecious";208;0;100
0;11;"lapresha";11;0;100
0;11;"lapria";11;0;100
0;10;"lapriel";10;0;100
6;0;"lapriest";6;100;0
0;27;"laprincess";27;0;100
0;60;"laprincia";60;0;100
0;6;"laqresha";6;0;100
0;5;"laquail";5;0;100
5;0;"laquain";5;100;0
0;35;"laquaisha";35;0;100
0;10;"laquala";10;0;100
2320;217;"laquan";2537;91.4465904611746;8.55340953882538
0;763;"laquana";763;0;100
0;1539;"laquanda";1539;0;100
0;432;"laquandra";432;0;100
0;29;"laquandria";29;0;100
23;0;"laquane";23;100;0
0;7;"laquania";7;0;100
42;0;"laquann";42;100;0
0;273;"laquanna";273;0;100
0;333;"laquanta";333;0;100
12;0;"laquante";12;100;0
0;15;"laquanya";15;0;100
0;17;"laquanza";17;0;100
42;5;"laquarius";47;89.3617021276596;10.6382978723404
0;433;"laquasha";433;0;100
0;70;"laquashia";70;0;100
0;162;"laquasia";162;0;100
0;37;"laquata";37;0;100
0;7;"laquatta";7;0;100
0;13;"laquavia";13;0;100
5;0;"laquavion";5;100;0
38;0;"laquavious";38;100;0
12;0;"laquavis";12;100;0
5;0;"laquavius";5;100;0
5;12;"laquay";17;29.4117647058824;70.5882352941177
0;29;"laquaya";29;0;100
0;19;"laquaysha";19;0;100
0;21;"laqueda";21;0;100
0;10;"laqueen";10;0;100
0;149;"laqueena";149;0;100
0;15;"laqueeta";15;0;100
0;128;"laqueisha";128;0;100
0;10;"laqueita";10;0;100
0;5;"laquel";5;0;100
0;6;"laquela";6;0;100
0;6;"laquella";6;0;100
0;10;"laquenda";10;0;100
0;69;"laquenta";69;0;100
130;0;"laquentin";130;100;0
0;946;"laquesha";946;0;100
0;141;"laqueshia";141;0;100
0;5;"laquesta";5;0;100
0;426;"laqueta";426;0;100
0;5;"laquetha";5;0;100
0;1031;"laquetta";1031;0;100
0;43;"laquette";43;0;100
20;0;"laquez";20;100;0
0;62;"laquia";62;0;100
0;5;"laquicha";5;0;100
0;130;"laquida";130;0;100
0;94;"laquiesha";94;0;100
0;12;"laquieta";12;0;100
0;5;"laquietta";5;0;100
0;5;"laquil";5;0;100
0;31;"laquila";31;0;100
0;77;"laquilla";77;0;100
5;0;"laquin";5;100;0
0;47;"laquina";47;0;100
0;10;"laquincia";10;0;100
134;0;"laquincy";134;100;0
0;145;"laquinda";145;0;100
53;5;"laquinn";58;91.3793103448276;8.62068965517241
27;1209;"laquinta";1236;2.18446601941748;97.8155339805825
0;5;"laquinthia";5;0;100
49;0;"laquintin";49;100;0
351;0;"laquinton";351;100;0
0;47;"laquisa";47;0;100
0;5;"laquise";5;0;100
0;2728;"laquisha";2728;0;100
0;49;"laquishia";49;0;100
0;16;"laquista";16;0;100
0;6398;"laquita";6398;0;100
0;5;"laquite";5;0;100
0;68;"laquitha";68;0;100
0;18;"laquitia";18;0;100
0;707;"laquitta";707;0;100
0;60;"laqunda";60;0;100
0;5;"laqundra";5;0;100
0;10;"laqunita";10;0;100
0;10;"laquoia";10;0;100
108;0;"laquon";108;100;0
0;63;"laquonda";63;0;100
0;5;"laqusha";5;0;100
15;0;"laqwan";15;100;0
0;17;"laqwanda";17;0;100
34;26556;"lara";26590;0.127867619405792;99.8721323805942
0;3274;"larae";3274;0;100
0;5;"laraea";5;0;100
0;195;"larah";195;0;100
0;51;"laraib";51;0;100
0;10;"larain";10;0;100
0;55;"laraina";55;0;100
0;3449;"laraine";3449;0;100
0;33;"laralee";33;0;100
0;5;"laralyn";5;0;100
0;10;"laramee";10;0;100
1006;781;"laramie";1787;56.2954672635702;43.7045327364298
47;0;"laramy";47;100;0
171;0;"larance";171;100;0
0;284;"laranda";284;0;100
0;10;"larane";10;0;100
0;11;"larasha";11;0;100
0;47;"laraven";47;0;100
371;366;"laray";737;50.3392130257802;49.6607869742198
0;207;"laraya";207;0;100
0;69;"larayah";69;0;100
0;5;"laraye";5;0;100
0;15;"larayna";15;0;100
0;393;"larayne";393;0;100
5;0;"larce";5;100;0
0;64;"larcenia";64;0;100
0;5;"larea";5;0;100
0;5;"larean";5;0;100
0;5;"larecia";5;0;100
5;0;"lareco";5;100;0
19;5;"laredo";24;79.1666666666667;20.8333333333333
0;1429;"laree";1429;0;100
0;152;"lareen";152;0;100
0;48;"lareesa";48;0;100
0;21;"lareese";21;0;100
0;559;"lareina";559;0;100
0;28;"lareine";28;0;100
0;40;"lareisha";40;0;100
0;23;"lareka";23;0;100
336;5;"larell";341;98.533724340176;1.46627565982405
14;15;"larelle";29;48.2758620689655;51.7241379310345
24;0;"laremy";24;100;0
370;525;"laren";895;41.340782122905;58.659217877095
0;810;"larena";810;0;100
1091;0;"larence";1091;100;0
0;6;"larencia";6;0;100
0;347;"larenda";347;0;100
0;866;"larene";866;0;100
450;0;"larenz";450;100;0
0;5;"larenza";5;0;100
957;0;"larenzo";957;100;0
0;408;"laresa";408;0;100
0;250;"laresha";250;0;100
0;15;"lareshia";15;0;100
0;257;"laressa";257;0;100
0;102;"lareta";102;0;100
0;227;"laretha";227;0;100
0;650;"laretta";650;0;100
21;0;"larey";21;100;0
0;51;"lareyna";51;0;100
5;0;"larez";5;100;0
0;6;"larhea";6;0;100
0;2509;"larhonda";2509;0;100
38;841;"lari";879;4.3230944254835;95.6769055745165
0;133;"laria";133;0;100
0;901;"lariah";901;0;100
0;34;"lariana";34;0;100
0;10;"larianna";10;0;100
0;53;"larica";53;0;100
0;47;"larice";47;0;100
0;10;"laricia";10;0;100
0;5;"laricka";5;0;100
144;0;"larico";144;100;0
5;351;"larie";356;1.40449438202247;98.5955056179775
0;16;"lariel";16;0;100
0;5;"lariesha";5;0;100
0;37;"larika";37;0;100
0;35;"larimar";35;0;100
58;68;"larin";126;46.031746031746;53.968253968254
0;423;"larina";423;0;100
0;525;"larinda";525;0;100
0;76;"larine";76;0;100
10;0;"larion";10;100;0
0;5;"larionna";5;0;100
10;0;"laris";10;100;0
0;3304;"larisa";3304;0;100
0;385;"larisha";385;0;100
0;22188;"larissa";22188;0;100
0;1649;"larita";1649;0;100
0;5;"laritha";5;0;100
0;266;"laritza";266;0;100
0;170;"lariya";170;0;100
0;490;"lariyah";490;0;100
0;187;"lariza";187;0;100
0;5;"larizza";5;0;100
209;1394;"lark";1603;13.0380536494074;86.9619463505926
0;12;"larke";12;0;100
10;69;"larken";79;12.6582278481013;87.3417721518987
5;5;"larkie";10;50;50
1948;1387;"larkin";3335;58.4107946026986;41.5892053973013
0;257;"larkyn";257;0;100
41;0;"larmar";41;100;0
10;0;"larmon";10;100;0
10;0;"larmont";10;100;0
0;234;"larna";234;0;100
332;0;"larnce";332;100;0
874;5;"larnell";879;99.4311717861206;0.568828213879408
5;0;"larnelle";5;100;0
0;5;"larnette";5;0;100
34;0;"larney";34;100;0
0;5;"larnice";5;0;100
77;0;"larnie";77;100;0
5;0;"larobert";5;100;0
16;0;"larod";16;100;0
21;0;"laroderick";21;100;0
5;0;"larodney";5;100;0
5;0;"laroi";5;100;0
39;0;"larome";39;100;0
4928;119;"laron";5047;97.6421636615811;2.35783633841886
0;39;"larona";39;0;100
0;2289;"laronda";2289;0;100
251;0;"larone";251;100;0
0;123;"laronica";123;0;100
103;0;"laronn";103;100;0
0;23;"laronna";23;0;100
12;0;"laronte";12;100;0
10;0;"laronzo";10;100;0
0;116;"larosa";116;0;100
0;224;"larose";224;0;100
0;5;"larosha";5;0;100
1307;0;"laroy";1307;100;0
0;29;"laroya";29;0;100
55;41;"laroyce";96;57.2916666666667;42.7083333333333
0;215;"larra";215;0;100
0;1258;"larraine";1258;0;100
5;0;"larre";5;100;0
103;0;"larrell";103;100;0
79;22;"larren";101;78.2178217821782;21.7821782178218
0;5;"larrene";5;0;100
5;0;"larreon";5;100;0
0;17;"larresha";17;0;100
7;0;"larrey";7;100;0
62;203;"larri";265;23.3962264150943;76.6037735849057
0;5;"larriah";5;0;100
0;5;"larrica";5;0;100
929;339;"larrie";1268;73.2649842271293;26.7350157728707
0;5;"larriesha";5;0;100
0;5;"larrine";5;0;100
56;0;"larrion";56;100;0
27;0;"larris";27;100;0
0;330;"larrisa";330;0;100
0;104;"larrisha";104;0;100
0;343;"larrissa";343;0;100
136;0;"larron";136;100;0
5;0;"larrry";5;100;0
804459;3559;"larry";808018;99.5595395152088;0.44046048479118
6295;0;"lars";6295;100;0
0;5;"larsa";5;0;100
406;115;"larsen";521;77.9270633397313;22.0729366602687
1203;54;"larson";1257;95.7040572792363;4.29594272076372
5;0;"larsson";5;100;0
0;26;"larsyn";26;0;100
0;6;"lartarsha";6;0;100
0;5;"lartha";5;0;100
0;207;"larua";207;0;100
1520;3848;"larue";5368;28.3159463487332;71.6840536512668
0;156;"laruen";156;0;100
0;141;"laruth";141;0;100
6;0;"larvell";6;100;0
11;0;"larwance";11;100;0
394;0;"larwence";394;100;0
33;0;"larwrence";33;100;0
1577;0;"lary";1577;100;0
0;65;"larya";65;0;100
0;107;"laryah";107;0;100
26;0;"laryan";26;100;0
0;46;"laryiah";46;0;100
0;389;"laryn";389;0;100
0;155;"larysa";155;0;100
0;1208;"laryssa";1208;0;100
171;0;"larz";171;100;0
395;16;"lasalle";411;96.1070559610706;3.89294403892944
16;0;"lasana";16;100;0
0;6;"lasanda";6;0;100
0;1520;"lasandra";1520;0;100
0;15;"lasanya";15;0;100
0;5;"lasara";5;0;100
131;0;"lasaro";131;100;0
0;162;"lasasha";162;0;100
0;5;"lasaunda";5;0;100
0;300;"lasaundra";300;0;100
0;23;"lasca";23;0;100
5;0;"lascelles";5;100;0
5;0;"lasco";5;100;0
399;155;"lasean";554;72.0216606498195;27.9783393501805
5;0;"lasedrick";5;100;0
0;8;"lasette";8;0;100
0;39;"lasey";39;0;100
78;0;"lash";78;100;0
0;1033;"lasha";1033;0;100
23;0;"lashad";23;100;0
0;11;"lashada";11;0;100
0;1581;"lashae";1581;0;100
0;210;"lashai";210;0;100
0;18;"lashaina";18;0;100
0;56;"lashala";56;0;100
0;5;"lashalle";5;0;100
87;512;"lashan";599;14.5242070116861;85.4757929883139
0;1060;"lashana";1060;0;100
0;56;"lashanae";56;0;100
0;10;"lashanay";10;0;100
0;4674;"lashanda";4674;0;100
0;960;"lashandra";960;0;100
0;12;"lashandria";12;0;100
10;106;"lashane";116;8.62068965517241;91.3793103448276
0;10;"lashanette";10;0;100
0;35;"lashanique";35;0;100
0;93;"lashann";93;0;100
0;806;"lashanna";806;0;100
0;291;"lashannon";291;0;100
0;509;"lashanta";509;0;100
0;272;"lashante";272;0;100
0;349;"lashanti";349;0;100
0;17;"lashanya";17;0;100
0;6;"lashaon";6;0;100
0;358;"lashara";358;0;100
0;6;"lasharee";6;0;100
0;16;"lashari";16;0;100
0;6;"lasharia";6;0;100
0;83;"lasharn";83;0;100
0;157;"lasharon";157;0;100
0;21;"lasharra";21;0;100
0;23;"lashasta";23;0;100
817;1275;"lashaun";2092;39.0535372848948;60.9464627151052
0;732;"lashauna";732;0;100
0;1421;"lashaunda";1421;0;100
0;480;"lashaundra";480;0;100
0;17;"lashaundria";17;0;100
0;26;"lashaune";26;0;100
0;39;"lashaunna";39;0;100
0;78;"lashaunta";78;0;100
0;21;"lashaunte";21;0;100
0;12;"lashaunti";12;0;100
0;15;"lashavia";15;0;100
5;5;"lashaw";10;50;50
0;30;"lashawanda";30;0;100
0;10;"lashawda";10;0;100
3060;7321;"lashawn";10381;29.4769290049128;70.5230709950872
0;1795;"lashawna";1795;0;100
0;2226;"lashawnda";2226;0;100
0;256;"lashawndra";256;0;100
0;78;"lashawne";78;0;100
0;75;"lashawnna";75;0;100
0;84;"lashawnta";84;0;100
10;2749;"lashay";2759;0.362450163102573;99.6375498368974
0;273;"lashaya";273;0;100
0;163;"lashaye";163;0;100
0;473;"lashayla";473;0;100
0;22;"lashayna";22;0;100
0;66;"lashe";66;0;100
0;900;"lashea";900;0;100
0;80;"lasheba";80;0;100
0;6;"lasheen";6;0;100
0;478;"lasheena";478;0;100
0;5;"lasheia";5;0;100
0;146;"lasheika";146;0;100
0;10;"lasheila";10;0;100
0;304;"lasheka";304;0;100
0;37;"lashekia";37;0;100
0;22;"lashel";22;0;100
0;5;"lashelia";5;0;100
0;993;"lashell";993;0;100
0;11;"lashella";11;0;100
0;1045;"lashelle";1045;0;100
0;34;"lashema";34;0;100
0;74;"lashena";74;0;100
0;6;"lashenda";6;0;100
0;19;"lashenna";19;0;100
0;37;"lashera";37;0;100
0;5;"lasherrie";5;0;100
0;5;"lasheryl";5;0;100
0;5;"lasheta";5;0;100
0;16;"lashey";16;0;100
0;153;"lashia";153;0;100
0;84;"lashica";84;0;100
0;18;"lashieka";18;0;100
0;156;"lashika";156;0;100
0;56;"lashina";56;0;100
0;7;"lashinda";7;0;100
0;46;"lashira";46;0;100
0;40;"lashiya";40;0;100
0;6;"lashiyah";6;0;100
0;5;"lashley";5;0;100
677;1534;"lashon";2211;30.6196291270918;69.3803708729082
0;419;"lashona";419;0;100
0;10;"lashond";10;0;100
0;9230;"lashonda";9230;0;100
0;17;"lashondia";17;0;100
0;1097;"lashondra";1097;0;100
0;34;"lashondria";34;0;100
56;396;"lashone";452;12.3893805309735;87.6106194690265
0;42;"lashonia";42;0;100
0;32;"lashonn";32;0;100
0;429;"lashonna";429;0;100
0;65;"lashonne";65;0;100
0;238;"lashonta";238;0;100
0;36;"lashonte";36;0;100
0;52;"lashonya";52;0;100
0;6;"lashounda";6;0;100
0;5;"lashown";5;0;100
0;5;"lashowna";5;0;100
307;677;"lashun";984;31.1991869918699;68.8008130081301
0;139;"lashuna";139;0;100
0;2270;"lashunda";2270;0;100
0;5;"lashundia";5;0;100
0;983;"lashundra";983;0;100
0;24;"lashundria";24;0;100
0;8;"lashune";8;0;100
0;23;"lashunna";23;0;100
0;106;"lashunta";106;0;100
0;5;"lashunti";5;0;100
0;5;"lashunya";5;0;100
0;5;"lashurn";5;0;100
0;65;"lashya";65;0;100
0;20;"lashyia";20;0;100
0;37;"lashyra";37;0;100
0;10;"lasia";10;0;100
0;12;"lasiah";12;0;100
0;8;"lasiya";8;0;100
0;6;"lasiyah";6;0;100
112;0;"lason";112;100;0
0;47;"lasonda";47;0;100
0;539;"lasondra";539;0;100
0;450;"lasonia";450;0;100
0;452;"lasonja";452;0;100
0;1700;"lasonya";1700;0;100
13;0;"lassana";13;100;0
0;21;"lassandra";21;0;100
6;0;"lasse";6;100;0
0;847;"lassie";847;0;100
0;79;"lastacia";79;0;100
0;38;"lastar";38;0;100
0;39;"lastarr";39;0;100
6;0;"lastarza";6;100;0
0;11;"lastasha";11;0;100
0;5;"lastasia";5;0;100
12;0;"lastat";12;100;0
67;0;"laster";67;100;0
0;11;"lasunda";11;0;100
0;80;"lasundra";80;0;100
0;273;"lasya";273;0;100
798;0;"laszlo";798;100;0
0;5;"lata";5;0;100
0;168;"latacha";168;0;100
0;18;"latachia";18;0;100
0;38;"latacia";38;0;100
0;5;"latae";5;0;100
0;6;"lataesha";6;0;100
0;5;"latai";5;0;100
0;44;"lataija";44;0;100
0;273;"lataisha";273;0;100
0;5;"lataivia";5;0;100
0;5;"lataiya";5;0;100
0;106;"lataja";106;0;100
0;85;"latajah";85;0;100
0;15;"latajia";15;0;100
0;93;"latalia";93;0;100
0;13;"latalya";13;0;100
0;68;"latamara";68;0;100
0;79;"latana";79;0;100
0;98;"latandra";98;0;100
0;11;"latane";11;0;100
0;152;"latanga";152;0;100
0;143;"latangela";143;0;100
0;5;"latangie";5;0;100
0;497;"latania";497;0;100
0;5;"latanisha";5;0;100
0;136;"latanja";136;0;100
23;9840;"latanya";9863;0.233194768326067;99.7668052316739
0;5;"latanyia";5;0;100
0;80;"latanza";80;0;100
0;1394;"latara";1394;0;100
0;5;"latarah";5;0;100
0;34;"latarcha";34;0;100
0;5;"latari";5;0;100
0;69;"lataria";69;0;100
0;16;"latarisha";16;0;100
38;0;"latarius";38;100;0
0;87;"latarra";87;0;100
0;1975;"latarsha";1975;0;100
0;65;"latarshia";65;0;100
0;5;"latarsia";5;0;100
18;0;"latarus";18;100;0
0;22;"latarya";22;0;100
0;45;"latascha";45;0;100
0;92;"latash";92;0;100
114;30184;"latasha";30298;0.376262459568288;99.6237375404317
0;6;"latashi";6;0;100
0;1798;"latashia";1798;0;100
0;10;"latashua";10;0;100
0;605;"latasia";605;0;100
0;6;"lataska";6;0;100
0;5;"latassha";5;0;100
0;5;"latatia";5;0;100
0;61;"lataunya";61;0;100
0;7;"lataura";7;0;100
52;5;"lataurus";57;91.2280701754386;8.7719298245614
0;285;"latausha";285;0;100
0;5;"latavea";5;0;100
5;0;"lataveon";5;100;0
0;2295;"latavia";2295;0;100
50;0;"latavian";50;100;0
125;0;"latavion";125;100;0
178;0;"latavious";178;100;0
10;0;"latavis";10;100;0
156;0;"latavius";156;100;0
0;5;"latawn";5;0;100
0;54;"latawnya";54;0;100
0;17;"latay";17;0;100
0;758;"lataya";758;0;100
0;5;"latayia";5;0;100
0;183;"latayna";183;0;100
0;109;"lataysha";109;0;100
0;9;"latayshia";9;0;100
0;41;"lataysia";41;0;100
0;86;"latayvia";86;0;100
0;43;"latazia";43;0;100
0;43;"latea";43;0;100
0;6;"lateafa";6;0;100
0;5;"lateaka";5;0;100
0;13;"lateasa";13;0;100
0;5;"latease";5;0;100
0;439;"lateasha";439;0;100
0;5;"lateashia";5;0;100
0;21;"latece";21;0;100
0;18;"latecha";18;0;100
0;26;"latechia";26;0;100
0;505;"latecia";505;0;100
0;31;"latedra";31;0;100
10;0;"latee";10;100;0
848;0;"lateef";848;100;0
0;115;"lateefa";115;0;100
0;617;"lateefah";617;0;100
6;0;"lateek";6;100;0
0;6;"lateeka";6;0;100
0;5;"lateela";5;0;100
0;18;"lateen";18;0;100
0;13;"lateena";13;0;100
0;446;"lateesha";446;0;100
0;28;"latefa";28;0;100
0;5;"latefah";5;0;100
0;6;"latefia";6;0;100
0;106;"lateia";106;0;100
0;5;"lateika";5;0;100
0;1019;"lateisha";1019;0;100
0;171;"lateka";171;0;100
0;5;"latela";5;0;100
5;0;"laten";5;100;0
0;5;"latenya";5;0;100
0;98;"latera";98;0;100
0;10;"lateresa";10;0;100
0;6;"laterese";6;0;100
0;262;"lateria";262;0;100
5;0;"laterian";5;100;0
0;202;"laterica";202;0;100
0;6;"latericka";6;0;100
0;36;"laterika";36;0;100
15;0;"laterius";15;100;0
0;257;"laterra";257;0;100
196;0;"laterrance";196;100;0
5;0;"laterrell";5;100;0
25;0;"laterrence";25;100;0
0;204;"laterria";204;0;100
65;5;"laterrian";70;92.8571428571429;7.14285714285714
0;235;"laterrica";235;0;100
0;20;"laterrika";20;0;100
12;0;"laterrion";12;100;0
11;0;"laterrious";11;100;0
20;0;"laterrius";20;100;0
0;182;"latesa";182;0;100
0;88;"latese";88;0;100
0;3109;"latesha";3109;0;100
0;682;"lateshia";682;0;100
0;172;"latesia";172;0;100
0;282;"latessa";282;0;100
0;6;"latessia";6;0;100
0;10;"latetia";10;0;100
0;5;"latevia";5;0;100
11;0;"latevin";11;100;0
0;78;"lateya";78;0;100
0;209;"latha";209;0;100
449;0;"latham";449;100;0
3506;0;"lathan";3506;100;0
160;0;"lathaniel";160;100;0
0;6;"lathasha";6;0;100
18;0;"lathe";18;100;0
6;0;"lathem";6;100;0
317;0;"lathen";317;100;0
0;5;"lathena";5;0;100
0;7;"lathisa";7;0;100
5;0;"lathomas";5;100;0
88;0;"lathon";88;100;0
68;0;"lathyn";68;100;0
0;2865;"latia";2865;0;100
0;15;"latiah";15;0;100
0;181;"latiana";181;0;100
0;26;"latianna";26;0;100
0;31;"latiara";31;0;100
0;11;"latiasha";11;0;100
0;89;"latica";89;0;100
0;209;"latice";209;0;100
0;146;"laticha";146;0;100
0;13;"latichia";13;0;100
0;2342;"laticia";2342;0;100
0;5;"latiea";5;0;100
5;0;"latief";5;100;0
0;10;"latieka";10;0;100
0;25;"latiera";25;0;100
0;27;"latierra";27;0;100
0;308;"latiesha";308;0;100
374;0;"latif";374;100;0
0;725;"latifa";725;0;100
0;1421;"latifah";1421;0;100
0;11;"latiffa";11;0;100
0;223;"latiffany";223;0;100
0;42;"latifha";42;0;100
0;9;"latifia";9;0;100
0;22;"latigra";22;0;100
0;11;"latijera";11;0;100
0;474;"latika";474;0;100
0;58;"latima";58;0;100
24;0;"latimer";24;100;0
0;2049;"latina";2049;0;100
0;10;"latinia";10;0;100
0;23;"latinya";23;0;100
0;12;"lationa";12;0;100
0;58;"latiqua";58;0;100
6;0;"latique";6;100;0
0;16;"latira";16;0;100
0;535;"latisa";535;0;100
0;16;"latischa";16;0;100
0;78;"latise";78;0;100
0;121;"latish";121;0;100
38;18344;"latisha";18382;0.206723969100207;99.7932760308998
0;645;"latishia";645;0;100
0;71;"latisia";71;0;100
0;119;"latissa";119;0;100
0;28;"latissha";28;0;100
0;5;"latissia";5;0;100
0;5;"latissue";5;0;100
0;38;"latita";38;0;100
0;490;"latitia";490;0;100
0;6;"lativa";6;0;100
0;61;"lativia";61;0;100
0;165;"latiya";165;0;100
0;6;"latiyah";6;0;100
0;16;"latocha";16;0;100
5;0;"latodd";5;100;0
0;88;"latoi";88;0;100
0;288;"latoia";288;0;100
0;5;"latoina";5;0;100
0;16;"latoisha";16;0;100
0;174;"latoiya";174;0;100
32;0;"laton";32;100;0
0;345;"latona";345;0;100
0;252;"latonda";252;0;100
0;174;"latondra";174;0;100
0;128;"latonga";128;0;100
0;10;"latongia";10;0;100
0;31;"latoni";31;0;100
16;5104;"latonia";5120;0.3125;99.6875
28;0;"latonio";28;100;0
0;684;"latonja";684;0;100
0;10;"latonjia";10;0;100
0;44;"latonna";44;0;100
0;10;"latonnia";10;0;100
11;0;"latony";11;100;0
67;21732;"latonya";21799;0.307353548327905;99.6926464516721
0;107;"latonyia";107;0;100
0;10;"latonza";10;0;100
0;521;"latora";521;0;100
0;157;"latori";157;0;100
0;2697;"latoria";2697;0;100
0;74;"latorie";74;0;100
0;37;"latorra";37;0;100
5;0;"latorrance";5;100;0
0;5;"latorri";5;0;100
0;151;"latorria";151;0;100
0;10;"latorrie";10;0;100
0;84;"latorsha";84;0;100
0;44;"latory";44;0;100
0;532;"latorya";532;0;100
0;13;"latosca";13;0;100
0;6;"latoscha";6;0;100
0;6441;"latosha";6441;0;100
0;1057;"latoshia";1057;0;100
0;21;"latosia";21;0;100
0;17;"latousha";17;0;100
0;12;"latova";12;0;100
0;15;"latovia";15;0;100
0;136;"latoy";136;0;100
185;45452;"latoya";45637;0.405372833446546;99.5946271665535
0;43;"latoyah";43;0;100
0;11;"latoye";11;0;100
0;10;"latoyer";10;0;100
0;1578;"latoyia";1578;0;100
0;5;"latoyla";5;0;100
0;181;"latoyna";181;0;100
0;6;"latoynia";6;0;100
0;11;"latoyo";11;0;100
0;5;"latoyra";5;0;100
0;17;"latoyria";17;0;100
0;33;"latoysha";33;0;100
0;17;"latoyta";17;0;100
0;43;"latoyya";43;0;100
0;16;"latracia";16;0;100
0;5;"latracy";5;0;100
6;0;"latrae";6;100;0
107;13;"latrail";120;89.1666666666667;10.8333333333333
0;5;"latrasha";5;0;100
0;200;"latravia";200;0;100
113;0;"latravion";113;100;0
170;0;"latravious";170;100;0
138;0;"latravis";138;100;0
29;0;"latravius";29;100;0
31;0;"latray";31;100;0
0;10;"latraya";10;0;100
5;0;"latrayvion";5;100;0
33;0;"latre";33;100;0
0;10;"latrea";10;0;100
0;41;"latreace";41;0;100
16;0;"latreal";16;100;0
0;15;"latreasa";15;0;100
0;289;"latrease";289;0;100
0;5;"latreca";5;0;100
0;690;"latrece";690;0;100
0;450;"latrecia";450;0;100
0;175;"latreece";175;0;100
0;5;"latreena";5;0;100
0;49;"latreese";49;0;100
0;7;"latreice";7;0;100
0;12;"latreisha";12;0;100
0;5;"latreka";5;0;100
92;0;"latrel";92;100;0
3452;541;"latrell";3993;86.4512897570749;13.5487102429251
241;570;"latrelle";811;29.7163995067817;70.2836004932182
0;261;"latrena";261;0;100
0;485;"latrenda";485;0;100
0;11;"latrenia";11;0;100
0;22;"latres";22;0;100
0;549;"latresa";549;0;100
0;810;"latrese";810;0;100
0;464;"latresha";464;0;100
0;61;"latreshia";61;0;100
0;53;"latresia";53;0;100
0;19;"latress";19;0;100
0;290;"latressa";290;0;100
0;22;"latreva";22;0;100
0;11;"latrevia";11;0;100
30;0;"latrevion";30;100;0
21;0;"latrevious";21;100;0
17;0;"latrey";17;100;0
36;0;"latrez";36;100;0
0;64;"latria";64;0;100
0;5;"latric";5;0;100
0;503;"latrica";503;0;100
17;9088;"latrice";9105;0.186710598572213;99.8132894014278
0;14;"latricha";14;0;100
0;5616;"latricia";5616;0;100
0;183;"latriece";183;0;100
0;6;"latrika";6;0;100
0;2319;"latrina";2319;0;100
0;46;"latrinda";46;0;100
0;26;"latrinia";26;0;100
0;30;"latrinity";30;0;100
0;6;"latris";6;0;100
0;144;"latrisa";144;0;100
0;171;"latrise";171;0;100
0;86;"latrish";86;0;100
0;1804;"latrisha";1804;0;100
0;16;"latrishia";16;0;100
0;7;"latrissa";7;0;100
0;41;"latrista";41;0;100
0;34;"latrivia";34;0;100
357;0;"latron";357;100;0
0;87;"latronda";87;0;100
17;0;"latrone";17;100;0
0;10;"latronya";10;0;100
827;0;"latroy";827;100;0
0;278;"latroya";278;0;100
0;5;"latroyia";5;0;100
0;11;"latryce";11;0;100
0;44;"latsha";44;0;100
0;7;"latshia";7;0;100
136;368;"lattie";504;26.984126984127;73.015873015873
5;0;"latu";5;100;0
0;15;"latundra";15;0;100
0;17;"latunia";17;0;100
0;7;"latunja";7;0;100
0;219;"latunya";219;0;100
0;47;"latusha";47;0;100
62;0;"latwan";62;100;0
0;42;"latwana";42;0;100
0;37;"latwanda";37;0;100
0;6;"latwanna";6;0;100
6;0;"latwon";6;100;0
0;21;"latya";21;0;100
0;5;"latyia";5;0;100
0;5;"latyna";5;0;100
0;215;"latyra";215;0;100
0;124;"latysha";124;0;100
0;11;"lauana";11;0;100
5;0;"lauar";5;100;0
5;0;"lauchlin";5;100;0
0;5;"lauda";5;0;100
0;5;"laudan";5;0;100
10;0;"lauden";10;100;0
46;0;"laudie";46;100;0
11;0;"laughlin";11;100;0
0;6;"lauire";6;0;100
0;2490;"launa";2490;0;100
0;5;"launda";5;0;100
0;26;"laundyn";26;0;100
0;77;"launi";77;0;100
0;5;"launia";5;0;100
0;33;"launie";33;0;100
0;10;"laur";10;0;100
2499;764455;"laura";766954;0.325834404670945;99.6741655953291
0;235;"lauraann";235;0;100
0;24;"lauraanne";24;0;100
0;40;"lauraashley";40;0;100
0;31;"laurabel";31;0;100
0;18;"laurabell";18;0;100
0;294;"laurabelle";294;0;100
0;70;"laurabeth";70;0;100
0;10;"laurae";10;0;100
0;6;"lauraelizabeth";6;0;100
0;25;"lauraetta";25;0;100
0;27;"laurah";27;0;100
0;756;"lauraine";756;0;100
0;106;"laurajean";106;0;100
0;1058;"laural";1058;0;100
0;17;"lauralai";17;0;100
0;10;"laurale";10;0;100
0;23;"lauralea";23;0;100
0;2184;"lauralee";2184;0;100
0;86;"lauralei";86;0;100
0;100;"laurali";100;0;100
0;101;"lauralie";101;0;100
0;65;"lauralye";65;0;100
0;393;"lauralyn";393;0;100
0;102;"lauralynn";102;0;100
0;68;"lauramae";68;0;100
0;14;"lauramarie";14;0;100
0;1464;"lauran";1464;0;100
0;160;"laurana";160;0;100
1926;5;"laurance";1931;99.7410668047644;0.258933195235629
0;213;"laurann";213;0;100
0;87;"lauranne";87;0;100
0;1705;"laure";1705;0;100
0;17;"laurea";17;0;100
0;16;"laurean";16;0;100
0;10;"laureana";10;0;100
133;0;"laureano";133;100;0
7;0;"laureat";7;100;0
0;6;"laurece";6;0;100
0;755;"lauree";755;0;100
0;7072;"laureen";7072;0;100
1828;43140;"laurel";44968;4.06511296922256;95.9348870307774
0;53;"laurelai";53;0;100
0;58;"laurelee";58;0;100
0;52;"laurelei";52;0;100
0;48;"laureli";48;0;100
0;76;"laurelin";76;0;100
10;376;"laurell";386;2.59067357512953;97.4093264248705
0;77;"laurella";77;0;100
0;371;"laurelle";371;0;100
0;116;"laurelyn";116;0;100
5764;464488;"lauren";470252;1.22572578107058;98.7742742189294
0;959;"laurena";959;0;100
0;6;"laurenann";6;0;100
0;76;"laurenashley";76;0;100
38254;415;"laurence";38669;98.9267889006698;1.07321109933021
0;89;"laurencia";89;0;100
42;0;"laurencio";42;100;0
0;43;"laurenda";43;0;100
0;4108;"laurene";4108;0;100
0;5;"laurenelizabeth";5;0;100
0;23;"laurenmarie";23;0;100
0;11;"laurenn";11;0;100
0;15;"laurenne";15;0;100
0;6;"laurennicole";6;0;100
153;0;"laurens";153;100;0
1811;0;"laurent";1811;100;0
0;10;"laurentina";10;0;100
0;5;"laurentine";5;0;100
6;0;"laurentino";6;100;0
28;0;"laurenz";28;100;0
6;0;"laurenzo";6;100;0
0;7;"lauressa";7;0;100
0;30;"lauretha";30;0;100
0;5;"laurett";5;0;100
0;8980;"lauretta";8980;0;100
0;3038;"laurette";3038;0;100
0;236;"laurey";236;0;100
183;11039;"lauri";11222;1.63072536089824;98.3692746391018
0;327;"lauria";327;0;100
0;80;"laurian";80;0;100
0;107;"lauriana";107;0;100
0;5;"lauriane";5;0;100
0;159;"lauriann";159;0;100
0;24;"laurianna";24;0;100
0;229;"laurianne";229;0;100
45;0;"lauriano";45;100;0
0;5;"laurica";5;0;100
280;1740;"laurice";2020;13.8613861386139;86.1386138613861
1928;165895;"laurie";167823;1.14882942147381;98.8511705785262
0;410;"laurieann";410;0;100
0;63;"laurieanne";63;0;100
0;165;"lauriel";165;0;100
0;74;"laurielle";74;0;100
5;16;"laurien";21;23.8095238095238;76.1904761904762
353;0;"laurier";353;100;0
0;6;"laurietta";6;0;100
0;10;"laurilyn";10;0;100
481;1578;"laurin";2059;23.3608547838757;76.6391452161243
0;387;"laurina";387;0;100
0;1342;"laurinda";1342;0;100
0;2478;"laurine";2478;0;100
167;132;"lauris";299;55.8528428093645;44.1471571906354
0;310;"laurisa";310;0;100
0;732;"laurissa";732;0;100
5;0;"lauriston";5;100;0
0;629;"laurita";629;0;100
48;0;"lauritz";48;100;0
0;21;"laurn";21;0;100
0;65;"laurna";65;0;100
0;15;"laurne";15;0;100
0;6;"laurnea";6;0;100
2030;0;"lauro";2030;100;0
0;24;"lauron";24;0;100
0;85;"laurren";85;0;100
0;102;"laurrie";102;0;100
0;5;"laurrine";5;0;100
51;850;"laury";901;5.66037735849057;94.3396226415094
0;175;"lauryl";175;0;100
12;19137;"lauryn";19149;0.0626664577784741;99.9373335422215
0;5;"lauryne";5;0;100
0;506;"laurynn";506;0;100
74;0;"lautaro";74;100;0
0;5;"lauvenia";5;0;100
0;4232;"lavada";4232;0;100
0;34;"lavae";34;0;100
0;105;"lavaeh";105;0;100
12;0;"lavail";12;100;0
204;0;"laval";204;100;0
55;0;"lavale";55;100;0
5;0;"lavall";5;100;0
121;5;"lavalle";126;96.031746031746;3.96825396825397
281;5;"lavan";286;98.2517482517483;1.74825174825175
0;114;"lavana";114;0;100
247;0;"lavance";247;100;0
0;5;"lavancha";5;0;100
0;441;"lavanda";441;0;100
15;0;"lavander";15;100;0
0;6;"lavani";6;0;100
0;59;"lavania";59;0;100
0;69;"lavanna";69;0;100
20;0;"lavant";20;100;0
174;0;"lavante";174;100;0
0;203;"lavanya";203;0;100
2009;11;"lavar";2020;99.4554455445545;0.544554455445544
0;5;"lavara";5;0;100
5;0;"lavare";5;100;0
19;0;"lavares";19;100;0
0;21;"lavaria";21;0;100
24;0;"lavarious";24;100;0
185;0;"lavaris";185;100;0
120;0;"lavarius";120;100;0
55;0;"lavarr";55;100;0
20;0;"lavarus";20;100;0
0;44;"lavasha";44;0;100
0;37;"lavasia";37;0;100
0;7;"lavatrice";7;0;100
882;962;"lavaughn";1844;47.8308026030369;52.1691973969631
0;382;"lavaun";382;0;100
0;16;"lavaune";16;0;100
0;10;"lavay";10;0;100
0;106;"lavaya";106;0;100
0;76;"lavayah";76;0;100
0;227;"laveah";227;0;100
0;1091;"laveda";1091;0;100
0;22;"lavee";22;0;100
0;36;"laveeda";36;0;100
0;5;"laveen";5;0;100
200;0;"lavel";200;100;0
0;7;"lavelda";7;0;100
2773;327;"lavell";3100;89.4516129032258;10.5483870967742
0;411;"lavella";411;0;100
2333;1575;"lavelle";3908;59.6980552712385;40.3019447287615
6;0;"lavelton";6;100;0
11;0;"laven";11;100;0
0;1178;"lavena";1178;0;100
0;36;"lavenda";36;0;100
0;831;"lavender";831;0;100
0;135;"lavene";135;0;100
0;1557;"lavenia";1557;0;100
0;5;"lavenna";5;0;100
11;0;"laveon";11;100;0
6;0;"laver";6;100;0
0;2567;"lavera";2567;0;100
0;363;"laverda";363;0;100
340;94;"lavere";434;78.3410138248848;21.6589861751152
17;526;"lavergne";543;3.13075506445672;96.8692449355433
0;6;"laveria";6;0;100
49;15;"laverl";64;76.5625;23.4375
13;191;"laverle";204;6.37254901960784;93.6274509803922
9929;6824;"lavern";16753;59.2669969557691;40.7330030442309
0;3672;"laverna";3672;0;100
13122;42668;"laverne";55790;23.5203441476967;76.4796558523033
0;10;"lavernia";10;0;100
5;0;"lavernon";5;100;0
168;7;"lavert";175;96;4
0;422;"laverta";422;0;100
0;5;"laveryl";5;0;100
0;22;"lavesha";22;0;100
0;10;"lavesta";10;0;100
11;0;"lavester";11;100;0
0;1547;"laveta";1547;0;100
0;16;"lavetra";16;0;100
0;22;"lavett";22;0;100
0;1186;"lavetta";1186;0;100
5;1184;"lavette";1189;0.420521446593776;99.5794785534062
0;39;"laveya";39;0;100
0;56;"laveyah";56;0;100
74;0;"lavi";74;100;0
0;10;"lavia";10;0;100
0;5;"lavickie";5;0;100
0;176;"lavida";176;0;100
0;12;"lavie";12;0;100
0;30;"lavila";30;0;100
0;120;"lavilla";120;0;100
79;0;"lavin";79;100;0
0;5834;"lavina";5834;0;100
0;17;"lavinda";17;0;100
0;115;"lavine";115;0;100
0;4471;"lavinia";4471;0;100
0;5;"lavinnia";5;0;100
0;47;"lavisha";47;0;100
0;714;"lavita";714;0;100
5;0;"lavith";5;100;0
0;6;"lavitta";6;0;100
5;0;"lavoid";5;100;0
0;31;"lavola";31;0;100
4650;6215;"lavon";10865;42.7979751495628;57.2020248504372
0;1791;"lavona";1791;0;100
0;3586;"lavonda";3586;0;100
0;6;"lavonde";6;0;100
0;5;"lavondia";5;0;100
0;26;"lavondra";26;0;100
117;1173;"lavone";1290;9.06976744186047;90.9302325581395
0;1847;"lavonia";1847;0;100
16;65;"lavonn";81;19.7530864197531;80.2469135802469
0;1949;"lavonna";1949;0;100
217;16420;"lavonne";16637;1.30432169261285;98.6956783073871
0;16;"lavonnia";16;0;100
0;6;"lavonnie";6;0;100
16;0;"lavont";16;100;0
302;11;"lavonta";313;96.4856230031949;3.51437699680511
360;0;"lavontae";360;100;0
103;0;"lavontay";103;100;0
1144;11;"lavonte";1155;99.0476190476191;0.952380952380952
15;0;"lavontre";15;100;0
0;251;"lavonya";251;0;100
48;0;"lavor";48;100;0
0;283;"lavora";283;0;100
0;12;"lavoria";12;0;100
212;163;"lavoris";375;56.5333333333333;43.4666666666667
10;5;"lavorn";15;66.6666666666667;33.3333333333333
205;0;"lavoy";205;100;0
0;11;"lavoyce";11;0;100
0;140;"lavra";140;0;100
0;396;"lavren";396;0;100
79;0;"law";79;100;0
15;0;"lawaia";15;100;0
54;96;"lawan";150;36;64
0;3029;"lawana";3029;0;100
6;12087;"lawanda";12093;0.0496154800297693;99.9503845199702
0;12;"lawander";12;0;100
0;16;"lawandra";16;0;100
0;5;"lawanika";5;0;100
0;2381;"lawanna";2381;0;100
0;18;"lawanza";18;0;100
100;0;"lawarence";100;100;0
23;0;"lawarnce";23;100;0
6;0;"lawarren";6;100;0
5;0;"lawaun";5;100;0
506;10;"lawayne";516;98.062015503876;1.93798449612403
5;0;"lawell";5;100;0
46;0;"lawence";46;100;0
0;5;"lawenda";5;0;100
995;0;"lawerance";995;100;0
4766;0;"lawerence";4766;100;0
1049;0;"lawernce";1049;100;0
0;5;"lawhitney";5;0;100
18;0;"lawless";18;100;0
0;16;"lawna";16;0;100
5;0;"lawney";5;100;0
5;5;"lawon";10;50;50
0;29;"lawona";29;0;100
0;307;"lawonda";307;0;100
0;22;"lawonna";22;0;100
0;6;"lawra";6;0;100
2620;0;"lawrance";2620;100;0
59;1003;"lawren";1062;5.55555555555556;94.4444444444444
26;0;"lawrenc";26;100;0
448679;2096;"lawrence";450775;99.535023015917;0.464976984082968
0;147;"lawrencia";147;0;100
21;15;"lawrene";36;58.3333333333333;41.6666666666667
16;0;"lawrenzo";16;100;0
0;131;"lawrie";131;0;100
5;0;"lawrin";5;100;0
70;0;"lawrnce";70;100;0
0;48;"lawryn";48;0;100
122;0;"lawsen";122;100;0
10850;303;"lawson";11153;97.2832421769927;2.71675782300726
42;37;"lawsyn";79;53.1645569620253;46.8354430379747
2472;0;"lawton";2472;100;0
939;0;"lawyer";939;100;0
11;0;"laxavier";11;100;0
0;52;"laxmi";52;0;100
0;7;"laxmy";7;0;100
28;12;"lay";40;70;30
0;1207;"laya";1207;0;100
0;55;"layaan";55;0;100
0;773;"layah";773;0;100
0;6;"layahna";6;0;100
0;461;"layal";461;0;100
0;135;"layali";135;0;100
0;1192;"layan";1192;0;100
0;290;"layana";290;0;100
0;14;"layanah";14;0;100
0;5;"layane";5;0;100
0;85;"layani";85;0;100
0;5;"layanie";5;0;100
0;60;"layann";60;0;100
0;202;"layanna";202;0;100
0;13;"layanne";13;0;100
0;189;"layce";189;0;100
0;641;"laycee";641;0;100
7;0;"laycen";7;100;0
0;102;"layci";102;0;100
0;286;"laycie";286;0;100
5;0;"laydell";5;100;0
747;52;"layden";799;93.4918648310388;6.5081351689612
84;0;"laydon";84;100;0
0;21;"layelle";21;0;100
0;5;"layeska";5;0;100
0;51;"layia";51;0;100
0;22;"layiah";22;0;100
40;5;"layke";45;88.8888888888889;11.1111111111111
124;687;"layken";811;15.2897657213317;84.7102342786683
11;373;"laykin";384;2.86458333333333;97.1354166666667
0;18;"laykyn";18;0;100
80;74504;"layla";74584;0.107261611069398;99.8927383889306
0;98;"laylaa";98;0;100
0;17;"laylaann";17;0;100
0;6;"laylagrace";6;0;100
0;4575;"laylah";4575;0;100
0;55;"laylamarie";55;0;100
5;13;"laylan";18;27.7777777777778;72.2222222222222
0;62;"laylana";62;0;100
11;0;"layland";11;100;0
0;7;"laylanee";7;0;100
0;943;"laylani";943;0;100
0;226;"laylanie";226;0;100
0;11;"laylanii";11;0;100
0;11;"laylanna";11;0;100
0;25;"laylanni";25;0;100
0;6;"laylannie";6;0;100
0;5;"laylarae";5;0;100
0;37;"laylarose";37;0;100
5;17;"layle";22;22.7272727272727;77.2727272727273
0;161;"laylee";161;0;100
0;31;"layleen";31;0;100
0;24;"layleigh";24;0;100
15;7;"laylen";22;68.1818181818182;31.8181818181818
0;6;"laylene";6;0;100
0;74;"layli";74;0;100
0;92;"laylia";92;0;100
0;10;"layliah";10;0;100
0;100;"layliana";100;0;100
0;30;"laylianna";30;0;100
0;44;"laylie";44;0;100
0;35;"laylin";35;0;100
0;5;"laylina";5;0;100
0;19;"laylla";19;0;100
10;0;"laylon";10;100;0
0;173;"layloni";173;0;100
0;101;"laylonie";101;0;100
0;6;"laylonni";6;0;100
0;48;"laylonnie";48;0;100
0;5;"laylyn";5;0;100
0;55;"laylynn";55;0;100
244;0;"layman";244;100;0
779;0;"laymon";779;100;0
133;0;"laymond";133;100;0
80;0;"layn";80;100;0
0;2258;"layna";2258;0;100
0;24;"laynah";24;0;100
10792;3754;"layne";14546;74.1922177918328;25.8077822081672
0;1123;"laynee";1123;0;100
0;17;"laynette";17;0;100
0;112;"layney";112;0;100
0;328;"layni";328;0;100
0;1238;"laynie";1238;0;100
0;24;"layona";24;0;100
0;5;"layoni";5;0;100
0;164;"layonna";164;0;100
0;16;"layota";16;0;100
0;12;"layoya";12;0;100
0;17;"layra";17;0;100
5;0;"layron";5;100;0
0;88;"laysa";88;0;100
0;780;"laysha";780;0;100
110;0;"layson";110;100;0
0;16;"layssa";16;0;100
249;25;"layten";274;90.8759124087591;9.12408759124088
511;0;"layth";511;100;0
183;0;"laythan";183;100;0
50;0;"laythen";50;100;0
26;0;"laython";26;100;0
37;0;"laytin";37;100;0
8395;482;"layton";8877;94.5702376929143;5.42976230708573
0;16;"laytona";16;0;100
0;12;"laytonya";12;0;100
0;142;"laytoya";142;0;100
0;5;"layvonne";5;0;100
0;78;"layza";78;0;100
0;29;"lazandra";29;0;100
564;0;"lazar";564;100;0
0;164;"lazara";164;0;100
5;0;"lazare";5;100;0
5;0;"lazareth";5;100;0
0;451;"lazaria";451;0;100
0;137;"lazariah";137;0;100
12;0;"lazarick";12;100;0
6;0;"lazario";6;100;0
6;0;"lazarion";6;100;0
156;0;"lazarius";156;100;0
0;6;"lazariya";6;0;100
0;5;"lazariyah";5;0;100
6167;0;"lazaro";6167;100;0
10;0;"lazaros";10;100;0
0;11;"lazarria";11;0;100
2642;0;"lazarus";2642;100;0
22;0;"lazavion";22;100;0
0;27;"lazaya";27;0;100
5;0;"lazell";5;100;0
0;42;"lazelle";42;0;100
473;0;"lazer";473;100;0
39;0;"lazerick";39;100;0
23;0;"lazerrick";23;100;0
0;28;"lazetta";28;0;100
0;146;"lazette";146;0;100
0;5;"lazhane";5;0;100
0;10;"laziah";10;0;100
0;22;"laziya";22;0;100
0;53;"laziyah";53;0;100
91;0;"lazlo";91;100;0
0;5;"lazuli";5;0;100
5;0;"lazzaro";5;100;0
21;0;"lb";21;100;0
338;0;"lc";338;100;0
45;0;"ld";45;100;0
5;0;"ldarius";5;100;0
770;878;"le";1648;46.7233009708738;53.2766990291262
598;30297;"lea";30895;1.93558828289367;98.0644117171063
0;458;"leaann";458;0;100
0;42;"leaanne";42;0;100
0;18;"leabella";18;0;100
0;7;"leabeth";7;0;100
0;22;"leacy";22;0;100
0;11;"leada";11;0;100
0;5;"leady";5;0;100
0;31;"leaetta";31;0;100
116;0;"leaf";116;100;0
0;16;"leafa";16;0;100
0;41;"leafie";41;0;100
10;0;"leaford";10;100;0
0;118;"leafy";118;0;100
0;5;"leagh";5;0;100
424;213716;"leah";214140;0.198001307555805;99.8019986924442
0;558;"leaha";558;0;100
0;32;"leahana";32;0;100
0;69;"leahann";69;0;100
0;105;"leahanna";105;0;100
0;10;"leahgrace";10;0;100
0;13;"leahla";13;0;100
0;144;"leahmarie";144;0;100
0;179;"leahna";179;0;100
0;12;"leahnna";12;0;100
0;5;"leahrae";5;0;100
0;11;"leahrose";11;0;100
0;175;"leaira";175;0;100
0;23;"leairah";23;0;100
0;13;"leaisha";13;0;100
0;16;"leaja";16;0;100
0;15;"leajah";15;0;100
24;23;"leal";47;51.063829787234;48.936170212766
0;790;"leala";790;0;100
0;24;"lealah";24;0;100
18;0;"lealan";18;100;0
276;0;"lealand";276;100;0
0;44;"lealani";44;0;100
0;244;"lealer";244;0;100
0;11;"lealia";11;0;100
0;19;"lealo";19;0;100
201;0;"lealon";201;100;0
147;0;"leam";147;100;0
135;0;"leaman";135;100;0
0;23;"leamarie";23;0;100
0;19;"leamber";19;0;100
2650;0;"leamon";2650;100;0
15;0;"leamond";15;100;0
0;32;"leamsi";32;0;100
131;636;"lean";767;17.0795306388527;82.9204693611473
0;4212;"leana";4212;0;100
0;66;"leanah";66;0;100
387;0;"leanard";387;100;0
0;215;"leanda";215;0;100
5778;28;"leander";5806;99.5177402686876;0.482259731312435
38;6651;"leandra";6689;0.568096875467185;99.4319031245328
5;0;"leandrae";5;100;0
1453;15;"leandre";1468;98.9782016348774;1.02179836512262
5;680;"leandrea";685;0.72992700729927;99.2700729927007
986;0;"leandrew";986;100;0
0;241;"leandria";241;0;100
6574;0;"leandro";6574;100;0
12;0;"leandros";12;100;0
0;514;"leane";514;0;100
0;307;"leaner";307;0;100
0;5;"leanetta";5;0;100
0;137;"leanette";137;0;100
0;11;"leangela";11;0;100
12;0;"leangelo";12;100;0
0;133;"leani";133;0;100
0;22;"leanie";22;0;100
7;23941;"leann";23948;0.0292299983297144;99.9707700016703
5;22908;"leanna";22913;0.0218216732859076;99.9781783267141
0;207;"leannah";207;0;100
0;133;"leanndra";133;0;100
0;28867;"leanne";28867;0;100
0;5;"leanner";5;0;100
0;14;"leanni";14;0;100
0;49;"leannie";49;0;100
0;120;"leanny";120;0;100
0;309;"leanor";309;0;100
0;1322;"leanora";1322;0;100
592;0;"leanord";592;100;0
0;772;"leanore";772;0;100
292;0;"leanthony";292;100;0
0;33;"leany";33;0;100
0;91;"leanza";91;0;100
13;0;"leaon";13;100;0
36;457;"lear";493;7.30223123732252;92.6977687626775
0;231;"leara";231;0;100
0;24;"learah";24;0;100
0;26;"learlean";26;0;100
0;5;"learlene";5;0;100
0;56;"learline";56;0;100
5;0;"learon";5;100;0
20;0;"learoy";20;100;0
43;0;"leart";43;100;0
0;5;"learta";5;0;100
19;0;"leartis";19;100;0
194;16;"leary";210;92.3809523809524;7.61904761904762
0;922;"leasa";922;0;100
0;7;"leaser";7;0;100
0;309;"leasha";309;0;100
0;30;"leashia";30;0;100
0;993;"leasia";993;0;100
0;11;"leasie";11;0;100
18;40;"leaster";58;31.0344827586207;68.9655172413793
0;56;"leata";56;0;100
0;21;"leath";21;0;100
0;5585;"leatha";5585;0;100
15;0;"leathan";15;100;0
0;6;"leathe";6;0;100
0;10;"leathea";10;0;100
0;195;"leather";195;0;100
0;245;"leathia";245;0;100
0;60;"leathie";60;0;100
0;6;"leathy";6;0;100
10;0;"leaton";10;100;0
0;5862;"leatrice";5862;0;100
0;5;"leatricia";5;0;100
0;66;"leatta";66;0;100
0;66;"leauna";66;0;100
0;22;"leaundra";22;0;100
0;10;"leaunna";10;0;100
0;10;"leavie";10;0;100
5;0;"leavitt";5;100;0
5;0;"leavon";5;100;0
169;6;"leavy";175;96.5714285714286;3.42857142857143
0;33;"leaya";33;0;100
0;29;"leayah";29;0;100
0;11;"leayla";11;0;100
0;5;"leaysia";5;0;100
0;109;"leba";109;0;100
207;0;"lebaron";207;100;0
29;0;"lebarron";29;100;0
5;0;"lebern";5;100;0
82;0;"lebert";82;100;0
0;24;"leberta";24;0;100
26;0;"lebrandon";26;100;0
0;6;"lebrea";6;0;100
0;5;"lebria";5;0;100
1379;0;"lebron";1379;100;0
8;0;"lebrone";8;100;0
44;0;"leburn";44;100;0
0;11;"leca";11;0;100
16;0;"lecedric";16;100;0
10;0;"lecester";10;100;0
5;0;"lech";5;100;0
10;0;"lecharles";10;100;0
0;166;"lechelle";166;0;100
0;34;"lechia";34;0;100
0;1169;"lecia";1169;0;100
0;23;"lecie";23;0;100
302;0;"lecil";302;100;0
12;0;"leck";12;100;0
0;5;"lecole";5;0;100
6;0;"leconte";6;100;0
5;0;"lecory";5;100;0
0;20;"lecresha";20;0;100
0;62;"lecretia";62;0;100
0;15;"lecta";15;0;100
0;10;"lector";10;0;100
0;10;"lectoria";10;0;100
0;6;"lecy";6;0;100
0;3024;"leda";3024;0;100
5;0;"ledaniel";5;100;0
17;0;"ledarion";17;100;0
467;0;"ledarius";467;100;0
118;0;"ledarrius";118;100;0
0;10;"ledawn";10;0;100
0;6;"leddi";6;0;100
0;12;"leddie";12;0;100
0;32;"leddy";32;0;100
0;5;"ledeja";5;0;100
5;0;"ledel";5;100;0
541;21;"ledell";562;96.2633451957295;3.73665480427046
14;0;"lederrick";14;100;0
248;0;"ledford";248;100;0
5;0;"ledge";5;100;0
1159;0;"ledger";1159;100;0
0;71;"ledia";71;0;100
40;0;"ledion";40;100;0
70;0;"ledon";70;100;0
0;15;"ledonia";15;0;100
0;68;"ledonna";68;0;100
0;493;"ledora";493;0;100
0;24;"ledra";24;0;100
222084;60784;"lee";282868;78.5115318805945;21.4884681194055
0;643;"leea";643;0;100
0;1123;"leeah";1123;0;100
0;11;"leeaira";11;0;100
192;0;"leeam";192;100;0
0;83;"leean";83;0;100
0;650;"leeana";650;0;100
0;5;"leeanah";5;0;100
5;0;"leeander";5;100;0
0;332;"leeandra";332;0;100
56;0;"leeandre";56;100;0
0;12;"leeandrea";12;0;100
45;0;"leeandrew";45;100;0
0;45;"leeani";45;0;100
0;13952;"leeann";13952;0;100
0;3685;"leeanna";3685;0;100
0;5;"leeannah";5;0;100
0;3085;"leeanne";3085;0;100
53;0;"leeanthony";53;100;0
0;5;"leeara";5;0;100
0;137;"leeasia";137;0;100
0;5;"leeat";5;0;100
0;199;"leeba";199;0;100
0;5;"leecy";5;0;100
0;22;"leeda";22;0;100
15;0;"leedell";15;100;0
5;0;"leedward";5;100;0
0;5;"leeila";5;0;100
5;0;"leejay";5;100;0
0;2838;"leela";2838;0;100
0;263;"leelah";263;0;100
359;0;"leelan";359;100;0
2207;11;"leeland";2218;99.5040577096483;0.495942290351668
0;10;"leelani";10;0;100
0;25;"leelee";25;0;100
36;0;"leelen";36;100;0
29;0;"leelend";29;100;0
41;0;"leelin";41;100;0
0;22;"leella";22;0;100
0;34;"leellen";34;0;100
0;59;"leeloo";59;0;100
0;6;"leelou";6;0;100
0;43;"leelu";43;0;100
94;10;"leelyn";104;90.3846153846154;9.61538461538462
84;0;"leelynd";84;100;0
83;43;"leelynn";126;65.8730158730159;34.1269841269841
380;0;"leeman";380;100;0
0;5;"leemarie";5;0;100
11;0;"leemichael";11;100;0
79;0;"leemon";79;100;0
0;868;"leen";868;0;100
0;3809;"leena";3809;0;100
0;121;"leenah";121;0;100
0;16;"leenora";16;0;100
10;0;"leeo";10;100;0
0;39;"leeola";39;0;100
0;5;"leeoma";5;0;100
58;0;"leeon";58;100;0
0;64;"leeona";64;0;100
0;28;"leeonna";28;0;100
16;15;"leeor";31;51.6129032258064;48.3870967741936
5;0;"leequan";5;100;0
5;0;"leeric";5;100;0
11;0;"leeron";11;100;0
4126;0;"leeroy";4126;100;0
0;4117;"leesa";4117;0;100
0;442;"leesha";442;0;100
5;0;"leeshaun";5;100;0
44;0;"leeshawn";44;100;0
0;17;"leesly";17;0;100
21;0;"leeson";21;100;0
0;6;"leester";6;0;100
0;492;"leeta";492;0;100
0;5;"leetal";5;0;100
0;39;"leetha";39;0;100
0;519;"leetta";519;0;100
62;0;"leeum";62;100;0
5;0;"leevan";5;100;0
550;0;"leevi";550;100;0
60;0;"leevon";60;100;0
5;0;"leeward";5;100;0
0;437;"leeya";437;0;100
0;310;"leeyah";310;0;100
0;22;"leeyana";22;0;100
0;856;"leeza";856;0;100
0;17;"lefa";17;0;100
28;0;"lefty";28;100;0
0;19;"legacee";19;0;100
0;150;"legaci";150;0;100
0;54;"legacie";54;0;100
317;1176;"legacy";1493;21.2324179504354;78.7675820495646
13;0;"legen";13;100;0
4408;448;"legend";4856;90.7742998352554;9.22570016474465
5;0;"legendary";5;100;0
0;43;"legina";43;0;100
184;0;"legion";184;100;0
0;99;"legna";99;0;100
13;0;"legolas";13;100;0
506;0;"legrand";506;100;0
147;0;"legrande";147;100;0
10;0;"legrant";10;100;0
0;54;"leha";54;0;100
0;13;"lehana";13;0;100
0;23;"lehanna";23;0;100
299;0;"lehi";299;100;0
0;5;"lehiwa";5;0;100
0;8;"lehlani";8;0;100
969;0;"lehman";969;100;0
37;0;"lehmon";37;100;0
0;5;"lehna";5;0;100
0;263;"lehua";263;0;100
0;12;"lehuanani";12;0;100
31;626;"lei";657;4.71841704718417;95.2815829528158
0;8576;"leia";8576;0;100
0;1007;"leiah";1007;0;100
0;6;"leiahna";6;0;100
0;89;"leialoha";89;0;100
97;0;"leiam";97;100;0
0;719;"leiana";719;0;100
0;11;"leianah";11;0;100
0;167;"leiani";167;0;100
0;241;"leiann";241;0;100
0;567;"leianna";567;0;100
0;117;"leianne";117;0;100
0;15;"leiara";15;0;100
0;12;"leiasia";12;0;100
276;0;"leib";276;100;0
97;0;"leibish";97;100;0
51;0;"leiby";51;100;0
0;14;"leica";14;0;100
0;5;"leicha";5;0;100
0;5;"leicia";5;0;100
0;478;"leida";478;0;100
21;0;"leiden";21;100;0
0;136;"leidi";136;0;100
0;645;"leidy";645;0;100
7816;5;"leif";7821;99.9360695563227;0.0639304436772791
4992;39829;"leigh";44821;11.137636375806;88.862363624194
0;5930;"leigha";5930;0;100
17;0;"leigham";17;100;0
0;22;"leighan";22;0;100
0;265;"leighana";265;0;100
0;3297;"leighann";3297;0;100
0;1040;"leighanna";1040;0;100
0;1263;"leighanne";1263;0;100
0;5;"leighia";5;0;100
0;546;"leighla";546;0;100
0;24;"leighlah";24;0;100
5;0;"leighlan";5;100;0
49;0;"leighland";49;100;0
0;23;"leighlani";23;0;100
0;10;"leighlynn";10;0;100
0;26;"leighna";26;0;100
0;5;"leightan";5;0;100
6947;5287;"leighton";12234;56.7843714239006;43.2156285760994
0;122;"leightyn";122;0;100
0;23;"leiha";23;0;100
0;22;"leihla";22;0;100
0;5;"leihlani";5;0;100
10;0;"leihum";10;100;0
6;40865;"leila";40871;0.0146803356903428;99.9853196643097
0;5;"leilaann";5;0;100
0;2750;"leilah";2750;0;100
0;18;"leilahni";18;0;100
0;10;"leilamarie";10;0;100
99;0;"leilan";99;100;0
0;337;"leilana";337;0;100
422;0;"leiland";422;100;0
0;10;"leilane";10;0;100
0;61;"leilanee";61;0;100
0;15;"leilaney";15;0;100
19;27948;"leilani";27967;0.0679372117138056;99.9320627882862
0;629;"leilanie";629;0;100
0;33;"leilanii";33;0;100
0;217;"leilanni";217;0;100
0;11;"leilannie";11;0;100
0;80;"leilanny";80;0;100
0;2055;"leilany";2055;0;100
0;5;"leilarose";5;0;100
0;5;"leilauni";5;0;100
0;27;"leileen";27;0;100
0;5;"leilena";5;0;100
5;0;"leilend";5;100;0
0;157;"leilene";157;0;100
0;81;"leili";81;0;100
0;27;"leilia";27;0;100
0;112;"leiliana";112;0;100
0;5;"leiliani";5;0;100
0;6;"leiliany";6;0;100
0;12;"leilla";12;0;100
0;367;"leiloni";367;0;100
0;5;"leilonie";5;0;100
0;5;"leilonnie";5;0;100
0;125;"leily";125;0;100
0;55;"leilyn";55;0;100
5;0;"leilynd";5;100;0
0;61;"leilynn";61;0;100
40;0;"leim";40;100;0
0;82;"leimomi";82;0;100
0;541;"leina";541;0;100
0;68;"leinaala";68;0;100
0;67;"leinani";67;0;100
0;5;"leini";5;0;100
0;35;"leiny";35;0;100
12;0;"leion";12;100;0
0;10;"leiona";10;0;100
0;11;"leionna";11;0;100
0;249;"leira";249;0;100
0;26;"leire";26;0;100
0;4933;"leisa";4933;0;100
0;10;"leise";10;0;100
0;106;"leisel";106;0;100
0;1971;"leisha";1971;0;100
0;5;"leishla";5;0;100
0;79;"leisl";79;0;100
0;38;"leisly";38;0;100
0;16;"leissa";16;0;100
0;8;"leisy";8;0;100
0;691;"leita";691;0;100
532;110;"leith";642;82.8660436137072;17.1339563862928
0;718;"leitha";718;0;100
5;0;"leithan";5;100;0
42;0;"leium";42;100;0
0;211;"leiya";211;0;100
0;204;"leiyah";204;0;100
0;27;"leiyana";27;0;100
0;6;"leiyla";6;0;100
0;5;"leizel";5;0;100
38;0;"lejend";38;100;0
5;6;"lejeune";11;45.4545454545455;54.5454545454545
0;669;"lejla";669;0;100
235;0;"lejon";235;100;0
0;5;"lejoyce";5;0;100
202;0;"lejuan";202;100;0
10;0;"lekai";10;100;0
0;5;"lekayla";5;0;100
0;56;"lekecia";56;0;100
0;5;"lekedia";5;0;100
0;21;"lekeesha";21;0;100
0;11;"lekeia";11;0;100
0;785;"lekeisha";785;0;100
125;0;"lekeith";125;100;0
0;18;"lekeitha";18;0;100
0;53;"lekendra";53;0;100
5;0;"lekendric";5;100;0
193;0;"lekendrick";193;100;0
0;13;"lekenya";13;0;100
0;671;"lekesha";671;0;100
0;404;"lekeshia";404;0;100
0;23;"lekesia";23;0;100
0;31;"leketa";31;0;100
0;11;"leketha";11;0;100
0;10;"lekethia";10;0;100
0;6;"lekevia";6;0;100
0;86;"lekeya";86;0;100
0;40;"lekeysha";40;0;100
0;87;"lekha";87;0;100
5;0;"lekhi";5;100;0
0;213;"lekia";213;0;100
0;44;"lekiesha";44;0;100
0;7;"lekisa";7;0;100
0;914;"lekisha";914;0;100
0;6;"lekishia";6;0;100
0;134;"lekita";134;0;100
0;32;"leksi";32;0;100
63;36215;"lela";36278;0.173658966866972;99.826341033133
0;1634;"lelah";1634;0;100
0;136;"lelaina";136;0;100
0;10;"lelamae";10;0;100
774;0;"lelan";774;100;0
0;15;"lelana";15;0;100
51206;411;"leland";51617;99.203750702288;0.796249297711994
0;7;"lelandra";7;0;100
0;633;"lelani";633;0;100
0;66;"lelania";66;0;100
0;10;"lelanie";10;0;100
0;5;"lelanya";5;0;100
0;467;"lelar";467;0;100
310;0;"leldon";310;100;0
0;5;"lelea";5;0;100
6;0;"lelen";6;100;0
99;0;"lelend";99;100;0
0;76;"leler";76;0;100
0;12905;"lelia";12905;0;100
0;146;"leliana";146;0;100
0;11;"lelianna";11;0;100
5;0;"lelind";5;100;0
0;5;"lelita";5;0;100
0;689;"lella";689;0;100
0;10;"leller";10;0;100
0;10;"lellie";10;0;100
433;0;"lelon";433;100;0
0;5;"leloni";5;0;100
0;22;"lelsie";22;0;100
46;0;"lelton";46;100;0
0;47;"lelu";47;0;100
22;0;"lelyn";22;100;0
70;0;"lelynd";70;100;0
14;0;"lelynn";14;100;0
965;0;"lem";965;100;0
0;320;"lema";320;0;100
6;0;"lemaj";6;100;0
625;0;"leman";625;100;0
28;0;"lemanuel";28;100;0
1797;0;"lemar";1797;100;0
5;0;"lemarco";5;100;0
387;0;"lemarcus";387;100;0
5;0;"lemari";5;100;0
60;0;"lemario";60;100;0
56;0;"lemarion";56;100;0
20;0;"lemark";20;100;0
26;0;"lemarr";26;100;0
0;7;"lemaya";7;0;100
16;0;"lemel";16;100;0
0;26;"lemia";26;0;100
32;0;"lemichael";32;100;0
0;5;"lemisha";5;0;100
0;207;"lemma";207;0;100
636;120;"lemmie";756;84.1269841269841;15.8730158730159
5;0;"lemmon";5;100;0
20;6;"lemmy";26;76.9230769230769;23.0769230769231
109;0;"lemoine";109;100;0
956;60;"lemon";1016;94.0944881889764;5.90551181102362
107;0;"lemond";107;100;0
0;5;"lemonica";5;0;100
677;0;"lemont";677;100;0
105;0;"lemonte";105;100;0
5;0;"lemorris";5;100;0
357;62;"lemoyne";419;85.2028639618138;14.7971360381862
0;316;"lempi";316;0;100
60;0;"lemual";60;100;0
8670;0;"lemuel";8670;100;0
0;62;"lemya";62;0;100
4276;107;"len";4383;97.5587497148072;2.44125028519279
298;114828;"lena";115126;0.258846828692042;99.741153171308
0;21;"lenabelle";21;0;100
0;746;"lenae";746;0;100
0;142;"lenah";142;0;100
0;5;"lenai";5;0;100
0;6;"lenalee";6;0;100
0;45;"lenamae";45;0;100
0;16;"lenamarie";16;0;100
0;5;"lenar";5;0;100
9698;7;"lenard";9705;99.9278722308089;0.0721277691911386
114;0;"lenardo";114;100;0
0;15;"lenasia";15;0;100
0;181;"lenay";181;0;100
0;230;"lenaya";230;0;100
0;46;"lenayah";46;0;100
0;12;"lenci";12;0;100
0;10;"lencola";10;0;100
0;24;"lency";24;0;100
0;872;"lenda";872;0;100
27;0;"lendal";27;100;0
15;0;"lendale";15;100;0
25;0;"lendall";25;100;0
38;0;"lendel";38;100;0
684;0;"lendell";684;100;0
18;0;"lenden";18;100;0
0;27;"lender";27;0;100
0;40;"lendia";40;0;100
5;0;"lendol";5;100;0
561;0;"lendon";561;100;0
0;125;"lendora";125;0;100
0;5;"lendra";5;0;100
0;22;"lendsey";22;0;100
0;130;"lendy";130;0;100
0;277;"lene";277;0;100
0;192;"lenea";192;0;100
0;6;"leneah";6;0;100
5;0;"lenear";5;100;0
0;5;"lenecia";5;0;100
0;480;"lenee";480;0;100
0;16;"leneisha";16;0;100
0;6;"leneka";6;0;100
539;343;"lenell";882;61.1111111111111;38.8888888888889
0;45;"lenelle";45;0;100
0;87;"lener";87;0;100
5;0;"lenes";5;100;0
0;48;"lenesha";48;0;100
0;15;"leneta";15;0;100
0;5;"lenett";5;0;100
0;394;"lenetta";394;0;100
0;1012;"lenette";1012;0;100
0;7;"leneve";7;0;100
65;0;"lenford";65;100;0
324;5;"leng";329;98.4802431610942;1.51975683890578
15;750;"leni";765;1.96078431372549;98.0392156862745
0;147;"lenia";147;0;100
0;60;"leniah";60;0;100
0;512;"lenice";512;0;100
0;6;"leniece";6;0;100
39;0;"leniel";39;100;0
0;23;"lenika";23;0;100
1187;5;"lenin";1192;99.5805369127517;0.419463087248322
0;15;"lenina";15;0;100
170;55;"lenis";225;75.5555555555556;24.4444444444444
0;835;"lenise";835;0;100
0;224;"lenisha";224;0;100
0;1179;"lenita";1179;0;100
77;44;"lenix";121;63.6363636363636;36.3636363636364
0;128;"leniya";128;0;100
0;205;"leniyah";205;0;100
0;42;"lenka";42;0;100
5;0;"lenley";5;100;0
508;6;"lenn";514;98.8326848249027;1.16731517509728
0;3009;"lenna";3009;0;100
0;57;"lennan";57;0;100
1116;0;"lennard";1116;100;0
419;0;"lennart";419;100;0
0;54;"lennea";54;0;100
5;0;"lennel";5;100;0
128;15;"lennell";143;89.5104895104895;10.4895104895105
0;16;"lenner";16;0;100
5;0;"lenneth";5;100;0
0;5;"lennett";5;0;100
0;27;"lennetta";27;0;100
0;356;"lennette";356;0;100
38;28;"lennex";66;57.5757575757576;42.4242424242424
0;48;"lenni";48;0;100
0;5;"lennia";5;0;100
0;37;"lennice";37;0;100
2762;3866;"lennie";6628;41.6716958358479;58.3283041641521
202;6;"lennin";208;97.1153846153846;2.88461538461538
1217;520;"lennis";1737;70.0633275762809;29.9366724237191
141;122;"lennix";263;53.6121673003802;46.3878326996198
4744;2654;"lennon";7398;64.1254393079211;35.8745606920789
0;11;"lennora";11;0;100
3886;1351;"lennox";5237;74.2027878556425;25.7972121443575
7269;380;"lenny";7649;95.0320303307622;4.96796966923781
74;113;"lennyn";187;39.572192513369;60.427807486631
13;52;"lennyx";65;20;80
615;6;"leno";621;99.0338164251208;0.966183574879227
670;0;"lenoard";670;100;0
0;69;"lenoir";69;0;100
0;93;"lenola";93;0;100
512;0;"lenon";512;100;0
0;10;"lenona";10;0;100
0;383;"lenor";383;0;100
31;32487;"lenora";32518;0.0953318162248601;99.9046681837751
0;32;"lenorah";32;0;100
1733;0;"lenord";1733;100;0
6;21572;"lenore";21578;0.0278060988043378;99.9721939011957
0;146;"lenoria";146;0;100
15;0;"lenoris";15;100;0
65;0;"lenorris";65;100;0
802;186;"lenox";988;81.1740890688259;18.8259109311741
31;0;"lenoxx";31;100;0
5;0;"lens";5;100;0
0;10;"lensa";10;0;100
0;35;"lensey";35;0;100
5;0;"lensy";5;100;0
5;0;"lent";5;100;0
657;0;"lenton";657;100;0
10;0;"lenuel";10;100;0
73;0;"lenus";73;100;0
63;0;"lenvil";63;100;0
164;0;"lenville";164;100;0
352;0;"lenward";352;100;0
2412;0;"lenwood";2412;100;0
57;22;"leny";79;72.1518987341772;27.8481012658228
0;97;"lenya";97;0;100
10;6;"lenyn";16;62.5;37.5
22;81;"lenyx";103;21.3592233009709;78.6407766990291
5;0;"lenz";5;100;0
0;122;"lenzi";122;0;100
373;179;"lenzie";552;67.5724637681159;32.4275362318841
457;54;"lenzy";511;89.4324853228963;10.5675146771037
185339;1718;"leo";187057;99.081563373731;0.918436626268998
5;0;"leoanthony";5;100;0
0;5;"leoba";5;0;100
2528;0;"leobardo";2528;100;0
5;0;"leoben";5;100;0
0;665;"leocadia";665;0;100
122;0;"leocadio";122;100;0
0;526;"leoda";526;0;100
199;0;"leodan";199;100;0
41;0;"leodegario";41;100;0
458;0;"leodis";458;100;0
7;0;"leodore";7;100;0
5;0;"leoh";5;100;0
0;55;"leokadia";55;0;100
0;5;"leokadja";5;0;100
0;10;"leokadya";10;0;100
52;26131;"leola";26183;0.19860214643089;99.8013978535691
0;5;"leolani";5;0;100
0;16;"leolar";16;0;100
0;6;"leoler";6;0;100
0;93;"leolia";93;0;100
0;1160;"leoma";1160;0;100
110;0;"leomar";110;100;0
0;115;"leomia";115;0;100
159909;1377;"leon";161286;99.1462371191548;0.853762880845207
294;100524;"leona";100818;0.291614592632268;99.7083854073677
0;18;"leonah";18;0;100
5;0;"leonaldo";5;100;0
0;11;"leonara";11;0;100
285245;1405;"leonard";286650;99.5098552241409;0.490144775859062
0;1000;"leonarda";1000;0;100
58851;129;"leonardo";58980;99.7812817904374;0.218718209562564
402;0;"leonce";402;100;0
454;0;"leoncio";454;100;0
0;213;"leonda";213;0;100
5;753;"leondra";758;0.659630606860158;99.3403693931398
16;0;"leondrae";16;100;0
576;0;"leondre";576;100;0
0;45;"leondria";45;0;100
65;0;"leondro";65;100;0
5;0;"leondrus";5;100;0
262;5569;"leone";5831;4.49322586177328;95.5067741382267
18329;5;"leonel";18334;99.9727282644267;0.0272717355732519
0;933;"leonela";933;0;100
86;0;"leonell";86;100;0
0;60;"leonella";60;0;100
0;13;"leoner";13;0;100
0;63;"leonetta";63;0;100
0;387;"leonette";387;0;100
53;0;"leonhard";53;100;0
0;154;"leoni";154;0;100
0;1435;"leonia";1435;0;100
0;5;"leonice";5;0;100
296;0;"leonid";296;100;0
0;26;"leonida";26;0;100
4542;0;"leonidas";4542;100;0
5;0;"leonide";5;100;0
580;18;"leonides";598;96.989966555184;3.01003344481605
11;0;"leonidis";11;100;0
101;0;"leonidus";101;100;0
0;1428;"leonie";1428;0;100
0;319;"leonila";319;0;100
0;125;"leonilda";125;0;100
0;10;"leonilla";10;0;100
0;5;"leonis";5;0;100
0;5;"leonise";5;0;100
0;5;"leonisha";5;0;100
0;29;"leonita";29;0;100
54;0;"leonitus";54;100;0
0;1092;"leonna";1092;0;100
0;10;"leonnah";10;0;100
0;12;"leonne";12;0;100
0;6;"leonnie";6;0;100
10;5578;"leonor";5588;0.178954903364352;99.8210450966357
0;6186;"leonora";6186;0;100
19;0;"leonord";19;100;0
0;2113;"leonore";2113;0;100
25;0;"leonta";25;100;0
118;0;"leontae";118;100;0
10;0;"leontay";10;100;0
231;0;"leonte";231;100;0
0;79;"leontina";79;0;100
0;980;"leontine";980;0;100
5;0;"leontre";5;100;0
0;213;"leontyne";213;0;100
5;0;"leonydus";5;100;0
15;0;"leonzo";15;100;0
3049;0;"leopold";3049;100;0
5651;0;"leopoldo";5651;100;0
237;24;"leor";261;90.8045977011494;9.19540229885057
6;10205;"leora";10211;0.0587601606111057;99.9412398393889
0;26;"leorah";26;0;100
0;35;"leoria";35;0;100
24;0;"leorn";24;100;0
286;0;"leory";286;100;0
0;31;"leosha";31;0;100
6;0;"leosvel";6;100;0
0;9304;"leota";9304;0;100
119;367;"leotha";486;24.4855967078189;75.5144032921811
0;5;"leother";5;0;100
0;5;"leotie";5;0;100
887;5;"leotis";892;99.4394618834081;0.560538116591928
0;152;"leotta";152;0;100
5;0;"leoul";5;100;0
5;0;"leovani";5;100;0
45;0;"leovanni";45;100;0
252;0;"leovardo";252;100;0
5;0;"leovigildo";5;100;0
0;5;"lepha";5;0;100
390;5;"lequan";395;98.7341772151899;1.26582278481013
10;0;"lequentin";10;100;0
0;10;"lequesha";10;0;100
0;10;"lequetta";10;0;100
7;0;"lequient";7;100;0
0;7;"lequinta";7;0;100
5;0;"lequinton";5;100;0
0;141;"lequisha";141;0;100
0;552;"lequita";552;0;100
0;5;"lequitta";5;0;100
5;0;"lequon";5;100;0
0;2333;"lera";2333;0;100
0;74;"lerae";74;0;100
0;16;"lerah";16;0;100
5;0;"lerald";5;100;0
174;0;"leray";174;100;0
0;5;"lerena";5;0;100
33;0;"lerenzo";33;100;0
0;10;"leresa";10;0;100
0;6;"leretha";6;0;100
0;19;"lerhonda";19;0;100
11;0;"leri";11;100;0
0;5;"leriah";5;0;100
5;0;"lerico";5;100;0
29;195;"lerin";224;12.9464285714286;87.0535714285714
0;27;"lerissa";27;0;100
0;5;"lerita";5;0;100
0;15;"leriyah";15;0;100
0;10;"lerlean";10;0;100
0;93;"lerlene";93;0;100
0;68;"lerline";68;0;100
150;0;"leroi";150;100;0
5;0;"lerome";5;100;0
1679;0;"leron";1679;100;0
0;64;"leronda";64;0;100
401;0;"lerone";401;100;0
0;6;"leronia";6;0;100
194475;1182;"leroy";195657;99.3958815682547;0.60411843174535
0;8;"leroya";8;0;100
23;0;"leroyal";23;100;0
7;0;"leroyce";7;100;0
74;0;"lerry";74;100;0
0;7;"leryn";7;0;100
3372;32;"les";3404;99.0599294947121;0.940070505287897
12;11400;"lesa";11412;0.10515247108307;99.8948475289169
0;29;"lesandra";29;0;100
8;0;"lesane";8;100;0
0;55;"lesbia";55;0;100
338;10;"lesean";348;97.1264367816092;2.8735632183908
0;5;"lesedi";5;0;100
0;55;"lesette";55;0;100
0;1053;"lesha";1053;0;100
0;94;"leshae";94;0;100
11;16;"leshan";27;40.7407407407407;59.2592592592593
0;38;"leshanda";38;0;100
0;5;"leshanta";5;0;100
230;28;"leshaun";258;89.1472868217054;10.8527131782946
0;5;"leshauna";5;0;100
0;10;"leshaunda";10;0;100
0;5;"leshaundra";5;0;100
761;312;"leshawn";1073;70.9226467847158;29.0773532152843
0;8;"leshawna";8;0;100
0;5;"leshawnda";5;0;100
0;172;"leshay";172;0;100
0;6;"leshe";6;0;100
0;108;"leshea";108;0;100
0;5;"lesheena";5;0;100
0;5;"lesheka";5;0;100
0;26;"leshell";26;0;100
0;17;"leshelle";17;0;100
0;517;"leshia";517;0;100
0;29;"leshly";29;0;100
80;28;"leshon";108;74.0740740740741;25.9259259259259
0;160;"leshonda";160;0;100
21;7;"leshun";28;75;25
0;15;"leshunda";15;0;100
0;19;"lesi";19;0;100
0;3175;"lesia";3175;0;100
0;57;"lesie";57;0;100
0;83;"lesieli";83;0;100
5;45;"lesile";50;10;90
0;187;"lesle";187;0;100
0;349;"leslea";349;0;100
96;4849;"leslee";4945;1.94135490394338;98.0586450960566
0;52;"leslei";52;0;100
0;474;"lesleigh";474;0;100
4767;33888;"lesley";38655;12.3321691889794;87.6678308110206
0;86;"lesleyann";86;0;100
0;80;"lesleyanne";80;0;100
0;5662;"lesli";5662;0;100
0;27;"leslian";27;0;100
0;6;"lesliann";6;0;100
0;10;"leslianne";10;0;100
109288;265388;"leslie";374676;29.168668396161;70.8313316038391
0;472;"leslieann";472;0;100
0;93;"leslieanne";93;0;100
0;8;"lesliee";8;0;100
0;5;"leslly";5;0;100
502;13700;"lesly";14202;3.53471342064498;96.465286579355
0;16;"leslyann";16;0;100
0;2389;"leslye";2389;0;100
0;166;"leslyn";166;0;100
256;0;"less";256;100;0
0;148;"lessa";148;0;100
0;11;"lessette";11;0;100
0;23;"lessia";23;0;100
934;12606;"lessie";13540;6.89807976366322;93.1019202363368
43;54;"lessley";97;44.3298969072165;55.6701030927835
0;24;"lessli";24;0;100
142;492;"lesslie";634;22.397476340694;77.602523659306
0;618;"lessly";618;0;100
0;601;"lesta";601;0;100
407;0;"lestat";407;100;0
125567;1288;"lester";126855;98.9846675337984;1.01533246620157
42;0;"lesther";42;100;0
0;31;"lestie";31;0;100
0;16;"lestina";16;0;100
0;208;"lestine";208;0;100
182;0;"leston";182;100;0
0;31;"lesvia";31;0;100
0;10866;"leta";10866;0;100
0;5;"letah";5;0;100
0;92;"letanya";92;0;100
0;16;"letara";16;0;100
0;6;"letarsha";6;0;100
0;285;"letasha";285;0;100
0;16;"letavia";16;0;100
340;0;"letcher";340;100;0
0;525;"letecia";525;0;100
0;18;"leteisha";18;0;100
0;197;"letesha";197;0;100
0;18;"leteshia";18;0;100
0;160;"letetia";160;0;100
25;17540;"letha";17565;0.142328494164532;99.8576715058355
40;0;"lethaniel";40;100;0
0;5;"lethe";5;0;100
0;54;"lethea";54;0;100
5;0;"lethel";5;100;0
6;0;"lethell";6;100;0
5;236;"lether";241;2.0746887966805;97.9253112033195
0;907;"lethia";907;0;100
0;13;"lethie";13;0;100
0;25;"leti";25;0;100
0;379;"letia";379;0;100
0;193;"letica";193;0;100
0;30;"leticha";30;0;100
215;41851;"leticia";42066;0.511101602244093;99.4888983977559
0;89;"letina";89;0;100
0;10;"letisa";10;0;100
0;1889;"letisha";1889;0;100
0;64;"letishia";64;0;100
0;933;"letisia";933;0;100
0;96;"letita";96;0;100
0;10874;"letitia";10874;0;100
0;394;"letizia";394;0;100
49;0;"leto";49;100;0
0;86;"letonia";86;0;100
0;182;"letonya";182;0;100
0;49;"letoria";49;0;100
0;24;"letosha";24;0;100
0;282;"letoya";282;0;100
0;15;"letrece";15;0;100
0;5;"letrecia";5;0;100
206;0;"letrell";206;100;0
0;5;"letrese";5;0;100
0;5;"letriana";5;0;100
0;5;"letrica";5;0;100
0;429;"letrice";429;0;100
0;505;"letricia";505;0;100
0;5;"letrina";5;0;100
0;22;"letrisha";22;0;100
161;0;"letroy";161;100;0
0;578;"letta";578;0;100
0;154;"letti";154;0;100
0;5;"lettia";5;0;100
0;15;"lettica";15;0;100
0;18;"lettice";18;0;100
0;568;"letticia";568;0;100
0;7572;"lettie";7572;0;100
0;3235;"letty";3235;0;100
0;27;"lettye";27;0;100
5;0;"letwan";5;100;0
0;70;"lety";70;0;100
0;11;"letycia";11;0;100
0;107;"letzy";107;0;100
11;0;"leudy";11;100;0
123;0;"leul";123;100;0
37;0;"leum";37;100;0
0;16;"leuna";16;0;100
0;10;"leura";10;0;100
0;5;"leuvenia";5;0;100
1227;13;"lev";1240;98.9516129032258;1.04838709677419
0;661;"leva";661;0;100
0;516;"levada";516;0;100
0;52;"levaeh";52;0;100
573;0;"levan";573;100;0
0;108;"levana";108;0;100
10;0;"levance";10;100;0
189;0;"levander";189;100;0
5;0;"levane";5;100;0
0;5;"levani";5;0;100
5;0;"levant";5;100;0
71;0;"levante";71;100;0
1970;9;"levar";1979;99.5452248610409;0.45477513895907
15;6;"levarn";21;71.4285714285714;28.5714285714286
14;0;"levarr";14;100;0
0;5;"levata";5;0;100
0;6;"levater";6;0;100
119;0;"levaughn";119;100;0
0;5;"levaun";5;0;100
5;0;"leve";5;100;0
0;32;"leveah";32;0;100
0;5;"levearn";5;0;100
0;144;"leveda";144;0;100
0;5;"levee";5;0;100
748;0;"levell";748;100;0
0;5;"levella";5;0;100
251;0;"levelle";251;100;0
131;5;"leven";136;96.3235294117647;3.67647058823529
0;18;"levena";18;0;100
0;189;"levenia";189;0;100
92;0;"levent";92;100;0
37;0;"levente";37;100;0
61;0;"leveon";61;100;0
0;59;"levera";59;0;100
0;5;"leverda";5;0;100
59;0;"levere";59;100;0
163;0;"leverett";163;100;0
5;0;"leverette";5;100;0
0;10;"leveria";10;0;100
1901;382;"levern";2283;83.2676303109943;16.7323696890057
0;16;"leverna";16;0;100
985;487;"leverne";1472;66.9157608695652;33.0842391304348
588;5;"levert";593;99.1568296795953;0.843170320404722
0;33;"leverta";33;0;100
5;0;"levertis";5;100;0
838;6;"levester";844;99.2890995260664;0.710900473933649
0;143;"leveta";143;0;100
0;99;"levetta";99;0;100
0;241;"levette";241;0;100
129566;806;"levi";130372;99.3817690915227;0.61823090847728
0;238;"levia";238;0;100
0;13;"leviah";13;0;100
19;13;"levian";32;59.375;40.625
288;0;"leviathan";288;100;0
0;5;"levicy";5;0;100
6;0;"levid";6;100;0
877;143;"levie";1020;85.9803921568627;14.0196078431373
94;0;"levii";94;100;0
1310;0;"levin";1310;100;0
0;518;"levina";518;0;100
20;0;"levine";20;100;0
0;41;"levinia";41;0;100
5;0;"levio";5;100;0
10;0;"levion";10;100;0
257;15;"levis";272;94.4852941176471;5.51470588235294
10;0;"levit";10;100;0
0;205;"levita";205;0;100
937;0;"leviticus";937;100;0
13;0;"levitt";13;100;0
0;5;"levity";5;0;100
0;16;"levolia";16;0;100
4732;433;"levon";5165;91.6166505324298;8.38334946757018
0;49;"levona";49;0;100
0;40;"levonda";40;0;100
117;39;"levone";156;75;25
0;491;"levonia";491;0;100
0;5;"levonna";5;0;100
26;343;"levonne";369;7.04607046070461;92.9539295392954
19;0;"levonta";19;100;0
26;0;"levontae";26;100;0
237;0;"levonte";237;100;0
0;128;"levora";128;0;100
122;19;"levorn";141;86.5248226950355;13.4751773049645
5;0;"levorne";5;100;0
80;0;"levoy";80;100;0
3000;45;"levy";3045;98.5221674876847;1.47783251231527
11;0;"levyn";11;100;0
1978;15;"lew";1993;99.2473657802308;0.752634219769192
0;26;"lewana";26;0;100
0;169;"lewanda";169;0;100
0;5;"lewann";5;0;100
0;87;"lewanna";87;0;100
21;0;"leward";21;100;0
63;0;"lewayne";63;100;0
39;0;"lewell";39;100;0
0;5;"lewella";5;0;100
305;33;"lewellyn";338;90.2366863905325;9.76331360946746
23;0;"lewey";23;100;0
55;0;"lewi";55;100;0
840;0;"lewie";840;100;0
157;0;"lewin";157;100;0
142177;854;"lewis";143031;99.4029266382812;0.597073361718788
12;0;"lewyn";12;100;0
3239;5;"lex";3244;99.845869297164;0.154130702836005
0;1031;"lexa";1031;0;100
0;6;"lexah";6;0;100
110;0;"lexander";110;100;0
0;139;"lexandra";139;0;100
0;5;"lexandria";5;0;100
5;0;"lexandro";5;100;0
5;326;"lexani";331;1.51057401812689;98.4894259818731
0;6;"lexanie";6;0;100
0;5;"lexanne";5;0;100
0;6;"lexanni";6;0;100
0;77;"lexany";77;0;100
0;29;"lexas";29;0;100
0;5;"lexcee";5;0;100
0;10;"lexci";10;0;100
0;5;"lexcie";5;0;100
0;5;"lexe";5;0;100
0;372;"lexee";372;0;100
0;36;"lexes";36;0;100
0;203;"lexey";203;0;100
0;21314;"lexi";21314;0;100
0;713;"lexia";713;0;100
0;137;"lexiana";137;0;100
0;32;"lexiann";32;0;100
0;100;"lexianna";100;0;100
431;14166;"lexie";14597;2.95266150578886;97.0473384942111
0;5;"lexiee";5;0;100
5;0;"lexiel";5;100;0
0;126;"lexii";126;0;100
0;5;"lexilynn";5;0;100
21;6;"lexin";27;77.7777777777778;22.2222222222222
0;306;"lexine";306;0;100
524;858;"lexington";1382;37.9160636758321;62.0839363241679
44;3226;"lexis";3270;1.34556574923547;98.6544342507645
0;52;"lexiss";52;0;100
0;37;"lexius";37;0;100
0;15;"lexly";15;0;100
26;0;"lexon";26;100;0
0;14;"lexsey";14;0;100
0;5;"lexsie";5;0;100
0;6;"lexsis";6;0;100
0;5;"lexsy";5;0;100
266;0;"lexton";266;100;0
263;6346;"lexus";6609;3.97942200030262;96.0205779996974
69;0;"lexx";69;100;0
0;236;"lexxi";236;0;100
0;122;"lexxie";122;0;100
0;41;"lexxis";41;0;100
0;228;"lexxus";228;0;100
0;22;"lexxy";22;0;100
0;2562;"lexy";2562;0;100
0;69;"lexys";69;0;100
0;1080;"leya";1080;0;100
0;912;"leyah";912;0;100
0;65;"leyan";65;0;100
0;240;"leyana";240;0;100
0;67;"leyani";67;0;100
0;8;"leyann";8;0;100
0;176;"leyanna";176;0;100
0;5;"leyanni";5;0;100
0;5;"leyat";5;0;100
5;0;"leycester";5;100;0
0;328;"leyda";328;0;100
26;0;"leyden";26;100;0
0;387;"leydi";387;0;100
0;70;"leydy";70;0;100
0;6;"leyiah";6;0;100
0;5;"leyka";5;0;100
0;6298;"leyla";6298;0;100
0;544;"leylah";544;0;100
5;0;"leylan";5;100;0
192;0;"leyland";192;100;0
0;834;"leylani";834;0;100
0;242;"leylanie";242;0;100
0;18;"leylanni";18;0;100
0;113;"leylany";113;0;100
0;84;"leyli";84;0;100
0;1706;"leyna";1706;0;100
0;5;"leynah";5;0;100
0;12;"leyni";12;0;100
0;28;"leyona";28;0;100
0;58;"leyonna";58;0;100
0;19;"leyre";19;0;100
0;38;"leysha";38;0;100
1868;238;"leyton";2106;88.698955365622;11.301044634378
7;0;"leyver";7;100;0
0;304;"leza";304;0;100
0;16;"lezah";16;0;100
0;6;"lezanne";6;0;100
5;0;"lezer";5;100;0
0;56;"lezette";56;0;100
0;483;"lezlee";483;0;100
0;280;"lezley";280;0;100
0;348;"lezli";348;0;100
0;2375;"lezlie";2375;0;100
0;523;"lezly";523;0;100
5;0;"lg";5;100;0
0;5;"lhea";5;0;100
7;0;"lhiam";7;100;0
113;251;"li";364;31.043956043956;68.956043956044
10;17091;"lia";17101;0.0584761125080405;99.941523887492
56;0;"liad";56;100;0
0;70;"liadan";70;0;100
0;1220;"liah";1220;0;100
60;0;"liahm";60;100;0
0;164;"liahna";164;0;100
0;28;"liahona";28;0;100
0;109;"liala";109;0;100
0;5;"lialah";5;0;100
173821;274;"liam";174095;99.8426146644074;0.157385335592636
11;0;"liamalexander";11;100;0
7;0;"liamgabriel";7;100;0
29;0;"liamjames";29;100;0
6;0;"liamm";6;100;0
7;0;"liammatthew";7;100;0
7;0;"liammichael";7;100;0
1031;768;"lian";1799;57.3096164535853;42.6903835464147
0;14374;"liana";14374;0;100
0;5;"lianabel";5;0;100
0;83;"lianah";83;0;100
0;181;"liandra";181;0;100
102;0;"liandro";102;100;0
0;3808;"liane";3808;0;100
0;34;"lianet";34;0;100
0;6;"lianett";6;0;100
0;90;"lianette";90;0;100
34;0;"liang";34;100;0
0;561;"liani";561;0;100
0;498;"liann";498;0;100
0;4563;"lianna";4563;0;100
0;65;"liannah";65;0;100
0;2860;"lianne";2860;0;100
0;6;"liannette";6;0;100
0;84;"lianni";84;0;100
0;6;"liannie";6;0;100
0;161;"lianny";161;0;100
0;181;"liany";181;0;100
0;25;"lianys";25;0;100
0;315;"liara";315;0;100
0;20;"liasia";20;0;100
0;455;"liat";455;0;100
22;0;"liav";22;100;0
0;622;"liba";622;0;100
346;0;"liban";346;100;0
0;114;"libbey";114;0;100
0;215;"libbi";215;0;100
0;1986;"libbie";1986;0;100
5;15743;"libby";15748;0.031750063500127;99.9682499364999
0;48;"libera";48;0;100
166;0;"liberato";166;100;0
97;0;"libero";97;100;0
0;83;"liberta";83;0;100
0;51;"libertad";51;0;100
0;50;"libertee";50;0;100
0;132;"liberti";132;0;100
0;79;"libertie";79;0;100
148;11646;"liberty";11794;1.25487536035272;98.7451246396473
0;5;"libeth";5;0;100
0;62;"libi";62;0;100
0;68;"libia";68;0;100
0;12;"libna";12;0;100
0;274;"libni";274;0;100
0;58;"libny";58;0;100
0;90;"liboria";90;0;100
522;0;"liborio";522;100;0
0;218;"libra";218;0;100
0;652;"librada";652;0;100
1259;0;"librado";1259;100;0
0;14;"libya";14;0;100
0;5;"lica";5;0;100
0;75;"licet";75;0;100
0;17;"licette";17;0;100
0;124;"lichelle";124;0;100
0;724;"licia";724;0;100
0;5;"liczy";5;0;100
0;4461;"lida";4461;0;100
0;6;"liddia";6;0;100
0;960;"liddie";960;0;100
0;62;"liddy";62;0;100
0;5;"lidea";5;0;100
10;0;"lidell";10;100;0
0;10118;"lidia";10118;0;100
0;51;"lidiana";51;0;100
0;34;"lidie";34;0;100
0;7;"lidija";7;0;100
5;0;"lidio";5;100;0
0;104;"lidiya";104;0;100
70;0;"lido";70;100;0
0;25;"liduvina";25;0;100
0;66;"lidwina";66;0;100
0;6;"lidy";6;0;100
0;299;"lidya";299;0;100
0;16;"lieba";16;0;100
5;0;"liedson";5;100;0
253;0;"lief";253;100;0
35;231;"liel";266;13.1578947368421;86.8421052631579
0;294;"liela";294;0;100
0;9;"lielah";9;0;100
0;194;"lielle";194;0;100
535;0;"liem";535;100;0
6;505;"lien";511;1.17416829745597;98.825831702544
0;5;"lienna";5;0;100
0;6;"liera";6;0;100
0;16;"lieren";16;0;100
0;33;"lierin";33;0;100
0;6;"lierra";6;0;100
0;392;"liesa";392;0;100
0;144;"liese";144;0;100
0;936;"liesel";936;0;100
0;20;"lieselotte";20;0;100
0;59;"liesha";59;0;100
0;1674;"liesl";1674;0;100
0;5;"liette";5;0;100
0;12;"lieu";12;0;100
200;0;"lieutenant";200;100;0
268;0;"liev";268;100;0
0;5;"lieve";5;0;100
0;5;"lieza";5;0;100
0;48;"liezel";48;0;100
0;33;"liezl";33;0;100
34;17;"life";51;66.6666666666667;33.3333333333333
0;60;"ligaya";60;0;100
946;0;"lige";946;100;0
0;5;"ligeia";5;0;100
33;6;"light";39;84.6153846153846;15.3846153846154
0;689;"ligia";689;0;100
0;5;"ligita";5;0;100
0;65;"lihanna";65;0;100
0;12;"lihi";12;0;100
11;0;"liiam";11;100;0
6;0;"liiban";6;100;0
0;427;"liisa";427;0;100
0;11;"lija";11;0;100
112;10;"lijah";122;91.8032786885246;8.19672131147541
0;6;"lijana";6;0;100
6;0;"like";6;100;0
0;12;"likesha";12;0;100
0;6;"likhita";6;0;100
0;5;"likhitha";5;0;100
0;67;"likisha";67;0;100
0;32;"likita";32;0;100
17;0;"liko";17;100;0
0;126;"lil";126;0;100
57;61281;"lila";61338;0.0929277120219114;99.9070722879781
0;140;"lilac";140;0;100
0;7;"lilagrace";7;0;100
0;12191;"lilah";12191;0;100
0;57;"lilamae";57;0;100
0;25;"lilan";25;0;100
0;66;"lilana";66;0;100
0;26;"lilandra";26;0;100
0;20;"lilani";20;0;100
0;5;"lilany";5;0;100
0;6;"lilar";6;0;100
0;13;"lilarose";13;0;100
0;320;"lilas";320;0;100
45;0;"lilbern";45;100;0
10;0;"lilbert";10;100;0
6;0;"lilborn";6;100;0
701;0;"lilburn";701;100;0
31;61;"lile";92;33.695652173913;66.304347826087
0;22;"lilea";22;0;100
0;24;"lileah";24;0;100
0;37;"lileana";37;0;100
0;765;"lilee";765;0;100
0;5;"lileeann";5;0;100
0;201;"lileigh";201;0;100
0;30;"liler";30;0;100
0;7;"lilette";7;0;100
0;70;"liley";70;0;100
0;3330;"lili";3330;0;100
5;11948;"lilia";11953;0.0418305028026437;99.9581694971974
0;130;"liliah";130;0;100
0;93;"liliahna";93;0;100
0;16;"liliam";16;0;100
0;15391;"lilian";15391;0;100
157;49911;"liliana";50068;0.31357353998562;99.6864264600144
0;136;"lilianah";136;0;100
0;589;"liliane";589;0;100
0;119;"liliani";119;0;100
0;449;"liliann";449;0;100
0;5859;"lilianna";5859;0;100
0;39;"liliannah";39;0;100
0;658;"lilianne";658;0;100
0;5;"liliano";5;0;100
0;31;"liliany";31;0;100
0;52;"lilias";52;0;100
0;69;"liliauna";69;0;100
0;28;"lilibet";28;0;100
0;1364;"lilibeth";1364;0;100
0;5;"lilica";5;0;100
0;1244;"lilie";1244;0;100
0;23;"lilien";23;0;100
0;53;"lilienne";53;0;100
0;5;"lilieth";5;0;100
0;46;"lilija";46;0;100
0;54;"lilijana";54;0;100
0;16;"lilika";16;0;100
0;37;"lilikoi";37;0;100
0;110;"lilinoe";110;0;100
0;11;"liliona";11;0;100
0;5;"lilirose";5;0;100
0;276;"lilit";276;0;100
0;5;"lilita";5;0;100
0;4493;"lilith";4493;0;100
0;47;"lilium";47;0;100
0;6;"liliuokalani";6;0;100
0;414;"liliya";414;0;100
0;51;"liliyana";51;0;100
0;5;"liliyanna";5;0;100
0;159;"lilja";159;0;100
0;11;"lill";11;0;100
0;3316;"lilla";3316;0;100
0;121;"lillah";121;0;100
0;22;"lillain";22;0;100
0;104;"lillan";104;0;100
0;79;"lillar";79;0;100
516;0;"lillard";516;100;0
0;120;"lille";120;0;100
0;6;"lillea";6;0;100
0;6;"lilleah";6;0;100
0;835;"lillee";835;0;100
0;5;"lilleeana";5;0;100
0;120;"lilleigh";120;0;100
0;278;"liller";278;0;100
0;31;"lillette";31;0;100
0;336;"lilley";336;0;100
0;2954;"lilli";2954;0;100
0;2055;"lillia";2055;0;100
0;136;"lilliah";136;0;100
0;86;"lilliahna";86;0;100
0;764;"lilliam";764;0;100
1270;397634;"lillian";398904;0.318372340212181;99.6816276597878
0;14677;"lilliana";14677;0;100
0;78;"lillianah";78;0;100
0;189;"lilliane";189;0;100
0;5;"lilliangrace";5;0;100
0;24;"lilliani";24;0;100
0;859;"lilliann";859;0;100
0;4613;"lillianna";4613;0;100
0;56;"lilliannah";56;0;100
0;983;"lillianne";983;0;100
0;12;"lillianrose";12;0;100
0;184;"lillias";184;0;100
0;103;"lilliauna";103;0;100
0;11;"lilliaunna";11;0;100
0;27;"lillibeth";27;0;100
758;131603;"lillie";132361;0.572676241491074;99.4273237585089
0;27;"lillieana";27;0;100
0;124;"lillieann";124;0;100
0;94;"lillieanna";94;0;100
0;24;"lillieanne";24;0;100
0;15;"lilliebell";15;0;100
0;252;"lilliemae";252;0;100
0;252;"lillien";252;0;100
0;46;"lillienne";46;0;100
0;350;"lillion";350;0;100
0;102;"lilliona";102;0;100
0;100;"lillionna";100;0;100
0;558;"lillis";558;0;100
0;1135;"lillith";1135;0;100
0;10;"lilliyan";10;0;100
0;5;"lilliyn";5;0;100
24;51804;"lilly";51828;0.0463070155128502;99.9536929844871
0;11;"lillya";11;0;100
0;5;"lillyah";5;0;100
0;63;"lillyahna";63;0;100
0;2142;"lillyan";2142;0;100
0;2592;"lillyana";2592;0;100
0;47;"lillyanah";47;0;100
0;1842;"lillyann";1842;0;100
0;2441;"lillyanna";2441;0;100
0;34;"lillyannah";34;0;100
0;802;"lillyanne";802;0;100
0;81;"lillyauna";81;0;100
0;11;"lillyaunna";11;0;100
0;17;"lillybelle";17;0;100
0;64;"lillybeth";64;0;100
0;54;"lillye";54;0;100
0;68;"lillyen";68;0;100
0;78;"lillyian";78;0;100
0;32;"lillyin";32;0;100
0;5;"lillyjo";5;0;100
0;5;"lillykate";5;0;100
0;71;"lillymae";71;0;100
0;5;"lillymay";5;0;100
0;75;"lillyn";75;0;100
0;26;"lillynn";26;0;100
0;137;"lillyona";137;0;100
0;202;"lillyonna";202;0;100
0;45;"lillyrose";45;0;100
0;80;"lillyth";80;0;100
0;127;"lilo";127;0;100
5;0;"liloa";5;100;0
0;172;"lilou";172;0;100
209;0;"lilton";209;100;0
0;139;"lilu";139;0;100
140;134801;"lily";134941;0.10374904587931;99.8962509541207
0;333;"lilya";333;0;100
0;30;"lilyah";30;0;100
0;133;"lilyahna";133;0;100
0;3865;"lilyan";3865;0;100
0;6897;"lilyana";6897;0;100
0;198;"lilyanah";198;0;100
0;12;"lilyane";12;0;100
0;26;"lilyani";26;0;100
0;2461;"lilyann";2461;0;100
0;3542;"lilyanna";3542;0;100
0;78;"lilyannah";78;0;100
0;1218;"lilyanne";1218;0;100
0;109;"lilyauna";109;0;100
0;5;"lilyaunna";5;0;100
0;86;"lilybelle";86;0;100
0;378;"lilybeth";378;0;100
0;40;"lilyen";40;0;100
0;101;"lilygrace";101;0;100
0;117;"lilyian";117;0;100
0;6;"lilyiana";6;0;100
0;20;"lilyin";20;0;100
0;43;"lilykate";43;0;100
0;5;"lilylynn";5;0;100
0;108;"lilymae";108;0;100
0;59;"lilymarie";59;0;100
0;5;"lilymay";5;0;100
0;8;"lilynn";8;0;100
0;116;"lilyona";116;0;100
0;170;"lilyonna";170;0;100
0;6;"lilyrae";6;0;100
0;285;"lilyrose";285;0;100
0;184;"lilyth";184;0;100
19;0;"lim";19;100;0
0;117;"lima";117;0;100
0;7;"limairy";7;0;100
0;16;"limayri";16;0;100
295;28;"limmie";323;91.3312693498452;8.6687306501548
10;0;"limon";10;100;0
0;28;"limor";28;0;100
104;0;"limuel";104;100;0
833;969;"lin";1802;46.2264150943396;53.7735849056604
5;14393;"lina";14398;0.0347270454229754;99.965272954577
0;42;"linae";42;0;100
0;61;"linah";61;0;100
235;0;"linard";235;100;0
117;0;"linas";117;100;0
0;5;"linay";5;0;100
0;58;"linaya";58;0;100
0;17;"linayah";17;0;100
166;0;"linc";166;100;0
0;11;"lincey";11;0;100
47959;759;"lincoln";48718;98.4420542715218;1.55794572847818
67;0;"lincon";67;100;0
0;143;"lincy";143;0;100
29;90;"lind";119;24.3697478991597;75.6302521008403
3757;1450444;"linda";1454201;0.258354931677258;99.7416450683227
0;5;"lindaa";5;0;100
0;79;"lindaann";79;0;100
0;18;"lindajean";18;0;100
0;20;"lindajo";20;0;100
30;5;"lindal";35;85.7142857142857;14.2857142857143
11;0;"lindale";11;100;0
0;340;"lindalee";340;0;100
10;0;"lindall";10;100;0
0;85;"lindalou";85;0;100
0;5;"lindamaria";5;0;100
0;63;"lindamarie";63;0;100
31;0;"lindan";31;100;0
0;5;"lindarose";5;0;100
0;18;"lindasue";18;0;100
0;27;"lindasy";27;0;100
0;133;"linday";133;0;100
231;0;"lindberg";231;100;0
477;0;"lindbergh";477;100;0
32;0;"lindburg";32;100;0
48;0;"lindburgh";48;100;0
0;442;"linde";442;0;100
0;385;"lindee";385;0;100
340;16;"lindel";356;95.5056179775281;4.49438202247191
2405;357;"lindell";2762;87.0745836350471;12.9254163649529
0;5;"lindella";5;0;100
3130;1298;"linden";4428;70.6865401987353;29.3134598012647
12;302;"linder";314;3.82165605095541;96.1783439490446
0;209;"lindey";209;0;100
0;1071;"lindi";1071;0;100
0;438;"lindia";438;0;100
0;370;"lindie";370;0;100
0;40;"lindita";40;0;100
0;6;"lindiwe";6;0;100
53;0;"lindle";53;100;0
621;816;"lindley";1437;43.2150313152401;56.7849686847599
0;5;"lindly";5;0;100
57;0;"lindo";57;100;0
6;0;"lindol";6;100;0
0;13;"lindola";13;0;100
1117;0;"lindon";1117;100;0
0;85;"lindora";85;0;100
0;6;"lindra";6;0;100
0;17;"lindsae";17;0;100
4979;129153;"lindsay";134132;3.71201502997048;96.2879849700295
0;10;"lindse";10;0;100
0;70;"lindsea";70;0;100
0;257;"lindsee";257;0;100
7480;155477;"lindsey";162957;4.59016795841848;95.4098320415815
0;776;"lindsi";776;0;100
0;969;"lindsie";969;0;100
15;15;"lindsley";30;50;50
5;2115;"lindsy";2120;0.235849056603774;99.7641509433962
69;0;"lindwood";69;100;0
1777;8134;"lindy";9911;17.9295732014933;82.0704267985067
0;100;"lindyn";100;0;100
0;97;"lindzee";97;0;100
0;264;"lindzey";264;0;100
0;46;"lindzi";46;0;100
0;144;"lindzie";144;0;100
0;204;"lindzy";204;0;100
0;165;"linea";165;0;100
159;293;"linell";452;35.1769911504425;64.8230088495575
0;51;"linelle";51;0;100
0;5;"linen";5;0;100
0;6;"linesha";6;0;100
0;69;"linet";69;0;100
0;135;"lineth";135;0;100
0;37;"linett";37;0;100
0;114;"linetta";114;0;100
0;4190;"linette";4190;0;100
769;0;"linford";769;100;0
18;183;"ling";201;8.95522388059701;91.044776119403
0;10;"lingxi";10;0;100
0;6;"lingyi";6;0;100
213;1397;"linh";1610;13.2298136645963;86.7701863354037
0;5;"linhchi";5;0;100
0;5;"linie";5;0;100
0;34;"linita";34;0;100
0;5;"liniyah";5;0;100
1316;0;"link";1316;100;0
258;0;"linken";258;100;0
1033;0;"linkin";1033;100;0
283;0;"linkoln";283;100;0
165;0;"linkon";165;100;0
122;28;"linkyn";150;81.3333333333333;18.6666666666667
0;87;"linlee";87;0;100
0;34;"linleigh";34;0;100
84;1040;"linley";1124;7.47330960854092;92.5266903914591
0;5;"linly";5;0;100
1421;837;"linn";2258;62.9317980513729;37.0682019486271
0;758;"linna";758;0;100
0;295;"linnae";295;0;100
0;143;"linnaea";143;0;100
5;0;"linnard";5;100;0
0;5;"linnda";5;0;100
0;29;"linne";29;0;100
0;8667;"linnea";8667;0;100
0;6;"linneah";6;0;100
59;86;"linnell";145;40.6896551724138;59.3103448275862
0;135;"linnet";135;0;100
0;10;"linnett";10;0;100
0;15;"linnetta";15;0;100
0;1132;"linnette";1132;0;100
700;6322;"linnie";7022;9.96866989461692;90.0313301053831
5;0;"linnis";5;100;0
6;0;"linny";6;100;0
0;17;"linnzi";17;0;100
3721;6;"lino";3727;99.8390126106788;0.16098738932117
0;18;"linora";18;0;100
0;6;"linoshka";6;0;100
0;13;"linoy";13;0;100
0;673;"linsay";673;0;100
0;6;"linsday";6;0;100
0;19;"linsdey";19;0;100
0;11;"linsee";11;0;100
240;5039;"linsey";5279;4.54631559007388;95.4536844099261
0;77;"linsi";77;0;100
0;123;"linsie";123;0;100
5;0;"linsley";5;100;0
10;0;"linson";10;100;0
0;251;"linsy";251;0;100
2271;0;"linton";2271;100;0
4167;0;"linus";4167;100;0
27;5;"linux";32;84.375;15.625
33;0;"linvel";33;100;0
407;0;"linville";407;100;0
59;0;"linward";59;100;0
12518;5;"linwood";12523;99.9600734648247;0.0399265351752775
5;0;"linza";5;100;0
0;17;"linze";17;0;100
0;290;"linzee";290;0;100
5;0;"linzell";5;100;0
16;325;"linzey";341;4.69208211143695;95.3079178885631
0;557;"linzi";557;0;100
338;551;"linzie";889;38.0202474690664;61.9797525309336
545;916;"linzy";1461;37.3032169746749;62.6967830253251
116;0;"lio";116;100;0
0;6;"liola";6;0;100
159;0;"lion";159;100;0
0;116;"liona";116;0;100
100;0;"lional";100;100;0
130;0;"lionardo";130;100;0
29421;44;"lionel";29465;99.8506702867809;0.149329713219073
0;17;"lionela";17;0;100
1586;0;"lionell";1586;100;0
0;10;"lionna";10;0;100
0;22;"lionor";22;0;100
11;0;"lionso";11;100;0
423;203;"lior";626;67.5718849840256;32.4281150159744
0;702;"liora";702;0;100
772;0;"lipa";772;100;0
6;0;"lipman";6;100;0
0;153;"lira";153;0;100
28;0;"liran";28;100;0
0;17;"liria";17;0;100
44;0;"liridon";44;100;0
0;73;"liridona";73;0;100
0;19;"liriel";19;0;100
0;5;"lirije";5;0;100
6;0;"lirim";6;100;0
0;114;"lirio";114;0;100
79;38;"liron";117;67.5213675213675;32.4786324786325
0;276;"lis";276;0;100
2788;964655;"lisa";967443;0.288182352862132;99.7118176471379
0;582;"lisaann";582;0;100
0;63;"lisaanne";63;0;100
0;19;"lisabella";19;0;100
0;6;"lisabelle";6;0;100
0;1258;"lisabeth";1258;0;100
0;5;"lisah";5;0;100
0;5;"lisajean";5;0;100
0;10;"lisajo";10;0;100
0;17;"lisamaria";17;0;100
0;1813;"lisamarie";1813;0;100
19;0;"lisander";19;100;0
0;1593;"lisandra";1593;0;100
1713;5;"lisandro";1718;99.708963911525;0.291036088474971
0;58;"lisania";58;0;100
0;23;"lisann";23;0;100
0;26;"lisanna";26;0;100
0;408;"lisanne";408;0;100
0;24;"lisbed";24;0;100
0;17;"lisbel";17;0;100
0;961;"lisbet";961;0;100
0;5590;"lisbeth";5590;0;100
0;11;"lisbett";11;0;100
5;0;"lisbon";5;100;0
0;2771;"lise";2771;0;100
0;5;"lised";5;0;100
0;89;"lisel";89;0;100
0;5;"liseli";5;0;100
0;33;"liselle";33;0;100
0;1019;"liset";1019;0;100
0;8;"lisete";8;0;100
0;697;"liseth";697;0;100
0;488;"lisett";488;0;100
0;10;"lisetta";10;0;100
0;9291;"lisette";9291;0;100
12;7;"lish";19;63.1578947368421;36.8421052631579
0;2364;"lisha";2364;0;100
0;28;"lishia";28;0;100
0;24;"lisi";24;0;100
0;191;"lisia";191;0;100
5;0;"lisiate";5;100;0
0;60;"lisl";60;0;100
503;21;"lisle";524;95.9923664122137;4.00763358778626
0;27;"lislie";27;0;100
0;6;"lismari";6;0;100
0;23;"lismarie";23;0;100
0;60;"lismary";60;0;100
0;6;"liss";6;0;100
0;3859;"lissa";3859;0;100
0;266;"lissandra";266;0;100
131;0;"lissandro";131;100;0
0;5;"lissbet";5;0;100
0;11;"lissbeth";11;0;100
0;1442;"lisset";1442;0;100
0;432;"lissete";432;0;100
0;612;"lisseth";612;0;100
0;607;"lissett";607;0;100
5;7353;"lissette";7358;0.0679532481652623;99.9320467518347
0;5;"lissianna";5;0;100
0;718;"lissie";718;0;100
0;63;"lissy";63;0;100
128;0;"lister";128;100;0
898;0;"liston";898;100;0
0;103;"lisvet";103;0;100
0;6;"lisveth";6;0;100
0;5;"lisvette";5;0;100
0;4252;"lita";4252;0;100
0;29;"lital";29;0;100
0;6;"litany";6;0;100
0;25;"litasha";25;0;100
0;6;"litcy";6;0;100
0;220;"litha";220;0;100
0;66;"lithzy";66;0;100
0;36;"litia";36;0;100
0;121;"liticia";121;0;100
0;256;"litisha";256;0;100
0;97;"lititia";97;0;100
15;0;"lito";15;100;0
0;5;"litonia";5;0;100
0;26;"litonya";26;0;100
0;21;"litsa";21;0;100
0;6;"litsi";6;0;100
0;92;"litsy";92;0;100
0;526;"littie";526;0;100
1533;218;"little";1751;87.5499714448886;12.4500285551114
282;0;"littleton";282;100;0
0;38;"littzy";38;0;100
0;5;"litza";5;0;100
0;495;"litzi";495;0;100
0;12;"litzie";12;0;100
6;6111;"litzy";6117;0.0980872976949485;99.9019127023051
0;43;"litzzy";43;0;100
31;0;"lium";31;100;0
5;0;"lius";5;100;0
0;3330;"liv";3330;0;100
0;10;"liva";10;0;100
239;0;"livan";239;100;0
0;20;"livana";20;0;100
0;7;"livanna";7;0;100
0;5;"livea";5;0;100
0;5;"livee";5;0;100
0;90;"lively";90;0;100
0;279;"livi";279;0;100
0;7042;"livia";7042;0;100
0;53;"liviah";53;0;100
0;133;"livian";133;0;100
0;257;"liviana";257;0;100
0;79;"livianna";79;0;100
0;262;"livie";262;0;100
0;278;"livier";278;0;100
0;5;"livija";5;0;100
880;25;"livingston";905;97.2375690607735;2.76243093922652
0;18;"livinia";18;0;100
165;0;"livio";165;100;0
0;139;"liviya";139;0;100
0;33;"livvie";33;0;100
0;203;"livvy";203;0;100
0;201;"livy";201;0;100
0;39;"livya";39;0;100
10;0;"lixandro";10;100;0
0;6;"lixy";6;0;100
0;1243;"liya";1243;0;100
0;1638;"liyah";1638;0;100
14;0;"liyam";14;100;0
6;5;"liyan";11;54.5454545454545;45.4545454545455
0;527;"liyana";527;0;100
0;16;"liyanah";16;0;100
0;65;"liyanna";65;0;100
0;52;"liyat";52;0;100
0;78;"liyla";78;0;100
0;38;"liylah";38;0;100
0;44;"liyu";44;0;100
0;8941;"liz";8941;0;100
14;16032;"liza";16046;0.0872491586688271;99.9127508413312
0;48;"lizabella";48;0;100
0;10;"lizabelle";10;0;100
0;5498;"lizabeth";5498;0;100
0;12;"lizah";12;0;100
0;11;"lizaida";11;0;100
0;32;"lizamarie";32;0;100
0;502;"lizandra";502;0;100
749;0;"lizandro";749;100;0
0;85;"lizania";85;0;100
0;103;"lizann";103;0;100
0;404;"lizanne";404;0;100
10;0;"lizardo";10;100;0
0;29;"lizbeht";29;0;100
0;5;"lizbella";5;0;100
0;1195;"lizbet";1195;0;100
31;23918;"lizbeth";23949;0.129441730343647;99.8705582696564
0;109;"lizbett";109;0;100
0;39;"lizbette";39;0;100
0;24;"lizbhet";24;0;100
0;5;"lize";5;0;100
0;5;"lizeht";5;0;100
0;13;"lizel";13;0;100
0;51;"lizelle";51;0;100
0;2464;"lizet";2464;0;100
0;48;"lizete";48;0;100
9;8106;"lizeth";8115;0.11090573012939;99.8890942698706
0;5;"lizethe";5;0;100
0;1168;"lizett";1168;0;100
0;5;"lizetta";5;0;100
5;11734;"lizette";11739;0.0425930658488798;99.9574069341511
0;5;"lizhet";5;0;100
0;15;"lizie";15;0;100
0;37;"lizmar";37;0;100
0;31;"lizmari";31;0;100
0;454;"lizmarie";454;0;100
0;169;"lizmary";169;0;100
0;5;"lizneidy";5;0;100
0;6;"lizsandra";6;0;100
0;62;"lizvet";62;0;100
0;37;"lizveth";37;0;100
0;70;"lizvette";70;0;100
0;13;"lizy";13;0;100
0;6;"lizz";6;0;100
0;55;"lizza";55;0;100
0;10;"lizzbeth";10;0;100
0;618;"lizzet";618;0;100
0;103;"lizzete";103;0;100
0;540;"lizzeth";540;0;100
0;221;"lizzett";221;0;100
0;1698;"lizzette";1698;0;100
0;7;"lizzi";7;0;100
91;28117;"lizzie";28208;0.322603516732842;99.6773964832672
0;10;"lizzieann";10;0;100
0;582;"lizzy";582;0;100
168;0;"lj";168;100;0
0;10;"ljiljana";10;0;100
0;32;"lladira";32;0;100
0;6;"llamile";6;0;100
0;72;"llana";72;0;100
7;0;"llandel";7;100;0
0;6;"llaneli";6;0;100
0;5;"llanet";5;0;100
0;15;"llareli";15;0;100
0;5;"llarely";5;0;100
0;47;"llasmin";47;0;100
0;5;"llayla";5;0;100
0;5;"llecenia";5;0;100
0;12;"llenifer";12;0;100
0;202;"llesenia";202;0;100
0;14;"llesica";14;0;100
3159;291;"llewellyn";3450;91.5652173913043;8.43478260869565
82;0;"llewelyn";82;100;0
115;0;"llewyn";115;100;0
670;0;"lleyton";670;100;0
0;6;"llia";6;0;100
341;0;"lliam";341;100;0
0;6;"llinda";6;0;100
0;5;"lloana";5;0;100
0;27;"llona";27;0;100
5;0;"llovani";5;100;0
7;0;"lloyal";7;100;0
156309;999;"lloyd";157308;99.3649401174765;0.635059882523457
149;0;"lloyde";149;100;0
0;11;"lloydene";11;0;100
0;5;"lloydine";5;0;100
5;0;"lloyed";5;100;0
0;6;"llubia";6;0;100
0;26;"lluliana";26;0;100
0;13;"llulisa";13;0;100
0;2969;"lluvia";2969;0;100
0;6;"lluviana";6;0;100
0;5;"lluvy";5;0;100
10;0;"llyod";10;100;0
33;26;"lo";59;55.9322033898305;44.0677966101695
0;750;"loa";750;0;100
10;0;"loagan";10;100;0
5;0;"loagen";5;100;0
0;6;"loah";6;0;100
12;0;"loai";12;100;0
27;0;"loal";27;100;0
0;6;"loammi";6;0;100
0;426;"loan";426;0;100
0;49;"loana";49;0;100
0;338;"loann";338;0;100
0;23;"loanna";23;0;100
0;130;"loanne";130;0;100
0;49;"loany";49;0;100
0;5;"loarine";5;0;100
34;0;"loay";34;100;0
0;11;"loberta";11;0;100
11;0;"lobsang";11;100;0
274;0;"loc";274;100;0
11;0;"locadio";11;100;0
35;0;"loch";35;100;0
17;0;"lochlain";17;100;0
11;0;"lochlainn";11;100;0
1794;36;"lochlan";1830;98.0327868852459;1.9672131147541
170;0;"lochlann";170;100;0
11;0;"lochlen";11;100;0
66;0;"lochlin";66;100;0
26;149;"lochlyn";175;14.8571428571429;85.1428571428571
0;26;"lochlynn";26;0;100
0;16;"locie";16;0;100
16;0;"lock";16;100;0
530;0;"locke";530;100;0
0;352;"lockie";352;0;100
63;0;"locklan";63;100;0
18;0;"locklin";18;100;0
10;196;"locklyn";206;4.85436893203883;95.1456310679612
0;33;"locklynn";33;0;100
5;0;"locksley";5;100;0
27;0;"lockwood";27;100;0
9;0;"locryn";9;100;0
0;130;"loda";130;0;100
7;6;"loddie";13;53.8461538461538;46.1538461538462
0;15;"lodean";15;0;100
0;22;"lodell";22;0;100
0;479;"lodema";479;0;100
92;0;"loden";92;100;0
0;34;"lodena";34;0;100
0;7;"lodia";7;0;100
0;140;"lodie";140;0;100
0;5;"lodine";5;0;100
10;0;"lodis";10;100;0
0;7;"loeda";7;0;100
12;0;"loegan";12;100;0
278;5;"loel";283;98.2332155477032;1.76678445229682
0;144;"loella";144;0;100
0;23;"loena";23;0;100
0;11;"loene";11;0;100
0;277;"loeta";277;0;100
0;429;"loetta";429;0;100
0;23;"loette";23;0;100
0;30;"loeva";30;0;100
0;17;"loey";17;0;100
5;0;"loften";5;100;0
558;0;"lofton";558;100;0
5;7;"logahn";12;41.6666666666667;58.3333333333333
305988;23317;"logan";329305;92.9193301043106;7.08066989568941
5;0;"loganjames";5;100;0
22;453;"logann";475;4.63157894736842;95.3684210526316
0;39;"loganne";39;0;100
1189;158;"logen";1347;88.2702301410542;11.7297698589458
0;5;"logene";5;0;100
7;0;"loggan";7;100;0
435;413;"loghan";848;51.2971698113208;48.7028301886792
17;0;"logic";17;100;0
126;11;"login";137;91.970802919708;8.02919708029197
81;0;"logon";81;100;0
378;0;"logun";378;100;0
5;0;"logunn";5;100;0
166;211;"logyn";377;44.0318302387268;55.9681697612732
0;28;"logynn";28;0;100
5;0;"lohan";5;100;0
40;48;"lohgan";88;45.4545454545455;54.5454545454545
44;0;"lohith";44;100;0
5;0;"lohn";5;100;0
0;12;"lohoma";12;0;100
53;12;"loi";65;81.5384615384615;18.4615384615385
284;0;"loic";284;100;0
6;52;"loice";58;10.3448275862069;89.6551724137931
39;0;"loid";39;100;0
0;667;"loida";667;0;100
0;165;"loie";165;0;100
0;10;"loir";10;0;100
2603;327640;"lois";330243;0.78820747146798;99.211792528532
0;184;"loisann";184;0;100
0;7;"loisanne";7;0;100
37;812;"loise";849;4.35806831566549;95.6419316843345
0;13;"loisjean";13;0;100
0;11;"loismae";11;0;100
0;34;"loisteen";34;0;100
0;19;"loistene";19;0;100
0;85;"loistine";85;0;100
0;22;"lojain";22;0;100
0;111;"lokelani";111;0;100
14;0;"loken";14;100;0
22;0;"lokesh";22;100;0
918;32;"loki";950;96.6315789473684;3.36842105263158
260;79431;"lola";79691;0.326260179945038;99.673739820055
0;5;"lolabelle";5;0;100
0;153;"lolah";153;0;100
0;79;"lolamae";79;0;100
5;0;"lolan";5;100;0
0;6;"lolana";6;0;100
0;30;"lolanda";30;0;100
0;6;"lolani";6;0;100
0;13;"lolar";13;0;100
0;15;"loleatha";15;0;100
0;5;"loleatta";5;0;100
0;26;"lolene";26;0;100
0;1021;"loleta";1021;0;100
0;240;"loletha";240;0;100
0;5;"lolethia";5;0;100
0;23;"loletia";23;0;100
0;256;"loletta";256;0;100
0;25;"lolisa";25;0;100
0;8517;"lolita";8517;0;100
0;96;"lolitha";96;0;100
0;35;"lolitta";35;0;100
0;35;"lolla";35;0;100
0;820;"lollie";820;0;100
0;308;"lolly";308;0;100
5;6;"lolo";11;45.4545454545455;54.5454545454545
5;2129;"loma";2134;0.234301780693533;99.7656982193065
283;0;"loman";283;100;0
5;0;"lomant";5;100;0
17;0;"lomar";17;100;0
133;0;"lomax";133;100;0
0;88;"lometa";88;0;100
0;31;"lomie";31;0;100
18;0;"lomont";18;100;0
9002;20;"lon";9022;99.7783196630459;0.221680336954112
17;9651;"lona";9668;0.175837815473728;99.8241621845263
75;0;"lonald";75;100;0
10;0;"lonan";10;100;0
5;0;"lonard";5;100;0
41;0;"lonas";41;100;0
0;1669;"londa";1669;0;100
15;0;"londale";15;100;0
0;135;"londan";135;0;100
640;0;"londell";640;100;0
217;373;"londen";590;36.7796610169491;63.2203389830509
0;5;"londi";5;0;100
0;13;"londie";13;0;100
0;127;"londin";127;0;100
5;0;"londo";5;100;0
8266;32508;"london";40774;20.2727228135577;79.7272771864423
0;18;"londonmarie";18;0;100
0;5;"londonn";5;0;100
0;5;"londonrose";5;0;100
0;5;"londrea";5;0;100
312;14836;"londyn";15148;2.0596778452601;97.9403221547399
0;6;"londynmarie";6;0;100
0;1526;"londynn";1526;0;100
0;14;"londynne";14;0;100
5;0;"lone";5;100;0
6;0;"lonel";6;100;0
763;23;"lonell";786;97.0737913486005;2.92620865139949
11;0;"lones";11;100;0
0;5;"lonesha";5;0;100
0;118;"loneta";118;0;100
0;304;"lonetta";304;0;100
0;198;"lonette";198;0;100
483;244;"loney";727;66.4374140302613;33.5625859697386
1826;0;"long";1826;100;0
14;0;"longin";14;100;0
0;25;"longina";25;0;100
74;0;"longino";74;100;0
108;3627;"loni";3735;2.89156626506024;97.1084337349398
0;224;"lonia";224;0;100
917;1304;"lonie";2221;41.2877082395317;58.7122917604683
0;5;"lonika";5;0;100
16;0;"lonis";16;100;0
0;61;"lonisha";61;0;100
0;464;"lonita";464;0;100
392;0;"lonn";392;100;0
0;3297;"lonna";3297;0;100
39;0;"lonne";39;100;0
70;0;"lonnel";70;100;0
1091;0;"lonnell";1091;100;0
0;5;"lonnesha";5;0;100
0;61;"lonnetta";61;0;100
0;204;"lonnette";204;0;100
286;0;"lonney";286;100;0
19;381;"lonni";400;4.75;95.25
0;5;"lonnia";5;0;100
91563;6516;"lonnie";98079;93.3563759826262;6.64362401737375
6;0;"lonniel";6;100;0
0;5;"lonniesha";5;0;100
0;30;"lonnisha";30;0;100
0;5;"lonnita";5;0;100
6304;60;"lonny";6364;99.0571967316153;0.942803268384664
6;0;"lontrell";6;100;0
0;65;"lonya";65;0;100
0;5;"lonyea";5;0;100
360;0;"lonza";360;100;0
10;0;"lonzel";10;100;0
466;0;"lonzell";466;100;0
0;52;"lonzetta";52;0;100
776;0;"lonzie";776;100;0
3528;0;"lonzo";3528;100;0
81;0;"lonzy";81;100;0
125;0;"loomis";125;100;0
6;0;"looney";6;100;0
134;0;"lopaka";134;100;0
90;0;"lopez";90;100;0
38;0;"lor";38;100;0
220;49293;"lora";49513;0.444327752307475;99.5556722476925
0;80;"lorae";80;0;100
0;92;"lorah";92;0;100
213;1024;"lorain";1237;17.2190784155214;82.7809215844786
0;140;"loraina";140;0;100
340;16789;"loraine";17129;1.98493782474167;98.0150621752583
0;40;"lorainne";40;0;100
54;100;"loral";154;35.0649350649351;64.9350649350649
0;253;"loralai";253;0;100
0;10;"loralea";10;0;100
0;1733;"loralee";1733;0;100
0;1216;"loralei";1216;0;100
0;332;"lorali";332;0;100
0;760;"loralie";760;0;100
0;186;"loralye";186;0;100
0;357;"loralyn";357;0;100
0;26;"loralynn";26;0;100
0;5;"loramae";5;0;100
3620;811;"loran";4431;81.6971338298353;18.3028661701647
0;67;"lorana";67;0;100
174;0;"lorance";174;100;0
0;97;"loranda";97;0;100
5;423;"lorane";428;1.16822429906542;98.8317757009346
0;104;"lorann";104;0;100
0;12;"loranna";12;0;100
0;16;"loranne";16;0;100
29;0;"loranza";29;100;0
133;0;"loranzo";133;100;0
226;0;"loras";226;100;0
0;86;"loray";86;0;100
0;12;"lorayn";12;0;100
0;5;"lorayna";5;0;100
0;1147;"lorayne";1147;0;100
151;0;"lorcan";151;100;0
515;0;"lord";515;100;0
0;5;"lorde";5;0;100
0;5;"lordina";5;0;100
0;1082;"lore";1082;0;100
0;175;"lorea";175;0;100
0;1566;"loreal";1566;0;100
0;1363;"lorean";1363;0;100
0;10;"loreana";10;0;100
0;29;"loreane";29;0;100
0;60;"loreatha";60;0;100
0;100;"lorece";100;0;100
0;300;"loreda";300;0;100
0;268;"loredana";268;0;100
5;3448;"loree";3453;0.144801621778164;99.8551983782218
0;3542;"loreen";3542;0;100
0;118;"loreena";118;0;100
0;5;"loreene";5;0;100
0;5;"loreeta";5;0;100
0;11;"loreina";11;0;100
0;21;"loreine";21;0;100
0;15;"loreita";15;0;100
5;283;"lorel";288;1.73611111111111;98.2638888888889
0;4391;"lorelai";4391;0;100
0;6;"lorelay";6;0;100
0;160;"lorelee";160;0;100
0;12117;"lorelei";12117;0;100
0;82;"loreley";82;0;100
0;531;"loreli";531;0;100
0;367;"lorelie";367;0;100
42;305;"lorell";347;12.1037463976945;87.8962536023055
0;345;"lorella";345;0;100
0;912;"lorelle";912;0;100
0;166;"lorely";166;0;100
0;11;"lorelyn";11;0;100
45456;12084;"loren";57540;78.9989572471324;21.0010427528676
219;41753;"lorena";41972;0.521776422376823;99.4782235776232
642;6;"lorence";648;99.0740740740741;0.925925925925926
0;15;"lorencita";15;0;100
0;829;"lorenda";829;0;100
113;38685;"lorene";38798;0.291252126398268;99.7087478736017
0;266;"lorenia";266;0;100
0;5;"lorenn";5;0;100
0;125;"lorenna";125;0;100
0;5;"lorensa";5;0;100
402;0;"lorenso";402;100;0
23;0;"lorentz";23;100;0
1632;0;"lorenz";1632;100;0
3633;2944;"lorenza";6577;55.2379504333283;44.7620495666717
10;0;"lorenze";10;100;0
11;0;"lorenzia";11;100;0
61191;307;"lorenzo";61498;99.5007967738788;0.499203226121175
0;39;"loresa";39;0;100
0;23;"lorese";23;0;100
0;18;"loressa";18;0;100
0;1220;"loreta";1220;0;100
0;1792;"loretha";1792;0;100
448;16;"loreto";464;96.551724137931;3.44827586206897
0;15;"lorett";15;0;100
501;170198;"loretta";170699;0.293499083181507;99.7065009168185
0;1092;"lorette";1092;0;100
5;700;"loretto";705;0.709219858156028;99.290780141844
0;265;"lorey";265;0;100
0;11;"loreyna";11;0;100
0;11;"lorez";11;0;100
853;340678;"lori";341531;0.249757708670662;99.7502422913293
0;1461;"loria";1461;0;100
0;54;"loriah";54;0;100
0;233;"lorian";233;0;100
0;360;"loriana";360;0;100
0;32;"loriane";32;0;100
0;3685;"loriann";3685;0;100
0;356;"lorianna";356;0;100
0;1620;"lorianne";1620;0;100
0;130;"loribeth";130;0;100
0;344;"lorice";344;0;100
0;5;"lorida";5;0;100
104;21865;"lorie";21969;0.473394328371797;99.5266056716282
0;73;"lorieann";73;0;100
0;11;"loriece";11;0;100
0;211;"loriel";211;0;100
0;5;"loriell";5;0;100
0;299;"lorielle";299;0;100
0;853;"lorien";853;0;100
0;5;"loriena";5;0;100
0;124;"loriene";124;0;100
0;16;"lorii";16;0;100
0;61;"lorijean";61;0;100
0;24;"lorijo";24;0;100
61;0;"lorik";61;100;0
0;12;"lorilai";12;0;100
0;10;"lorilea";10;0;100
0;853;"lorilee";853;0;100
0;224;"lorilei";224;0;100
0;10;"lorilie";10;0;100
0;296;"lorilyn";296;0;100
0;130;"lorilynn";130;0;100
0;28;"lorimar";28;0;100
66;0;"lorimer";66;100;0
4642;2586;"lorin";7228;64.2224681793027;35.7775318206973
0;1743;"lorina";1743;0;100
0;4635;"lorinda";4635;0;100
12;8633;"lorine";8645;0.138808559861191;99.8611914401388
1254;22;"loring";1276;98.2758620689655;1.72413793103448
0;10;"lorinne";10;0;100
10;0;"lorinza";10;100;0
35;0;"lorinzo";35;100;0
567;1694;"loris";2261;25.077399380805;74.9226006191951
0;402;"lorisa";402;0;100
0;10;"lorise";10;0;100
0;10;"lorisha";10;0;100
0;1226;"lorissa";1226;0;100
0;1748;"lorita";1748;0;100
0;23;"loritta";23;0;100
0;6;"loriyah";6;0;100
0;70;"lorma";70;0;100
7;0;"lorman";7;100;0
805;0;"lorn";805;100;0
22;27955;"lorna";27977;0.07863602244701;99.921363977553
0;5;"lornalee";5;0;100
4235;50;"lorne";4285;98.8331388564761;1.16686114352392
6;0;"lornell";6;100;0
72;0;"loron";72;100;0
0;10;"loronda";10;0;100
0;436;"lorra";436;0;100
0;10;"lorrae";10;0;100
10;636;"lorrain";646;1.54798761609907;98.4520123839009
0;329;"lorraina";329;0;100
935;207872;"lorraine";208807;0.447781923019822;99.5522180769802
0;16;"lorrainne";16;0;100
0;124;"lorrane";124;0;100
0;827;"lorrayne";827;0;100
0;421;"lorre";421;0;100
0;64;"lorree";64;0;100
0;15;"lorreen";15;0;100
0;5;"lorrel";5;0;100
0;7;"lorrell";7;0;100
368;404;"lorren";772;47.6683937823834;52.3316062176166
0;90;"lorrena";90;0;100
0;5;"lorrenda";5;0;100
0;556;"lorrene";556;0;100
5;0;"lorrenzo";5;100;0
0;5;"lorreta";5;0;100
0;2703;"lorretta";2703;0;100
0;8022;"lorri";8022;0;100
0;16;"lorria";16;0;100
0;5;"lorrian";5;0;100
0;607;"lorriane";607;0;100
0;63;"lorriann";63;0;100
0;32;"lorrianne";32;0;100
88;17270;"lorrie";17358;0.506970849176172;99.4930291508238
0;27;"lorrieann";27;0;100
214;244;"lorrin";458;46.7248908296943;53.2751091703057
0;55;"lorrina";55;0;100
0;105;"lorrinda";105;0;100
0;938;"lorrine";938;0;100
85;0;"lorris";85;100;0
0;5;"lorrisa";5;0;100
0;16;"lorrita";16;0;100
221;1024;"lorry";1245;17.7510040160643;82.2489959839357
0;51;"lorryn";51;0;100
267;2227;"lory";2494;10.7056936647955;89.2943063352045
0;5;"loryanna";5;0;100
0;1513;"loryn";1513;0;100
0;116;"lorynn";116;0;100
0;5;"loryssa";5;0;100
24;1110;"lossie";1134;2.11640211640212;97.8835978835979
52;0;"lot";52;100;0
0;465;"lota";465;0;100
6;5;"lotanna";11;54.5454545454545;45.4545454545455
0;15;"lotasha";15;0;100
0;5;"lotaya";5;0;100
0;5;"lotella";5;0;100
0;5;"lotha";5;0;100
68;0;"lothar";68;100;0
6;0;"lothario";6;100;0
5;0;"lothrop";5;100;0
5;18;"lotis";23;21.7391304347826;78.2608695652174
0;15;"lotonya";15;0;100
0;6;"lotosha";6;0;100
0;466;"lotoya";466;0;100
95;0;"lott";95;100;0
0;240;"lotta";240;0;100
0;36;"lotte";36;0;100
0;12;"lotti";12;0;100
122;36633;"lottie";36755;0.331927628894028;99.668072371106
0;5;"lotty";5;0;100
0;23;"lottye";23;0;100
67;1722;"lotus";1789;3.74510899944103;96.254891000559
3334;30988;"lou";34322;9.71388613717149;90.2861138628285
0;5;"louaine";5;0;100
0;76;"louan";76;0;100
0;87;"louana";87;0;100
0;5139;"louann";5139;0;100
0;1279;"louanna";1279;0;100
0;1762;"louanne";1762;0;100
5;0;"louard";5;100;0
53;0;"louay";53;100;0
0;5;"loubelle";5;0;100
0;50;"louberta";50;0;100
0;28;"loubertha";28;0;100
23;0;"loucas";23;100;0
0;99;"loucile";99;0;100
0;266;"loucille";266;0;100
0;236;"loucinda";236;0;100
0;11;"loudean";11;0;100
0;33;"loudell";33;0;100
0;5;"loudella";5;0;100
459;0;"louden";459;100;0
0;6;"loudes";6;0;100
97;0;"loudon";97;100;0
0;22;"loueen";22;0;100
0;10;"louell";10;0;100
0;11871;"louella";11871;0;100
0;12;"louelle";12;0;100
0;478;"louellen";478;0;100
0;8;"louene";8;0;100
0;18;"louese";18;0;100
0;1403;"louetta";1403;0;100
0;20;"louette";20;0;100
0;20;"loueva";20;0;100
11;30;"lougene";41;26.8292682926829;73.1707317073171
0;62;"lougenia";62;0;100
65;0;"loui";65;100;0
11;0;"louia";11;100;0
0;46;"louida";46;0;100
26910;1727;"louie";28637;93.9693403638649;6.03065963613507
0;11;"louies";11;0;100
0;16;"louiese";16;0;100
0;5;"louina";5;0;100
0;65;"louine";65;0;100
376935;2655;"louis";379590;99.3005611317474;0.699438868252588
5;15765;"louisa";15770;0.0317057704502219;99.9682942295498
2052;307555;"louise";309607;0.662775712435442;99.3372242875646
0;5;"louiseann";5;0;100
0;5;"louisette";5;0;100
0;5;"louisia";5;0;100
0;242;"louisiana";242;0;100
0;71;"louiza";71;0;100
0;11;"loujean";11;0;100
5;0;"louka";5;100;0
356;0;"loukas";356;100;0
0;69;"loukisha";69;0;100
0;30;"loukya";30;0;100
0;384;"loula";384;0;100
0;5;"loulou";5;0;100
0;47;"louna";47;0;100
0;115;"lounell";115;0;100
0;91;"lounette";91;0;100
0;552;"loura";552;0;100
0;34;"louraine";34;0;100
0;6;"lourd";6;0;100
69;14123;"lourdes";14192;0.486189402480271;99.5138105975197
0;93;"lourdez";93;0;100
0;5;"lourdine";5;0;100
0;10;"louree";10;0;100
0;58;"louren";58;0;100
0;43;"lourena";43;0;100
5;0;"lourence";5;100;0
0;250;"lourene";250;0;100
0;6;"louretha";6;0;100
0;250;"louretta";250;0;100
0;59;"louri";59;0;100
0;17;"louria";17;0;100
0;575;"lourie";575;0;100
0;5;"lourinda";5;0;100
0;320;"lourine";320;0;100
0;5;"lourita";5;0;100
0;12;"lousia";12;0;100
0;142;"lousie";142;0;100
0;5;"loutricia";5;0;100
0;32;"louva";32;0;100
0;5;"louvada";5;0;100
0;31;"louvella";31;0;100
0;42;"louvena";42;0;100
0;7;"louvene";7;0;100
0;3323;"louvenia";3323;0;100
0;268;"louvina";268;0;100
0;5;"louvine";5;0;100
0;265;"louvinia";265;0;100
0;11;"louvonia";11;0;100
0;21;"louwana";21;0;100
0;16;"louwanna";16;0;100
0;404;"lova";404;0;100
0;61;"lovada";61;0;100
5;0;"loval";5;100;0
0;10;"lovanda";10;0;100
0;8;"lovann";8;0;100
722;2433;"love";3155;22.8843106180666;77.1156893819334
0;12;"lovea";12;0;100
0;109;"loveah";109;0;100
0;6;"loveaya";6;0;100
0;174;"loveda";174;0;100
96;7;"lovel";103;93.2038834951456;6.79611650485437
142;0;"lovelace";142;100;0
0;63;"lovelee";63;0;100
0;43;"loveleen";43;0;100
50;0;"loveless";50;100;0
0;5;"lovelia";5;0;100
3216;620;"lovell";3836;83.837330552659;16.162669447341
0;1494;"lovella";1494;0;100
75;115;"lovelle";190;39.4736842105263;60.5263157894737
12;1625;"lovely";1637;0.733048259010385;99.2669517409896
0;74;"lovelyn";74;0;100
0;41;"lovelynn";41;0;100
0;409;"lovena";409;0;100
0;62;"lovene";62;0;100
0;651;"lovenia";651;0;100
0;22;"lovera";22;0;100
11;10;"lovern";21;52.3809523809524;47.6190476190476
10;5;"loverne";15;66.6666666666667;33.3333333333333
0;11;"lovesta";11;0;100
0;295;"loveta";295;0;100
0;5;"loveth";5;0;100
313;0;"lovett";313;100;0
0;1003;"lovetta";1003;0;100
10;419;"lovette";429;2.33100233100233;97.6689976689977
0;701;"lovey";701;0;100
0;5;"loveya";5;0;100
0;10;"lovi";10;0;100
0;28;"lovia";28;0;100
11;0;"lovic";11;100;0
0;16;"lovice";16;0;100
17;0;"lovick";17;100;0
612;5123;"lovie";5735;10.6713164777681;89.3286835222319
0;12;"lovilla";12;0;100
0;1860;"lovina";1860;0;100
0;5;"lovine";5;0;100
0;60;"lovinia";60;0;100
68;26;"lovis";94;72.3404255319149;27.6595744680851
0;27;"lovisa";27;0;100
0;12;"lovita";12;0;100
0;5;"lovonda";5;0;100
0;10;"lovonia";10;0;100
0;6;"lovonne";6;0;100
5;0;"low";5;100;0
0;120;"lowana";120;0;100
0;457;"lowanda";457;0;100
0;41;"lowanna";41;0;100
0;5;"lowayne";5;0;100
40;5;"lowe";45;88.8888888888889;11.1111111111111
40;0;"lowel";40;100;0
40678;347;"lowell";41025;99.1541742839732;0.845825716026813
0;65;"lowella";65;0;100
253;23;"lowen";276;91.6666666666667;8.33333333333333
0;6;"lowene";6;0;100
379;0;"lowery";379;100;0
0;5;"loweta";5;0;100
56;0;"lowis";56;100;0
21;0;"lowman";21;100;0
10;0;"lowrey";10;100;0
5;0;"lowrie";5;100;0
0;5;"lowrine";5;0;100
465;15;"lowry";480;96.875;3.125
0;8;"lowyn";8;0;100
0;20;"loxi";20;0;100
0;46;"loxie";46;0;100
16;90;"loxley";106;15.0943396226415;84.9056603773585
3979;857;"loy";4836;82.2787427626137;17.7212572373863
0;5;"loya";5;0;100
3840;186;"loyal";4026;95.3800298062593;4.61997019374069
5;0;"loyall";5;100;0
0;10;"loyaltee";10;0;100
0;34;"loyalti";34;0;100
122;507;"loyalty";629;19.39586645469;80.60413354531
775;3503;"loyce";4278;18.1159420289855;81.8840579710145
0;5;"loycie";5;0;100
21713;86;"loyd";21799;99.605486490206;0.394513509794027
0;152;"loyda";152;0;100
575;0;"loyde";575;100;0
0;29;"loydene";29;0;100
448;173;"loye";621;72.1417069243156;27.8582930756844
204;0;"loyed";204;100;0
0;11;"loyette";11;0;100
55;0;"loyle";55;100;0
0;594;"loyola";594;0;100
193;139;"loys";332;58.1325301204819;41.8674698795181
0;8;"loyse";8;0;100
0;51;"loza";51;0;100
5;0;"lozell";5;100;0
0;11;"lozelle";11;0;100
0;5;"lozen";5;0;100
5;0;"lrey";5;100;0
0;515;"ltanya";515;0;100
0;34;"ltonya";34;0;100
0;10;"ltoya";10;0;100
18;3933;"lu";3951;0.455580865603645;99.5444191343963
0;257;"lua";257;0;100
0;16;"luada";16;0;100
15;0;"luai";15;100;0
18;0;"lual";18;100;0
453;515;"luan";968;46.797520661157;53.202479338843
0;3991;"luana";3991;0;100
0;25;"luanda";25;0;100
0;241;"luane";241;0;100
6;15412;"luann";15418;0.0389155532494487;99.9610844467505
0;1737;"luanna";1737;0;100
0;8566;"luanne";8566;0;100
10;0;"luar";10;100;0
0;61;"luara";61;0;100
101;0;"luay";101;100;0
0;545;"luba";545;0;100
5;0;"lubby";5;100;0
0;5;"lubell";5;0;100
0;5;"luberdie";5;0;100
10;0;"lubert";10;100;0
0;937;"luberta";937;0;100
0;688;"lubertha";688;0;100
17;5;"lubie";22;77.2727272727273;22.7272727272727
0;5;"lubina";5;0;100
0;328;"lubna";328;0;100
0;17;"lubov";17;0;100
286;52;"luby";338;84.6153846153846;15.3846153846154
3135;0;"luc";3135;100;0
22191;903;"luca";23094;96.0898934788257;3.91010652117433
0;6;"lucabella";6;0;100
176;0;"lucah";176;100;0
5;0;"lucais";5;100;0
359;0;"lucan";359;100;0
5;0;"lucanus";5;100;0
226724;425;"lucas";227149;99.8128981417484;0.187101858251632
2779;433;"lucca";3212;86.519302615193;13.480697384807
146;0;"luccas";146;100;0
6;5;"lucchese";11;54.5454545454545;45.4545454545455
0;53;"luccia";53;0;100
0;129;"lucciana";129;0;100
253;0;"lucciano";253;100;0
0;11;"luce";11;0;100
0;10;"lucea";10;0;100
0;221;"luceal";221;0;100
0;19;"lucecita";19;0;100
0;65;"lucee";65;0;100
0;142;"luceil";142;0;100
0;5;"luceile";5;0;100
0;36;"luceille";36;0;100
0;11;"lucele";11;0;100
0;16;"lucelenia";16;0;100
0;16;"luceli";16;0;100
0;120;"lucelia";120;0;100
0;5;"lucell";5;0;100
0;61;"lucella";61;0;100
0;34;"lucelle";34;0;100
0;78;"lucely";78;0;100
0;13;"lucena";13;0;100
0;41;"lucenda";41;0;100
0;113;"lucendia";113;0;100
0;13;"lucene";13;0;100
0;5;"lucenia";5;0;100
0;379;"lucerito";379;0;100
191;6514;"lucero";6705;2.84862043251305;97.151379567487
0;5;"lucertia";5;0;100
0;11;"lucesita";11;0;100
0;496;"lucetta";496;0;100
0;294;"lucette";294;0;100
0;35;"lucey";35;0;100
0;6;"lucha";6;0;100
0;35;"luchana";35;0;100
0;5;"luchanna";5;0;100
0;5;"luchia";5;0;100
0;5;"luchiana";5;0;100
84;0;"luchiano";84;100;0
0;13;"luchina";13;0;100
5;0;"luchious";5;100;0
0;2246;"luci";2246;0;100
91;39465;"lucia";39556;0.230053594903428;99.7699464050966
9464;32;"lucian";9496;99.6630160067397;0.33698399326032
0;8531;"luciana";8531;0;100
0;59;"luciann";59;0;100
0;1142;"lucianna";1142;0;100
0;244;"lucianne";244;0;100
10537;0;"luciano";10537;100;0
17;0;"lucias";17;100;0
0;5819;"lucie";5819;0;100
0;581;"luciel";581;0;100
0;5;"luciele";5;0;100
0;17;"luciell";17;0;100
0;34;"luciella";34;0;100
0;225;"lucielle";225;0;100
7911;5;"lucien";7916;99.9368367862557;0.0631632137443153
0;5;"lucienna";5;0;100
0;1458;"lucienne";1458;0;100
91;0;"lucifer";91;100;0
0;10;"lucija";10;0;100
0;47;"lucil";47;0;100
0;2303;"lucila";2303;0;100
96;31493;"lucile";31589;0.303903257463041;99.696096742537
0;87;"lucilia";87;0;100
0;235;"lucill";235;0;100
0;837;"lucilla";837;0;100
750;215866;"lucille";216616;0.346234811832921;99.6537651881671
0;45;"lucillia";45;0;100
0;260;"lucillie";260;0;100
0;1246;"lucina";1246;0;100
11;35343;"lucinda";35354;0.0311138767890479;99.968886123211
0;152;"lucindia";152;0;100
0;202;"lucindy";202;0;100
0;270;"lucine";270;0;100
0;5;"lucinia";5;0;100
36;0;"lucino";36;100;0
5290;0;"lucio";5290;100;0
113;0;"lucion";113;100;0
4262;5;"lucious";4267;99.8828216545582;0.117178345441762
0;188;"lucita";188;0;100
8158;0;"lucius";8158;100;0
0;5;"lucja";5;0;100
5;0;"luck";5;100;0
39;0;"luckas";39;100;0
15;0;"luckey";15;100;0
27;15;"luckie";42;64.2857142857143;35.7142857142857
3073;439;"lucky";3512;87.5;12.5
0;996;"lucrecia";996;0;100
0;73;"lucresha";73;0;100
0;6;"lucreshia";6;0;100
0;56;"lucresia";56;0;100
0;10;"lucreta";10;0;100
0;9741;"lucretia";9741;0;100
0;299;"lucrezia";299;0;100
0;11;"lucricia";11;0;100
0;15;"lucritia";15;0;100
15;0;"lucuis";15;100;0
1646;0;"lucus";1646;100;0
574;175773;"lucy";176347;0.325494621399854;99.6745053786001
0;10;"lucya";10;0;100
0;35;"lucyana";35;0;100
0;161;"lucyann";161;0;100
0;44;"lucyanna";44;0;100
0;24;"lucye";24;0;100
0;240;"lucyle";240;0;100
0;219;"lucylle";219;0;100
0;20;"lucymae";20;0;100
0;5;"lucymarie";5;0;100
0;14;"lucyna";14;0;100
0;56;"lucynda";56;0;100
0;5;"lucyrose";5;0;100
0;220;"luda";220;0;100
23;196;"luddie";219;10.5022831050228;89.4977168949772
5;0;"luddy";5;100;0
0;154;"ludean";154;0;100
0;247;"ludell";247;0;100
0;118;"ludella";118;0;100
0;6;"ludelle";6;0;100
0;79;"ludene";79;0;100
179;0;"ludger";179;100;0
0;80;"ludia";80;0;100
265;2134;"ludie";2399;11.0462692788662;88.9537307211338
0;10;"ludine";10;0;100
0;445;"ludivina";445;0;100
21;0;"ludlow";21;100;0
0;221;"ludmila";221;0;100
0;242;"ludmilla";242;0;100
0;31;"ludora";31;0;100
27;0;"ludovic";27;100;0
0;5;"ludovica";5;0;100
16;0;"ludvig";16;100;0
11;0;"ludvik";11;100;0
0;5;"ludvina";5;0;100
5;0;"ludwell";5;100;0
2443;0;"ludwig";2443;100;0
23;0;"ludwik";23;100;0
0;101;"ludwika";101;0;100
158;0;"ludwin";158;100;0
0;20;"ludwina";20;0;100
17;0;"ludwing";17;100;0
21;207;"ludy";228;9.21052631578947;90.7894736842105
645;5854;"lue";6499;9.92460378519772;90.0753962148023
0;6;"lueann";6;0;100
0;5;"luease";5;0;100
0;5;"lueberta";5;0;100
0;16;"luebertha";16;0;100
0;35;"luecile";35;0;100
0;11;"luecille";11;0;100
0;10;"luecinda";10;0;100
0;5;"luedella";5;0;100
0;5;"luedora";5;0;100
0;17;"lueella";17;0;100
5;10;"luegene";15;33.3333333333333;66.6666666666667
0;12;"luegenia";12;0;100
5;0;"luel";5;100;0
0;16;"luell";16;0;100
16;26429;"luella";26445;0.0605029306107015;99.9394970693893
0;32;"luellar";32;0;100
0;11;"luelle";11;0;100
5;690;"luellen";695;0.719424460431655;99.2805755395683
0;10;"lueller";10;0;100
0;6;"luena";6;0;100
0;5;"luereatha";5;0;100
0;11;"luerene";11;0;100
0;5;"lueretha";5;0;100
0;5;"lueseal";5;0;100
0;11;"luethel";11;0;100
0;5;"luetricia";5;0;100
0;1881;"luetta";1881;0;100
0;5;"lueva";5;0;100
0;557;"luevenia";557;0;100
0;5;"luevertha";5;0;100
0;39;"luevina";39;0;100
0;13;"luevinia";13;0;100
5;0;"luffy";5;100;0
0;44;"lugarda";44;0;100
0;5;"lugardita";5;0;100
746;665;"lugene";1411;52.8703047484054;47.1296952515946
0;732;"lugenia";732;0;100
0;10;"lugina";10;0;100
5;0;"lugman";5;100;0
97;0;"lui";97;100;0
62;0;"luian";62;100;0
0;10;"luicana";10;0;100
0;5;"luida";5;0;100
145;0;"luie";145;100;0
13;0;"luiggi";13;100;0
3913;0;"luigi";3913;100;0
0;20;"luigina";20;0;100
5;0;"luigino";5;100;0
12;0;"luigy";12;100;0
266450;1510;"luis";267960;99.4364830571727;0.563516942827288
33;11766;"luisa";11799;0.279684719043987;99.720315280956
0;35;"luisafernanda";35;0;100
305;0;"luisalberto";305;100;0
11;0;"luisalejandro";11;100;0
22;0;"luisalfredo";22;100;0
0;540;"luisana";540;0;100
11;0;"luisandres";11;100;0
5;0;"luisandro";5;100;0
1215;0;"luisangel";1215;100;0
0;35;"luisanna";35;0;100
223;0;"luisantonio";223;100;0
5;0;"luisarmando";5;100;0
111;0;"luiscarlos";111;100;0
63;0;"luisdaniel";63;100;0
86;0;"luisdavid";86;100;0
7;0;"luisdiego";7;100;0
5;571;"luise";576;0.868055555555556;99.1319444444444
45;0;"luiseduardo";45;100;0
309;0;"luisenrique";309;100;0
63;0;"luisfelipe";63;100;0
284;0;"luisfernando";284;100;0
6;0;"luisgabriel";6;100;0
11;0;"luisgerardo";11;100;0
17;0;"luisgustavo";17;100;0
0;6;"luisiana";6;0;100
0;6;"luisita";6;0;100
15;0;"luisito";15;100;0
5;0;"luisjavier";5;100;0
7;0;"luisjose";7;100;0
107;0;"luismanuel";107;100;0
63;0;"luismario";63;100;0
210;0;"luismiguel";210;100;0
6;0;"luispablo";6;100;0
3114;0;"luiz";3114;100;0
0;666;"luiza";666;0;100
5;0;"lujack";5;100;0
0;246;"lujain";246;0;100
0;55;"lujane";55;0;100
0;53;"lujayn";53;0;100
0;291;"lujean";291;0;100
0;5;"lujuan";5;0;100
0;75;"lujuana";75;0;100
10;0;"luk";10;100;0
5401;331;"luka";5732;94.2254012561061;5.77459874389393
5;0;"lukacs";5;100;0
215;0;"lukah";215;100;0
10;0;"lukan";10;100;0
30038;19;"lukas";30057;99.9367867718002;0.0632132281997538
537;0;"lukasz";537;100;0
5;0;"lukaus";5;100;0
251490;504;"luke";251994;99.7999952379818;0.200004762018143
5;0;"lukeanthony";5;100;0
178;0;"luken";178;100;0
51;0;"lukes";51;100;0
0;21;"lukesha";21;0;100
0;11;"lukeshia";11;0;100
12;0;"lukeus";12;100;0
16;0;"lukian";16;100;0
16;0;"lukin";16;100;0
171;0;"lukis";171;100;0
0;79;"lukisha";79;0;100
35;0;"lukka";35;100;0
16;0;"lukkas";16;100;0
12;0;"lukman";12;100;0
848;0;"lukus";848;100;0
6;0;"lukyan";6;100;0
0;20;"lul";20;0;100
311;65108;"lula";65419;0.475397055901191;99.5246029440988
0;36;"lulabell";36;0;100
0;128;"lulabelle";128;0;100
0;27;"lulah";27;0;100
0;144;"lulamae";144;0;100
0;50;"lulani";50;0;100
0;348;"lular";348;0;100
0;5;"luler";5;0;100
0;5;"luley";5;0;100
0;127;"lulia";127;0;100
0;100;"lulie";100;0;100
0;401;"lulla";401;0;100
0;6262;"lulu";6262;0;100
0;10;"lulubell";10;0;100
0;80;"lulubelle";80;0;100
0;5;"lulwa";5;0;100
0;5;"luly";5;0;100
0;6;"lulya";6;0;100
318;0;"lum";318;100;0
0;107;"luma";107;0;100
142;0;"luman";142;100;0
17;0;"lumas";17;100;0
7;188;"lumen";195;3.58974358974359;96.4102564102564
0;81;"lumi";81;0;100
0;11;"lumin";11;0;100
0;56;"lumina";56;0;100
160;0;"lumir";160;100;0
41;55;"lummie";96;42.7083333333333;57.2916666666667
49;0;"lumumba";49;100;0
0;38;"lun";38;0;100
33;20929;"luna";20962;0.157427726361988;99.842572273638
0;52;"lunabella";52;0;100
0;54;"lunabelle";54;0;100
0;54;"lunah";54;0;100
0;18;"lunamarie";18;0;100
0;11;"lunarae";11;0;100
0;16;"lunda";16;0;100
237;337;"lunden";574;41.2891986062718;58.7108013937282
5;33;"lundin";38;13.1578947368421;86.8421052631579
102;235;"lundon";337;30.2670623145401;69.7329376854599
319;16;"lundy";335;95.2238805970149;4.77611940298508
6;771;"lundyn";777;0.772200772200772;99.2277992277992
0;82;"lundynn";82;0;100
0;87;"lunell";87;0;100
0;6;"lunelle";6;0;100
0;86;"lunetta";86;0;100
0;285;"lunette";285;0;100
7;0;"lung";7;100;0
0;5;"lunie";5;0;100
0;5;"luniva";5;0;100
0;154;"lunna";154;0;100
16;11;"lunnie";27;59.2592592592593;40.7407407407407
34;0;"lunsford";34;100;0
0;6;"luola";6;0;100
5;0;"luong";5;100;0
5990;18478;"lupe";24468;24.4809547163642;75.5190452836358
0;74;"lupie";74;0;100
0;5244;"lupita";5244;0;100
42;0;"luqmaan";42;100;0
648;0;"luqman";648;100;0
5;7792;"lura";7797;0.0641272284211876;99.9358727715788
0;95;"lurae";95;0;100
0;5;"lurah";5;0;100
0;5;"luraine";5;0;100
5;0;"lural";5;100;0
0;42;"lurana";42;0;100
0;27;"luray";27;0;100
0;423;"lurdes";423;0;100
0;7;"lurean";7;0;100
0;12;"lureatha";12;0;100
0;187;"luree";187;0;100
0;6;"lureen";6;0;100
5;5;"luren";10;50;50
0;373;"lurena";373;0;100
0;5;"lurenda";5;0;100
0;882;"lurene";882;0;100
0;6;"lureta";6;0;100
0;502;"luretha";502;0;100
0;341;"luretta";341;0;100
0;69;"luria";69;0;100
16;107;"lurie";123;13.0081300813008;86.9918699186992
0;15;"lurinda";15;0;100
0;252;"lurine";252;0;100
0;10;"lurla";10;0;100
0;308;"lurlean";308;0;100
0;5;"lurlee";5;0;100
0;126;"lurleen";126;0;100
0;881;"lurlene";881;0;100
0;11;"lurley";11;0;100
0;94;"lurlie";94;0;100
0;1778;"lurline";1778;0;100
0;5;"lurlyne";5;0;100
5;0;"lurton";5;100;0
0;475;"lus";475;0;100
0;5;"lusana";5;0;100
0;6;"luscious";6;0;100
0;13;"luseane";13;0;100
0;5;"luserito";5;0;100
0;131;"lusero";131;0;100
0;5;"lusetta";5;0;100
0;5;"lusha";5;0;100
0;6;"lushana";6;0;100
0;5;"lushawn";5;0;100
0;5;"lushonda";5;0;100
0;5;"lushus";5;0;100
0;5;"lusi";5;0;100
0;231;"lusia";231;0;100
0;13;"lusiana";13;0;100
46;0;"lusiano";46;100;0
0;27;"lusila";27;0;100
0;92;"lusine";92;0;100
5;0;"lusio";5;100;0
1088;12;"luster";1100;98.9090909090909;1.09090909090909
5;0;"lusvin";5;100;0
0;12;"luta";12;0;100
10;0;"lutalo";10;100;0
16;0;"lute";16;100;0
0;17;"lutece";17;0;100
0;38;"lutha";38;0;100
60634;435;"luther";61069;99.2876909725065;0.712309027493491
0;14;"luthera";14;0;100
0;15;"luthien";15;0;100
5;0;"luthor";5;100;0
37;0;"luthur";37;100;0
0;92;"luticia";92;0;100
0;402;"lutie";402;0;100
0;5;"lutina";5;0;100
0;213;"lutisha";213;0;100
0;5;"lutishia";5;0;100
0;28;"lutitia";28;0;100
0;5;"lutrecia";5;0;100
15;5;"lutrell";20;75;25
0;9;"lutrelle";9;0;100
0;10;"lutrica";10;0;100
0;733;"lutricia";733;0;100
0;36;"luttie";36;0;100
5;0;"lutz";5;100;0
5;0;"luu";5;100;0
5;0;"luukas";5;100;0
0;25;"luul";25;0;100
38;64;"luv";102;37.2549019607843;62.7450980392157
0;59;"luva";59;0;100
0;78;"luvada";78;0;100
10;0;"luvell";10;100;0
0;5;"luvella";5;0;100
0;114;"luvena";114;0;100
5;0;"luvender";5;100;0
0;3505;"luvenia";3505;0;100
0;10;"luvera";10;0;100
266;107;"luvern";373;71.313672922252;28.686327077748
0;122;"luverna";122;0;100
1066;847;"luverne";1913;55.7239937271302;44.2760062728698
5;0;"luvert";5;100;0
0;64;"luverta";64;0;100
0;67;"luvia";67;0;100
0;392;"luvina";392;0;100
0;11;"luvine";11;0;100
0;226;"luvinia";226;0;100
0;5;"luvonia";5;0;100
0;5;"luvonne";5;0;100
0;41;"luwam";41;0;100
0;320;"luwana";320;0;100
0;148;"luwanda";148;0;100
0;173;"luwanna";173;0;100
219;822;"lux";1041;21.0374639769452;78.9625360230548
0;5;"luxanna";5;0;100
0;61;"luxe";61;0;100
0;7;"luxi";7;0;100
0;34;"luxie";34;0;100
5;0;"luxton";5;100;0
0;11;"luxx";11;0;100
0;5;"luxy";5;0;100
906;25176;"luz";26082;3.47365999539913;96.5263400046009
0;41;"luzclarita";41;0;100
0;5;"luzdari";5;0;100
0;15;"luzdary";15;0;100
0;345;"luzelena";345;0;100
5;5;"luzell";10;50;50
0;5;"luzenia";5;0;100
12;0;"luzer";12;100;0
0;11;"luzero";11;0;100
0;37;"luzetta";37;0;100
0;5;"luzette";5;0;100
0;17;"luzia";17;0;100
0;10;"luziana";10;0;100
5;0;"luziano";5;100;0
0;27;"luzma";27;0;100
0;5;"luzmar";5;0;100
0;682;"luzmaria";682;0;100
0;45;"luzmarie";45;0;100
0;13;"luzmary";13;0;100
0;5;"luzmila";5;0;100
0;12;"luzviminda";12;0;100
0;14;"lwren";14;0;100
119;279;"ly";398;29.8994974874372;70.1005025125628
0;498;"lya";498;0;100
0;213;"lyah";213;0;100
145;0;"lyal";145;100;0
268;0;"lyall";268;100;0
656;0;"lyam";656;100;0
134;64;"lyan";198;67.6767676767677;32.3232323232323
0;519;"lyana";519;0;100
0;11;"lyanah";11;0;100
0;31;"lyandra";31;0;100
0;32;"lyani";32;0;100
0;5;"lyanie";5;0;100
0;265;"lyann";265;0;100
0;941;"lyanna";941;0;100
0;6;"lyannah";6;0;100
0;385;"lyanne";385;0;100
0;6;"lyanni";6;0;100
0;48;"lyasia";48;0;100
0;34;"lyba";34;0;100
0;82;"lyberti";82;0;100
0;5;"lybertie";5;0;100
0;26;"lyberty";26;0;100
62;0;"lycan";62;100;0
0;71;"lycia";71;0;100
0;5;"lycinda";5;0;100
0;5;"lycrecia";5;0;100
7;0;"lycurgus";7;100;0
5;3888;"lyda";3893;0.128435653737478;99.8715643462625
5;0;"lydale";5;100;0
0;5;"lyddia";5;0;100
0;58;"lydea";58;0;100
1826;10;"lydell";1836;99.4553376906318;0.544662309368192
52;0;"lyden";52;100;0
264;150664;"lydia";150928;0.174917841619845;99.8250821583802
0;230;"lydiah";230;0;100
0;154;"lydian";154;0;100
0;82;"lydiana";82;0;100
0;299;"lydiann";299;0;100
0;38;"lydianna";38;0;100
0;5;"lydianne";5;0;100
0;262;"lydie";262;0;100
214;0;"lydon";214;100;0
0;5;"lydya";5;0;100
0;16;"lyela";16;0;100
0;5;"lyelah";5;0;100
140;0;"lyell";140;100;0
163;61;"lyfe";224;72.7678571428571;27.2321428571429
0;76;"lygia";76;0;100
0;11;"lyia";11;0;100
0;19;"lyiah";19;0;100
16;0;"lyiam";16;100;0
5;0;"lyjah";5;100;0
0;10;"lyka";10;0;100
0;25899;"lyla";25899;0;100
0;4066;"lylah";4066;0;100
0;7;"lylarae";7;0;100
0;17;"lylarose";17;0;100
0;17;"lylas";17;0;100
56771;909;"lyle";57680;98.4240638002774;1.57593619972261
0;105;"lylee";105;0;100
0;12;"lyleigh";12;0;100
11;0;"lyles";11;100;0
0;27;"lyli";27;0;100
0;343;"lylia";343;0;100
0;46;"lyliah";46;0;100
0;303;"lylian";303;0;100
0;320;"lyliana";320;0;100
0;45;"lylianah";45;0;100
0;5;"lyliann";5;0;100
0;107;"lylianna";107;0;100
0;58;"lylie";58;0;100
0;10;"lylis";10;0;100
0;65;"lylith";65;0;100
0;95;"lylla";95;0;100
0;28;"lyllah";28;0;100
0;33;"lylli";33;0;100
0;6;"lyllia";6;0;100
0;531;"lyllian";531;0;100
0;75;"lylliana";75;0;100
0;5;"lyllianna";5;0;100
0;77;"lyllie";77;0;100
0;5;"lyllyan";5;0;100
0;115;"lyly";115;0;100
0;10;"lylybell";10;0;100
7906;0;"lyman";7906;100;0
0;40;"lymari";40;0;100
185;0;"lymon";185;100;0
1557;7188;"lyn";8745;17.8044596912521;82.1955403087479
0;893;"lyna";893;0;100
0;1201;"lynae";1201;0;100
5;0;"lynal";5;100;0
0;287;"lynann";287;0;100
0;192;"lynanne";192;0;100
107;0;"lynard";107;100;0
0;76;"lynasia";76;0;100
0;13;"lynaya";13;0;100
25;0;"lynch";25;100;0
196;91;"lyncoln";287;68.2926829268293;31.7073170731707
119;77669;"lynda";77788;0.152979894071065;99.8470201059289
0;7;"lyndah";7;0;100
398;313;"lyndal";711;55.9774964838256;44.0225035161744
25;5;"lyndale";30;83.3333333333333;16.6666666666667
296;609;"lyndall";905;32.707182320442;67.292817679558
5;12;"lyndan";17;29.4117647058824;70.5882352941177
0;432;"lynde";432;0;100
0;1064;"lyndee";1064;0;100
425;182;"lyndel";607;70.0164744645799;29.9835255354201
1895;828;"lyndell";2723;69.5923613661403;30.4076386338597
0;10;"lyndelle";10;0;100
1268;454;"lynden";1722;73.6353077816492;26.3646922183508
0;5;"lynder";5;0;100
0;1653;"lyndi";1653;0;100
0;1103;"lyndia";1103;0;100
0;607;"lyndie";607;0;100
0;23;"lyndin";23;0;100
127;0;"lyndle";127;100;0
0;17;"lyndley";17;0;100
99;12;"lyndol";111;89.1891891891892;10.8108108108108
8778;230;"lyndon";9008;97.4467140319716;2.55328596802842
0;52;"lyndora";52;0;100
0;11;"lyndra";11;0;100
0;5;"lyndsae";5;0;100
0;6678;"lyndsay";6678;0;100
0;36;"lyndse";36;0;100
0;22;"lyndsea";22;0;100
0;311;"lyndsee";311;0;100
32;14164;"lyndsey";14196;0.225415610030995;99.774584389969
0;1043;"lyndsi";1043;0;100
0;1466;"lyndsie";1466;0;100
0;621;"lyndsy";621;0;100
0;311;"lyndy";311;0;100
0;5;"lyndyn";5;0;100
0;16;"lyndze";16;0;100
0;58;"lyndzee";58;0;100
0;16;"lyndzey";16;0;100
0;59;"lyndzi";59;0;100
0;138;"lyndzie";138;0;100
0;6;"lyndzy";6;0;100
5;202;"lyne";207;2.41545893719807;97.5845410628019
0;383;"lynea";383;0;100
0;23;"lyneah";23;0;100
0;301;"lynee";301;0;100
0;45;"lyneisha";45;0;100
15;65;"lynel";80;18.75;81.25
805;1961;"lynell";2766;29.1033984092552;70.8966015907448
0;2198;"lynelle";2198;0;100
0;46;"lynese";46;0;100
0;89;"lynesha";89;0;100
0;10;"lyneshia";10;0;100
0;94;"lynessa";94;0;100
0;18;"lynet";18;0;100
0;16;"lyneth";16;0;100
0;472;"lynett";472;0;100
0;1466;"lynetta";1466;0;100
53;42774;"lynette";42827;0.123753706773764;99.8762462932262
0;13;"lynex";13;0;100
311;0;"lynford";311;100;0
0;10;"lynh";10;0;100
0;147;"lynia";147;0;100
0;206;"lyniah";206;0;100
0;18;"lynice";18;0;100
0;6;"lynika";6;0;100
0;5;"lynis";5;0;100
0;103;"lynise";103;0;100
0;108;"lynisha";108;0;100
0;5;"lynissa";5;0;100
0;378;"lynita";378;0;100
15;41;"lynix";56;26.7857142857143;73.2142857142857
0;5;"lyniya";5;0;100
0;18;"lyniyah";18;0;100
46;0;"lynk";46;100;0
26;0;"lynken";26;100;0
94;0;"lynkin";94;100;0
11;0;"lynkoln";11;100;0
34;0;"lynkon";34;100;0
0;19;"lynlea";19;0;100
0;1055;"lynlee";1055;0;100
0;221;"lynleigh";221;0;100
0;722;"lynley";722;0;100
0;19;"lynli";19;0;100
0;41;"lynlie";41;0;100
0;6;"lynly";6;0;100
0;19;"lynmarie";19;0;100
51606;181683;"lynn";233289;22.1210601442846;77.8789398557154
0;1643;"lynna";1643;0;100
0;1152;"lynnae";1152;0;100
0;7;"lynnai";7;0;100
0;296;"lynnann";296;0;100
0;40;"lynnanne";40;0;100
0;10;"lynnasia";10;0;100
0;27;"lynnaya";27;0;100
0;676;"lynnda";676;0;100
0;5;"lynndsey";5;0;100
457;61870;"lynne";62327;0.73322957947599;99.266770420524
0;1586;"lynnea";1586;0;100
0;34;"lynneah";34;0;100
0;5;"lynneann";5;0;100
0;106;"lynnel";106;0;100
0;584;"lynnell";584;0;100
0;291;"lynnelle";291;0;100
0;11;"lynnesha";11;0;100
0;5;"lynnessa";5;0;100
0;87;"lynnet";87;0;100
0;5;"lynnete";5;0;100
0;271;"lynnett";271;0;100
0;529;"lynnetta";529;0;100
0;15062;"lynnette";15062;0;100
0;61;"lynnex";61;0;100
0;23;"lynnia";23;0;100
0;85;"lynniah";85;0;100
16;239;"lynnie";255;6.27450980392157;93.7254901960784
0;9;"lynnis";9;0;100
0;10;"lynnise";10;0;100
0;11;"lynnisha";11;0;100
0;65;"lynnita";65;0;100
0;73;"lynnix";73;0;100
0;12;"lynnlea";12;0;100
0;451;"lynnlee";451;0;100
0;91;"lynnleigh";91;0;100
0;54;"lynnley";54;0;100
0;11;"lynnly";11;0;100
0;233;"lynnmarie";233;0;100
0;32;"lynnon";32;0;100
20;98;"lynnox";118;16.9491525423729;83.0508474576271
0;11;"lynnsay";11;0;100
0;770;"lynnsey";770;0;100
0;103;"lynnsie";103;0;100
264;0;"lynnwood";264;100;0
0;45;"lynnzee";45;0;100
0;90;"lynnzie";90;0;100
0;151;"lynora";151;0;100
0;101;"lynore";101;0;100
5;7;"lynox";12;41.6666666666667;58.3333333333333
0;307;"lynsay";307;0;100
0;16;"lynse";16;0;100
0;6;"lynsea";6;0;100
0;131;"lynsee";131;0;100
0;4882;"lynsey";4882;0;100
0;415;"lynsi";415;0;100
0;961;"lynsie";961;0;100
0;41;"lynsy";41;0;100
0;12;"lynthia";12;0;100
64;0;"lynton";64;100;0
15;0;"lynus";15;100;0
27;0;"lynward";27;100;0
4148;5;"lynwood";4153;99.8796051047436;0.120394895256441
61;5;"lynx";66;92.4242424242424;7.57575757575758
0;148;"lynze";148;0;100
0;802;"lynzee";802;0;100
0;37;"lynzey";37;0;100
0;553;"lynzi";553;0;100
0;951;"lynzie";951;0;100
0;79;"lynzy";79;0;100
0;29;"lyola";29;0;100
441;0;"lyon";441;100;0
191;0;"lyonel";191;100;0
0;6;"lyonna";6;0;100
0;3004;"lyra";3004;0;100
0;40;"lyrae";40;0;100
0;86;"lyrah";86;0;100
0;23;"lyria";23;0;100
2947;14144;"lyric";17091;17.242993388333;82.757006611667
0;318;"lyrica";318;0;100
0;110;"lyrical";110;0;100
0;24;"lyricc";24;0;100
126;127;"lyrick";253;49.802371541502;50.197628458498
0;55;"lyrics";55;0;100
0;11;"lyrie";11;0;100
536;867;"lyrik";1403;38.2038488952245;61.7961511047755
0;48;"lyrika";48;0;100
73;511;"lyriq";584;12.5;87.5
0;106;"lyrique";106;0;100
0;55;"lyris";55;0;100
0;22;"lyrissa";22;0;100
16;10;"lyrix";26;61.5384615384615;38.4615384615385
5;0;"lyron";5;100;0
0;5;"lyrric";5;0;100
0;757;"lysa";757;0;100
464;0;"lysander";464;100;0
0;661;"lysandra";661;0;100
0;110;"lysbeth";110;0;100
0;767;"lysette";767;0;100
0;72;"lysha";72;0;100
0;5;"lyshon";5;0;100
436;0;"lysle";436;100;0
0;1436;"lyssa";1436;0;100
0;55;"lyssette";55;0;100
0;11;"lyta";11;0;100
6;0;"lyth";6;100;0
0;14;"lytia";14;0;100
0;5;"lytina";5;0;100
0;16;"lytisha";16;0;100
205;0;"lytle";205;100;0
0;34;"lytonia";34;0;100
0;7;"lytonya";7;0;100
0;5;"lytzi";5;0;100
0;50;"lytzy";50;0;100
0;26;"lyubov";26;0;100
0;11;"lyudmila";11;0;100
0;7;"lyvette";7;0;100
0;440;"lyvia";440;0;100
0;193;"lyvonne";193;0;100
0;6;"lywanda";6;0;100
0;554;"lyza";554;0;100
0;8;"lyzah";8;0;100
34;0;"lyzander";34;100;0
0;5;"lyzandra";5;0;100
0;63;"lyzbeth";63;0;100
0;19;"lyzeth";19;0;100
0;338;"lyzette";338;0;100
0;622;"ma";622;0;100
10;0;"maadhav";10;100;0
0;5;"maaha";5;0;100
0;247;"maahi";247;0;100
0;5;"maahika";5;0;100
81;0;"maahir";81;100;0
0;10;"maahira";10;0;100
0;10;"maaike";10;0;100
0;24;"maali";24;0;100
467;0;"maalik";467;100;0
0;229;"maaliyah";229;0;100
0;119;"maame";119;0;100
69;0;"maan";69;100;0
49;0;"maanas";49;100;0
0;88;"maanasa";88;0;100
118;0;"maanav";118;100;0
0;110;"maansi";110;0;100
0;86;"maanvi";86;0;100
0;228;"maanya";228;0;100
0;17;"maari";17;0;100
0;29;"maaria";29;0;100
0;10;"maariyah";10;0;100
29;0;"maarten";29;100;0
33;0;"maasai";33;100;0
10;0;"maaseiah";10;100;0
0;79;"maat";79;0;100
0;30;"maaya";30;0;100
11;461;"maayan";472;2.33050847457627;97.6694915254237
425;0;"maaz";425;100;0
323;98428;"mabel";98751;0.327085295338781;99.6729147046612
0;60;"mabelene";60;0;100
0;5;"mabelin";5;0;100
0;135;"mabeline";135;0;100
0;468;"mabell";468;0;100
0;1377;"mabelle";1377;0;100
0;6;"mabelyn";6;0;100
0;11;"maber";11;0;100
0;25;"mabeth";25;0;100
0;5;"mabil";5;0;100
0;5;"mabinty";5;0;100
215;48052;"mable";48267;0.445438912714691;99.5545610872853
0;21;"mablean";21;0;100
0;25;"mablene";25;0;100
0;28;"mabree";28;0;100
5;134;"mabrey";139;3.59712230215827;96.4028776978417
0;34;"mabrie";34;0;100
213;745;"mabry";958;22.2338204592902;77.7661795407098
0;13;"mabyn";13;0;100
8353;34;"mac";8387;99.5946107070466;0.40538929295338
40;0;"macade";40;100;0
12;0;"macaden";12;100;0
0;36;"macady";36;0;100
0;325;"macaela";325;0;100
129;0;"macai";129;100;0
17;64;"macaiah";81;20.9876543209877;79.0123456790123
0;151;"macaila";151;0;100
0;5;"macailah";5;0;100
0;10;"macailyn";10;0;100
5;5;"macaire";10;50;50
0;155;"macala";155;0;100
0;40;"macalah";40;0;100
34;0;"macaleb";34;100;0
69;0;"macalister";69;100;0
0;88;"macall";88;0;100
0;8;"macalla";8;0;100
166;5;"macallan";171;97.0760233918129;2.92397660818713
7;0;"macallen";7;100;0
218;0;"macallister";218;100;0
0;5;"macara";5;0;100
0;131;"macarena";131;0;100
68;11;"macari";79;86.0759493670886;13.9240506329114
0;341;"macaria";341;0;100
2507;0;"macario";2507;100;0
90;0;"macarius";90;100;0
10;0;"macarther";10;100;0
1186;0;"macarthur";1186;100;0
0;6;"macartney";6;0;100
177;15;"macaulay";192;92.1875;7.8125
219;30;"macauley";249;87.9518072289157;12.0481927710843
5;0;"macauly";5;100;0
0;2101;"macayla";2101;0;100
0;47;"macaylah";47;0;100
5;56;"macayle";61;8.19672131147541;91.8032786885246
0;30;"macaylee";30;0;100
8;0;"maccabee";8;100;0
85;0;"maccoy";85;100;0
154;0;"macdonald";154;100;0
1478;0;"mace";1478;100;0
163;0;"macedonio";163;100;0
0;1649;"macee";1649;0;100
5;821;"macel";826;0.605326876513317;99.3946731234867
0;49;"macelyn";49;0;100
0;21;"macelynn";21;0;100
676;5;"macen";681;99.265785609398;0.734214390602056
0;6;"macenna";6;0;100
0;6;"macenzi";6;0;100
0;329;"macenzie";329;0;100
2541;0;"maceo";2541;100;0
5;0;"maceon";5;100;0
10;0;"maceson";10;100;0
51;10196;"macey";10247;0.497706645847565;99.5022933541524
258;0;"macgregor";258;100;0
71;0;"macguire";71;100;0
45;0;"macgyver";45;100;0
5;0;"mach";5;100;0
195;5;"machael";200;97.5;2.5
0;419;"machaela";419;0;100
236;0;"machai";236;100;0
0;47;"machala";47;0;100
0;33;"machayla";33;0;100
0;6;"mache";6;0;100
33;16;"macheal";49;67.3469387755102;32.6530612244898
0;10;"macheala";10;0;100
10;118;"machel";128;7.8125;92.1875
0;11;"machela";11;0;100
0;381;"machele";381;0;100
0;520;"machell";520;0;100
0;15;"machella";15;0;100
0;3178;"machelle";3178;0;100
5;32;"machenzie";37;13.5135135135135;86.4864864864865
275;0;"machi";275;100;0
0;11;"machia";11;0;100
0;11;"machiah";11;0;100
5;0;"machias";5;100;0
5;0;"machiavelli";5;100;0
0;7;"machiya";7;0;100
7;0;"machlan";7;100;0
6;15697;"maci";15703;0.0382092593771891;99.9617907406228
0;15;"macia";15;0;100
113;129;"maciah";242;46.6942148760331;53.3057851239669
31;17622;"macie";17653;0.175607545459695;99.8243924545403
0;18;"maciee";18;0;100
293;0;"maciej";293;100;0
51;198;"maciel";249;20.4819277108434;79.5180722891566
0;31;"macii";31;0;100
0;192;"macil";192;0;100
0;13;"macilyn";13;0;100
0;44;"macilynn";44;0;100
58;0;"macin";58;100;0
70;0;"macintyre";70;100;0
145;0;"macio";145;100;0
35330;180;"mack";35510;99.4931005350605;0.506899464939454
0;5;"mackaela";5;0;100
6;0;"mackai";6;100;0
0;5;"mackala";5;0;100
0;11;"mackanzie";11;0;100
216;21;"mackay";237;91.1392405063291;8.86075949367089
0;1169;"mackayla";1169;0;100
0;5;"mackaylah";5;0;100
0;13;"mackaylee";13;0;100
16;0;"mackel";16;100;0
0;101;"mackena";101;0;100
0;309;"mackenize";309;0;100
0;16;"mackenlee";16;0;100
0;5;"mackenley";5;0;100
0;6;"mackenlie";6;0;100
8;2995;"mackenna";3003;0.266400266400266;99.7335997335997
0;14;"mackennah";14;0;100
0;119;"mackensey";119;0;100
0;94;"mackensi";94;0;100
5;869;"mackensie";874;0.5720823798627;99.4279176201373
10;0;"mackenson";10;100;0
0;5;"mackensy";5;0;100
0;82;"mackenze";82;0;100
0;748;"mackenzee";748;0;100
0;169;"mackenzey";169;0;100
11;1915;"mackenzi";1926;0.571131879543095;99.4288681204569
7284;121557;"mackenzie";128841;5.6534798705381;94.3465201294619
0;5;"mackenziee";5;0;100
119;994;"mackenzy";1113;10.6918238993711;89.3081761006289
0;139;"mackenzye";139;0;100
6;0;"macker";6;100;0
565;0;"mackey";565;100;0
0;5;"mackeyla";5;0;100
994;534;"mackie";1528;65.0523560209424;34.9476439790576
0;47;"mackinlee";47;0;100
295;266;"mackinley";561;52.5846702317291;47.415329768271
10;0;"mackinnley";10;100;0
30;0;"mackinnon";30;100;0
0;189;"mackinsey";189;0;100
0;141;"mackinze";141;0;100
0;70;"mackinzee";70;0;100
0;10;"mackinzey";10;0;100
0;26;"mackinzi";26;0;100
15;802;"mackinzie";817;1.8359853121175;98.1640146878825
0;20;"mackinzy";20;0;100
27;0;"macklan";27;100;0
60;0;"macklen";60;100;0
1048;0;"macklin";1048;100;0
20;72;"macklyn";92;21.7391304347826;78.2608695652174
0;19;"macklynn";19;0;100
25;0;"macks";25;100;0
26;0;"macksen";26;100;0
123;0;"mackson";123;100;0
7;0;"mackston";7;100;0
137;0;"macky";137;100;0
0;9;"mackynze";9;0;100
0;6;"mackynzi";6;0;100
0;331;"mackynzie";331;0;100
335;5;"maclain";340;98.5294117647059;1.47058823529412
19;92;"maclaine";111;17.1171171171171;82.8828828828829
33;0;"maclan";33;100;0
135;0;"maclane";135;100;0
11;40;"maclaren";51;21.5686274509804;78.4313725490196
0;11;"maclay";11;0;100
0;17;"maclayne";17;0;100
0;21;"macle";21;0;100
252;0;"maclean";252;100;0
177;6;"maclin";183;96.7213114754098;3.27868852459016
0;107;"maclovia";107;0;100
86;0;"maclovio";86;100;0
8;25;"maclyn";33;24.2424242424242;75.7575757575758
0;18;"maclynn";18;0;100
0;5;"macola";5;0;100
18;0;"macolm";18;100;0
1819;171;"macon";1990;91.4070351758794;8.5929648241206
350;0;"macoy";350;100;0
123;0;"macrae";123;100;0
8;0;"macray";8;100;0
0;138;"macrina";138;0;100
210;0;"macsen";210;100;0
12;0;"macson";12;100;0
16;0;"macus";16;100;0
550;28392;"macy";28942;1.90035242899592;98.0996475710041
0;21;"macye";21;0;100
109;733;"macyn";842;12.9453681710214;87.0546318289786
0;11;"macynn";11;0;100
0;471;"mada";471;0;100
0;520;"madai";520;0;100
0;163;"madailein";163;0;100
0;19;"madajah";19;0;100
0;71;"madalaine";71;0;100
0;80;"madalee";80;0;100
0;201;"madaleine";201;0;100
0;139;"madalen";139;0;100
0;653;"madalena";653;0;100
0;1348;"madalene";1348;0;100
6;0;"madaleno";6;100;0
0;29;"madalie";29;0;100
0;6;"madaliene";6;0;100
0;527;"madalin";527;0;100
0;61;"madalina";61;0;100
0;4604;"madaline";4604;0;100
0;10;"madalinn";10;0;100
0;12;"madalon";12;0;100
0;10;"madaly";10;0;100
0;20256;"madalyn";20256;0;100
0;638;"madalyne";638;0;100
0;7192;"madalynn";7192;0;100
0;621;"madalynne";621;0;100
31;0;"madan";31;100;0
0;19;"madasen";19;0;100
0;43;"madasin";43;0;100
0;183;"madason";183;0;100
0;396;"madasyn";396;0;100
6;0;"madax";6;100;0
0;91;"maday";91;0;100
0;15;"madaya";15;0;100
0;17;"madchen";17;0;100
0;650;"maddalena";650;0;100
0;480;"maddalyn";480;0;100
0;215;"maddalynn";215;0;100
11;0;"maddan";11;100;0
346;8;"maddax";354;97.7401129943503;2.25988700564972
0;13;"maddee";13;0;100
0;123;"maddeline";123;0;100
0;523;"maddelyn";523;0;100
0;157;"maddelynn";157;0;100
4512;773;"madden";5285;85.3736991485336;14.6263008514664
1172;19;"maddex";1191;98.4047019311503;1.59529806884971
0;416;"maddi";416;0;100
0;3918;"maddie";3918;0;100
0;5;"maddielyn";5;0;100
0;40;"maddielynn";40;0;100
0;23;"maddigan";23;0;100
0;803;"maddilyn";803;0;100
0;475;"maddilynn";475;0;100
24;0;"maddin";24;100;0
0;520;"maddisen";520;0;100
47;17769;"maddison";17816;0.263807813201617;99.7361921867984
0;6;"maddisson";6;0;100
0;901;"maddisyn";901;0;100
1330;208;"maddix";1538;86.4759427828348;13.5240572171652
0;6;"maddlynn";6;0;100
47;0;"maddoc";47;100;0
137;0;"maddock";137;100;0
230;5;"maddon";235;97.8723404255319;2.12765957446809
5;0;"maddoux";5;100;0
26873;976;"maddox";27849;96.49538583073;3.50461416926999
89;0;"maddoxx";89;100;0
2324;158;"maddux";2482;93.6341659951652;6.36583400483481
0;540;"maddy";540;0;100
0;5;"maddylynn";5;0;100
22;508;"maddyn";530;4.15094339622642;95.8490566037736
0;51;"maddysen";51;0;100
0;796;"maddyson";796;0;100
123;119;"maddyx";242;50.8264462809917;49.1735537190083
0;24;"madee";24;0;100
0;61;"madeeha";61;0;100
0;27;"madeira";27;0;100
0;11;"madel";11;0;100
0;3153;"madelaine";3153;0;100
0;5;"madelane";5;0;100
0;11;"madelayne";11;0;100
0;176;"madelein";176;0;100
15;38121;"madeleine";38136;0.039332913782253;99.9606670862178
0;55;"madelen";55;0;100
0;157;"madelena";157;0;100
0;2591;"madelene";2591;0;100
0;22;"madeley";22;0;100
0;95;"madeleyn";95;0;100
0;591;"madeliene";591;0;100
0;2718;"madelin";2718;0;100
0;277;"madelina";277;0;100
240;178867;"madeline";179107;0.133998112859911;99.8660018871401
0;5;"madelinerose";5;0;100
0;51;"madelinn";51;0;100
0;16;"madelinne";16;0;100
0;30;"madelis";30;0;100
0;12;"madeliz";12;0;100
0;147;"madell";147;0;100
0;36;"madella";36;0;100
0;24;"madelle";24;0;100
0;138;"madelline";138;0;100
0;60;"madellyn";60;0;100
0;5;"madellyne";5;0;100
0;1768;"madelon";1768;0;100
0;12;"madely";12;0;100
38;83489;"madelyn";83527;0.0454942713134675;99.9545057286865
0;2974;"madelyne";2974;0;100
0;12;"madelyngrace";12;0;100
0;13160;"madelynn";13160;0;100
0;1559;"madelynne";1559;0;100
0;5;"madelys";5;0;100
37;0;"maden";37;100;0
0;10;"madena";10;0;100
0;11;"madene";11;0;100
0;12;"madesen";12;0;100
0;20;"madeson";20;0;100
0;158;"madesyn";158;0;100
63;0;"madex";63;100;0
0;6;"madgalene";6;0;100
0;11694;"madge";11694;0;100
0;5;"madgel";5;0;100
0;34;"madgelene";34;0;100
0;74;"madgeline";74;0;100
0;553;"madgie";553;0;100
0;10;"madgline";10;0;100
370;0;"madhav";370;100;0
0;83;"madhavi";83;0;100
0;6;"madhulika";6;0;100
0;7;"madhumita";7;0;100
0;29;"madhumitha";29;0;100
0;11;"madhura";11;0;100
0;58;"madhuri";58;0;100
0;213;"madi";213;0;100
0;199;"madia";199;0;100
0;7;"madian";7;0;100
0;7;"madianna";7;0;100
5;0;"madiba";5;100;0
0;5;"madicella";5;0;100
0;127;"madicyn";127;0;100
0;2822;"madie";2822;0;100
0;16;"madielyn";16;0;100
0;7;"madielynn";7;0;100
0;815;"madigan";815;0;100
0;290;"madiha";290;0;100
0;52;"madilee";52;0;100
0;10;"madilen";10;0;100
0;6;"madilene";6;0;100
0;36;"madilin";36;0;100
0;73;"madiline";73;0;100
0;15462;"madilyn";15462;0;100
0;275;"madilyne";275;0;100
0;6944;"madilynn";6944;0;100
0;403;"madilynne";403;0;100
0;893;"madina";893;0;100
0;184;"madinah";184;0;100
0;247;"madine";247;0;100
0;7;"madis";7;0;100
0;193;"madisan";193;0;100
0;4884;"madisen";4884;0;100
0;110;"madisin";110;0;100
7235;365694;"madison";372929;1.94004756937648;98.0599524306235
0;11;"madisongrace";11;0;100
0;19;"madisonrose";19;0;100
0;174;"madissen";174;0;100
0;982;"madisson";982;0;100
0;37;"madissyn";37;0;100
0;231;"madisun";231;0;100
5;14357;"madisyn";14362;0.0348140927447431;99.9651859072553
0;326;"madisynn";326;0;100
0;12;"madisynne";12;0;100
339;0;"madix";339;100;0
0;5;"madiyson";5;0;100
0;18;"madlen";18;0;100
0;36;"madlene";36;0;100
0;32;"madlin";32;0;100
0;249;"madline";249;0;100
0;2285;"madlyn";2285;0;100
0;27;"madlyne";27;0;100
0;128;"madlynn";128;0;100
0;5;"madlynne";5;0;100
138;0;"madoc";138;100;0
0;20;"madoka";20;0;100
0;99;"madolin";99;0;100
0;61;"madoline";61;0;100
0;1697;"madolyn";1697;0;100
0;39;"madolynn";39;0;100
10;0;"madon";10;100;0
0;10;"madona";10;0;100
0;9500;"madonna";9500;0;100
0;341;"madora";341;0;100
287;0;"madox";287;100;0
23;0;"madoxx";23;100;0
0;26;"madra";26;0;100
0;5;"madrene";5;0;100
0;17;"madria";17;0;100
5;32;"madrid";37;13.5135135135135;86.4864864864865
0;12;"madrona";12;0;100
5;0;"madrox";5;100;0
40;0;"mads";40;100;0
88;5;"madsen";93;94.6236559139785;5.37634408602151
0;24;"madsion";24;0;100
17;0;"madux";17;100;0
0;143;"mady";143;0;100
0;53;"madylan";53;0;100
0;13;"madylen";13;0;100
0;535;"madylin";535;0;100
0;50;"madyline";50;0;100
0;97;"madylyn";97;0;100
0;43;"madylynn";43;0;100
0;202;"madyn";202;0;100
0;18;"madysan";18;0;100
5;2573;"madysen";2578;0.193948797517455;99.8060512024825
0;264;"madysin";264;0;100
0;31;"madysn";31;0;100
0;12162;"madyson";12162;0;100
0;36;"madysson";36;0;100
0;87;"madysun";87;0;100
0;137;"madysyn";137;0;100
79;34;"madyx";113;69.9115044247788;30.0884955752212
566;93152;"mae";93718;0.603939478008494;99.3960605219915
0;5;"maeanna";5;0;100
0;91;"maebel";91;0;100
0;810;"maebell";810;0;100
0;1031;"maebelle";1031;0;100
0;43;"maebh";43;0;100
0;43;"maebree";43;0;100
0;5;"maebri";5;0;100
0;15;"maebrie";15;0;100
0;173;"maebry";173;0;100
0;64;"maeby";64;0;100
0;25;"maecee";25;0;100
0;110;"maeci";110;0;100
0;72;"maecie";72;0;100
0;212;"maecy";212;0;100
0;67;"maecyn";67;0;100
0;5;"maeda";5;0;100
0;46;"maedean";46;0;100
0;260;"maedell";260;0;100
0;26;"maedelle";26;0;100
0;14;"maedot";14;0;100
0;9105;"maegan";9105;0;100
0;12;"maegann";12;0;100
0;875;"maegen";875;0;100
0;1064;"maeghan";1064;0;100
0;32;"maeghen";32;0;100
0;10;"maegon";10;0;100
64;0;"maejor";64;100;0
0;97;"maekayla";97;0;100
223;0;"mael";223;100;0
0;149;"maela";149;0;100
0;6;"maelah";6;0;100
0;5;"maelana";5;0;100
0;150;"maelani";150;0;100
0;48;"maelea";48;0;100
0;11;"maeleah";11;0;100
0;884;"maelee";884;0;100
0;6;"maelei";6;0;100
0;419;"maeleigh";419;0;100
0;33;"maelena";33;0;100
0;57;"maelene";57;0;100
0;142;"maeley";142;0;100
0;300;"maeli";300;0;100
0;16;"maelia";16;0;100
0;295;"maelie";295;0;100
0;197;"maelin";197;0;100
0;5;"maelina";5;0;100
0;6;"maelis";6;0;100
0;5;"maeliyah";5;0;100
0;268;"maelle";268;0;100
5;0;"maelo";5;100;0
0;208;"maely";208;0;100
0;1074;"maelyn";1074;0;100
0;1075;"maelynn";1075;0;100
0;13;"maelynne";13;0;100
0;69;"maelys";69;0;100
0;5;"maemi";5;0;100
0;445;"maeola";445;0;100
0;6;"maeoma";6;0;100
0;6;"maera";6;0;100
0;22;"maerene";22;0;100
0;5;"maerose";5;0;100
0;77;"maeryn";77;0;100
0;26;"maesa";26;0;100
11;11;"maesen";22;50;50
0;11;"maesha";11;0;100
0;16;"maesie";16;0;100
455;176;"maeson";631;72.107765451664;27.892234548336
27;196;"maesyn";223;12.1076233183857;87.8923766816144
0;5;"maesynn";5;0;100
0;5;"maeta";5;0;100
0;26;"maetta";26;0;100
0;396;"maeva";396;0;100
0;10558;"maeve";10558;0;100
0;71;"maeven";71;0;100
0;39;"maevis";39;0;100
0;18;"maevry";18;0;100
0;40;"maevyn";40;0;100
0;9;"maewyn";9;0;100
0;6;"maeya";6;0;100
0;15;"maezell";15;0;100
0;68;"maezie";68;0;100
0;5;"maezy";5;0;100
0;1279;"mafalda";1279;0;100
0;6;"mafata";6;0;100
0;6;"mag";6;0;100
0;14;"magabi";14;0;100
0;149;"magaby";149;0;100
0;5;"magalena";5;0;100
0;511;"magalene";511;0;100
6;3283;"magali";3289;0.182426269382791;99.8175737306172
0;260;"magalie";260;0;100
0;439;"magaline";439;0;100
0;11;"magalis";11;0;100
0;7;"magalli";7;0;100
0;110;"magally";110;0;100
0;4796;"magaly";4796;0;100
0;2739;"magan";2739;0;100
0;458;"magaret";458;0;100
0;15;"magarita";15;0;100
0;5;"magavi";5;0;100
0;2734;"magda";2734;0;100
0;65;"magdala";65;0;100
0;2825;"magdalen";2825;0;100
10;16501;"magdalena";16511;0.0605656834837381;99.9394343165163
0;8451;"magdalene";8451;0;100
979;0;"magdaleno";979;100;0
0;5;"magdali";5;0;100
0;7;"magdalia";7;0;100
0;122;"magdalina";122;0;100
0;1342;"magdaline";1342;0;100
0;5;"magdaly";5;0;100
0;508;"magdalyn";508;0;100
0;116;"magdalynn";116;0;100
0;6;"magdelana";6;0;100
0;328;"magdelena";328;0;100
0;153;"magdelene";153;0;100
0;6;"magdelin";6;0;100
0;10;"magdelina";10;0;100
0;619;"magdeline";619;0;100
0;172;"magdelyn";172;0;100
441;26;"magdiel";467;94.4325481798715;5.56745182012848
0;46;"magdlene";46;0;100
0;23;"magdline";23;0;100
0;20;"magean";20;0;100
22;0;"maged";22;100;0
0;10;"magee";10;0;100
0;10;"magel";10;0;100
0;23;"mageline";23;0;100
0;3345;"magen";3345;0;100
0;5;"magena";5;0;100
0;203;"magenta";203;0;100
11;0;"mager";11;100;0
0;28;"maggee";28;0;100
0;5;"maggen";5;0;100
0;762;"maggi";762;0;100
252;97438;"maggie";97690;0.25795884942164;99.7420411505784
0;6;"maggielean";6;0;100
0;13;"maggiemae";13;0;100
0;453;"maggy";453;0;100
0;496;"maghan";496;0;100
0;6;"maghann";6;0;100
0;108;"maghen";108;0;100
0;5;"magi";5;0;100
222;34;"magic";256;86.71875;13.28125
0;184;"magie";184;0;100
5;69;"magin";74;6.75675675675676;93.2432432432432
0;43;"magline";43;0;100
17;0;"magno";17;100;0
0;6;"magnola";6;0;100
0;8071;"magnolia";8071;0;100
236;0;"magnum";236;100;0
3221;0;"magnus";3221;100;0
0;179;"magon";179;0;100
0;69;"maguadalupe";69;0;100
0;5;"maguerite";5;0;100
0;6;"maguette";6;0;100
518;63;"maguire";581;89.1566265060241;10.8433734939759
0;6;"magy";6;0;100
0;5;"mah";5;0;100
0;1594;"maha";1594;0;100
542;0;"mahad";542;100;0
10;0;"mahadev";10;100;0
16;0;"mahadi";16;100;0
0;6;"mahaela";6;0;100
0;24;"mahagany";24;0;100
0;207;"mahagony";207;0;100
0;118;"mahaila";118;0;100
0;22;"mahailey";22;0;100
0;51;"mahak";51;0;100
0;6;"mahal";6;0;100
0;2316;"mahala";2316;0;100
0;54;"mahalah";54;0;100
0;13;"mahalakshmi";13;0;100
0;5;"mahalet";5;0;100
0;346;"mahaley";346;0;100
0;10;"mahali";10;0;100
0;1834;"mahalia";1834;0;100
0;5;"mahaliah";5;0;100
0;164;"mahalie";164;0;100
0;6;"mahalya";6;0;100
0;252;"maham";252;0;100
319;0;"mahamadou";319;100;0
311;0;"mahamed";311;100;0
5;0;"mahammad";5;100;0
79;0;"mahamud";79;100;0
39;0;"mahan";39;100;0
0;36;"mahana";36;0;100
0;5;"mahani";5;0;100
182;173;"mahari";355;51.2676056338028;48.7323943661972
0;87;"mahasin";87;0;100
0;224;"mahathi";224;0;100
0;83;"mahati";83;0;100
0;17;"mahawa";17;0;100
0;728;"mahayla";728;0;100
0;5;"mahaylee";5;0;100
0;5;"mahaylia";5;0;100
6;0;"mahbeer";6;100;0
44;0;"mahd";44;100;0
5;0;"mahde";5;100;0
18;0;"mahdee";18;100;0
0;6;"mahdeen";6;0;100
1646;0;"mahdi";1646;100;0
0;10;"mahdia";10;0;100
0;94;"mahdiya";94;0;100
47;0;"mahdy";47;100;0
0;481;"mahealani";481;0;100
0;19;"mahee";19;0;100
6;533;"maheen";539;1.11317254174397;98.886827458256
15;0;"maheer";15;100;0
0;373;"mahek";373;0;100
0;31;"mahelet";31;0;100
0;5;"mahely";5;0;100
21;0;"mahendra";21;100;0
827;0;"maher";827;100;0
0;7;"mahera";7;0;100
203;0;"mahesh";203;100;0
15;896;"mahi";911;1.64654226125137;98.3534577387486
0;32;"mahia";32;0;100
5;0;"mahib";5;100;0
0;5;"mahibah";5;0;100
18;0;"mahid";18;100;0
0;5;"mahie";5;0;100
0;352;"mahika";352;0;100
0;389;"mahima";389;0;100
142;16;"mahin";158;89.873417721519;10.126582278481
0;356;"mahina";356;0;100
736;0;"mahir";736;100;0
0;241;"mahira";241;0;100
0;5;"mahirah";5;0;100
0;5;"mahisha";5;0;100
11;0;"mahit";11;100;0
0;32;"mahita";32;0;100
22;0;"mahith";22;100;0
0;78;"mahitha";78;0;100
0;95;"mahiya";95;0;100
0;37;"mahiyah";37;0;100
0;6;"mahjabeen";6;0;100
255;0;"mahkai";255;100;0
0;181;"mahkayla";181;0;100
0;13;"mahkaylah";13;0;100
20;0;"mahkel";20;100;0
0;12;"mahkenna";12;0;100
0;29;"mahkenzie";29;0;100
5;0;"mahkhi";5;100;0
738;0;"mahki";738;100;0
0;5;"mahkiya";5;0;100
0;12;"mahkya";12;0;100
0;5;"mahkyla";5;0;100
0;5;"mahlah";5;0;100
0;38;"mahlani";38;0;100
0;30;"mahlaya";30;0;100
0;21;"mahlea";21;0;100
0;11;"mahleah";11;0;100
10;0;"mahleek";10;100;0
5;0;"mahlek";5;100;0
0;5;"mahlena";5;0;100
0;182;"mahlet";182;0;100
0;91;"mahli";91;0;100
0;393;"mahlia";393;0;100
249;0;"mahlik";249;100;0
0;17;"mahliya";17;0;100
0;18;"mahliyah";18;0;100
4984;11;"mahlon";4995;99.7797797797798;0.22022022022022
302;0;"mahmood";302;100;0
2165;0;"mahmoud";2165;100;0
154;0;"mahmud";154;100;0
0;12;"mahnaz";12;0;100
0;50;"mahniya";50;0;100
0;663;"mahnoor";663;0;100
0;15;"maho";15;0;100
0;5;"mahoganee";5;0;100
0;10;"mahoganey";10;0;100
0;226;"mahogani";226;0;100
0;74;"mahoganie";74;0;100
0;3372;"mahogany";3372;0;100
0;11;"mahoghany";11;0;100
0;109;"mahogony";109;0;100
94;0;"mahonri";94;100;0
0;31;"mahra";31;0;100
0;112;"mahreen";112;0;100
0;57;"mahri";57;0;100
0;30;"mahria";30;0;100
0;11;"mahriah";11;0;100
0;58;"mahrosh";58;0;100
0;72;"mahrukh";72;0;100
5;0;"mahrus";5;100;0
0;86;"mahsa";86;0;100
6;0;"mahsiah";6;100;0
0;11;"mahtab";11;0;100
6;0;"mahue";6;100;0
0;190;"mahum";190;0;100
0;23;"mahveen";23;0;100
0;12;"mahwish";12;0;100
0;33;"mahya";33;0;100
15;0;"mahyar";15;100;0
20;5177;"mai";5197;0.384837406195882;99.6151625938041
0;12175;"maia";12175;0;100
0;809;"maiah";809;0;100
0;5;"maialen";5;0;100
0;57;"maiana";57;0;100
0;21;"maianh";21;0;100
0;43;"maiara";43;0;100
0;5;"maica";5;0;100
0;143;"maicee";143;0;100
0;75;"maicey";75;0;100
28;0;"maichael";28;100;0
0;102;"maicie";102;0;100
120;0;"maico";120;100;0
128;0;"maicol";128;100;0
28;0;"maicon";28;100;0
0;96;"maicy";96;0;100
0;10;"maicyn";10;0;100
0;2438;"maida";2438;0;100
0;21;"maidah";21;0;100
0;5;"maide";5;0;100
0;6;"maidee";6;0;100
0;6;"maidell";6;0;100
0;10;"maidelyn";10;0;100
0;22;"maiden";22;0;100
0;5;"maider";5;0;100
0;145;"maidie";145;0;100
0;5;"maidson";5;0;100
0;136;"maie";136;0;100
0;5;"maiella";5;0;100
0;14;"maielle";14;0;100
5;0;"maier";5;100;0
0;34;"maiesha";34;0;100
0;239;"maigan";239;0;100
0;109;"maigen";109;0;100
0;5;"maigon";5;0;100
0;5;"maiha";5;0;100
0;1086;"maija";1086;0;100
0;6;"maijah";6;0;100
72;0;"maijor";72;100;0
205;376;"maika";581;35.2839931153184;64.7160068846816
0;64;"maikayla";64;0;100
121;0;"maikel";121;100;0
0;6;"maiken";6;0;100
5;0;"maiki";5;100;0
0;15;"maikia";15;0;100
28;71;"maiko";99;28.2828282828283;71.7171717171717
66;0;"maikol";66;100;0
0;38;"maikou";38;0;100
0;371;"maila";371;0;100
0;26;"mailah";26;0;100
0;33;"mailan";33;0;100
0;236;"mailani";236;0;100
0;5;"mailany";5;0;100
0;3433;"maile";3433;0;100
0;5;"mailea";5;0;100
0;492;"mailee";492;0;100
0;37;"maileen";37;0;100
0;20;"mailei";20;0;100
0;6;"maileigh";6;0;100
0;217;"mailen";217;0;100
0;10;"mailene";10;0;100
0;374;"mailey";374;0;100
0;334;"maili";334;0;100
0;11;"mailia";11;0;100
0;17;"mailie";17;0;100
0;152;"mailin";152;0;100
0;5;"mailing";5;0;100
0;24;"mailinh";24;0;100
6;0;"mailk";6;100;0
0;189;"maille";189;0;100
5;0;"mailo";5;100;0
5;0;"mailon";5;100;0
0;387;"maily";387;0;100
0;621;"mailyn";621;0;100
0;152;"mailynn";152;0;100
0;19;"maimoona";19;0;100
0;392;"maimouna";392;0;100
0;184;"maimuna";184;0;100
0;5;"maina";5;0;100
0;17;"mainhia";17;0;100
104;0;"mainor";104;100;0
0;5;"mainou";5;0;100
0;6;"maiquel";6;0;100
17;5772;"maira";5789;0.293660390395578;99.7063396096044
0;18;"mairah";18;0;100
0;54;"mairani";54;0;100
0;112;"mairany";112;0;100
0;862;"maire";862;0;100
0;1151;"mairead";1151;0;100
0;5;"maireli";5;0;100
0;84;"mairely";84;0;100
0;70;"mairen";70;0;100
0;11;"mairene";11;0;100
0;6;"mairenn";6;0;100
0;243;"mairi";243;0;100
0;114;"mairim";114;0;100
0;616;"mairin";616;0;100
0;74;"mairlyn";74;0;100
42;0;"mairon";42;100;0
0;134;"mairyn";134;0;100
0;34;"mais";34;0;100
0;168;"maisa";168;0;100
0;17;"maisah";17;0;100
0;100;"maisee";100;0;100
193;54;"maisen";247;78.1376518218623;21.8623481781377
0;528;"maisey";528;0;100
0;1737;"maisha";1737;0;100
0;4654;"maisie";4654;0;100
0;58;"maisley";58;0;100
0;16;"maislyn";16;0;100
0;5;"maislynn";5;0;100
2746;587;"maison";3333;82.3882388238824;17.6117611761176
0;16;"maissa";16;0;100
0;1841;"maisy";1841;0;100
28;292;"maisyn";320;8.75;91.25
0;5;"maita";5;0;100
0;2913;"maite";2913;0;100
0;5;"maitha";5;0;100
0;14;"maithe";14;0;100
0;28;"maithili";28;0;100
0;5;"maiti";5;0;100
221;125;"maitland";346;63.8728323699422;36.1271676300578
0;11;"maitlin";11;0;100
0;101;"maitlyn";101;0;100
10;7;"maitreya";17;58.8235294117647;41.1764705882353
0;22;"maitreyi";22;0;100
0;95;"maitri";95;0;100
0;41;"maitte";41;0;100
0;19;"maive";19;0;100
0;8;"maiven";8;0;100
0;7;"maivy";7;0;100
0;3612;"maiya";3612;0;100
0;424;"maiyah";424;0;100
0;5;"maiyana";5;0;100
0;10;"maiyer";10;0;100
0;22;"maiysha";22;0;100
0;17;"maiza";17;0;100
0;8;"maizah";8;0;100
10;39;"maize";49;20.4081632653061;79.5918367346939
0;154;"maizee";154;0;100
10;0;"maizen";10;100;0
0;283;"maizey";283;0;100
0;1415;"maizie";1415;0;100
0;10;"maizley";10;0;100
0;7;"maizlyn";7;0;100
0;842;"maizy";842;0;100
0;1646;"maja";1646;0;100
0;18;"majayla";18;0;100
382;10;"majd";392;97.4489795918367;2.55102040816327
0;11;"majda";11;0;100
21;0;"majdi";21;100;0
289;0;"majed";289;100;0
50;0;"majeed";50;100;0
0;5;"majeeda";5;0;100
0;349;"majel";349;0;100
0;6;"majella";6;0;100
0;7;"majenta";7;0;100
32;0;"majer";32;100;0
0;22;"majerle";22;0;100
0;179;"majesta";179;0;100
0;76;"majesti";76;0;100
119;220;"majestic";339;35.1032448377581;64.8967551622419
0;5;"majestie";5;0;100
229;800;"majesty";1029;22.2546161321672;77.7453838678329
5;0;"majic";5;100;0
511;0;"majid";511;100;0
0;5;"majida";5;0;100
13;0;"majik";13;100;0
0;5;"majken";5;0;100
6;0;"majok";6;100;0
14096;28;"major";14124;99.8017558765222;0.198244123477768
0;1334;"majorie";1334;0;100
0;5;"majorlynn";5;0;100
58;0;"majour";58;100;0
0;5;"majuma";5;0;100
10;0;"majur";10;100;0
77;0;"mak";77;100;0
0;34;"maka";34;0;100
0;5;"makada";5;0;100
31;0;"makade";31;100;0
28;0;"makaden";28;100;0
71;0;"makael";71;100;0
0;2557;"makaela";2557;0;100
0;103;"makaelah";103;0;100
0;148;"makaelyn";148;0;100
0;22;"makaelynn";22;0;100
12;0;"makah";12;100;0
53;0;"makahi";53;100;0
0;6;"makahia";6;0;100
0;107;"makahla";107;0;100
4473;226;"makai";4699;95.1904660566078;4.80953394339221
0;248;"makaia";248;0;100
5;126;"makaiah";131;3.81679389312977;96.1832061068702
6;0;"makaiden";6;100;0
44;0;"makaih";44;100;0
13;0;"makaii";13;100;0
144;0;"makail";144;100;0
0;4514;"makaila";4514;0;100
0;493;"makailah";493;0;100
0;70;"makailee";70;0;100
0;70;"makailey";70;0;100
0;11;"makaili";11;0;100
0;5;"makaily";5;0;100
0;227;"makailyn";227;0;100
0;27;"makailynn";27;0;100
641;0;"makaio";641;100;0
0;6;"makaira";6;0;100
10;0;"makaius";10;100;0
0;409;"makaiya";409;0;100
0;157;"makaiyah";157;0;100
0;28;"makaiyla";28;0;100
7;0;"makal";7;100;0
5;3345;"makala";3350;0.149253731343284;99.8507462686567
0;643;"makalah";643;0;100
5;0;"makalani";5;100;0
204;0;"makale";204;100;0
0;5;"makalea";5;0;100
6;0;"makaleb";6;100;0
0;53;"makalee";53;0;100
0;5;"makalei";5;0;100
0;102;"makaleigh";102;0;100
0;120;"makaley";120;0;100
0;34;"makali";34;0;100
0;372;"makalia";372;0;100
0;50;"makaliah";50;0;100
0;37;"makalie";37;0;100
0;24;"makalla";24;0;100
0;300;"makalya";300;0;100
0;366;"makalyn";366;0;100
0;135;"makalynn";135;0;100
0;11;"makamae";11;0;100
399;247;"makana";646;61.7647058823529;38.2352941176471
0;5;"makanalei";5;0;100
216;34;"makani";250;86.4;13.6
0;5;"makanna";5;0;100
5;0;"makao";5;100;0
68;0;"makar";68;100;0
0;192;"makara";192;0;100
0;5;"makarah";5;0;100
461;90;"makari";551;83.6660617059891;16.3339382940109
0;70;"makaria";70;0;100
5;0;"makarie";5;100;0
6;0;"makario";6;100;0
71;0;"makarios";71;100;0
5;0;"makarius";5;100;0
0;6;"makasha";6;0;100
0;5;"makasia";5;0;100
5;0;"makauri";5;100;0
71;0;"makaveli";71;100;0
35;37;"makay";72;48.6111111111111;51.3888888888889
0;911;"makaya";911;0;100
0;177;"makayah";177;0;100
0;11;"makayda";11;0;100
18;39;"makayden";57;31.5789473684211;68.4210526315789
0;75;"makayela";75;0;100
0;90;"makayia";90;0;100
0;5;"makayiah";5;0;100
152;99329;"makayla";99481;0.15279299564741;99.8472070043526
0;2852;"makaylah";2852;0;100
0;46;"makaylan";46;0;100
0;154;"makayle";154;0;100
0;11;"makaylea";11;0;100
0;1326;"makaylee";1326;0;100
0;87;"makayleigh";87;0;100
0;100;"makaylen";100;0;100
0;12;"makayley";12;0;100
0;113;"makayli";113;0;100
0;216;"makaylia";216;0;100
0;5;"makayliah";5;0;100
0;273;"makaylie";273;0;100
0;340;"makaylin";340;0;100
0;57;"makaylla";57;0;100
0;5;"makayln";5;0;100
0;202;"makaylyn";202;0;100
0;159;"makaylynn";159;0;100
5;0;"makayo";5;100;0
27;0;"makbel";27;100;0
0;50;"makda";50;0;100
0;6;"makea";6;0;100
0;702;"makeba";702;0;100
0;1530;"makeda";1530;0;100
0;15;"makeeba";15;0;100
19;0;"makeen";19;100;0
0;41;"makeena";41;0;100
0;41;"makeesha";41;0;100
22;0;"makei";22;100;0
0;39;"makeia";39;0;100
0;226;"makeila";226;0;100
0;6;"makeira";6;0;100
0;229;"makeisha";229;0;100
0;6;"makeitha";6;0;100
634;48;"makel";682;92.9618768328446;7.03812316715543
0;286;"makela";286;0;100
0;5;"makelah";5;0;100
268;149;"makell";417;64.2685851318945;35.7314148681055
0;80;"makella";80;0;100
0;137;"makelle";137;0;100
84;5405;"makena";5489;1.53033339406085;98.4696666059392
0;277;"makenah";277;0;100
0;94;"makendra";94;0;100
0;115;"makenize";115;0;100
0;238;"makenlee";238;0;100
0;7;"makenlei";7;0;100
0;67;"makenleigh";67;0;100
0;208;"makenley";208;0;100
0;70;"makenli";70;0;100
0;60;"makenlie";60;0;100
0;102;"makenly";102;0;100
8;26766;"makenna";26774;0.0298797340703668;99.9701202659296
0;605;"makennah";605;0;100
0;5;"makennzie";5;0;100
0;126;"makensey";126;0;100
0;52;"makensi";52;0;100
0;651;"makensie";651;0;100
0;30;"makensley";30;0;100
0;51;"makensy";51;0;100
0;34;"makenya";34;0;100
0;187;"makenze";187;0;100
0;883;"makenzee";883;0;100
0;168;"makenzey";168;0;100
0;3220;"makenzi";3220;0;100
288;38198;"makenzie";38486;0.748324065894091;99.2516759341059
0;32;"makenzii";32;0;100
0;13;"makenzlee";13;0;100
0;6;"makenzley";6;0;100
0;10;"makenzly";10;0;100
0;1352;"makenzy";1352;0;100
0;190;"makenzye";190;0;100
6;0;"makeo";6;100;0
0;473;"makesha";473;0;100
0;98;"makeshia";98;0;100
0;5;"makesia";5;0;100
0;43;"maketa";43;0;100
0;5;"maketta";5;0;100
0;15;"makeva";15;0;100
0;96;"makeya";96;0;100
0;271;"makeyla";271;0;100
571;0;"makhai";571;100;0
34;0;"makhail";34;100;0
0;26;"makhaila";26;0;100
0;48;"makhala";48;0;100
67;12;"makhari";79;84.8101265822785;15.1898734177215
0;5;"makhaya";5;0;100
0;97;"makhayla";97;0;100
10;0;"makhel";10;100;0
2957;52;"makhi";3009;98.2718511133267;1.72814888667331
0;694;"makhia";694;0;100
11;0;"makhii";11;100;0
0;28;"makhila";28;0;100
0;173;"makhiya";173;0;100
0;10;"makhiyah";10;0;100
16;0;"makhy";16;100;0
0;115;"makhya";115;0;100
0;19;"makhyia";19;0;100
0;47;"makhyla";47;0;100
436;180;"maki";616;70.7792207792208;29.2207792207792
28;1318;"makia";1346;2.08023774145617;97.9197622585438
340;1938;"makiah";2278;14.9253731343284;85.0746268656716
0;5;"makiala";5;0;100
0;40;"makiaya";40;0;100
0;42;"makiba";42;0;100
0;10;"makida";10;0;100
5;0;"makieh";5;100;0
5;0;"makiel";5;100;0
0;10;"makiesha";10;0;100
0;16;"makieya";16;0;100
86;0;"makih";86;100;0
39;0;"makii";39;100;0
0;18;"makiko";18;0;100
11;0;"makil";11;100;0
0;304;"makila";304;0;100
0;138;"makilah";138;0;100
0;5;"makiley";5;0;100
16;0;"makin";16;100;0
0;90;"makina";90;0;100
0;56;"makini";56;0;100
0;340;"makinlee";340;0;100
0;47;"makinleigh";47;0;100
0;1368;"makinley";1368;0;100
0;10;"makinlie";10;0;100
0;45;"makinly";45;0;100
0;334;"makinna";334;0;100
0;5;"makinnah";5;0;100
0;34;"makinnley";34;0;100
0;304;"makinsey";304;0;100
0;79;"makinsley";79;0;100
0;154;"makinze";154;0;100
0;185;"makinzee";185;0;100
0;65;"makinzey";65;0;100
0;189;"makinzi";189;0;100
0;829;"makinzie";829;0;100
0;180;"makinzy";180;0;100
0;193;"makira";193;0;100
0;23;"makirah";23;0;100
7;0;"makis";7;100;0
0;446;"makisha";446;0;100
0;309;"makita";309;0;100
6;0;"makiy";6;100;0
14;2687;"makiya";2701;0.518326545723806;99.4816734542762
20;2736;"makiyah";2756;0.725689404934688;99.2743105950653
0;22;"makiyha";22;0;100
0;117;"makiyla";117;0;100
0;18;"makiylah";18;0;100
0;21;"makkah";21;0;100
0;5;"makkiyah";5;0;100
0;5;"maklyn";5;0;100
0;6;"maklynn";6;0;100
72;46;"mako";118;61.0169491525424;38.9830508474576
550;0;"makoa";550;100;0
5;0;"makoi";5;100;0
16;0;"makonnen";16;100;0
464;0;"makoto";464;100;0
25;0;"makoy";25;100;0
231;0;"maks";231;100;0
6;0;"maksen";6;100;0
1851;0;"maksim";1851;100;0
11;0;"maksimus";11;100;0
15;0;"makson";15;100;0
5;0;"makston";5;100;0
332;0;"maksym";332;100;0
329;0;"maksymilian";329;100;0
9;0;"makua";9;100;0
92;1004;"makya";1096;8.39416058394161;91.6058394160584
43;675;"makyah";718;5.98885793871866;94.0111420612813
317;0;"makye";317;100;0
82;0;"makyi";82;100;0
0;395;"makyia";395;0;100
0;192;"makyiah";192;0;100
0;2170;"makyla";2170;0;100
0;458;"makylah";458;0;100
137;0;"makyle";137;100;0
0;111;"makylee";111;0;100
0;12;"makyleigh";12;0;100
0;22;"makylia";22;0;100
0;117;"makylie";117;0;100
0;66;"makyna";66;0;100
0;459;"makynlee";459;0;100
0;5;"makynlei";5;0;100
0;66;"makynleigh";66;0;100
0;25;"makynley";25;0;100
0;178;"makynli";178;0;100
0;65;"makynlie";65;0;100
0;403;"makynna";403;0;100
0;5;"makynsie";5;0;100
0;47;"makynze";47;0;100
0;158;"makynzee";158;0;100
0;181;"makynzi";181;0;100
0;712;"makynzie";712;0;100
0;292;"makyra";292;0;100
0;39;"makyrah";39;0;100
290;0;"mal";290;100;0
0;611;"mala";611;0;100
0;245;"malaak";245;0;100
93;0;"malacai";93;100;0
929;0;"malachai";929;100;0
43320;226;"malachi";43546;99.4810085886189;0.518991411381068
11;20;"malachia";31;35.4838709677419;64.5161290322581
539;0;"malachy";539;100;0
0;5;"malacia";5;0;100
0;5;"malack";5;0;100
56;0;"malacki";56;100;0
0;44;"malae";44;0;100
0;10;"malaeka";10;0;100
0;5;"malaena";5;0;100
0;5;"malaeya";5;0;100
11;0;"malahkai";11;100;0
69;0;"malahki";69;100;0
0;20;"malahni";20;0;100
0;120;"malai";120;0;100
0;180;"malaia";180;0;100
0;119;"malaiah";119;0;100
0;34;"malaija";34;0;100
0;98;"malaijah";98;0;100
0;2035;"malaika";2035;0;100
0;23;"malaikah";23;0;100
0;18;"malaila";18;0;100
0;763;"malaina";763;0;100
0;5;"malaine";5;0;100
0;130;"malaisha";130;0;100
0;10;"malaisia";10;0;100
0;234;"malaiya";234;0;100
0;169;"malaiyah";169;0;100
0;48;"malaja";48;0;100
0;218;"malajah";218;0;100
0;5;"malajia";5;0;100
157;2679;"malak";2836;5.53596614950635;94.4640338504936
0;142;"malaka";142;0;100
6185;21;"malakai";6206;99.6616177892362;0.338382210763777
5;0;"malakei";5;100;0
174;0;"malakhai";174;100;0
1452;0;"malakhi";1452;100;0
3368;5;"malaki";3373;99.8517640083012;0.148235991698784
49;8;"malakia";57;85.9649122807018;14.0350877192982
38;0;"malakiah";38;100;0
70;0;"malakie";70;100;0
46;0;"malakii";46;100;0
61;0;"malaky";61;100;0
371;0;"malakye";371;100;0
18;0;"malakyi";18;100;0
0;40;"malala";40;0;100
0;5;"malalai";5;0;100
5;130;"malan";135;3.7037037037037;96.2962962962963
0;976;"malana";976;0;100
0;12;"malanda";12;0;100
0;72;"malaney";72;0;100
0;1217;"malani";1217;0;100
0;219;"malania";219;0;100
0;652;"malanie";652;0;100
0;10;"malanii";10;0;100
0;19;"malanna";19;0;100
0;10;"malanni";10;0;100
0;10;"malany";10;0;100
0;5;"malanya";5;0;100
49;0;"malaquias";49;100;0
0;33;"malaree";33;0;100
0;35;"malari";35;0;100
0;744;"malarie";744;0;100
0;123;"malary";123;0;100
0;95;"malasha";95;0;100
0;104;"malashia";104;0;100
0;639;"malasia";639;0;100
0;32;"malaun";32;0;100
11;0;"malav";11;100;0
0;69;"malavika";69;0;100
0;96;"malay";96;0;100
0;4926;"malaya";4926;0;100
0;1964;"malayah";1964;0;100
0;134;"malayasia";134;0;100
0;16;"malayha";16;0;100
0;325;"malayia";325;0;100
0;166;"malayiah";166;0;100
0;86;"malayja";86;0;100
0;126;"malayjah";126;0;100
0;26;"malayka";26;0;100
0;176;"malayla";176;0;100
0;1104;"malayna";1104;0;100
0;5;"malaysa";5;0;100
0;469;"malaysha";469;0;100
0;349;"malayshia";349;0;100
0;6786;"malaysia";6786;0;100
0;28;"malaysiah";28;0;100
0;69;"malayzia";69;0;100
0;6;"malaz";6;0;100
0;18;"malazia";18;0;100
5;0;"malchijah";5;100;0
5;0;"malcohm";5;100;0
59899;119;"malcolm";60018;99.801726148822;0.19827385117798
10;0;"malcolmjamal";10;100;0
7;0;"malcoln";7;100;0
5133;0;"malcom";5133;100;0
105;0;"malcomb";105;100;0
96;0;"malcome";96;100;0
17;0;"malcon";17;100;0
47;0;"malcum";47;100;0
0;10;"malda";10;0;100
5;0;"malden";5;100;0
1525;0;"male";1525;100;0
0;2176;"malea";2176;0;100
0;6791;"maleah";6791;0;100
0;163;"maleaha";163;0;100
203;0;"maleak";203;100;0
0;16;"maleana";16;0;100
0;5;"maleaya";5;0;100
11;0;"malec";11;100;0
52;0;"malechi";52;100;0
0;10;"malecia";10;0;100
6;0;"maleck";6;100;0
0;288;"malee";288;0;100
0;196;"maleea";196;0;100
0;182;"maleeah";182;0;100
0;233;"maleeha";233;0;100
0;18;"maleehah";18;0;100
1638;0;"maleek";1638;100;0
0;211;"maleeka";211;0;100
0;678;"maleena";678;0;100
0;5;"maleesa";5;0;100
0;273;"maleeya";273;0;100
0;163;"maleeyah";163;0;100
0;5;"maleficent";5;0;100
0;5;"maleha";5;0;100
0;5;"malei";5;0;100
0;715;"maleia";715;0;100
0;199;"maleiah";199;0;100
0;190;"maleigh";190;0;100
0;1073;"maleigha";1073;0;100
370;0;"maleik";370;100;0
0;29;"maleika";29;0;100
0;18;"maleina";18;0;100
0;7;"maleisha";7;0;100
0;66;"maleiya";66;0;100
0;69;"maleiyah";69;0;100
1998;6;"malek";2004;99.7005988023952;0.29940119760479
0;378;"maleka";378;0;100
125;0;"malekai";125;100;0
200;0;"maleke";200;100;0
31;0;"malekhi";31;100;0
208;0;"maleki";208;100;0
0;10;"malekia";10;0;100
46;0;"maleko";46;100;0
15;5;"malen";20;75;25
0;3360;"malena";3360;0;100
0;11;"malenda";11;0;100
0;164;"malene";164;0;100
0;224;"maleni";224;0;100
0;46;"malenie";46;0;100
0;5;"malenna";5;0;100
0;6;"malenny";6;0;100
0;434;"maleny";434;0;100
0;10;"maleri";10;0;100
0;1151;"malerie";1151;0;100
0;34;"malery";34;0;100
0;32;"malesa";32;0;100
0;72;"malesha";72;0;100
0;5;"malesia";5;0;100
0;74;"malessa";74;0;100
0;62;"maleta";62;0;100
0;6;"maletha";6;0;100
0;20;"malette";20;0;100
5;0;"malex";5;100;0
0;164;"maley";164;0;100
0;387;"maleya";387;0;100
0;429;"maleyah";429;0;100
0;35;"maleyna";35;0;100
6;0;"malford";6;100;0
0;81;"malgorzata";81;0;100
37;0;"malhar";37;100;0
38;982;"mali";1020;3.72549019607843;96.2745098039216
0;21075;"malia";21075;0;100
0;3461;"maliah";3461;0;100
11;0;"maliak";11;100;0
0;62;"maliaka";62;0;100
0;5;"malialani";5;0;100
0;16;"maliana";16;0;100
0;11;"maliaya";11;0;100
0;10;"maliayah";10;0;100
0;50;"malibu";50;0;100
133;0;"malic";133;100;0
0;10;"malica";10;0;100
22;0;"malicah";22;100;0
11;0;"malicai";11;100;0
12;0;"malichai";12;100;0
421;0;"malichi";421;100;0
0;110;"malicia";110;0;100
472;0;"malick";472;100;0
0;5;"malicka";5;0;100
0;293;"malie";293;0;100
0;82;"maliea";82;0;100
944;0;"maliek";944;100;0
0;21;"malieka";21;0;100
0;5;"malieya";5;0;100
0;1049;"maliha";1049;0;100
93;0;"maliik";93;100;0
50;94;"malijah";144;34.7222222222222;65.2777777777778
42182;259;"malik";42441;99.3897410522844;0.610258947715652
36;4252;"malika";4288;0.83955223880597;99.160447761194
76;884;"malikah";960;7.91666666666667;92.0833333333333
908;0;"malikai";908;100;0
5;0;"malikaih";5;100;0
166;0;"malike";166;100;0
21;0;"malikhai";21;100;0
214;0;"malikhi";214;100;0
844;0;"maliki";844;100;0
5;45;"malikia";50;10;90
64;0;"malikiah";64;100;0
0;5;"malikiya";5;0;100
37;0;"malikk";37;100;0
0;10;"malikka";10;0;100
46;0;"maliky";46;100;0
276;0;"malikye";276;100;0
0;30;"malila";30;0;100
0;7;"malillani";7;0;100
0;144;"malillany";144;0;100
181;611;"malin";792;22.8535353535354;77.1464646464647
0;3528;"malina";3528;0;100
0;16;"malinah";16;0;100
0;13;"malinalli";13;0;100
0;19689;"malinda";19689;0;100
0;10;"malindia";10;0;100
0;34;"maline";34;0;100
0;288;"malini";288;0;100
646;0;"maliq";646;100;0
1740;11;"malique";1751;99.3717875499714;0.628212450028555
0;5;"malira";5;0;100
0;2313;"malisa";2313;0;100
0;30;"malise";30;0;100
0;626;"malisha";626;0;100
0;17;"malisia";17;0;100
0;8429;"malissa";8429;0;100
0;441;"malissia";441;0;100
0;335;"malissie";335;0;100
0;123;"malita";123;0;100
0;1738;"maliya";1738;0;100
0;9650;"maliyah";9650;0;100
0;42;"maliyani";42;0;100
0;40;"maliyha";40;0;100
0;11;"maliza";11;0;100
0;22;"malk";22;0;100
5;4529;"malka";4534;0.110277900308778;99.8897220996912
0;17;"malkah";17;0;100
0;30;"malke";30;0;100
0;225;"malkia";225;0;100
0;83;"malkie";83;0;100
23;0;"malkiel";23;100;0
16;0;"malkolm";16;100;0
0;1647;"malky";1647;0;100
0;31;"mallak";31;0;100
18;0;"mallaki";18;100;0
5;0;"mallard";5;100;0
0;21;"mallari";21;0;100
0;204;"mallarie";204;0;100
0;753;"mallary";753;0;100
0;6;"mallee";6;0;100
0;19;"mallely";19;0;100
0;78;"mallerie";78;0;100
0;11;"mallerly";11;0;100
0;481;"mallery";481;0;100
5;0;"mallex";5;100;0
0;181;"malley";181;0;100
0;65;"malli";65;0;100
0;5;"mallia";5;0;100
402;2550;"mallie";2952;13.6178861788618;86.3821138211382
19;0;"mallik";19;100;0
0;332;"mallika";332;0;100
0;5;"mallina";5;0;100
0;99;"mallisa";99;0;100
0;128;"mallissa";128;0;100
0;17;"malliyah";17;0;100
0;248;"malloree";248;0;100
0;64;"mallorey";64;0;100
0;1484;"mallori";1484;0;100
0;3981;"mallorie";3981;0;100
1094;53378;"mallory";54472;2.00837127331473;97.9916287266853
31;0;"malloy";31;100;0
0;141;"mally";141;0;100
52;0;"malo";52;100;0
294;63;"malon";357;82.3529411764706;17.6470588235294
0;5;"malonda";5;0;100
252;188;"malone";440;57.2727272727273;42.7272727272727
0;108;"maloni";108;0;100
0;53;"malonie";53;0;100
0;5;"malonna";5;0;100
0;12;"malonni";12;0;100
0;15;"malonnie";15;0;100
0;20;"malora";20;0;100
0;288;"maloree";288;0;100
0;47;"malorey";47;0;100
0;736;"malori";736;0;100
0;3615;"malorie";3615;0;100
0;1266;"malory";1266;0;100
74;0;"malosi";74;100;0
21;0;"maloy";21;100;0
5;0;"malquan";5;100;0
0;55;"malta";55;0;100
0;5;"maltie";5;0;100
5;0;"malton";5;100;0
0;85;"malu";85;0;100
0;5;"maluhia";5;0;100
0;5;"malulani";5;0;100
0;209;"malva";209;0;100
11;0;"malven";11;100;0
0;44;"malvena";44;0;100
0;7;"malvene";7;0;100
0;22;"malvenia";22;0;100
385;0;"malvern";385;100;0
0;11;"malvery";11;0;100
0;5;"malvie";5;0;100
0;69;"malvika";69;0;100
2613;12;"malvin";2625;99.5428571428571;0.457142857142857
0;1356;"malvina";1356;0;100
0;22;"malvine";22;0;100
0;5;"malwina";5;0;100
0;204;"maly";204;0;100
0;206;"malya";206;0;100
0;198;"malyah";198;0;100
0;10;"malyha";10;0;100
0;65;"malyia";65;0;100
0;111;"malyiah";111;0;100
295;0;"malyk";295;100;0
0;38;"malyka";38;0;100
34;0;"malykai";34;100;0
17;0;"malyke";17;100;0
45;0;"malyki";45;100;0
0;150;"malyn";150;0;100
0;89;"malyna";89;0;100
0;897;"malynda";897;0;100
0;192;"malynn";192;0;100
0;11;"malysa";11;0;100
0;7;"malysia";7;0;100
0;388;"malyssa";388;0;100
0;16;"malzie";16;0;100
0;30;"mama";30;0;100
16;0;"mamadi";16;100;0
1293;0;"mamadou";1293;100;0
5;0;"mamadu";5;100;0
31;0;"mamady";31;100;0
0;335;"mame";335;0;100
0;23;"mamediarra";23;0;100
0;13;"mami";13;0;100
240;61299;"mamie";61539;0.389996587529859;99.6100034124701
0;2293;"mammie";2293;0;100
25;0;"mamon";25;100;0
18;0;"mamoon";18;100;0
182;0;"mamoru";182;100;0
68;0;"mamoudou";68;100;0
28;0;"mamoun";28;100;0
0;39;"mamta";39;0;100
0;5;"mamy";5;0;100
0;236;"mamye";236;0;100
192;76;"man";268;71.6417910447761;28.3582089552239
64;516;"mana";580;11.0344827586207;88.9655172413793
0;215;"manaal";215;0;100
19;0;"manabu";19;100;0
0;5;"manada";5;0;100
12;0;"manaf";12;100;0
0;7;"manahal";7;0;100
0;6;"manahel";6;0;100
0;283;"manahil";283;0;100
11;174;"manaia";185;5.94594594594595;94.0540540540541
0;1090;"manal";1090;0;100
0;69;"manali";69;0;100
0;104;"manami";104;0;100
242;0;"manan";242;100;0
5;599;"manar";604;0.827814569536424;99.1721854304636
41;0;"manard";41;100;0
261;0;"manas";261;100;0
0;272;"manasa";272;0;100
30;0;"manase";30;100;0
146;0;"manases";146;100;0
0;187;"manasi";187;0;100
381;5;"manasseh";386;98.7046632124352;1.29533678756477
0;303;"manasvi";303;0;100
0;53;"manasvini";53;0;100
0;21;"manaswini";21;0;100
5;0;"manaure";5;100;0
636;0;"manav";636;100;0
0;5;"manavi";5;0;100
0;26;"manaya";26;0;100
17;0;"manbir";17;100;0
232;0;"mance";232;100;0
247;0;"mancel";247;100;0
5;0;"mancie";5;100;0
115;0;"mancil";115;100;0
10;15;"mancy";25;40;60
0;2915;"manda";2915;0;100
0;5;"mandala";5;0;100
0;5;"mandalin";5;0;100
0;300;"mandalyn";300;0;100
0;33;"mandalynn";33;0;100
0;43;"mandana";43;0;100
0;92;"mande";92;0;100
0;887;"mandee";887;0;100
251;160;"mandeep";411;61.0705596107056;38.9294403892944
583;0;"mandel";583;100;0
145;0;"mandela";145;100;0
287;0;"mandell";287;100;0
0;16;"mandelyn";16;0;100
0;8;"mandey";8;0;100
0;9953;"mandi";9953;0;100
0;2648;"mandie";2648;0;100
0;34;"mandilyn";34;0;100
0;374;"mandisa";374;0;100
0;10;"mandisha";10;0;100
107;0;"mando";107;100;0
0;179;"mandolin";179;0;100
0;58;"mandolyn";58;0;100
0;49;"mandra";49;0;100
5;0;"mandre";5;100;0
6;0;"mandrel";6;100;0
250;0;"mandrell";250;100;0
0;19;"mandria";19;0;100
29;0;"mandrill";29;100;0
138;41088;"mandy";41226;0.334740212487265;99.6652597875127
0;5;"mandye";5;0;100
0;52;"mane";52;0;100
0;5;"manee";5;0;100
32;0;"maneesh";32;100;0
0;5;"maneesha";5;0;100
13;0;"maneet";13;100;0
0;69;"maneh";69;0;100
0;44;"maneka";44;0;100
0;39;"manerva";39;0;100
0;35;"manervia";35;0;100
0;28;"manesha";28;0;100
0;88;"manessa";88;0;100
0;57;"manetta";57;0;100
0;304;"manette";304;0;100
6;0;"manferd";6;100;0
1408;0;"manford";1408;100;0
1430;0;"manfred";1430;100;0
5;0;"manfredo";5;100;0
11;0;"manfried";11;100;0
71;29;"mang";100;71;29
10;0;"manh";10;100;0
0;628;"manha";628;0;100
5;65;"manhattan";70;7.14285714285714;92.8571428571429
87;5;"mani";92;94.5652173913043;5.43478260869565
0;18;"mania";18;0;100
0;221;"maniah";221;0;100
0;39;"manica";39;0;100
0;348;"manie";348;0;100
5;0;"manifred";5;100;0
0;6;"manija";6;0;100
0;14;"manijah";14;0;100
0;5;"manijeh";5;0;100
22;0;"manik";22;100;0
0;195;"manika";195;0;100
0;69;"manila";69;0;100
0;78;"manilla";78;0;100
0;38;"manina";38;0;100
17;0;"maninder";17;100;0
0;16;"manique";16;0;100
0;5;"manisa";5;0;100
523;0;"manish";523;100;0
0;854;"manisha";854;0;100
41;0;"manit";41;100;0
0;5;"manita";5;0;100
0;523;"maniya";523;0;100
0;574;"maniyah";574;0;100
0;6;"manjari";6;0;100
5;0;"manjinder";5;100;0
0;10;"manjit";10;0;100
141;95;"manjot";236;59.7457627118644;40.2542372881356
0;12;"manju";12;0;100
5;0;"mankirat";5;100;0
2088;0;"manley";2088;100;0
11;0;"manlio";11;100;0
501;0;"manly";501;100;0
35;77;"manmeet";112;31.25;68.75
127;0;"mann";127;100;0
0;140;"manna";140;0;100
24;0;"mannan";24;100;0
0;311;"mannat";311;0;100
0;6;"mannette";6;0;100
941;401;"mannie";1342;70.1192250372578;29.8807749627422
1570;38;"manning";1608;97.636815920398;2.36318407960199
417;0;"mannix";417;100;0
7;5;"mannon";12;58.3333333333333;41.6666666666667
11;0;"mannuel";11;100;0
3623;0;"manny";3623;100;0
18;0;"mano";18;100;0
24;0;"manoa";24;100;0
145;0;"manoah";145;100;0
0;5;"manogna";5;0;100
225;0;"manoj";225;100;0
0;52;"manola";52;0;100
18;0;"manolis";18;100;0
111;0;"manolito";111;100;0
812;0;"manolo";812;100;0
5;765;"manon";770;0.649350649350649;99.3506493506494
0;8;"manouchka";8;0;100
0;5;"manoy";5;0;100
203;338;"manpreet";541;37.5231053604436;62.4768946395564
276;0;"manraj";276;100;0
0;118;"manreet";118;0;100
50;0;"manrique";50;100;0
0;37;"manroop";37;0;100
71;0;"mansa";71;100;0
280;0;"mansel";280;100;0
15;0;"mansell";15;100;0
489;0;"mansfield";489;100;0
0;6;"mansha";6;0;100
0;5;"manshi";5;0;100
0;452;"mansi";452;0;100
0;18;"mansirat";18;0;100
735;0;"manson";735;100;0
255;0;"mansoor";255;100;0
305;0;"mansour";305;100;0
178;0;"mansur";178;100;0
23;0;"mantas";23;100;0
0;9;"mantasha";9;0;100
8;0;"mantej";8;100;0
5;0;"manthan";5;100;0
39;0;"manton";39;100;0
10;0;"mantra";10;100;0
530;5;"manu";535;99.0654205607477;0.934579439252336
1022;0;"manual";1022;100;0
180114;1153;"manuel";181267;99.3639217287206;0.636078271279383
35;10065;"manuela";10100;0.346534653465347;99.6534653465347
0;908;"manuelita";908;0;100
136;0;"manuelito";136;100;0
5;0;"manuell";5;100;0
0;488;"manuella";488;0;100
14;0;"manuelle";14;100;0
5;0;"manul";5;100;0
125;0;"manus";125;100;0
0;6;"manushri";6;0;100
166;10;"manveer";176;94.3181818181818;5.68181818181818
22;0;"manvel";22;100;0
0;93;"manvi";93;0;100
29;0;"manvik";29;100;0
5;0;"manvil";5;100;0
76;0;"manville";76;100;0
177;23;"manvir";200;88.5;11.5
14;0;"manvith";14;100;0
0;21;"manvitha";21;0;100
5;0;"manwell";5;100;0
0;26;"many";26;0;100
0;900;"manya";900;0;100
0;42;"manyah";42;0;100
5;0;"manzell";5;100;0
10;0;"manzie";10;100;0
10;285;"mao";295;3.38983050847458;96.6101694915254
0;15;"maomi";15;0;100
112;0;"maor";112;100;0
0;5;"maori";5;0;100
5;1834;"maple";1839;0.271886895051659;99.7281131049483
0;5;"mapuana";5;0;100
13;0;"maquan";13;100;0
0;24;"maquel";24;0;100
0;18;"maquela";18;0;100
0;5;"maquetta";5;0;100
0;10;"maquisha";10;0;100
0;133;"maquita";133;0;100
194;554;"mar";748;25.9358288770053;74.0641711229947
16;19664;"mara";19680;0.0813008130081301;99.9186991869919
0;5;"maraam";5;0;100
0;13;"marabel";13;0;100
0;95;"marabella";95;0;100
0;172;"marabelle";172;0;100
0;134;"marabeth";134;0;100
0;5;"maradee";5;0;100
0;5;"maradith";5;0;100
0;213;"marae";213;0;100
0;10;"maragaret";10;0;100
0;218;"maragret";218;0;100
0;2130;"marah";2130;0;100
0;62;"marai";62;0;100
0;12;"maraia";12;0;100
0;21;"maraiah";21;0;100
0;11;"maraih";11;0;100
0;26;"maraina";26;0;100
0;29;"maraiya";29;0;100
0;11;"maraja";11;0;100
0;68;"marajade";68;0;100
0;89;"maraki";89;0;100
0;290;"maral";290;0;100
0;882;"maralee";882;0;100
0;42;"maralene";42;0;100
0;5;"marali";5;0;100
0;5;"maralou";5;0;100
0;1301;"maralyn";1301;0;100
0;31;"maralynn";31;0;100
0;645;"maram";645;0;100
0;22;"maran";22;0;100
0;288;"maranatha";288;0;100
0;11302;"maranda";11302;0;100
0;5;"marandia";5;0;100
0;32;"marangely";32;0;100
0;63;"marasia";63;0;100
27;0;"marat";27;100;0
0;22;"maratha";22;0;100
0;11;"maravene";11;0;100
0;11;"maray";11;0;100
0;776;"maraya";776;0;100
0;294;"marayah";294;0;100
0;12;"marayla";12;0;100
0;7;"marayna";7;0;100
0;6;"marba";6;0;100
0;15;"marbel";15;0;100
0;6;"marbeli";6;0;100
0;1654;"marbella";1654;0;100
0;19;"marbely";19;0;100
0;96;"marbeth";96;0;100
0;5;"marbeya";5;0;100
153;0;"marbin";153;100;0
138677;532;"marc";139209;99.617840800523;0.382159199477045
0;285;"marca";285;0;100
0;16;"marcail";16;0;100
38;0;"marcal";38;100;0
18;0;"marcale";18;100;0
0;10;"marcalene";10;0;100
6;0;"marcandre";6;100;0
6;0;"marcandrew";6;100;0
22;0;"marcangelo";22;100;0
1321;0;"marcanthony";1321;100;0
226;0;"marcas";226;100;0
0;17;"marcasia";17;0;100
0;143;"marcayla";143;0;100
105;169;"marce";274;38.3211678832117;61.6788321167883
0;222;"marcea";222;0;100
6;0;"marceau";6;100;0
0;17;"marceda";17;0;100
5;306;"marcedes";311;1.60771704180064;98.3922829581994
0;11;"marcedez";11;0;100
0;698;"marcee";698;0;100
0;5;"marceen";5;0;100
0;16;"marceia";16;0;100
0;438;"marceil";438;0;100
0;37;"marceille";37;0;100
16908;992;"marcel";17900;94.4581005586592;5.54189944134078
0;7783;"marcela";7783;0;100
0;12;"marcelaine";12;0;100
0;104;"marcele";104;0;100
0;10;"marceleen";10;0;100
0;10;"marcelena";10;0;100
0;911;"marcelene";911;0;100
0;131;"marcelia";131;0;100
5;0;"marcelin";5;100;0
0;2985;"marcelina";2985;0;100
0;3199;"marceline";3199;0;100
6614;0;"marcelino";6614;100;0
104;0;"marcelis";104;100;0
25;0;"marcelius";25;100;0
4294;1126;"marcell";5420;79.2250922509225;20.7749077490775
222;62512;"marcella";62734;0.353875091656837;99.6461249083432
74;0;"marcellas";74;100;0
464;5284;"marcelle";5748;8.07237299930411;91.9276270006959
0;112;"marcellene";112;0;100
92;0;"marcelles";92;100;0
0;37;"marcellia";37;0;100
0;269;"marcellina";269;0;100
0;1035;"marcelline";1035;0;100
254;0;"marcellino";254;100;0
277;0;"marcellis";277;100;0
61;0;"marcellius";61;100;0
5095;10;"marcello";5105;99.8041136141038;0.19588638589618
10;0;"marcellos";10;100;0
935;0;"marcellous";935;100;0
7074;5;"marcellus";7079;99.9293685548806;0.0706314451193671
0;6;"marcellyn";6;0;100
8321;0;"marcelo";8321;100;0
35;0;"marcelous";35;100;0
256;0;"marcelus";256;100;0
0;699;"marcelyn";699;0;100
0;227;"marcena";227;0;100
0;1281;"marcene";1281;0;100
0;26;"marcenia";26;0;100
10;0;"marcese";10;100;0
0;20;"marcetta";20;0;100
0;1102;"marcey";1102;0;100
150;98;"march";248;60.4838709677419;39.5161290322581
0;233;"marcha";233;0;100
0;41;"marchae";41;0;100
5;7;"marchand";12;41.6666666666667;58.3333333333333
7;0;"marchant";7;100;0
7;411;"marche";418;1.67464114832536;98.3253588516746
56;73;"marchel";129;43.4108527131783;56.5891472868217
0;102;"marchele";102;0;100
6;578;"marchell";584;1.02739726027397;98.972602739726
14;150;"marchella";164;8.53658536585366;91.4634146341463
0;1643;"marchelle";1643;0;100
506;0;"marchello";506;100;0
6;0;"marchelo";6;100;0
0;595;"marcheta";595;0;100
0;83;"marchetta";83;0;100
0;115;"marchia";115;0;100
0;11;"marchie";11;0;100
0;39;"marchita";39;0;100
11;13796;"marci";13807;0.0796697327442601;99.9203302672557
284;132491;"marcia";132775;0.213895688194314;99.7861043118057
1874;0;"marcial";1874;100;0
0;246;"marciana";246;0;100
0;19;"marciann";19;0;100
0;81;"marcianna";81;0;100
0;71;"marcianne";71;0;100
988;0;"marciano";988;100;0
13;15308;"marcie";15321;0.0848508582990666;99.9151491417009
5;84;"marciel";89;5.61797752808989;94.3820224719101
0;21;"marciela";21;0;100
0;7;"marciella";7;0;100
0;538;"marcile";538;0;100
0;16;"marcilene";16;0;100
0;49;"marcilla";49;0;100
0;641;"marcille";641;0;100
433;0;"marcin";433;100;0
0;281;"marcina";281;0;100
0;24;"marcinda";24;0;100
0;995;"marcine";995;0;100
327;0;"marcio";327;100;0
5;0;"marcion";5;100;0
44;0;"marcis";44;100;0
0;11;"marcisha";11;0;100
0;39;"marcita";39;0;100
14;0;"marcius";14;100;0
18;0;"marcjacob";18;100;0
582;0;"marck";582;100;0
5;0;"marckel";5;100;0
5;0;"marckos";5;100;0
71;0;"marckus";71;100;0
0;5;"marclene";5;0;100
68734;338;"marco";69072;99.5106555478341;0.489344452165856
5;0;"marcoa";5;100;0
1458;0;"marcoantonio";1458;100;0
6;0;"marcon";6;100;0
5;0;"marcopolo";5;100;0
47751;162;"marcos";47913;99.6618871704965;0.338112829503475
7;0;"marcous";7;100;0
12;0;"marcquel";12;100;0
80;0;"marcques";80;100;0
25;0;"marcquez";25;100;0
134;0;"marcquis";134;100;0
38;0;"marcquise";38;100;0
5;0;"marctavious";5;100;0
20;0;"marcua";20;100;0
20;0;"marcum";20;100;0
226132;1332;"marcus";227464;99.4144128301621;0.585587169837864
11;0;"marcusanthony";11;100;0
5;0;"marcuse";5;100;0
5;0;"marcusjames";5;100;0
16;0;"marcuss";16;100;0
24;0;"marcuz";24;100;0
256;21477;"marcy";21733;1.17793217687388;98.8220678231261
0;5;"marcyanna";5;0;100
10;0;"marcys";10;100;0
0;391;"marda";391;0;100
32;0;"mardarius";32;100;0
0;45;"mardean";45;0;100
0;255;"mardee";255;0;100
0;19;"mardeen";19;0;100
0;264;"mardel";264;0;100
94;2164;"mardell";2258;4.162976085031;95.837023914969
0;499;"mardella";499;0;100
0;953;"mardelle";953;0;100
48;0;"marden";48;100;0
0;5;"mardena";5;0;100
0;103;"mardene";103;0;100
6;868;"mardi";874;0.68649885583524;99.3135011441648
5;62;"mardie";67;7.46268656716418;92.5373134328358
0;6;"mardina";6;0;100
0;26;"mardine";26;0;100
16;0;"mardis";16;100;0
0;5;"mardith";5;0;100
34;0;"mardochee";34;100;0
219;66;"mardy";285;76.8421052631579;23.1578947368421
333;0;"mare";333;100;0
0;562;"marea";562;0;100
0;32;"mareah";32;0;100
5;0;"mareck";5;100;0
8;0;"mareco";8;100;0
0;10;"mareda";10;0;100
0;29;"maredith";29;0;100
0;1002;"maree";1002;0;100
0;60;"mareen";60;0;100
0;289;"mareena";289;0;100
0;75;"mareesa";75;0;100
0;10;"mareesha";10;0;100
0;5;"mareike";5;0;100
0;5;"mareily";5;0;100
0;11;"mareisha";11;0;100
2514;5;"marek";2519;99.801508535133;0.198491464867011
0;40;"mareka";40;0;100
0;5;"marel";5;0;100
0;16;"marelene";16;0;100
0;999;"mareli";999;0;100
0;17;"marelie";17;0;100
0;231;"marelin";231;0;100
0;25;"marelis";25;0;100
29;0;"marell";29;100;0
0;378;"marella";378;0;100
0;5;"marelle";5;0;100
0;12;"marelli";12;0;100
0;66;"marelly";66;0;100
0;2527;"marely";2527;0;100
0;659;"marelyn";659;0;100
0;8;"marelys";8;0;100
0;5;"mareme";5;0;100
0;7702;"maren";7702;0;100
0;1215;"marena";1215;0;100
0;134;"marenda";134;0;100
0;162;"marene";162;0;100
0;15;"marenna";15;0;100
179;0;"mareo";179;100;0
96;0;"mareon";96;100;0
0;581;"maresa";581;0;100
0;226;"maresha";226;0;100
0;32;"mareshah";32;0;100
0;468;"maressa";468;0;100
0;5;"maressia";5;0;100
0;45;"maret";45;0;100
0;151;"mareta";151;0;100
0;31;"maretha";31;0;100
0;890;"maretta";890;0;100
0;17;"marette";17;0;100
0;10;"marey";10;0;100
0;47;"mareya";47;0;100
0;5;"mareyah";5;0;100
0;10;"marfa";10;0;100
0;17;"marfil";17;0;100
0;107;"marg";107;0;100
0;343;"marga";343;0;100
0;16;"margaet";16;0;100
0;93;"margalit";93;0;100
0;92;"margan";92;0;100
0;10;"margarat";10;0;100
0;11;"margare";11;0;100
0;616;"margaree";616;0;100
3526;1184650;"margaret";1188176;0.296757382744644;99.7032426172554
0;475;"margareta";475;0;100
0;294;"margaretann";294;0;100
0;5;"margaretanne";5;0;100
0;2226;"margarete";2226;0;100
0;200;"margareth";200;0;100
0;354;"margaretha";354;0;100
0;49;"margarethe";49;0;100
0;5;"margaretjo";5;0;100
0;189;"margaretmary";189;0;100
0;4755;"margarett";4755;0;100
0;2281;"margaretta";2281;0;100
0;5867;"margarette";5867;0;100
0;27;"margarida";27;0;100
0;234;"margarie";234;0;100
0;82;"margarine";82;0;100
0;86;"margarit";86;0;100
195;38915;"margarita";39110;0.498593710048581;99.5014062899514
0;1855;"margarite";1855;0;100
4755;0;"margarito";4755;100;0
0;11;"margaritte";11;0;100
5;0;"margaro";5;100;0
0;563;"margart";563;0;100
0;127;"margaruite";127;0;100
0;37;"margary";37;0;100
0;68;"margaurite";68;0;100
0;2420;"margaux";2420;0;100
0;3717;"marge";3717;0;100
0;69;"margean";69;0;100
0;5;"margearet";5;0;100
0;116;"margeart";116;0;100
0;704;"margeaux";704;0;100
0;86;"margee";86;0;100
0;69;"margel";69;0;100
0;5;"margelene";5;0;100
0;17;"margena";17;0;100
5;1687;"margene";1692;0.295508274231678;99.7044917257683
0;5;"margeree";5;0;100
0;946;"margeret";946;0;100
0;5;"margerete";5;0;100
0;6;"margerett";6;0;100
0;6;"margerette";6;0;100
0;118;"margerie";118;0;100
0;18;"margerine";18;0;100
0;78;"margerite";78;0;100
0;796;"margert";796;0;100
0;15268;"margery";15268;0;100
0;507;"marget";507;0;100
0;10;"margett";10;0;100
0;11;"margetta";11;0;100
0;5;"margette";5;0;100
0;25;"margeurite";25;0;100
0;16;"margey";16;0;100
0;21;"marggie";21;0;100
0;1109;"margherita";1109;0;100
0;12;"margherite";12;0;100
0;291;"margi";291;0;100
0;261;"margia";261;0;100
403;104337;"margie";104740;0.384762268474317;99.6152377315257
0;6;"margil";6;0;100
0;55;"margine";55;0;100
0;673;"margit";673;0;100
0;12;"margita";12;0;100
34;23421;"margo";23455;0.144958431038158;99.8550415689618
0;1026;"margorie";1026;0;100
0;58;"margory";58;0;100
0;11677;"margot";11677;0;100
0;10;"margoth";10;0;100
0;10;"margrate";10;0;100
0;390;"margreat";390;0;100
0;291;"margree";291;0;100
0;10;"margreet";10;0;100
0;9307;"margret";9307;0;100
0;10;"margreta";10;0;100
0;211;"margrete";211;0;100
0;5;"margretha";5;0;100
0;27;"margrethe";27;0;100
0;1282;"margrett";1282;0;100
0;794;"margretta";794;0;100
0;850;"margrette";850;0;100
0;33;"margrie";33;0;100
0;56;"margrit";56;0;100
0;224;"marguarite";224;0;100
5;0;"marguel";5;100;0
0;26;"marguerete";26;0;100
0;132;"marguerette";132;0;100
0;39;"margueriete";39;0;100
0;5;"margueriette";5;0;100
0;7;"marguerit";7;0;100
0;1268;"marguerita";1268;0;100
101;85684;"marguerite";85785;0.117736200967535;99.8822637990325
0;11;"margueritt";11;0;100
0;5;"margueritta";5;0;100
0;1159;"margueritte";1159;0;100
0;5;"marguery";5;0;100
48;0;"margues";48;100;0
0;86;"marguetta";86;0;100
28;0;"marguette";28;100;0
153;0;"marguis";153;100;0
42;0;"marguise";42;100;0
0;506;"marguita";506;0;100
0;13;"marguitta";13;0;100
0;5;"margulia";5;0;100
0;5;"marguree";5;0;100
0;32;"marguret";32;0;100
0;60;"margurete";60;0;100
0;263;"margurette";263;0;100
0;121;"marguriete";121;0;100
0;35;"marguriette";35;0;100
0;11;"margurita";11;0;100
0;1688;"margurite";1688;0;100
0;48;"marguritte";48;0;100
29;0;"margus";29;100;0
0;1524;"margy";1524;0;100
0;5;"marhia";5;0;100
0;12;"marhonda";12;0;100
6;0;"marhsall";6;100;0
0;33;"marhta";33;0;100
10;15398;"mari";15408;0.0649013499480789;99.9350986500519
4229;535897;"maria";540126;0.782965456208366;99.2170345437916
0;10;"mariaalejandra";10;0;100
0;7;"mariaangela";7;0;100
0;11;"mariaangelica";11;0;100
0;5;"mariaann";5;0;100
0;10;"mariaantonia";10;0;100
0;106;"mariabelen";106;0;100
0;69;"mariabella";69;0;100
0;23;"mariacamila";23;0;100
0;11;"mariacecilia";11;0;100
0;62;"mariaceleste";62;0;100
0;66;"mariachristina";66;0;100
0;197;"mariaclara";197;0;100
0;73;"mariacristina";73;0;100
0;39;"mariade";39;0;100
0;604;"mariadejesus";604;0;100
0;150;"mariadel";150;0;100
0;144;"mariadelaluz";144;0;100
0;486;"mariadelcarmen";486;0;100
0;5;"mariadelos";5;0;100
0;148;"mariadelosang";148;0;100
0;28;"mariadelosangel";28;0;100
0;17;"mariadelourdes";17;0;100
0;32;"mariadelrosari";32;0;100
0;16;"mariadelrosario";16;0;100
0;5;"mariae";5;0;100
0;11;"mariaeduard";11;0;100
0;202;"mariaeduarda";202;0;100
0;1880;"mariaelena";1880;0;100
0;5;"mariaelisa";5;0;100
0;34;"mariaelizabeth";34;0;100
0;5;"mariaemilia";5;0;100
0;6;"mariaesther";6;0;100
0;939;"mariafernanda";939;0;100
0;7;"mariagabriela";7;0;100
0;5;"mariagrazia";5;0;100
0;764;"mariaguadalupe";764;0;100
183;104999;"mariah";105182;0.173984141773307;99.8260158582267
0;200;"mariaha";200;0;100
0;6;"mariahann";6;0;100
0;21;"mariahlynn";21;0;100
0;10;"mariahna";10;0;100
0;21;"mariaines";21;0;100
0;545;"mariaisabel";545;0;100
0;34;"mariaisabella";34;0;100
0;1773;"mariajose";1773;0;100
0;24;"mariajulia";24;0;100
0;42;"marial";42;0;100
0;7;"marialaina";7;0;100
0;5;"marialana";5;0;100
0;7;"marialaura";7;0;100
0;218;"marialena";218;0;100
0;25;"mariali";25;0;100
0;180;"marialice";180;0;100
0;5;"marialicia";5;0;100
0;60;"marialis";60;0;100
0;18;"marialisa";18;0;100
0;139;"marializ";139;0;100
0;545;"marialuisa";545;0;100
0;68;"marialuiza";68;0;100
0;86;"marialy";86;0;100
0;54;"marialyce";54;0;100
0;7;"marialys";7;0;100
5;13584;"mariam";13589;0.0367944661122967;99.9632055338877
0;1622;"mariama";1622;0;100
0;63;"mariamawit";63;0;100
0;215;"mariame";215;0;100
0;14;"mariamne";14;0;100
0;6;"mariamu";6;0;100
1277;137352;"marian";138629;0.921163681480787;99.0788363185192
85;34907;"mariana";34992;0.242912665752172;99.7570873342478
0;44;"marianah";44;0;100
0;714;"mariane";714;0;100
0;597;"marianela";597;0;100
0;31;"marianella";31;0;100
0;5;"marianely";5;0;100
0;325;"mariangel";325;0;100
0;298;"mariangela";298;0;100
0;5;"mariangeles";5;0;100
0;6;"mariangelis";6;0;100
0;12;"mariangeliz";12;0;100
0;52;"mariangely";52;0;100
0;49;"mariani";49;0;100
0;120;"marianita";120;0;100
0;7079;"mariann";7079;0;100
0;15378;"marianna";15378;0;100
0;11;"mariannah";11;0;100
49;64639;"marianne";64688;0.0757482067771457;99.9242517932229
0;117;"marianny";117;0;100
8436;0;"mariano";8436;100;0
0;23;"marianthi";23;0;100
0;56;"mariany";56;0;100
0;104;"mariapaula";104;0;100
0;16;"mariapaz";16;0;100
0;11;"mariarosa";11;0;100
0;5;"mariasha";5;0;100
0;5;"mariasofia";5;0;100
0;278;"mariateresa";278;0;100
0;40;"mariatheresa";40;0;100
0;27;"mariauna";27;0;100
0;7;"mariavalentina";7;0;100
0;151;"mariavictoria";151;0;100
0;5;"mariaya";5;0;100
185;23733;"maribel";23918;0.77347604314742;99.2265239568526
0;28;"maribela";28;0;100
0;539;"maribell";539;0;100
0;528;"maribella";528;0;100
0;1081;"maribelle";1081;0;100
0;5968;"maribeth";5968;0;100
0;28;"maribi";28;0;100
0;11;"mariby";11;0;100
5;0;"maric";5;100;0
0;924;"marica";924;0;100
0;50;"maricar";50;0;100
0;1059;"maricarmen";1059;0;100
715;467;"marice";1182;60.4906937394247;39.5093062605753
0;460;"maricel";460;0;100
56;12578;"maricela";12634;0.443248377394333;99.5567516226057
0;28;"maricelda";28;0;100
0;6;"maricelis";6;0;100
0;1588;"maricella";1588;0;100
0;5;"maricely";5;0;100
0;5;"maricelys";5;0;100
0;5;"maricha";5;0;100
8;0;"marichal";8;100;0
0;11;"marichelle";11;0;100
0;5;"marichuy";5;0;100
0;347;"maricia";347;0;100
0;6;"maricielo";6;0;100
10;0;"maricio";10;100;0
12;0;"marick";12;100;0
0;12;"maricka";12;0;100
0;10;"mariclare";10;0;100
394;0;"marico";394;100;0
0;33;"maricris";33;0;100
0;5;"maricrus";5;0;100
0;2784;"maricruz";2784;0;100
0;101;"maricsa";101;0;100
125;0;"maricus";125;100;0
0;36;"maricza";36;0;100
5;0;"marid";5;100;0
0;51;"marida";51;0;100
0;5;"maridean";5;0;100
0;154;"maridee";154;0;100
0;69;"maridel";69;0;100
0;35;"maridell";35;0;100
0;11;"marideth";11;0;100
0;19;"maridith";19;0;100
2086;501337;"marie";503423;0.414363269060015;99.58563673094
0;733;"mariea";733;0;100
0;5;"marieana";5;0;100
0;5;"marieange";5;0;100
0;193;"marieann";193;0;100
0;11;"marieanna";11;0;100
0;127;"marieanne";127;0;100
0;10;"mariechristine";10;0;100
0;66;"marieclaire";66;0;100
0;15;"marieda";15;0;100
0;74;"marieelena";74;0;100
0;5;"mariejeanne";5;0;100
0;20;"marieka";20;0;100
0;117;"marieke";117;0;100
116;6184;"mariel";6300;1.84126984126984;98.1587301587302
8;10289;"mariela";10297;0.0776925318053802;99.9223074681946
0;40;"mariele";40;0;100
0;1235;"marielena";1235;0;100
0;229;"marieli";229;0;100
0;265;"marielis";265;0;100
0;10;"marielisa";10;0;100
0;105;"marieliz";105;0;100
0;68;"mariell";68;0;100
0;3364;"mariella";3364;0;100
0;3575;"marielle";3575;0;100
0;1166;"mariellen";1166;0;100
0;40;"marielly";40;0;100
0;10;"marielos";10;0;100
0;94;"marielouise";94;0;100
0;931;"mariely";931;0;100
0;282;"marielys";282;0;100
0;164;"mariem";164;0;100
0;139;"marieme";139;0;100
0;178;"marien";178;0;100
0;119;"mariena";119;0;100
0;84;"mariene";84;0;100
0;25;"marienne";25;0;100
21;0;"marieo";21;100;0
0;16;"marierose";16;0;100
0;347;"mariesa";347;0;100
0;128;"mariesha";128;0;100
0;36;"mariessa";36;0;100
0;434;"marieta";434;0;100
0;14;"marietha";14;0;100
0;27;"marietherese";27;0;100
0;35;"marietou";35;0;100
0;14170;"marietta";14170;0;100
0;1031;"mariette";1031;0;100
0;304;"marifer";304;0;100
0;16;"marifrances";16;0;100
0;5;"marigail";5;0;100
0;137;"marigene";137;0;100
0;56;"marigny";56;0;100
0;391;"marigold";391;0;100
0;166;"marigrace";166;0;100
0;339;"mariha";339;0;100
0;41;"marihanna";41;0;100
0;12;"marihelen";12;0;100
0;475;"marija";475;0;100
0;104;"marijah";104;0;100
0;5;"marijana";5;0;100
0;1627;"marijane";1627;0;100
0;62;"marijayne";62;0;100
0;373;"marijean";373;0;100
0;107;"marijke";107;0;100
0;1280;"marijo";1280;0;100
0;6;"marijon";6;0;100
0;151;"marijose";151;0;100
0;5;"marijuana";5;0;100
143;0;"marik";143;100;0
0;2233;"marika";2233;0;100
0;45;"marikate";45;0;100
0;212;"marikay";212;0;100
0;5;"marike";5;0;100
6;1251;"mariko";1257;0.477326968973747;99.5226730310263
0;30;"marilda";30;0;100
0;250;"marilea";250;0;100
0;7322;"marilee";7322;0;100
0;5;"marileen";5;0;100
0;524;"marilena";524;0;100
0;143;"marilene";143;0;100
0;8;"marileysis";8;0;100
0;255;"marili";255;0;100
0;28;"marilia";28;0;100
0;759;"marilin";759;0;100
0;5;"marilina";5;0;100
0;5;"marilinda";5;0;100
0;5;"marilis";5;0;100
0;50;"marilisa";50;0;100
0;17;"mariliz";17;0;100
0;596;"marilla";596;0;100
0;13;"marillany";13;0;100
0;437;"marillyn";437;0;100
0;5;"marilon";5;0;100
0;3180;"marilou";3180;0;100
0;268;"marilouise";268;0;100
0;2150;"marilu";2150;0;100
0;355;"mariluz";355;0;100
0;794;"marily";794;0;100
1066;369707;"marilyn";370773;0.287507450650398;99.7124925493496
0;329;"marilyne";329;0;100
0;12828;"marilynn";12828;0;100
0;968;"marilynne";968;0;100
0;21;"marim";21;0;100
0;304;"marimar";304;0;100
869;4964;"marin";5833;14.8979941710955;85.1020058289045
51;35432;"marina";35483;0.143730800665107;99.8562691993349
0;34;"marinah";34;0;100
0;1631;"marinda";1631;0;100
6;956;"marine";962;0.623700623700624;99.3762993762994
0;5;"marinee";5;0;100
0;27;"marinel";27;0;100
0;269;"marinell";269;0;100
0;12;"marinella";12;0;100
0;58;"marinelle";58;0;100
0;6;"marines";6;0;100
0;5;"marinette";5;0;100
0;5;"marinez";5;0;100
0;5;"marini";5;0;100
0;26;"marinn";26;0;100
0;410;"marinna";410;0;100
2065;0;"marino";2065;100;0
266;0;"marinus";266;100;0
142871;1092;"mario";143963;99.2414717670513;0.758528232948744
44;0;"marioalberto";44;100;0
0;15;"mariola";15;0;100
0;5;"mariolita";5;0;100
68785;178690;"marion";247475;27.7947267400748;72.2052732599252
0;222;"mariona";222;0;100
0;103;"marionette";103;0;100
10;0;"marioni";10;100;0
0;396;"marionna";396;0;100
99;0;"marios";99;100;0
16;0;"marious";16;100;0
0;101;"maripat";101;0;100
0;93;"maripaz";93;0;100
0;207;"mariposa";207;0;100
6;0;"marique";6;100;0
5;0;"mariques";5;100;0
0;18;"mariquita";18;0;100
0;70;"marirose";70;0;100
0;5;"mariruth";5;0;100
215;2200;"maris";2415;8.90269151138716;91.0973084886128
66;48225;"marisa";48291;0.136671429458905;99.8633285705411
0;567;"marisabel";567;0;100
0;109;"marisah";109;0;100
0;84;"marisal";84;0;100
0;285;"marise";285;0;100
0;414;"marisel";414;0;100
29;9983;"marisela";10012;0.289652417099481;99.7103475829005
0;65;"mariselda";65;0;100
0;459;"marisella";459;0;100
0;5;"marisely";5;0;100
0;5;"marish";5;0;100
0;1527;"marisha";1527;0;100
0;7;"marishia";7;0;100
0;86;"marishka";86;0;100
0;29;"marisia";29;0;100
0;873;"mariska";873;0;100
0;5;"marisleysi";5;0;100
0;44;"marisleysis";44;0;100
315;32135;"marisol";32450;0.970724191063174;99.0292758089368
0;16;"marison";16;0;100
0;10;"mariss";10;0;100
270;118751;"marissa";119021;0.226850723821847;99.7731492761781
0;110;"marissah";110;0;100
0;64;"marissia";64;0;100
0;5;"marista";5;0;100
0;157;"marisue";157;0;100
0;681;"marit";681;0;100
0;4983;"marita";4983;0;100
0;56;"maritere";56;0;100
0;72;"marites";72;0;100
0;58;"maritess";58;0;100
0;20;"maritha";20;0;100
0;82;"marithza";82;0;100
0;930;"maritsa";930;0;100
0;82;"maritssa";82;0;100
0;96;"maritta";96;0;100
79;22228;"maritza";22307;0.354148921863092;99.6458510781369
0;5;"maritzabel";5;0;100
0;339;"marium";339;0;100
2133;0;"marius";2133;100;0
80;0;"mariusz";80;100;0
0;5;"mariuxi";5;0;100
0;2094;"marivel";2094;0;100
0;5;"marivell";5;0;100
0;6;"marivella";6;0;100
0;7;"marivelle";7;0;100
0;37;"marivi";37;0;100
0;16;"marivic";16;0;100
0;10;"marivy";10;0;100
0;343;"marixa";343;0;100
0;27;"marixsa";27;0;100
0;12;"marixza";12;0;100
0;2253;"mariya";2253;0;100
0;5145;"mariyah";5145;0;100
0;208;"mariyam";208;0;100
0;11;"mariyan";11;0;100
0;122;"mariyana";122;0;100
0;11;"mariyani";11;0;100
0;54;"mariyanna";54;0;100
0;10;"mariyha";10;0;100
20;0;"mariyon";20;100;0
0;5;"mariyonna";5;0;100
0;1124;"mariza";1124;0;100
0;50;"marizela";50;0;100
0;332;"marizol";332;0;100
0;39;"marizza";39;0;100
0;14;"marj";14;0;100
0;436;"marja";436;0;100
0;6;"marjaan";6;0;100
0;13;"marjae";13;0;100
0;194;"marjan";194;0;100
0;10;"marjane";10;0;100
0;98;"marjani";98;0;100
0;101;"marjarie";101;0;100
0;5;"marje";5;0;100
0;1558;"marjean";1558;0;100
0;5;"marjeanne";5;0;100
0;145;"marji";145;0;100
0;972;"marjie";972;0;100
0;201;"marjo";201;0;100
12;0;"marjoe";12;100;0
0;11;"marjolaine";11;0;100
15;59;"marjon";74;20.2702702702703;79.7297297297297
0;13;"marjona";13;0;100
0;10;"marjoree";10;0;100
0;25;"marjori";25;0;100
0;155;"marjoria";155;0;100
594;268132;"marjorie";268726;0.221042995467502;99.7789570045325
0;10;"marjorine";10;0;100
0;7911;"marjory";7911;0;100
1346046;4475;"mark";1350521;99.6686463964648;0.331353603535228
5;249;"marka";254;1.96850393700787;98.0314960629921
38;0;"markael";38;100;0
37;10;"markai";47;78.7234042553192;21.2765957446809
62;0;"markail";62;100;0
0;39;"markaila";39;0;100
44;0;"markal";44;100;0
0;120;"markala";120;0;100
159;0;"markale";159;100;0
10;0;"markallen";10;100;0
0;30;"markan";30;0;100
34;0;"markandrew";34;100;0
11;0;"markangelo";11;100;0
1711;0;"markanthony";1711;100;0
140;0;"markas";140;100;0
0;66;"markasia";66;0;100
52;0;"markavion";52;100;0
74;0;"markavious";74;100;0
10;0;"markavius";10;100;0
0;27;"markay";27;0;100
0;42;"markaya";42;0;100
10;0;"markayden";10;100;0
0;2038;"markayla";2038;0;100
0;35;"markaylah";35;0;100
0;5;"markaysha";5;0;100
0;5;"markaysia";5;0;100
6;0;"markchristopher";6;100;0
6;0;"markco";6;100;0
196;0;"markcus";196;100;0
10;0;"markdaniel";10;100;0
5;0;"markdavid";5;100;0
159;5;"marke";164;96.9512195121951;3.04878048780488
0;79;"markea";79;0;100
29;0;"markeal";29;100;0
5;0;"markeas";5;100;0
10;0;"markease";10;100;0
19;0;"markece";19;100;0
0;54;"markecia";54;0;100
0;175;"markeda";175;0;100
687;110;"markee";797;86.198243412798;13.801756587202
43;0;"markeece";43;100;0
0;6;"markeeda";6;0;100
141;0;"markeem";141;100;0
147;0;"markees";147;100;0
455;0;"markeese";455;100;0
0;80;"markeesha";80;0;100
0;400;"markeeta";400;0;100
0;144;"markeia";144;0;100
16;0;"markeice";16;100;0
0;5;"markeida";5;0;100
35;0;"markeil";35;100;0
281;0;"markeis";281;100;0
152;0;"markeise";152;100;0
0;1296;"markeisha";1296;0;100
0;233;"markeita";233;0;100
2029;0;"markeith";2029;100;0
0;29;"markeitha";29;0;100
4088;121;"markel";4209;97.1252078878593;2.87479211214065
0;136;"markela";136;0;100
7;0;"markele";7;100;0
4080;219;"markell";4299;94.9057920446616;5.09420795533845
0;246;"markella";246;0;100
164;125;"markelle";289;56.7474048442907;43.2525951557093
24;0;"marken";24;100;0
0;5;"markena";5;0;100
0;32;"markenzie";32;0;100
6;0;"markeon";6;100;0
0;5;"markera";5;0;100
0;88;"markeria";88;0;100
153;0;"markes";153;100;0
0;6;"markesa";6;0;100
1052;0;"markese";1052;100;0
0;999;"markesha";999;0;100
0;408;"markeshia";408;0;100
0;83;"markesia";83;0;100
5;0;"markess";5;100;0
5;0;"markest";5;100;0
0;673;"marketa";673;0;100
0;55;"marketia";55;0;100
0;865;"marketta";865;0;100
0;5;"markette";5;0;100
5;0;"markeveon";5;100;0
0;57;"markevia";57;0;100
110;0;"markevion";110;100;0
274;0;"markevious";274;100;0
53;0;"markevis";53;100;0
131;0;"markevius";131;100;0
5;0;"markevus";5;100;0
277;5;"markey";282;98.2269503546099;1.77304964539007
0;383;"markeya";383;0;100
0;16;"markeyda";16;0;100
0;10;"markeyia";10;0;100
0;38;"markeyla";38;0;100
5;0;"markeys";5;100;0
0;58;"markeysha";58;0;100
0;46;"markeyta";46;0;100
278;0;"markez";278;100;0
452;0;"markham";452;100;0
62;0;"markhi";62;100;0
0;18;"markhia";18;0;100
29;364;"marki";393;7.37913486005089;92.6208651399491
0;1598;"markia";1598;0;100
0;62;"markiah";62;0;100
56;0;"markian";56;100;0
120;0;"markice";120;100;0
0;33;"markida";33;0;100
316;1462;"markie";1778;17.7727784026997;82.2272215973003
0;11;"markiea";11;0;100
7;0;"markiece";7;100;0
5;0;"markiee";5;100;0
28;0;"markiel";28;100;0
85;0;"markies";85;100;0
40;0;"markiese";40;100;0
0;213;"markiesha";213;0;100
11;0;"markiest";11;100;0
0;33;"markieta";33;0;100
11;0;"markieth";11;100;0
0;12;"markila";12;0;100
0;11;"markina";11;0;100
13;0;"marking";13;100;0
0;20;"markira";20;0;100
859;0;"markis";859;100;0
0;6;"markisa";6;0;100
191;0;"markise";191;100;0
0;1136;"markisha";1136;0;100
0;5;"markishia";5;0;100
10;0;"markiss";10;100;0
0;2495;"markita";2495;0;100
0;99;"markitta";99;0;100
11;0;"markius";11;100;0
0;200;"markiya";200;0;100
0;130;"markiyah";130;0;100
43;0;"markjoseph";43;100;0
5;0;"markk";5;100;0
5;0;"markkevin";5;100;0
0;5;"markki";5;0;100
5;0;"markkus";5;100;0
10;0;"markle";10;100;0
24;0;"markley";24;100;0
3724;0;"marko";3724;100;0
45;0;"markon";45;100;0
868;0;"markos";868;100;0
10;0;"markous";10;100;0
5;0;"markquan";5;100;0
36;0;"markquis";36;100;0
10;0;"markquise";10;100;0
5;0;"markryan";5;100;0
93;0;"marks";93;100;0
9;0;"markum";9;100;0
13365;0;"markus";13365;100;0
23;0;"markuz";23;100;0
5;0;"markwan";5;100;0
5;0;"markwilliam";5;100;0
15;0;"markwon";15;100;0
83;0;"marky";83;100;0
0;24;"markya";24;0;100
0;5;"markyia";5;0;100
0;43;"markyla";43;0;100
0;6;"markysha";6;0;100
116;0;"marl";116;100;0
38;38083;"marla";38121;0.09968258964875;99.9003174103512
0;10;"marlaena";10;0;100
0;1310;"marlaina";1310;0;100
0;361;"marlaine";361;0;100
1195;14;"marlan";1209;98.8420181968569;1.15798180314309
0;2778;"marlana";2778;0;100
1217;0;"marland";1217;100;0
0;5;"marlanda";5;0;100
33;0;"marlando";33;100;0
0;697;"marlane";697;0;100
0;6;"marlania";6;0;100
0;16;"marlanna";16;0;100
0;36;"marlasia";36;0;100
0;78;"marlaya";78;0;100
0;12;"marlayah";12;0;100
0;804;"marlayna";804;0;100
0;35;"marlayne";35;0;100
0;5;"marlaysha";5;0;100
0;5;"marlayshia";5;0;100
0;134;"marlaysia";134;0;100
6;46;"marle";52;11.5384615384615;88.4615384615385
0;724;"marlea";724;0;100
0;365;"marleah";365;0;100
0;142;"marlean";142;0;100
0;40;"marleana";40;0;100
0;5;"marlecia";5;0;100
123;11756;"marlee";11879;1.03544069366108;98.9645593063389
0;4014;"marleen";4014;0;100
0;181;"marleena";181;0;100
0;22;"marleene";22;0;100
0;314;"marlei";314;0;100
0;3213;"marleigh";3213;0;100
0;5;"marleigha";5;0;100
0;22;"marleina";22;0;100
0;5;"marleisha";5;0;100
0;36;"marlem";36;0;100
897;5059;"marlen";5956;15.0604432505037;84.9395567494963
0;10750;"marlena";10750;0;100
359;129079;"marlene";129438;0.277352863919405;99.7226471360806
0;10;"marlenea";10;0;100
0;11;"marlenee";11;0;100
0;611;"marleni";611;0;100
0;16;"marlenia";16;0;100
0;28;"marlenie";28;0;100
0;11;"marlenis";11;0;100
0;11;"marlenn";11;0;100
0;445;"marlenne";445;0;100
0;5;"marlenny";5;0;100
0;1119;"marleny";1119;0;100
0;58;"marles";58;0;100
0;11;"marlesa";11;0;100
0;21;"marlese";21;0;100
0;46;"marlesha";46;0;100
0;116;"marlet";116;0;100
0;76;"marleta";76;0;100
0;23;"marleth";23;0;100
0;5;"marletha";5;0;100
0;19;"marlett";19;0;100
0;293;"marletta";293;0;100
0;256;"marlette";256;0;100
3636;21726;"marley";25362;14.3364088005678;85.6635911994322
0;22;"marleyann";22;0;100
0;5;"marleyjane";5;0;100
0;51;"marleyna";51;0;100
0;1938;"marli";1938;0;100
0;65;"marlia";65;0;100
0;11;"marliah";11;0;100
0;6;"marliana";6;0;100
0;11;"marlianna";11;0;100
0;5;"marlice";5;0;100
0;70;"marlicia";70;0;100
0;3192;"marlie";3192;0;100
0;16;"marliee";16;0;100
0;5;"marliegh";5;0;100
0;23;"marliene";23;0;100
0;175;"marlies";175;0;100
0;25;"marliese";25;0;100
0;21;"marlii";21;0;100
31;0;"marlik";31;100;0
0;5;"marlika";5;0;100
20400;1549;"marlin";21949;92.9427308761219;7.05726912387808
0;1121;"marlina";1121;0;100
0;538;"marlinda";538;0;100
0;1518;"marline";1518;0;100
0;846;"marlis";846;0;100
0;789;"marlisa";789;0;100
0;359;"marlise";359;0;100
0;217;"marlisha";217;0;100
0;224;"marliss";224;0;100
0;420;"marlissa";420;0;100
0;212;"marlita";212;0;100
0;69;"marliyah";69;0;100
0;15;"marliz";15;0;100
2947;6337;"marlo";9284;31.7427832830676;68.2572167169324
0;26;"marloe";26;0;100
28840;335;"marlon";29175;98.8517566409597;1.14824335904027
28;0;"marlone";28;100;0
103;0;"marlos";103;100;0
0;49;"marlou";49;0;100
1790;679;"marlow";2469;72.4989874443094;27.5010125556906
1401;1724;"marlowe";3125;44.832;55.168
0;10;"marlus";10;0;100
5;0;"marlvin";5;100;0
5;1380;"marly";1385;0.36101083032491;99.6389891696751
0;508;"marlyce";508;0;100
0;5;"marlye";5;0;100
0;17;"marlyin";17;0;100
2296;6602;"marlyn";8898;25.8035513598561;74.1964486401439
0;10;"marlyna";10;0;100
0;5;"marlynda";5;0;100
0;460;"marlyne";460;0;100
0;908;"marlynn";908;0;100
0;5;"marlynne";5;0;100
5;8937;"marlys";8942;0.0559159024826661;99.9440840975173
0;40;"marlyse";40;0;100
0;95;"marlyss";95;0;100
0;16;"marlyssa";16;0;100
0;2678;"marna";2678;0;100
0;154;"marnae";154;0;100
0;15;"marnay";15;0;100
38;850;"marne";888;4.27927927927928;95.7207207207207
0;404;"marnee";404;0;100
0;23;"marneisha";23;0;100
32;245;"marnell";277;11.5523465703971;88.4476534296029
0;5;"marnella";5;0;100
0;84;"marnesha";84;0;100
0;5;"marneshia";5;0;100
0;59;"marnetta";59;0;100
0;172;"marnette";172;0;100
0;454;"marney";454;0;100
5;3255;"marni";3260;0.153374233128834;99.8466257668712
0;11;"marnia";11;0;100
0;42;"marnice";42;0;100
0;5647;"marnie";5647;0;100
0;13;"marnika";13;0;100
0;6;"marnina";6;0;100
0;5;"marniqua";5;0;100
0;15;"marnique";15;0;100
0;128;"marnisha";128;0;100
0;796;"marnita";796;0;100
0;5;"marniyah";5;0;100
0;254;"marny";254;0;100
58;0;"maro";58;100;0
0;1380;"marolyn";1380;0;100
366;33;"maron";399;91.7293233082707;8.27067669172932
0;100;"maronda";100;0;100
0;13;"maronica";13;0;100
0;8;"maroska";8;0;100
0;8;"marpessa";8;0;100
88;0;"marq";88;100;0
30;0;"marqavious";30;100;0
23;0;"marqel";23;100;0
5;0;"marqell";5;100;0
27;0;"marqez";27;100;0
5;0;"marqies";5;100;0
5;0;"marqis";5;100;0
0;28;"marqita";28;0;100
10;0;"marqua";10;100;0
16;0;"marquae";16;100;0
5;0;"marquael";5;100;0
177;0;"marquail";177;100;0
161;0;"marqual";161;100;0
0;11;"marquala";11;0;100
24;0;"marquale";24;100;0
1701;0;"marquan";1701;100;0
10;0;"marquarious";10;100;0
166;0;"marquarius";166;100;0
5;0;"marquas";5;100;0
0;106;"marquasha";106;0;100
0;121;"marquasia";121;0;100
14;0;"marquaveon";14;100;0
163;0;"marquavion";163;100;0
650;0;"marquavious";650;100;0
202;0;"marquavis";202;100;0
322;0;"marquavius";322;100;0
201;0;"marquay";201;100;0
996;140;"marque";1136;87.6760563380282;12.3239436619718
0;15;"marquea";15;0;100
5;0;"marqueal";5;100;0
39;0;"marquece";39;100;0
216;34;"marquee";250;86.4;13.6
0;5;"marqueen";5;0;100
10;0;"marquees";10;100;0
6;0;"marqueese";6;100;0
0;5;"marqueeta";5;0;100
22;0;"marqueis";22;100;0
0;42;"marqueisha";42;0;100
2472;248;"marquel";2720;90.8823529411765;9.11764705882353
1415;19;"marquell";1434;98.6750348675035;1.32496513249651
0;33;"marquella";33;0;100
267;84;"marquelle";351;76.0683760683761;23.9316239316239
0;792;"marquerite";792;0;100
7768;23;"marques";7791;99.7047875754075;0.295212424592478
0;75;"marquesa";75;0;100
1282;0;"marquese";1282;100;0
0;471;"marquesha";471;0;100
0;52;"marqueshia";52;0;100
18;0;"marquess";18;100;0
0;18;"marquessa";18;0;100
116;0;"marquest";116;100;0
194;0;"marquet";194;100;0
0;253;"marqueta";253;0;100
0;8;"marquetia";8;0;100
79;0;"marquett";79;100;0
0;2130;"marquetta";2130;0;100
1240;652;"marquette";1892;65.53911205074;34.46088794926
0;5;"marquettia";5;0;100
5;0;"marquevious";5;100;0
5119;5;"marquez";5124;99.9024199843872;0.0975800156128025
128;0;"marqueze";128;100;0
293;59;"marqui";352;83.2386363636364;16.7613636363636
0;459;"marquia";459;0;100
5;0;"marquian";5;100;0
785;0;"marquice";785;100;0
0;29;"marquida";29;0;100
108;27;"marquie";135;80;20
444;0;"marquies";444;100;0
44;0;"marquiese";44;100;0
0;30;"marquiesha";30;0;100
0;16;"marquieta";16;0;100
0;12;"marquietta";12;0;100
16;0;"marquiez";16;100;0
53;0;"marquil";53;100;0
0;23;"marquila";23;0;100
0;20;"marquilla";20;0;100
5;0;"marquille";5;100;0
107;0;"marquin";107;100;0
0;5;"marquina";5;0;100
75;0;"marquinn";75;100;0
0;5;"marquinta";5;0;100
23090;474;"marquis";23564;97.9884569682567;2.01154303174334
0;195;"marquisa";195;0;100
9770;392;"marquise";10162;96.1424916355048;3.85750836449518
0;1314;"marquisha";1314;0;100
0;13;"marquishia";13;0;100
0;38;"marquisia";38;0;100
11;0;"marquiss";11;100;0
130;0;"marquist";130;100;0
30;11010;"marquita";11040;0.271739130434783;99.7282608695652
0;52;"marquite";52;0;100
0;5;"marquitha";5;0;100
0;32;"marquitia";32;0;100
0;1183;"marquitta";1183;0;100
0;6;"marquitte";6;0;100
125;0;"marquiz";125;100;0
149;0;"marquize";149;100;0
204;0;"marquon";204;100;0
0;5;"marqurita";5;0;100
924;0;"marqus";924;100;0
0;12;"marqutia";12;0;100
7;0;"marqwan";7;100;0
6;0;"marqwon";6;100;0
0;307;"marra";307;0;100
0;80;"marrah";80;0;100
0;71;"marranda";71;0;100
5;0;"marreco";5;100;0
120;0;"marrell";120;100;0
0;29;"marren";29;0;100
29;0;"marreo";29;100;0
32;0;"marreon";32;100;0
0;6;"marretta";6;0;100
0;134;"marri";134;0;100
0;81;"marria";81;0;100
0;683;"marriah";683;0;100
0;11;"marriam";11;0;100
0;153;"marrian";153;0;100
0;74;"marriana";74;0;100
0;20;"marriann";20;0;100
0;20;"marrianna";20;0;100
0;293;"marrianne";293;0;100
11;0;"marrick";11;100;0
12;0;"marrico";12;100;0
0;612;"marrie";612;0;100
0;241;"marrietta";241;0;100
16;35;"marrin";51;31.3725490196078;68.6274509803922
0;45;"marrina";45;0;100
368;0;"marrio";368;100;0
581;378;"marrion";959;60.5839416058394;39.4160583941606
62;6;"marris";68;91.1764705882353;8.82352941176471
0;1059;"marrisa";1059;0;100
0;15;"marrisha";15;0;100
0;1438;"marrissa";1438;0;100
6;0;"marrius";6;100;0
0;16;"marriyah";16;0;100
5;0;"marrk";5;100;0
0;1762;"marry";1762;0;100
0;6;"marryn";6;0;100
339;6;"mars";345;98.2608695652174;1.73913043478261
0;66;"marsa";66;0;100
0;5;"marsadie";5;0;100
262;0;"marsalis";262;100;0
0;7;"marschell";7;0;100
215;0;"marsden";215;100;0
0;5;"marsea";5;0;100
340;0;"marsean";340;100;0
0;16;"marseille";16;0;100
63;0;"marsel";63;100;0
0;249;"marsela";249;0;100
0;12;"marselina";12;0;100
87;0;"marselino";87;100;0
15;0;"marsell";15;100;0
0;152;"marsella";152;0;100
5;0;"marselo";5;100;0
0;67;"marsena";67;0;100
5;0;"marsenio";5;100;0
0;5;"marsetta";5;0;100
367;11;"marsh";378;97.0899470899471;2.91005291005291
251;104038;"marsha";104289;0.240677348521896;99.7593226514781
0;577;"marshae";577;0;100
0;49;"marshai";49;0;100
5043;74;"marshal";5117;98.5538401407075;1.44615985929255
0;25;"marshala";25;0;100
0;5;"marshalene";5;0;100
87750;1126;"marshall";88876;98.7330662946127;1.26693370538728
0;5;"marshalle";5;0;100
0;25;"marshana";25;0;100
0;24;"marshanna";24;0;100
0;6;"marshanti";6;0;100
782;0;"marshaun";782;100;0
2103;78;"marshawn";2181;96.423658872077;3.57634112792297
0;31;"marshawna";31;0;100
5;744;"marshay";749;0.667556742323097;99.3324432576769
0;11;"marshaya";11;0;100
0;7;"marshaye";7;0;100
0;193;"marshayla";193;0;100
0;71;"marshe";71;0;100
0;165;"marshea";165;0;100
0;11;"marsheela";11;0;100
0;6;"marsheena";6;0;100
0;106;"marsheila";106;0;100
521;12;"marshel";533;97.7485928705441;2.25140712945591
0;35;"marshelia";35;0;100
925;636;"marshell";1561;59.2568866111467;40.7431133888533
0;162;"marshella";162;0;100
0;554;"marshelle";554;0;100
0;295;"marshia";295;0;100
0;5;"marshie";5;0;100
531;15;"marshon";546;97.2527472527473;2.74725274725275
0;5;"marshonda";5;0;100
211;0;"marshun";211;100;0
0;123;"marsi";123;0;100
0;115;"marsia";115;0;100
0;32;"marsie";32;0;100
0;5;"marsinah";5;0;100
16;0;"marson";16;100;0
314;0;"marston";314;100;0
0;5;"marsue";5;0;100
938;0;"mart";938;100;0
46;16859;"marta";16905;0.272108843537415;99.7278911564626
55;0;"martae";55;100;0
12;0;"martain";12;100;0
0;5;"martaja";5;0;100
0;15;"martajah";15;0;100
12;0;"martarius";12;100;0
0;136;"martasia";136;0;100
6;0;"martaveon";6;100;0
5;0;"martaveous";5;100;0
0;134;"martavia";134;0;100
15;0;"martavian";15;100;0
201;0;"martavion";201;100;0
1192;0;"martavious";1192;100;0
291;0;"martavis";291;100;0
725;0;"martavius";725;100;0
16;0;"martay";16;100;0
11;0;"martaz";11;100;0
133;35;"marte";168;79.1666666666667;20.8333333333333
0;5;"martee";5;0;100
0;5;"marteeka";5;0;100
0;40;"marteen";40;0;100
0;5;"marteisha";5;0;100
0;58;"marteka";58;0;100
1575;10;"martel";1585;99.3690851735016;0.630914826498423
2461;36;"martell";2497;98.5582699239087;1.44173007609131
0;21;"martella";21;0;100
25;12;"martelle";37;67.5675675675676;32.4324324324324
10;0;"martellis";10;100;0
474;0;"marten";474;100;0
0;78;"martena";78;0;100
0;33;"martene";33;0;100
5;0;"marterius";5;100;0
5;0;"marterrion";5;100;0
6;0;"marterrius";6;100;0
5;0;"martes";5;100;0
232;0;"martese";232;100;0
0;90;"martesha";90;0;100
3751;6;"martez";3757;99.8402981101943;0.159701889805696
90;0;"marteze";90;100;0
0;31;"marth";31;0;100
1885;514656;"martha";516541;0.364927469455474;99.6350725305445
0;5;"marthaann";5;0;100
0;16;"marthajane";16;0;100
0;16;"marthalee";16;0;100
0;5;"marthalene";5;0;100
0;11;"marthana";11;0;100
0;71;"marthann";71;0;100
0;20;"marthanne";20;0;100
0;6;"martharee";6;0;100
0;298;"marthe";298;0;100
0;17;"marthel";17;0;100
0;10;"marthell";10;0;100
0;116;"marthella";116;0;100
0;96;"marthena";96;0;100
0;16;"marthenia";16;0;100
0;6;"marther";6;0;100
0;10;"marthia";10;0;100
0;10;"marthie";10;0;100
6;0;"marthony";6;100;0
0;10;"marthy";10;0;100
216;4232;"marti";4448;4.85611510791367;95.1438848920863
0;383;"martia";383;0;100
47;0;"martial";47;100;0
0;50;"martiana";50;0;100
0;5;"martianna";5;0;100
0;31;"martica";31;0;100
305;15;"martice";320;95.3125;4.6875
0;67;"marticia";67;0;100
220;1145;"martie";1365;16.1172161172161;83.8827838827839
0;5;"martiel";5;0;100
5;0;"martijn";5;100;0
0;1077;"martika";1077;0;100
0;5;"martile";5;0;100
298172;1459;"martin";299631;99.5130677399869;0.48693226001315
40;16795;"martina";16835;0.237600237600238;99.7623997623998
304;2647;"martine";2951;10.3015926804473;89.6984073195527
1086;29;"martinez";1115;97.3991031390134;2.60089686098655
0;26;"martini";26;0;100
27;0;"martiniano";27;100;0
0;460;"martinique";460;0;100
5;0;"martinis";5;100;0
31;0;"martinjr";31;100;0
677;0;"martino";677;100;0
0;6;"martinque";6;0;100
24;0;"martinus";24;100;0
0;10;"martiqua";10;0;100
5;0;"martique";5;100;0
20;0;"martir";20;100;0
32;0;"martis";32;100;0
0;19;"martisa";19;0;100
109;0;"martise";109;100;0
0;406;"martisha";406;0;100
0;101;"martita";101;0;100
0;293;"martiza";293;0;100
25;0;"martize";25;100;0
115;0;"marton";115;100;0
5;0;"martrail";5;100;0
29;0;"martravious";29;100;0
5;0;"martravius";5;100;0
15;0;"martrel";15;100;0
483;0;"martrell";483;100;0
26;0;"martrez";26;100;0
11;123;"martrice";134;8.2089552238806;91.7910447761194
0;6;"martricia";6;0;100
0;5;"martrina";5;0;100
5;0;"martwan";5;100;0
5;0;"martwon";5;100;0
31734;4001;"marty";35735;88.8036938575626;11.1963061424374
539;0;"martyn";539;100;0
0;274;"martyna";274;0;100
13;0;"martynas";13;100;0
7;0;"maru";7;100;0
0;75;"marua";75;0;100
7;0;"marucs";7;100;0
0;26;"marueen";26;0;100
6;0;"maruf";6;100;0
168;0;"maruice";168;100;0
35;0;"maruin";35;100;0
35;0;"marus";35;100;0
0;14;"maruska";14;0;100
140;0;"marv";140;100;0
7;10348;"marva";10355;0.067600193143409;99.9323998068566
0;5;"marval";5;0;100
0;29;"marvalee";29;0;100
0;131;"marvalene";131;0;100
0;5;"marvaline";5;0;100
0;7;"marvalyn";7;0;100
5;0;"marvan";5;100;0
5;0;"marve";5;100;0
0;62;"marveen";62;0;100
1147;4739;"marvel";5886;19.4869181107713;80.5130818892287
0;6;"marvela";6;0;100
0;151;"marvelene";151;0;100
0;134;"marveline";134;0;100
1074;323;"marvell";1397;76.8790264853257;23.1209735146743
0;1375;"marvella";1375;0;100
62;437;"marvelle";499;12.4248496993988;87.5751503006012
134;56;"marvelous";190;70.5263157894737;29.4736842105263
0;6;"marvely";6;0;100
0;138;"marvelyn";138;0;100
677;0;"marven";677;100;0
0;109;"marvena";109;0;100
0;498;"marvene";498;0;100
0;6;"marvenia";6;0;100
215;0;"marvens";215;100;0
5;0;"marveon";5;100;0
0;298;"marvetta";298;0;100
0;326;"marvette";326;0;100
0;10;"marvi";10;0;100
0;183;"marvia";183;0;100
5;0;"marvic";5;100;0
68;269;"marvie";337;20.1780415430267;79.8219584569733
0;5;"marvil";5;0;100
0;5;"marvilla";5;0;100
248244;1610;"marvin";249854;99.3556236842316;0.644376315768409
0;598;"marvina";598;0;100
8;542;"marvine";550;1.45454545454545;98.5454545454545
0;6;"marvinia";6;0;100
34;0;"marvins";34;100;0
128;0;"marvion";128;100;0
1095;1366;"marvis";2461;44.4941080861438;55.5058919138562
0;17;"marvita";17;0;100
0;5;"marvlene";5;0;100
107;0;"marvon";107;100;0
0;60;"marvyl";60;0;100
277;0;"marvyn";277;100;0
0;1549;"marwa";1549;0;100
6;0;"marwaan";6;100;0
0;239;"marwah";239;0;100
926;0;"marwan";926;100;0
339;0;"marwin";339;100;0
26;0;"marwood";26;100;0
296;6;"marx";302;98.0132450331126;1.98675496688742
14303;3897887;"mary";3912190;0.365600852719321;99.6343991472807
0;2077;"marya";2077;0;100
0;78;"maryagnes";78;0;100
0;1927;"maryah";1927;0;100
0;2357;"maryalice";2357;0;100
0;66;"maryalyce";66;0;100
0;7742;"maryam";7742;0;100
0;318;"maryama";318;0;100
0;5;"maryamawit";5;0;100
33;1382;"maryan";1415;2.3321554770318;97.6678445229682
0;466;"maryana";466;0;100
0;47;"maryangel";47;0;100
52;61878;"maryann";61930;0.0839657678023575;99.9160342321976
0;2407;"maryanna";2407;0;100
0;13514;"maryanne";13514;0;100
0;678;"marybel";678;0;100
0;543;"marybell";543;0;100
0;66;"marybella";66;0;100
0;1680;"marybelle";1680;0;100
0;10098;"marybeth";10098;0;100
0;353;"marycarmen";353;0;100
0;34;"marycarol";34;0;100
0;5;"marycaroline";5;0;100
0;871;"marycatherine";871;0;100
0;5;"marycela";5;0;100
0;5;"marychristina";5;0;100
0;501;"maryclaire";501;0;100
0;310;"maryclare";310;0;100
0;430;"marycruz";430;0;100
0;29;"marydell";29;0;100
0;1515;"marye";1515;0;100
0;10;"maryeileen";10;0;100
0;30;"maryel";30;0;100
0;99;"maryela";99;0;100
0;5;"maryelaine";5;0;100
0;19;"maryeli";19;0;100
0;1956;"maryelizabeth";1956;0;100
0;593;"maryella";593;0;100
0;16;"maryelle";16;0;100
0;12913;"maryellen";12913;0;100
0;5;"maryellis";5;0;100
0;5;"maryellyn";5;0;100
0;68;"maryem";68;0;100
0;22;"maryemma";22;0;100
0;16;"maryesther";16;0;100
0;1116;"maryetta";1116;0;100
0;38;"maryette";38;0;100
0;5;"maryfaith";5;0;100
0;176;"maryfer";176;0;100
0;876;"maryfrances";876;0;100
0;1714;"marygrace";1714;0;100
0;5;"maryha";5;0;100
0;5;"maryhannah";5;0;100
0;1004;"maryhelen";1004;0;100
0;31;"maryia";31;0;100
0;173;"maryiah";173;0;100
0;12544;"maryjane";12544;0;100
0;117;"maryjayne";117;0;100
0;1093;"maryjean";1093;0;100
0;17;"maryjeanne";17;0;100
0;7010;"maryjo";7010;0;100
0;44;"maryjoan";44;0;100
0;6;"maryjoe";6;0;100
0;57;"maryjose";57;0;100
0;28;"maryjoy";28;0;100
0;6;"maryjune";6;0;100
0;5;"maryka";5;0;100
0;1940;"marykate";1940;0;100
0;720;"marykatherine";720;0;100
0;83;"marykathleen";83;0;100
0;474;"marykathryn";474;0;100
0;906;"marykay";906;0;100
0;26;"marykaye";26;0;100
0;11;"maryke";11;0;100
0;318;"maryl";318;0;100
0;16;"maryla";16;0;100
0;76;"marylan";76;0;100
311;978;"maryland";1289;24.1272304111715;75.8727695888285
0;6;"marylane";6;0;100
0;46;"marylea";46;0;100
0;5;"marylean";5;0;100
0;3307;"marylee";3307;0;100
0;89;"marylen";89;0;100
0;5;"marylena";5;0;100
0;301;"marylene";301;0;100
0;4259;"marylin";4259;0;100
0;29;"marylinda";29;0;100
0;27;"maryline";27;0;100
0;5;"marylinn";5;0;100
0;28;"marylisa";28;0;100
0;6;"maryliz";6;0;100
0;524;"maryln";524;0;100
0;11;"marylois";11;0;100
0;128;"marylon";128;0;100
0;12882;"marylou";12882;0;100
0;1878;"marylouise";1878;0;100
0;899;"marylu";899;0;100
0;10;"marylue";10;0;100
0;26;"maryluz";26;0;100
0;3304;"marylyn";3304;0;100
0;2062;"marylynn";2062;0;100
0;168;"marylynne";168;0;100
0;16;"marymae";16;0;100
0;35;"marymar";35;0;100
0;873;"marymargaret";873;0;100
0;17;"marymichael";17;0;100
0;2041;"maryn";2041;0;100
0;129;"maryna";129;0;100
0;6;"marynel";6;0;100
0;252;"marynell";252;0;100
5;420;"maryon";425;1.17647058823529;98.8235294117647
0;6;"maryona";6;0;100
0;54;"maryonna";54;0;100
0;102;"maryori";102;0;100
0;18;"maryorie";18;0;100
0;6;"maryory";6;0;100
0;115;"marypat";115;0;100
0;32;"marypatricia";32;0;100
0;16;"marypaz";16;0;100
0;37;"maryrita";37;0;100
0;2165;"maryrose";2165;0;100
0;245;"maryruth";245;0;100
0;543;"marysa";543;0;100
0;5;"marysabel";5;0;100
0;101;"maryse";101;0;100
0;30;"marysia";30;0;100
0;1426;"marysol";1426;0;100
0;1656;"maryssa";1656;0;100
0;440;"marysue";440;0;100
0;20;"marysusan";20;0;100
0;5;"maryterese";5;0;100
0;42;"marytheresa";42;0;100
0;93;"marytza";93;0;100
0;285;"maryum";285;0;100
0;134;"maryuri";134;0;100
0;5;"maryury";5;0;100
0;5;"maryvel";5;0;100
32;0;"marz";32;100;0
5;0;"marzavion";5;100;0
0;60;"marzee";60;0;100
6;0;"marzel";6;100;0
245;204;"marzell";449;54.56570155902;45.43429844098
0;511;"marzella";511;0;100
0;109;"marzelle";109;0;100
0;18;"marzena";18;0;100
0;212;"marzetta";212;0;100
0;17;"marzette";17;0;100
0;41;"marzia";41;0;100
0;5;"marziah";5;0;100
0;45;"marzie";45;0;100
0;7;"marziya";7;0;100
11;0;"mas";11;100;0
12;189;"masa";201;5.97014925373134;94.0298507462687
60;0;"masaaki";60;100;0
6;5;"masada";11;54.5454545454545;45.4545454545455
0;137;"masae";137;0;100
0;6;"masah";6;0;100
48;0;"masaharu";48;100;0
63;0;"masahiro";63;100;0
304;0;"masai";304;100;0
159;0;"masaichi";159;100;0
62;0;"masaji";62;100;0
5;0;"masakatsu";5;100;0
12;0;"masakazu";12;100;0
234;0;"masaki";234;100;0
0;821;"masako";821;0;100
0;11;"masal";11;0;100
288;5;"masami";293;98.2935153583618;1.70648464163823
15;0;"masan";15;100;0
0;5;"masani";5;0;100
35;0;"masanobu";35;100;0
60;0;"masanori";60;100;0
1012;0;"masao";1012;100;0
448;0;"masaru";448;100;0
146;0;"masashi";146;100;0
5;0;"masataka";5;100;0
446;0;"masato";446;100;0
16;0;"masatoshi";16;100;0
17;0;"masaya";17;100;0
0;63;"masaye";63;0;100
0;67;"masayo";67;0;100
133;0;"masayoshi";133;100;0
194;0;"masayuki";194;100;0
5;0;"mascen";5;100;0
11;0;"mascud";11;100;0
71;0;"mase";71;100;0
0;52;"masel";52;0;100
2593;74;"masen";2667;97.225346831646;2.77465316835396
17;0;"maseo";17;100;0
0;271;"masey";271;0;100
0;370;"masha";370;0;100
6;0;"mashad";6;100;0
0;10;"mashae";10;0;100
0;117;"mashal";117;0;100
0;22;"mashala";22;0;100
0;6;"mashana";6;0;100
0;89;"mashanda";89;0;100
0;6;"mashanna";6;0;100
0;7;"mashanti";7;0;100
0;5;"mashari";5;0;100
24;0;"mashaun";24;100;0
0;5;"mashauna";5;0;100
0;5;"mashaunda";5;0;100
37;62;"mashawn";99;37.3737373737374;62.6262626262626
0;11;"mashawna";11;0;100
0;10;"mashawnda";10;0;100
0;5;"mashay";5;0;100
0;11;"mashaya";11;0;100
0;432;"mashayla";432;0;100
0;5;"mashea";5;0;100
0;23;"masheka";23;0;100
0;309;"mashell";309;0;100
0;114;"mashelle";114;0;100
0;19;"mashia";19;0;100
0;11;"mashika";11;0;100
0;29;"mashiya";29;0;100
6;0;"mashon";6;100;0
0;24;"mashona";24;0;100
0;120;"mashonda";120;0;100
0;5;"mashunda";5;0;100
0;15;"mashyia";15;0;100
13;5;"masi";18;72.2222222222222;27.7777777777778
0;5;"masia";5;0;100
487;102;"masiah";589;82.6825127334465;17.3174872665535
0;361;"masie";361;0;100
0;139;"masiel";139;0;100
0;24;"masiela";24;0;100
31;0;"masih";31;100;0
0;15;"masika";15;0;100
0;6;"masil";6;0;100
259;0;"masin";259;100;0
0;27;"masina";27;0;100
10;0;"masion";10;100;0
6;0;"masir";6;100;0
5;71;"masiya";76;6.57894736842105;93.4210526315789
65;158;"masiyah";223;29.1479820627803;70.8520179372197
19;0;"maslah";19;100;0
0;5;"maslin";5;0;100
0;10;"maslyn";10;0;100
0;5;"maslynn";5;0;100
7;0;"maso";7;100;0
256932;2764;"mason";259696;98.9356786396402;1.06432136035981
16;0;"masonjames";16;100;0
5;0;"masonlee";5;100;0
31;0;"masood";31;100;0
0;5;"masooma";5;0;100
49;0;"masoud";49;100;0
0;91;"massa";91;0;100
69;0;"massai";69;100;0
10;0;"massen";10;100;0
64;32;"massey";96;66.6666666666667;33.3333333333333
17;0;"massi";17;100;0
538;86;"massiah";624;86.2179487179487;13.7820512820513
99;227;"massie";326;30.3680981595092;69.6319018404908
0;706;"massiel";706;0;100
222;0;"massimiliano";222;100;0
2326;0;"massimo";2326;100;0
6;0;"massiyah";6;100;0
256;0;"masson";256;100;0
347;0;"master";347;100;0
11;0;"mastin";11;100;0
223;0;"maston";223;100;0
151;0;"masud";151;100;0
0;18;"masue";18;0;100
0;16;"masuko";16;0;100
0;5;"masuma";5;0;100
0;19;"masumi";19;0;100
49;0;"masun";49;100;0
35;0;"masuo";35;100;0
1012;438;"masyn";1450;69.7931034482759;30.2068965517241
0;5;"masynn";5;0;100
611;0;"mat";611;100;0
0;93;"mata";93;0;100
68;0;"mataeo";68;100;0
325;0;"matai";325;100;0
0;13;"mataia";13;0;100
79;0;"mataio";79;100;0
0;136;"matalie";136;0;100
0;50;"matalin";50;0;100
0;335;"matalyn";335;0;100
0;65;"matalynn";65;0;100
620;0;"matan";620;100;0
30;0;"matao";30;100;0
114;0;"matas";114;100;0
0;229;"matasha";229;0;100
0;1032;"mataya";1032;0;100
0;61;"matayah";61;0;100
43;0;"matayo";43;100;0
50;0;"mate";50;100;0
0;672;"matea";672;0;100
0;22;"mateah";22;0;100
0;6;"mateel";6;0;100
483;0;"mateen";483;100;0
169;0;"matei";169;100;0
95;0;"matej";95;100;0
24;67;"mateja";91;26.3736263736264;73.6263736263736
0;5;"matella";5;0;100
0;96;"matelyn";96;0;100
0;5;"matelynn";5;0;100
39308;21;"mateo";39329;99.946604286913;0.053395713087035
11;0;"mateos";11;100;0
0;11;"matesha";11;0;100
585;0;"mateus";585;100;0
1088;0;"mateusz";1088;100;0
0;97;"mateya";97;0;100
5;0;"mateyo";5;100;0
62;0;"math";62;100;0
0;314;"matha";314;0;100
13;10;"mathai";23;56.5217391304348;43.4782608695652
24;0;"mathais";24;100;0
144;0;"mathan";144;100;0
29;0;"mathaniel";29;100;0
149;0;"mathayus";149;100;0
0;146;"mathea";146;0;100
67;0;"matheau";67;100;0
0;60;"mathel";60;0;100
624;0;"matheo";624;100;0
5;0;"matheos";5;100;0
21;0;"mather";21;100;0
99;0;"matheson";99;100;0
214;0;"matheu";214;100;0
1136;0;"matheus";1136;100;0
73577;207;"mathew";73784;99.7194513715711;0.280548628428928
433;0;"mathews";433;100;0
133;0;"mathhew";133;100;0
7898;0;"mathias";7898;100;0
0;5;"mathie";5;0;100
2111;0;"mathieu";2111;100;0
10;0;"mathiew";10;100;0
5;0;"mathijs";5;100;0
0;4822;"mathilda";4822;0;100
0;1146;"mathilde";1146;0;100
1437;0;"mathis";1437;100;0
6;5;"mathison";11;54.5454545454545;45.4545454545455
146;0;"mathius";146;100;0
11;0;"mathu";11;100;0
28;0;"mathue";28;100;0
5;0;"mathyas";5;100;0
5;0;"mathyis";5;100;0
6;0;"mathys";6;100;0
23;0;"mathyus";23;100;0
23;54;"mati";77;29.8701298701299;70.1298701298701
5;403;"matia";408;1.22549019607843;98.7745098039216
0;5;"matiah";5;0;100
0;55;"matiana";55;0;100
8126;0;"matias";8126;100;0
0;5;"maticia";5;0;100
0;260;"matie";260;0;100
0;44;"matigan";44;0;100
0;95;"matika";95;0;100
5;25138;"matilda";25143;0.0198862506463031;99.9801137493537
218;2809;"matilde";3027;7.20185001651801;92.798149983482
0;5;"matildia";5;0;100
0;5;"matilee";5;0;100
0;776;"matilyn";776;0;100
0;167;"matilynn";167;0;100
206;0;"matin";206;100;0
0;348;"matina";348;0;100
60;0;"matis";60;100;0
0;23;"matisen";23;0;100
0;167;"matisha";167;0;100
0;344;"matison";344;0;100
182;204;"matisse";386;47.1502590673575;52.8497409326425
38;0;"matisyahu";38;100;0
0;86;"matisyn";86;0;100
446;0;"matix";446;100;0
0;5;"matiya";5;0;100
0;7;"matlin";7;0;100
0;5;"matline";5;0;100
5;0;"matlock";5;100;0
0;46;"matlyn";46;0;100
0;5;"matney";5;0;100
44;0;"mato";44;100;0
0;31;"matoya";31;0;100
0;85;"matraca";85;0;100
0;9;"matracia";9;0;100
0;87;"matrice";87;0;100
0;58;"matricia";58;0;100
36;0;"matrim";36;100;0
47;0;"matrix";47;100;0
0;6;"matrona";6;0;100
78;0;"mats";78;100;0
176;0;"matson";176;100;0
0;157;"matsue";157;0;100
5;0;"matsuichi";5;100;0
0;111;"matsuko";111;0;100
24;0;"matsuo";24;100;0
0;18;"matsuye";18;0;100
0;19;"matsuyo";19;0;100
22895;5;"matt";22900;99.9781659388646;0.0218340611353712
0;163;"mattalyn";163;0;100
0;109;"mattalynn";109;0;100
51;0;"mattan";51;100;0
5;0;"mattaniah";5;100;0
0;5;"mattaya";5;0;100
0;1595;"mattea";1595;0;100
11;0;"matteen";11;100;0
0;124;"mattelyn";124;0;100
0;10;"mattelynn";10;0;100
5;0;"matten";5;100;0
12922;5;"matteo";12927;99.9613212655682;0.0386787344318094
10;110;"matteson";120;8.33333333333333;91.6666666666667
156;0;"matteus";156;100;0
1142;0;"mattew";1142;100;0
5;0;"matthaeus";5;100;0
34;0;"matthais";34;100;0
247;0;"matthan";247;100;0
10;0;"matthaus";10;100;0
68;0;"matthe";68;100;0
0;5;"matthea";5;0;100
21;0;"mattheau";21;100;0
35;0;"matthen";35;100;0
72;0;"mattheo";72;100;0
5;0;"mattheq";5;100;0
69;0;"matther";69;100;0
118;0;"mattheu";118;100;0
155;0;"mattheus";155;100;0
1576513;5496;"matthew";1582009;99.6525936325267;0.347406367473257
11;0;"matthewalexande";11;100;0
5;0;"matthewdavid";5;100;0
73;0;"matthewjames";73;100;0
10;0;"matthewjohn";10;100;0
18;0;"matthewjoseph";18;100;0
16;0;"matthewryan";16;100;0
1490;0;"matthews";1490;100;0
15;0;"matthey";15;100;0
7215;0;"matthias";7215;100;0
897;0;"matthieu";897;100;0
45;0;"matthiew";45;100;0
8;0;"matthijs";8;100;0
17;0;"matthis";17;100;0
9;0;"matthius";9;100;0
10;0;"matthrew";10;100;0
40;0;"matthue";40;100;0
18;0;"matthw";18;100;0
54;551;"matti";605;8.92561983471074;91.0743801652893
174;136;"mattia";310;56.1290322580645;43.8709677419355
1321;0;"mattias";1321;100;0
686;108489;"mattie";109175;0.628348980993817;99.3716510190062
0;10;"mattielee";10;0;100
0;26;"mattigan";26;0;100
0;461;"mattilyn";461;0;100
0;211;"mattilynn";211;0;100
53;248;"mattingly";301;17.6079734219269;82.3920265780731
103;0;"mattis";103;100;0
0;91;"mattisen";91;0;100
210;2071;"mattison";2281;9.20648838228847;90.7935116177115
0;168;"mattisyn";168;0;100
337;0;"mattix";337;100;0
7;0;"mattlock";7;100;0
0;10;"mattlyn";10;0;100
472;24;"mattox";496;95.1612903225807;4.83870967741935
66;0;"mattson";66;100;0
70;0;"mattthew";70;100;0
126;593;"matty";719;17.5243393602225;82.4756606397775
0;509;"mattye";509;0;100
0;10;"mattyson";10;0;100
5;0;"matus";5;100;0
32;0;"matvei";32;100;0
170;0;"matvey";170;100;0
31;0;"matviy";31;100;0
0;109;"maty";109;0;100
127;0;"matyas";127;100;0
0;99;"matylda";99;0;100
0;17;"matyson";17;0;100
5;0;"mau";5;100;0
5;5645;"maud";5650;0.0884955752212389;99.9115044247788
0;24;"mauda";24;0;100
35;22737;"maude";22772;0.153697523274196;99.8463024767258
0;144;"maudean";144;0;100
0;42;"maudeen";42;0;100
0;8;"maudeline";8;0;100
0;482;"maudell";482;0;100
0;60;"maudella";60;0;100
0;54;"maudelle";54;0;100
0;25;"maudena";25;0;100
0;73;"maudene";73;0;100
0;5;"maudestine";5;0;100
0;10115;"maudie";10115;0;100
0;1148;"maudine";1148;0;100
0;5;"maudra";5;0;100
0;17;"maudrey";17;0;100
0;206;"maudry";206;0;100
0;93;"maudy";93;0;100
15;0;"mauel";15;100;0
12;0;"mauer";12;100;0
82;64;"maui";146;56.1643835616438;43.8356164383562
0;8;"mauli";8;0;100
15;0;"maulik";15;100;0
5;0;"maulin";5;100;0
0;12;"mauline";12;0;100
0;57;"mauna";57;0;100
5;0;"maung";5;100;0
5;18832;"maura";18837;0.0265435048043744;99.9734564951956
5;0;"maurece";5;100;0
328;143940;"maureen";144268;0.227354645520836;99.7726453544792
0;85;"maureena";85;0;100
0;15;"maureene";15;0;100
0;26;"mauren";26;0;100
0;635;"maurene";635;0;100
10;0;"maurese";10;100;0
0;39;"mauresha";39;0;100
5;0;"maurey";5;100;0
123;770;"mauri";893;13.7737961926092;86.2262038073908
0;64;"mauria";64;0;100
0;153;"mauriah";153;0;100
0;168;"mauriana";168;0;100
0;74;"maurianna";74;0;100
0;393;"maurica";393;0;100
131491;2606;"maurice";134097;98.0566306479638;1.94336935203621
16;0;"mauriceo";16;100;0
0;517;"mauricia";517;0;100
20316;6;"mauricio";20322;99.9704753469147;0.0295246530853262
257;0;"maurico";257;100;0
5;0;"mauricus";5;100;0
98;312;"maurie";410;23.9024390243902;76.0975609756098
0;5;"mauriella";5;0;100
0;15;"maurielle";15;0;100
0;5;"maurietta";5;0;100
0;10;"maurika";10;0;100
685;0;"maurilio";685;100;0
0;5;"maurin";5;0;100
0;94;"maurina";94;0;100
0;8747;"maurine";8747;0;100
279;0;"maurio";279;100;0
194;0;"maurion";194;100;0
0;292;"maurisa";292;0;100
0;227;"maurisha";227;0;100
310;0;"maurisio";310;100;0
0;633;"maurissa";633;0;100
0;925;"maurita";925;0;100
12;0;"mauritz";12;100;0
0;24;"mauriyah";24;0;100
585;0;"maurizio";585;100;0
13;0;"maurkice";13;100;0
5608;0;"mauro";5608;100;0
6;0;"maurquise";6;100;0
5;0;"maurus";5;100;0
2437;258;"maury";2695;90.4267161410018;9.57328385899815
15;130;"maurya";145;10.3448275862069;89.6551724137931
0;6;"mauryn";6;0;100
0;288;"mava";288;0;100
0;27;"mavel";27;0;100
0;5;"mavelyn";5;0;100
251;300;"maven";551;45.5535390199637;54.4464609800363
224;0;"maveric";224;100;0
15696;112;"maverick";15808;99.2914979757085;0.708502024291498
371;0;"maverik";371;100;0
10;0;"maverix";10;100;0
0;52;"mavery";52;0;100
33;0;"maveryck";33;100;0
41;0;"maveryk";41;100;0
0;52;"mavi";52;0;100
0;5;"mavia";5;0;100
0;26;"mavie";26;0;100
71;16;"mavin";87;81.6091954022989;18.3908045977011
135;19276;"mavis";19411;0.695481943228067;99.3045180567719
0;52;"mavourneen";52;0;100
0;7;"mavra";7;0;100
107;0;"mavric";107;100;0
852;0;"mavrick";852;100;0
251;0;"mavrik";251;100;0
31;0;"mavryck";31;100;0
70;0;"mavryk";70;100;0
0;7;"mavyn";7;0;100
0;22;"mawa";22;0;100
0;29;"mawada";29;0;100
0;10;"mawiyah";10;0;100
143069;651;"max";143720;99.547035903145;0.452964096854996
78;0;"maxamilian";78;100;0
175;0;"maxamillian";175;100;0
377;0;"maxamillion";377;100;0
6;0;"maxamis";6;100;0
191;0;"maxamus";191;100;0
0;1083;"maxcine";1083;0;100
56;0;"maxden";56;100;0
0;18;"maxeen";18;0;100
17;0;"maxel";17;100;0
27;0;"maxell";27;100;0
172;0;"maxemiliano";172;100;0
288;0;"maxen";288;100;0
40;0;"maxence";40;100;0
0;487;"maxene";487;0;100
279;5;"maxey";284;98.2394366197183;1.76056338028169
824;0;"maxfield";824;100;0
108;125;"maxi";233;46.3519313304721;53.6480686695279
4551;3723;"maxie";8274;55.0036258158086;44.9963741841914
6;18;"maxiel";24;25;75
0;22;"maxiene";22;0;100
5352;6;"maxim";5358;99.8880179171333;0.111982082866741
0;82;"maxima";82;0;100
51;0;"maximas";51;100;0
841;50;"maxime";891;94.3883277216611;5.61167227833895
141;0;"maximiano";141;100;0
6;0;"maximilan";6;100;0
13;0;"maximilano";13;100;0
5;0;"maximili";5;100;0
13874;0;"maximilian";13874;100;0
12760;0;"maximiliano";12760;100;0
288;0;"maximilien";288;100;0
5;0;"maximilion";5;100;0
52;0;"maximillan";52;100;0
5287;0;"maximillian";5287;100;0
439;0;"maximilliano";439;100;0
6;0;"maximillien";6;100;0
502;0;"maximillion";502;100;0
0;120;"maximina";120;0;100
1798;0;"maximino";1798;100;0
5787;0;"maximo";5787;100;0
498;0;"maximos";498;100;0
41;0;"maximous";41;100;0
75;0;"maximum";75;100;0
21849;12;"maximus";21861;99.9451077260876;0.0548922739124468
49;0;"maxin";49;100;0
377;111377;"maxine";111754;0.337348103871002;99.662651896129
5;0;"maxis";5;100;0
0;5;"maxlynn";5;0;100
129;0;"maxmilian";129;100;0
5;0;"maxmiliano";5;100;0
198;0;"maxmillian";198;100;0
15;0;"maxmillion";15;100;0
0;5;"maxola";5;0;100
823;0;"maxon";823;100;0
19;0;"maxsen";19;100;0
42;0;"maxsim";42;100;0
606;0;"maxson";606;100;0
19;0;"maxston";19;100;0
80;0;"maxten";80;100;0
28;0;"maxtin";28;100;0
2630;0;"maxton";2630;100;0
37;5;"maxtyn";42;88.0952380952381;11.9047619047619
5;0;"maxuel";5;100;0
89;0;"maxum";89;100;0
21;0;"maxus";21;100;0
257;0;"maxwel";257;100;0
86827;310;"maxwell";87137;99.6442383832356;0.355761616764405
5;0;"maxwill";5;100;0
3231;53;"maxx";3284;98.3861144945189;1.61388550548112
5;0;"maxxamus";5;100;0
10;0;"maxxen";10;100;0
21;0;"maxxim";21;100;0
309;0;"maxximus";309;100;0
0;5;"maxxine";5;0;100
8;0;"maxxis";8;100;0
62;0;"maxxon";62;100;0
11;0;"maxxton";11;100;0
6;0;"maxxwel";6;100;0
217;0;"maxxwell";217;100;0
11;0;"maxy";11;100;0
24;0;"maxym";24;100;0
26;0;"maxymilian";26;100;0
5;0;"maxymus";5;100;0
5;0;"maxyn";5;100;0
0;87;"maxyne";87;0;100
605;35334;"may";35939;1.68340799688361;98.3165920031164
152;87555;"maya";87707;0.173304297262476;99.8266957027375
0;6;"mayaar";6;0;100
0;7;"mayada";7;0;100
0;2144;"mayah";2144;0;100
0;5;"mayala";5;0;100
0;11;"mayalen";11;0;100
0;5;"mayalyn";5;0;100
128;206;"mayan";334;38.3233532934132;61.6766467065868
0;145;"mayana";145;0;100
0;16;"mayani";16;0;100
198;0;"mayank";198;100;0
0;5;"mayann";5;0;100
0;82;"mayanna";82;0;100
20;445;"mayar";465;4.3010752688172;95.6989247311828
0;84;"mayara";84;0;100
0;42;"mayari";42;0;100
0;6;"mayarose";6;0;100
0;176;"maybel";176;0;100
0;6;"maybelin";6;0;100
0;30;"maybeline";30;0;100
0;1881;"maybell";1881;0;100
0;5093;"maybelle";5093;0;100
0;24;"maybellene";24;0;100
0;458;"maybelline";458;0;100
0;49;"maybeth";49;0;100
0;21;"mayble";21;0;100
0;5;"maybre";5;0;100
0;153;"maybree";153;0;100
0;33;"maybrie";33;0;100
0;429;"mayce";429;0;100
0;2228;"maycee";2228;0;100
0;64;"maycel";64;0;100
75;47;"maycen";122;61.4754098360656;38.5245901639344
10;0;"mayceon";10;100;0
0;6;"maycey";6;0;100
0;612;"mayci";612;0;100
0;1191;"maycie";1191;0;100
0;5;"maycin";5;0;100
0;13;"maycle";13;0;100
191;0;"mayco";191;100;0
112;0;"maycol";112;100;0
42;0;"maycon";42;100;0
0;545;"mayda";545;0;100
0;32;"maydean";32;0;100
0;5;"maydee";5;0;100
0;5;"maydeen";5;0;100
0;5;"maydel";5;0;100
0;94;"maydelin";94;0;100
0;367;"maydell";367;0;100
0;49;"maydelle";49;0;100
0;7;"maydelyn";7;0;100
0;12;"mayden";12;0;100
0;36;"maydene";36;0;100
0;1502;"maye";1502;0;100
0;15;"mayeda";15;0;100
11;0;"mayel";11;100;0
0;796;"mayela";796;0;100
0;448;"mayeli";448;0;100
0;106;"mayelin";106;0;100
0;32;"mayella";32;0;100
0;44;"mayely";44;0;100
15;0;"mayen";15;100;0
1824;5;"mayer";1829;99.7266265718972;0.273373428102788
0;93;"mayerli";93;0;100
0;49;"mayerlin";49;0;100
0;120;"mayerly";120;0;100
72;5;"mayes";77;93.5064935064935;6.49350649350649
0;238;"mayetta";238;0;100
128;0;"mayfield";128;100;0
230;0;"mayford";230;100;0
0;38;"mayfred";38;0;100
0;612;"maygan";612;0;100
0;398;"maygen";398;0;100
0;5;"mayghan";5;0;100
0;5;"mayha";5;0;100
11;0;"mayhem";11;100;0
0;5;"mayher";5;0;100
13;0;"mayhew";13;100;0
0;79;"mayia";79;0;100
0;32;"mayim";32;0;100
0;5;"mayisha";5;0;100
47;0;"mayjor";47;100;0
0;20;"mayka";20;0;100
0;37;"maykala";37;0;100
0;132;"maykayla";132;0;100
0;5;"maykaylee";5;0;100
49;0;"maykel";49;100;0
6;0;"mayko";6;100;0
22;0;"maykol";22;100;0
0;829;"mayla";829;0;100
0;33;"maylah";33;0;100
0;30;"maylan";30;0;100
0;23;"maylana";23;0;100
32;0;"mayland";32;100;0
0;327;"maylani";327;0;100
0;31;"maylanie";31;0;100
0;21;"maylasia";21;0;100
0;38;"mayle";38;0;100
0;232;"maylea";232;0;100
0;20;"mayleah";20;0;100
0;2526;"maylee";2526;0;100
0;673;"mayleen";673;0;100
0;51;"maylei";51;0;100
0;402;"mayleigh";402;0;100
0;500;"maylen";500;0;100
0;23;"maylena";23;0;100
0;987;"maylene";987;0;100
0;11;"maylet";11;0;100
0;110;"mayley";110;0;100
0;327;"mayli";327;0;100
0;55;"maylia";55;0;100
0;10;"mayliah";10;0;100
0;370;"maylie";370;0;100
0;2081;"maylin";2081;0;100
0;10;"maylina";10;0;100
0;108;"mayline";108;0;100
0;117;"mayling";117;0;100
0;11;"maylinn";11;0;100
0;18;"maylis";18;0;100
293;7;"maylon";300;97.6666666666667;2.33333333333333
0;5;"mayly";5;0;100
0;268;"maylyn";268;0;100
0;410;"maylynn";410;0;100
0;6939;"mayme";6939;0;100
0;825;"maymie";825;0;100
0;5;"maymouna";5;0;100
0;70;"maymuna";70;0;100
0;42;"maymunah";42;0;100
0;6;"mayna";6;0;100
14542;22;"maynard";14564;99.8489425981873;0.151057401812689
5;0;"mayne";5;100;0
6;0;"maynerd";6;100;0
0;15;"maynette";15;0;100
712;0;"maynor";712;100;0
10;0;"maynord";10;100;0
1220;256;"mayo";1476;82.6558265582656;17.3441734417344
0;1198;"mayola";1198;0;100
5;0;"mayolo";5;100;0
0;10;"mayoma";10;0;100
11;0;"mayon";11;100;0
0;21;"mayona";21;0;100
0;9;"mayonna";9;0;100
6;0;"mayor";6;100;0
10;0;"mayowa";10;100;0
345;32015;"mayra";32360;1.06613102595797;98.933868974042
0;53;"mayraalejandra";53;0;100
0;5;"mayrah";5;0;100
0;159;"mayrani";159;0;100
0;117;"mayre";117;0;100
0;5;"mayree";5;0;100
0;5;"mayrel";5;0;100
0;72;"mayreli";72;0;100
0;13;"mayrelin";13;0;100
0;5;"mayrely";5;0;100
0;27;"mayren";27;0;100
0;108;"mayrene";108;0;100
0;5;"mayreni";5;0;100
0;51;"mayrim";51;0;100
0;972;"mayrin";972;0;100
10;0;"mayron";10;100;0
58;24;"mays";82;70.7317073170732;29.2682926829268
0;684;"maysa";684;0;100
0;11;"maysaa";11;0;100
0;41;"maysam";41;0;100
0;6;"maysan";6;0;100
0;5;"maysea";5;0;100
0;346;"maysel";346;0;100
421;486;"maysen";907;46.4167585446527;53.5832414553473
0;11;"maysha";11;0;100
0;277;"maysie";277;0;100
80;5;"maysin";85;94.1176470588235;5.88235294117647
16;0;"maysn";16;100;0
3114;910;"mayson";4024;77.3856858846919;22.6143141153082
0;75;"maysoon";75;0;100
0;17;"mayssa";17;0;100
5;96;"maysun";101;4.95049504950495;95.049504950495
0;163;"maytal";163;0;100
0;2833;"mayte";2833;0;100
0;33;"maytee";33;0;100
0;6;"maytha";6;0;100
0;89;"maythe";89;0;100
0;6;"maythel";6;0;100
0;71;"maytte";71;0;100
0;169;"mayu";169;0;100
43;0;"mayukh";43;100;0
0;51;"mayukha";51;0;100
0;26;"mayuko";26;0;100
0;474;"mayumi";474;0;100
191;0;"mayur";191;100;0
0;122;"mayuri";122;0;100
0;7;"mayva";7;0;100
0;8;"mayve";8;0;100
0;24;"mayven";24;0;100
0;89;"mayvis";89;0;100
26;6;"maywood";32;81.25;18.75
0;105;"mayzee";105;0;100
0;40;"mayzell";40;0;100
0;5;"mayzelle";5;0;100
0;9;"mayzi";9;0;100
0;469;"mayzie";469;0;100
5;0;"maz";5;100;0
0;157;"mazal";157;0;100
0;5;"mazani";5;0;100
0;6;"mazari";6;0;100
0;5;"mazaria";5;0;100
0;17;"mazarine";17;0;100
77;0;"maze";77;100;0
0;27;"mazee";27;0;100
0;391;"mazel";391;0;100
0;285;"mazell";285;0;100
0;137;"mazella";137;0;100
0;218;"mazelle";218;0;100
0;5;"mazelyn";5;0;100
0;5;"mazelynn";5;0;100
941;0;"mazen";941;100;0
0;119;"mazey";119;0;100
5;0;"mazhar";5;100;0
55;75;"mazi";130;42.3076923076923;57.6923076923077
62;98;"maziah";160;38.75;61.25
32;0;"maziar";32;100;0
0;7116;"mazie";7116;0;100
0;7;"mazikeen";7;0;100
551;0;"mazin";551;100;0
0;17;"maziya";17;0;100
0;141;"maziyah";141;0;100
0;5;"mazle";5;0;100
0;51;"mazlyn";51;0;100
0;6;"mazlynn";6;0;100
0;58;"mazola";58;0;100
25;0;"mazon";25;100;0
0;157;"mazy";157;0;100
0;5;"mazyah";5;0;100
0;8;"mazzi";8;0;100
0;397;"mazzie";397;0;100
0;637;"mazzy";637;0;100
0;40;"mber";40;0;100
227;209;"mc";436;52.0642201834862;47.9357798165138
68;0;"mcadoo";68;100;0
5;0;"mcalister";5;100;0
43;11;"mcallister";54;79.6296296296296;20.3703703703704
47;0;"mcarther";47;100;0
2261;0;"mcarthur";2261;100;0
20;0;"mcauther";20;100;0
14;0;"mcauthor";14;100;0
17;0;"mcauthur";17;100;0
0;17;"mcayla";17;0;100
105;0;"mccabe";105;100;0
99;0;"mccade";99;100;0
0;20;"mccaela";20;0;100
6;0;"mccai";6;100;0
52;0;"mccain";52;100;0
79;983;"mccall";1062;7.43879472693032;92.5612052730697
41;0;"mccarthy";41;100;0
97;245;"mccartney";342;28.3625730994152;71.6374269005848
5;5;"mccarty";10;50;50
66;21;"mccauley";87;75.8620689655172;24.1379310344828
0;93;"mccayla";93;0;100
5;0;"mcchael";5;100;0
352;32;"mcclain";384;91.6666666666667;8.33333333333333
6;0;"mcclane";6;100;0
84;0;"mcclellan";84;100;0
34;0;"mcclinton";34;100;0
10;0;"mcclure";10;100;0
5;0;"mcconnell";5;100;0
14;0;"mccord";14;100;0
68;0;"mccormick";68;100;0
2387;39;"mccoy";2426;98.3924154987634;1.6075845012366
93;5;"mccrae";98;94.8979591836735;5.10204081632653
36;0;"mccray";36;100;0
86;0;"mcdaniel";86;100;0
605;0;"mcdonald";605;100;0
7;0;"mcelroy";7;100;0
22;0;"mcgarrett";22;100;0
80;0;"mcgregor";80;100;0
145;0;"mcguire";145;100;0
97;0;"mcgwire";97;100;0
5;0;"mchael";5;100;0
33;0;"mchale";33;100;0
51;0;"mchenry";51;100;0
98;0;"mcihael";98;100;0
0;5;"mcihelle";5;0;100
304;0;"mckade";304;100;0
23;0;"mckaden";23;100;0
0;6;"mckae";6;0;100
0;293;"mckaela";293;0;100
47;0;"mckai";47;100;0
5;0;"mckail";5;100;0
0;239;"mckaila";239;0;100
0;5;"mckailah";5;0;100
0;33;"mckailey";33;0;100
0;12;"mckailyn";12;0;100
0;230;"mckala";230;0;100
192;6;"mckale";198;96.969696969697;3.03030303030303
5;0;"mckaleb";5;100;0
0;10;"mckalee";10;0;100
0;5;"mckaleigh";5;0;100
0;21;"mckaley";21;0;100
0;12;"mckall";12;0;100
0;23;"mckalyn";23;0;100
0;11;"mckalynn";11;0;100
17;0;"mckane";17;100;0
1947;304;"mckay";2251;86.4948911594847;13.5051088405153
0;23;"mckaya";23;0;100
0;6;"mckayden";6;0;100
0;5;"mckaye";5;0;100
5;12211;"mckayla";12216;0.0409299279633268;99.9590700720367
0;259;"mckaylah";259;0;100
0;6;"mckaylan";6;0;100
0;22;"mckayle";22;0;100
0;518;"mckaylee";518;0;100
0;6;"mckaylen";6;0;100
0;5;"mckayli";5;0;100
0;6;"mckaylia";6;0;100
0;84;"mckaylie";84;0;100
0;75;"mckaylin";75;0;100
0;24;"mckaylyn";24;0;100
0;12;"mckaylynn";12;0;100
5;0;"mckean";5;100;0
5;0;"mckee";5;100;0
0;5;"mckeena";5;0;100
5;0;"mckeever";5;100;0
5;5;"mckel";10;50;50
13;417;"mckell";430;3.02325581395349;96.9767441860465
0;16;"mckella";16;0;100
0;58;"mckelle";58;0;100
0;6;"mckelvey";6;0;100
0;394;"mckena";394;0;100
0;53;"mckenah";53;0;100
0;53;"mckendra";53;0;100
0;212;"mckenize";212;0;100
0;165;"mckenlee";165;0;100
0;101;"mckenleigh";101;0;100
41;234;"mckenley";275;14.9090909090909;85.0909090909091
0;10;"mckenli";10;0;100
0;22;"mckenlie";22;0;100
5;50;"mckenly";55;9.09090909090909;90.9090909090909
183;34834;"mckenna";35017;0.522603306965188;99.4773966930348
0;473;"mckennah";473;0;100
10;0;"mckennan";10;100;0
93;0;"mckennon";93;100;0
0;29;"mckennzie";29;0;100
0;246;"mckensey";246;0;100
0;139;"mckensi";139;0;100
0;734;"mckensie";734;0;100
0;5;"mckensley";5;0;100
0;11;"mckensy";11;0;100
0;74;"mckenze";74;0;100
0;745;"mckenzee";745;0;100
0;173;"mckenzey";173;0;100
0;1858;"mckenzi";1858;0;100
2160;55326;"mckenzie";57486;3.75743659325749;96.2425634067425
0;11;"mckenziee";11;0;100
0;14;"mckenzii";14;0;100
0;6;"mckenzlee";6;0;100
0;7;"mckenzlie";7;0;100
35;944;"mckenzy";979;3.57507660878447;96.4249233912155
0;163;"mckenzye";163;0;100
10;0;"mckeon";10;100;0
0;12;"mckeyla";12;0;100
5;0;"mckinely";5;100;0
0;6;"mckinlea";6;0;100
0;935;"mckinlee";935;0;100
0;270;"mckinleigh";270;0;100
8844;8227;"mckinley";17071;51.8071583387031;48.1928416612969
0;14;"mckinli";14;0;100
0;30;"mckinlie";30;0;100
5;30;"mckinly";35;14.2857142857143;85.7142857142857
0;296;"mckinna";296;0;100
0;11;"mckinnah";11;0;100
35;23;"mckinney";58;60.3448275862069;39.6551724137931
67;360;"mckinnley";427;15.6908665105386;84.3091334894614
0;5;"mckinnly";5;0;100
91;5;"mckinnon";96;94.7916666666667;5.20833333333333
22;982;"mckinsey";1004;2.19123505976096;97.808764940239
0;16;"mckinsie";16;0;100
0;93;"mckinsley";93;0;100
0;68;"mckinze";68;0;100
0;192;"mckinzee";192;0;100
0;177;"mckinzey";177;0;100
0;116;"mckinzi";116;0;100
0;1431;"mckinzie";1431;0;100
0;20;"mckinzley";20;0;100
0;138;"mckinzy";138;0;100
152;0;"mckoy";152;100;0
12;0;"mckye";12;100;0
0;137;"mckyla";137;0;100
62;0;"mckyle";62;100;0
0;19;"mckylee";19;0;100
0;5;"mckylie";5;0;100
0;404;"mckynlee";404;0;100
0;50;"mckynleigh";50;0;100
0;22;"mckynley";22;0;100
0;11;"mckynli";11;0;100
0;90;"mckynlie";90;0;100
0;120;"mckynna";120;0;100
0;7;"mckynsie";7;0;100
0;5;"mckynze";5;0;100
0;53;"mckynzee";53;0;100
0;58;"mckynzi";58;0;100
0;513;"mckynzie";513;0;100
183;14;"mclain";197;92.8934010152284;7.10659898477157
0;10;"mclaine";10;0;100
87;5;"mclane";92;94.5652173913043;5.43478260869565
47;7;"mclaren";54;87.037037037037;12.962962962963
314;11;"mclean";325;96.6153846153846;3.38461538461538
43;0;"mcneal";43;100;0
53;0;"mcneil";53;100;0
0;5;"mcneva";5;0;100
5;0;"mcquade";5;100;0
26;5;"mcrae";31;83.8709677419355;16.1290322580645
5;0;"mcray";5;100;0
286;0;"md";286;100;0
0;5;"me";5;0;100
0;1467;"mea";1467;0;100
0;5;"meabh";5;0;100
118;0;"mead";118;100;0
0;5;"meada";5;0;100
515;6;"meade";521;98.8483685220729;1.15163147792706
0;15;"meadie";15;0;100
0;5749;"meadow";5749;0;100
72;41364;"meagan";41436;0.173761946133797;99.8262380538662
0;10;"meagann";10;0;100
0;1182;"meagen";1182;0;100
7;13988;"meaghan";13995;0.0500178635226867;99.9499821364773
0;145;"meaghann";145;0;100
0;172;"meaghen";172;0;100
0;17;"meagin";17;0;100
0;240;"meagon";240;0;100
0;5;"meagyn";5;0;100
0;1389;"meah";1389;0;100
0;7;"meahan";7;0;100
0;16;"meahgan";16;0;100
0;5;"mealea";5;0;100
0;6;"mealie";6;0;100
0;15;"meanna";15;0;100
0;1044;"meara";1044;0;100
0;13;"mearah";13;0;100
1203;423;"mearl";1626;73.9852398523985;26.0147601476015
82;26;"mearle";108;75.9259259259259;24.0740740740741
0;7;"mearlene";7;0;100
0;5;"mearline";5;0;100
0;33;"measha";33;0;100
0;56;"measia";56;0;100
32;9;"meba";41;78.0487804878049;21.9512195121951
0;45;"meca";45;0;100
0;10;"mecaela";10;0;100
0;5;"mecayla";5;0;100
214;1886;"mecca";2100;10.1904761904762;89.8095238095238
0;6;"meccah";6;0;100
0;12;"mecedes";12;0;100
0;12;"mecha";12;0;100
0;7;"mechaela";7;0;100
115;70;"mechel";185;62.1621621621622;37.8378378378378
0;722;"mechele";722;0;100
0;481;"mechell";481;0;100
0;5;"mechella";5;0;100
0;4372;"mechelle";4372;0;100
0;69;"mechille";69;0;100
0;21;"mecia";21;0;100
0;5;"mecie";5;0;100
5;0;"mecislaus";5;100;0
0;179;"meckenzie";179;0;100
43;43;"meco";86;50;50
0;19;"mecole";19;0;100
11;0;"mecos";11;100;0
0;1458;"meda";1458;0;100
69;0;"medard";69;100;0
353;0;"medardo";353;100;0
6;32;"meddie";38;15.7894736842105;84.2105263157895
0;202;"medea";202;0;100
0;12;"medelin";12;0;100
0;17;"medeline";17;0;100
0;15;"medelyn";15;0;100
0;5;"medena";5;0;100
5;0;"mederic";5;100;0
665;0;"medford";665;100;0
46;0;"medgar";46;100;0
11;0;"medger";11;100;0
0;735;"medha";735;0;100
51;0;"medhansh";51;100;0
0;361;"media";361;0;100
0;27;"medie";27;0;100
5;0;"medin";5;100;0
0;1592;"medina";1592;0;100
0;18;"medinah";18;0;100
5;13;"medley";18;27.7777777777778;72.2222222222222
0;660;"medora";660;0;100
0;16;"medra";16;0;100
6;0;"medric";6;100;0
17;0;"medrick";17;100;0
0;65;"medrith";65;0;100
5;0;"medwin";5;100;0
0;365;"mee";365;0;100
0;11;"meea";11;0;100
0;73;"meeah";73;0;100
0;979;"meegan";979;0;100
0;235;"meeghan";235;0;100
0;371;"meeka";371;0;100
0;46;"meekah";46;0;100
39;0;"meeko";39;100;0
0;300;"meela";300;0;100
14;0;"meelad";14;100;0
0;172;"meelah";172;0;100
12;1197;"meena";1209;0.992555831265509;99.0074441687345
0;5;"meenah";5;0;100
0;305;"meenakshi";305;0;100
127;0;"meer";127;100;0
0;2453;"meera";2453;0;100
6;94;"meerab";100;6;94
0;6;"meerah";6;0;100
0;5;"meerub";5;0;100
0;293;"meesha";293;0;100
97;0;"meet";97;100;0
0;155;"meeya";155;0;100
0;61;"meeyah";61;0;100
0;5255;"meg";5255;0;100
29;108;"mega";137;21.1678832116788;78.8321167883212
7;0;"megaa";7;100;0
0;6;"megaan";6;0;100
0;64;"megahn";64;0;100
7;0;"megail";7;100;0
5;0;"megale";5;100;0
0;5;"megam";5;0;100
1103;435896;"megan";436999;0.252403323577399;99.7475966764226
0;36;"megana";36;0;100
0;12;"meganelizabeth";12;0;100
0;10;"meganmarie";10;0;100
0;797;"megann";797;0;100
0;294;"meganne";294;0;100
0;174;"megean";174;0;100
0;682;"megen";682;0;100
0;2928;"meggan";2928;0;100
0;133;"meggen";133;0;100
0;10;"megghan";10;0;100
0;7;"meggi";7;0;100
0;514;"meggie";514;0;100
0;345;"meggin";345;0;100
22;0;"megh";22;100;0
0;1005;"megha";1005;0;100
0;36;"meghaan";36;0;100
0;91;"megham";91;0;100
226;94279;"meghan";94505;0.239140786201788;99.7608592137982
0;919;"meghana";919;0;100
0;3788;"meghann";3788;0;100
0;98;"meghanne";98;0;100
0;5;"meghean";5;0;100
0;135;"meghen";135;0;100
0;193;"meghin";193;0;100
0;593;"meghna";593;0;100
0;5;"meghon";5;0;100
0;5;"meghyn";5;0;100
0;294;"megin";294;0;100
0;16;"megna";16;0;100
0;16;"megnan";16;0;100
0;161;"megon";161;0;100
21;0;"meguel";21;100;0
0;531;"megumi";531;0;100
0;434;"megyn";434;0;100
0;178;"meha";178;0;100
6;0;"mehaan";6;100;0
0;341;"mehak";341;0;100
0;15;"mehakpreet";15;0;100
5;22;"mehan";27;18.5185185185185;81.4814814814815
0;48;"mehana";48;0;100
26;238;"mehar";264;9.84848484848485;90.1515151515152
810;0;"mehdi";810;100;0
0;140;"mehek";140;0;100
5;428;"meher";433;1.15473441108545;98.8452655889146
0;543;"mehgan";543;0;100
0;23;"mehjabeen";23;0;100
0;5;"mehjabin";5;0;100
125;0;"mehkai";125;100;0
1189;0;"mehki";1189;100;0
0;16;"mehlani";16;0;100
30;0;"mehmed";30;100;0
620;0;"mehmet";620;100;0
0;10;"mehnaz";10;0;100
0;153;"mehr";153;0;100
11;0;"mehrab";11;100;0
158;0;"mehran";158;100;0
6;0;"mehrdad";6;100;0
0;332;"mehreen";332;0;100
0;5;"mehret";5;0;100
0;5;"mehrimah";5;0;100
24;0;"mehtaab";24;100;0
108;0;"mehtab";108;100;0
292;0;"mehul";292;100;0
0;17;"mehvish";17;0;100
0;46;"mehwish";46;0;100
0;1195;"mei";1195;0;100
0;382;"meia";382;0;100
0;157;"meiah";157;0;100
0;6;"meichele";6;0;100
0;30;"meichelle";30;0;100
6;0;"meier";6;100;0
0;147;"meigan";147;0;100
0;5;"meigha";5;0;100
0;564;"meighan";564;0;100
0;522;"meika";522;0;100
0;12;"meikah";12;0;100
0;20;"meike";20;0;100
25;0;"meikhi";25;100;0
56;89;"meiko";145;38.6206896551724;61.3793103448276
0;289;"meila";289;0;100
0;53;"meilah";53;0;100
0;5;"meilahni";5;0;100
0;17;"meilan";17;0;100
0;1066;"meilani";1066;0;100
0;30;"meilanie";30;0;100
0;36;"meilany";36;0;100
0;5;"meile";5;0;100
151;0;"meilech";151;100;0
0;20;"meilee";20;0;100
0;274;"meili";274;0;100
12;0;"meilich";12;100;0
0;241;"meilin";241;0;100
0;321;"meiling";321;0;100
0;113;"meily";113;0;100
0;156;"meilyn";156;0;100
0;28;"meilynn";28;0;100
0;11;"meina";11;0;100
5;0;"meinrad";5;100;0
0;5;"meiqi";5;0;100
2644;0;"meir";2644;100;0
0;1037;"meira";1037;0;100
0;5;"meirah";5;0;100
0;21;"meirav";21;0;100
0;1016;"meisha";1016;0;100
8;0;"meison";8;100;0
0;6;"meissa";6;0;100
0;98;"meital";98;0;100
0;5;"meixi";5;0;100
0;55;"meiya";55;0;100
0;29;"meiyah";29;0;100
0;6;"meiyi";6;0;100
0;579;"meka";579;0;100
5;0;"mekaal";5;100;0
37;0;"mekael";37;100;0
0;105;"mekaela";105;0;100
0;36;"mekah";36;0;100
368;0;"mekai";368;100;0
6;0;"mekail";6;100;0
0;137;"mekaila";137;0;100
17;0;"mekal";17;100;0
0;181;"mekala";181;0;100
0;24;"mekalah";24;0;100
0;1616;"mekayla";1616;0;100
0;97;"mekaylah";97;0;100
0;5;"mekea";5;0;100
0;30;"mekeba";30;0;100
0;5;"mekeia";5;0;100
0;12;"mekeisha";12;0;100
128;16;"mekel";144;88.8888888888889;11.1111111111111
0;5;"mekela";5;0;100
30;0;"mekell";30;100;0
0;6;"mekella";6;0;100
0;5;"mekelle";5;0;100
0;14;"mekena";14;0;100
0;380;"mekenna";380;0;100
0;5;"mekensie";5;0;100
0;49;"mekenzi";49;0;100
0;1068;"mekenzie";1068;0;100
0;5;"mekenzy";5;0;100
0;86;"mekesha";86;0;100
0;5;"mekeshia";5;0;100
363;0;"mekhai";363;100;0
9652;113;"mekhi";9765;98.8428059395801;1.15719406041987
0;235;"mekhia";235;0;100
0;11;"mekhiah";11;0;100
0;37;"mekhiya";37;0;100
0;11;"mekhya";11;0;100
35;0;"meki";35;100;0
0;181;"mekia";181;0;100
66;110;"mekiah";176;37.5;62.5
5;0;"mekiel";5;100;0
5;0;"mekih";5;100;0
0;106;"mekisha";106;0;100
0;56;"mekiya";56;0;100
0;66;"mekiyah";66;0;100
0;47;"mekka";47;0;100
0;16;"mekkah";16;0;100
6;0;"mekkhi";6;100;0
17;0;"mekko";17;100;0
0;262;"meklit";262;0;100
129;97;"meko";226;57.0796460176991;42.9203539823009
10;0;"mekos";10;100;0
0;10;"mekya";10;0;100
0;6;"mekyah";6;0;100
0;29;"mekyla";29;0;100
5;0;"mekyle";5;100;0
3615;394;"mel";4009;90.1721127463208;9.82788725367922
0;698;"mela";698;0;100
59;0;"melachi";59;100;0
11;0;"melad";11;100;0
0;45;"meladee";45;0;100
0;52;"meladie";52;0;100
0;85;"melady";85;0;100
0;176;"melah";176;0;100
0;6;"melahni";6;0;100
0;1084;"melaina";1084;0;100
0;2359;"melaine";2359;0;100
0;107;"melainie";107;0;100
27;0;"melakai";27;100;0
5;0;"melakhi";5;100;0
24;0;"melaki";24;100;0
5;0;"melaku";5;100;0
0;5;"melan";5;0;100
0;777;"melana";777;0;100
0;21;"melandie";21;0;100
0;6;"melandy";6;0;100
0;210;"melane";210;0;100
0;1144;"melanee";1144;0;100
0;1183;"melaney";1183;0;100
0;3882;"melani";3882;0;100
0;1908;"melania";1908;0;100
610;240463;"melanie";241073;0.253035387621177;99.7469646123788
0;10;"melanieann";10;0;100
0;7;"melaniece";7;0;100
0;13;"melaniee";13;0;100
0;7;"melanierose";7;0;100
0;5;"melanin";5;0;100
0;18;"melanne";18;0;100
0;10;"melanney";10;0;100
0;74;"melanni";74;0;100
0;1492;"melannie";1492;0;100
0;722;"melanny";722;0;100
0;29;"melantha";29;0;100
5;12478;"melany";12483;0.0400544740847553;99.9599455259152
0;5;"melanya";5;0;100
0;269;"melanye";269;0;100
0;5;"melarie";5;0;100
0;45;"melasia";45;0;100
0;198;"melat";198;0;100
0;105;"melaya";105;0;100
0;77;"melayah";77;0;100
0;455;"melayna";455;0;100
0;5;"melaynie";5;0;100
0;109;"melaysia";109;0;100
52;34615;"melba";34667;0.149998557706176;99.8500014422938
0;11;"melbalene";11;0;100
33;0;"melbern";33;100;0
71;0;"melbert";71;100;0
50;0;"melbin";50;100;0
5;0;"melborn";5;100;0
5;0;"melbourn";5;100;0
1007;0;"melbourne";1007;100;0
0;5;"melbra";5;0;100
489;0;"melburn";489;100;0
16;0;"melchi";16;100;0
48;0;"melchior";48;100;0
287;0;"melchizedek";287;100;0
855;0;"melchor";855;100;0
0;5;"melchora";5;0;100
0;5;"melcina";5;0;100
0;1448;"melda";1448;0;100
0;6;"meldia";6;0;100
6;0;"meldin";6;100;0
240;0;"meldon";240;100;0
0;5;"meldora";5;0;100
0;28;"meldoy";28;0;100
50;0;"meldrick";50;100;0
0;790;"mele";790;0;100
0;973;"melea";973;0;100
0;1373;"meleah";1373;0;100
0;230;"meleana";230;0;100
0;72;"meleane";72;0;100
11;0;"melech";11;100;0
0;40;"melecia";40;0;100
440;0;"melecio";440;100;0
0;5;"meledy";5;0;100
0;193;"meleena";193;0;100
0;5;"meleesa";5;0;100
0;60;"meleia";60;0;100
0;30;"meleigha";30;0;100
41;167;"melek";208;19.7115384615385;80.2884615384615
0;12;"meleka";12;0;100
0;1155;"melena";1155;0;100
0;10;"melenaite";10;0;100
0;95;"melenda";95;0;100
0;28;"melene";28;0;100
0;86;"meleni";86;0;100
0;630;"melenie";630;0;100
0;506;"meleny";506;0;100
0;130;"melesa";130;0;100
0;18;"melesha";18;0;100
0;38;"melesia";38;0;100
69;0;"melesio";69;100;0
0;501;"melessa";501;0;100
0;212;"melessia";212;0;100
0;17;"meleta";17;0;100
0;13;"melette";13;0;100
0;6;"meleya";6;0;100
0;5;"meleyah";5;0;100
1175;0;"melford";1175;100;0
17;0;"melfred";17;100;0
0;97;"meli";97;0;100
0;4451;"melia";4451;0;100
0;546;"meliah";546;0;100
0;5;"meliame";5;0;100
0;11;"melian";11;0;100
0;78;"meliana";78;0;100
0;8;"melianna";8;0;100
0;27;"melica";27;0;100
0;55;"melicent";55;0;100
0;210;"melicia";210;0;100
0;627;"melida";627;0;100
8;0;"melieck";8;100;0
21;0;"meliek";21;100;0
35;0;"melih";35;100;0
0;41;"meliha";41;0;100
408;0;"melik";408;100;0
0;347;"melika";347;0;100
0;21;"melike";21;0;100
0;15692;"melina";15692;0;100
0;29;"melinah";29;0;100
338;134614;"melinda";134952;0.25045942260952;99.7495405773905
0;6;"melindasue";6;0;100
0;10;"melindy";10;0;100
0;79;"meline";79;0;100
0;5;"melinee";5;0;100
0;188;"melinna";188;0;100
25;0;"melio";25;100;0
30;0;"melique";30;100;0
0;254;"melis";254;0;100
10;18586;"melisa";18596;0.0537750053775005;99.9462249946225
0;27;"melisaa";27;0;100
0;21;"melisande";21;0;100
0;33;"melise";33;0;100
0;912;"melisha";912;0;100
0;5;"melishia";5;0;100
0;122;"melisia";122;0;100
0;351;"meliss";351;0;100
2496;751163;"melissa";753659;0.331184262378609;99.6688157376214
0;197;"melissaann";197;0;100
0;11;"melissaanne";11;0;100
0;10;"melissamarie";10;0;100
0;17;"melissasue";17;0;100
0;273;"melisse";273;0;100
0;6;"melissha";6;0;100
0;1921;"melissia";1921;0;100
0;28;"melissie";28;0;100
0;133;"melisssa";133;0;100
0;1809;"melita";1809;0;100
436;0;"meliton";436;100;0
0;83;"melitta";83;0;100
0;96;"melitza";96;0;100
7;0;"melivn";7;100;0
0;83;"meliya";83;0;100
0;324;"meliyah";324;0;100
0;1013;"meliza";1013;0;100
0;123;"melizza";123;0;100
15;0;"melkin";15;100;0
5;0;"melky";5;100;0
312;175;"mell";487;64.0657084188912;35.9342915811088
0;265;"mella";265;0;100
0;18;"mellani";18;0;100
0;1046;"mellanie";1046;0;100
0;446;"mellany";446;0;100
0;6;"melle";6;0;100
0;5;"meller";5;0;100
0;6;"mellette";6;0;100
0;5;"mellicent";5;0;100
0;1580;"mellie";1580;0;100
0;74;"mellina";74;0;100
0;27;"mellinda";27;0;100
0;4566;"mellisa";4566;0;100
0;5;"mellisha";5;0;100
0;10;"mellisia";10;0;100
0;5618;"mellissa";5618;0;100
0;57;"mellissia";57;0;100
0;5;"mellodee";5;0;100
0;5;"mellodie";5;0;100
0;416;"mellody";416;0;100
5;0;"mellon";5;100;0
0;29;"melloney";29;0;100
0;121;"mellonie";121;0;100
0;141;"mellony";141;0;100
0;5;"mellow";5;0;100
0;5;"mellssa";5;0;100
0;25;"melly";25;0;100
0;5;"mellyora";5;0;100
0;6;"mellyssa";6;0;100
0;29;"melma";29;0;100
0;5;"melna";5;0;100
55;0;"melo";55;100;0
0;37;"melode";37;0;100
0;2509;"melodee";2509;0;100
0;41;"melodey";41;0;100
0;1575;"melodi";1575;0;100
0;10;"melodia";10;0;100
0;9704;"melodie";9704;0;100
164;92129;"melody";92293;0.177694949779507;99.8223050502205
0;816;"melodye";816;0;100
0;6;"melodyrose";6;0;100
0;177;"melondy";177;0;100
0;349;"melonee";349;0;100
0;895;"meloney";895;0;100
0;340;"meloni";340;0;100
0;27;"melonia";27;0;100
0;5295;"melonie";5295;0;100
0;4275;"melony";4275;0;100
0;10;"melonye";10;0;100
0;331;"melora";331;0;100
0;10;"melorie";10;0;100
259;0;"melquan";259;100;0
175;0;"melquiades";175;100;0
93;0;"melquisedec";93;100;0
51;843;"melrose";894;5.70469798657718;94.2953020134228
171;0;"melroy";171;100;0
0;9;"melsa";9;0;100
0;5;"melssia";5;0;100
0;10;"melster";10;0;100
0;10;"meltem";10;0;100
4128;0;"melton";4128;100;0
30;13954;"melva";13984;0.214530892448513;99.7854691075515
0;11;"melvalene";11;0;100
27;0;"melvan";27;100;0
0;5;"melveen";5;0;100
511;0;"melven";511;100;0
0;383;"melvena";383;0;100
0;31;"melvene";31;0;100
0;204;"melvenia";204;0;100
0;7;"melverine";7;0;100
199;0;"melvern";199;100;0
0;967;"melvia";967;0;100
0;347;"melvie";347;0;100
2044;14;"melville";2058;99.3197278911565;0.680272108843537
239770;2129;"melvin";241899;99.1198806113295;0.880119388670478
0;5973;"melvina";5973;0;100
25;270;"melvine";295;8.47457627118644;91.5254237288136
0;220;"melvinia";220;0;100
44;54;"melvis";98;44.8979591836735;55.1020408163265
0;5;"melvita";5;0;100
60;0;"melvon";60;100;0
0;5;"melvonia";5;0;100
4312;10;"melvyn";4322;99.7686256362795;0.2313743637205
0;44;"mely";44;0;100
0;196;"melyna";196;0;100
0;2708;"melynda";2708;0;100
0;21;"melynie";21;0;100
0;44;"melynn";44;0;100
0;15;"melynna";15;0;100
0;80;"melysa";80;0;100
0;1949;"melyssa";1949;0;100
0;14;"melzie";14;0;100
0;10;"melzina";10;0;100
0;17;"memarie";17;0;100
0;10;"meme";10;0;100
0;25;"memoree";25;0;100
0;42;"memori";42;0;100
0;366;"memorie";366;0;100
6;1207;"memory";1213;0.494641384995878;99.5053586150041
4666;1017;"memphis";5683;82.10452225937;17.8954777406299
17;5;"memphys";22;77.2727272727273;22.7272727272727
161;1252;"mena";1413;11.3941967445152;88.6058032554848
0;126;"menaal";126;0;100
5265;0;"menachem";5265;100;0
6;0;"menachemmendel";6;100;0
0;16;"menah";16;0;100
0;5;"menal";5;0;100
5;0;"menasha";5;100;0
287;0;"menashe";287;100;0
0;28;"menda";28;0;100
6;0;"mendal";6;100;0
0;61;"mende";61;0;100
0;11;"mendee";11;0;100
8;0;"mendeecee";8;100;0
5;0;"mendeecees";5;100;0
2183;0;"mendel";2183;100;0
82;0;"mendell";82;100;0
0;514;"mendi";514;0;100
0;60;"mendie";60;0;100
469;2160;"mendy";2629;17.8394826930392;82.1605173069608
6;0;"menelek";6;100;0
270;0;"menelik";270;100;0
555;13;"meng";568;97.7112676056338;2.2887323943662
0;11;"menika";11;0;100
0;13;"menley";13;0;100
0;131;"menna";131;0;100
0;16;"mennah";16;0;100
0;673;"mennie";673;0;100
1119;0;"menno";1119;100;0
10;0;"menphis";10;100;0
33;0;"mensah";33;100;0
0;20;"mentha";20;0;100
0;5;"mentie";5;0;100
0;407;"menucha";407;0;100
0;12;"menyon";12;0;100
27;0;"menzo";27;100;0
0;500;"meosha";500;0;100
0;5;"meoshi";5;0;100
0;88;"meoshia";88;0;100
0;264;"mera";264;0;100
0;30;"merab";30;0;100
0;34;"meradith";34;0;100
0;38;"meraiah";38;0;100
6;0;"meraj";6;100;0
0;103;"meral";103;0;100
39;0;"merald";39;100;0
0;5;"merali";5;0;100
0;15;"meraly";15;0;100
0;2900;"meranda";2900;0;100
16;1185;"merari";1201;1.33222314737719;98.6677768526228
0;6;"meraris";6;0;100
0;427;"merary";427;0;100
0;23;"merav";23;0;100
0;10;"meraya";10;0;100
0;577;"mercades";577;0;100
0;152;"mercadez";152;0;100
0;148;"mercadies";148;0;100
5;5;"merce";10;50;50
752;181;"merced";933;80.6002143622722;19.3997856377278
0;35;"merceda";35;0;100
0;5;"mercedas";5;0;100
0;535;"mercede";535;0;100
0;21;"mercedee";21;0;100
0;61;"mercedees";61;0;100
0;20;"mercedeez";20;0;100
369;44159;"mercedes";44528;0.828692058929213;99.1713079410708
0;37;"mercedese";37;0;100
0;2909;"mercedez";2909;0;100
0;6;"mercedi";6;0;100
0;102;"mercedies";102;0;100
0;12;"mercedita";12;0;100
0;6;"mercedys";6;0;100
985;128;"mercer";1113;88.4995507637017;11.5004492362983
6;0;"merchant";6;100;0
0;5;"merchelle";5;0;100
0;533;"merci";533;0;100
0;114;"mercia";114;0;100
0;18;"mercides";18;0;100
0;400;"mercie";400;0;100
0;17;"mercile";17;0;100
0;6;"mercille";6;0;100
106;17;"mercury";123;86.1788617886179;13.8211382113821
17;0;"mercutio";17;100;0
48;7314;"mercy";7362;0.6519967400163;99.3480032599837
0;6;"mercygrace";6;0;100
0;5;"merdell";5;0;100
0;5;"merdice";5;0;100
0;6;"merdie";6;0;100
0;220;"merdis";220;0;100
63;62;"merdith";125;50.4;49.6
0;41;"merecedes";41;0;100
0;103;"meredeth";103;0;100
4223;72562;"meredith";76785;5.49977209090317;94.5002279090968
0;5;"meredy";5;0;100
0;591;"meredyth";591;0;100
0;5;"meredythe";5;0;100
300;0;"merek";300;100;0
205;35;"merel";240;85.4166666666667;14.5833333333333
0;27;"merelene";27;0;100
0;72;"merelin";72;0;100
0;10;"merely";10;0;100
0;274;"merelyn";274;0;100
0;6;"merena";6;0;100
0;10;"merenda";10;0;100
0;5;"meret";5;0;100
0;12;"merete";12;0;100
0;5;"merette";5;0;100
5;0;"mergeron";5;100;0
25;0;"mergim";25;100;0
0;2407;"meri";2407;0;100
0;132;"meria";132;0;100
0;866;"meriah";866;0;100
0;92;"merial";92;0;100
0;1295;"meriam";1295;0;100
0;204;"merian";204;0;100
0;15;"meriann";15;0;100
0;53;"merianne";53;0;100
0;6;"meribah";6;0;100
0;476;"meribeth";476;0;100
124;0;"meric";124;100;0
0;224;"merica";224;0;100
147;0;"merick";147;100;0
0;813;"merida";813;0;100
0;165;"meridee";165;0;100
0;38;"meridel";38;0;100
6;1730;"merideth";1736;0.345622119815668;99.6543778801843
0;284;"meridian";284;0;100
32;2640;"meridith";2672;1.19760479041916;98.8023952095808
0;5;"meridth";5;0;100
0;28;"meridy";28;0;100
0;39;"meridyth";39;0;100
0;177;"merie";177;0;100
0;376;"meriel";376;0;100
0;16;"merielle";16;0;100
0;117;"meriem";117;0;100
267;0;"merik";267;100;0
0;40;"merika";40;0;100
0;84;"merikay";84;0;100
130;20;"meril";150;86.6666666666667;13.3333333333333
0;21;"merilda";21;0;100
0;1150;"merilee";1150;0;100
0;12;"merilou";12;0;100
0;2296;"merilyn";2296;0;100
0;80;"merilynn";80;0;100
0;17;"merima";17;0;100
0;171;"merin";171;0;100
0;304;"merina";304;0;100
0;562;"merinda";562;0;100
156;119;"merion";275;56.7272727272727;43.2727272727273
0;70;"meris";70;0;100
0;555;"merisa";555;0;100
0;34;"merisha";34;0;100
0;3391;"merissa";3391;0;100
105;147;"merit";252;41.6666666666667;58.3333333333333
0;1120;"merita";1120;0;100
21;30;"meritt";51;41.1764705882353;58.8235294117647
0;11;"meritta";11;0;100
0;22;"meritxell";22;0;100
0;5;"meritza";5;0;100
0;5;"merium";5;0;100
0;16;"meriwether";16;0;100
0;6;"meriya";6;0;100
0;51;"meriyah";51;0;100
0;20;"merjem";20;0;100
2501;262;"merl";2763;90.5175533840029;9.48244661599711
0;424;"merla";424;0;100
6;0;"merlan";6;100;0
107;0;"merland";107;100;0
29821;13836;"merle";43657;68.3074879171725;31.6925120828275
0;5;"merleah";5;0;100
0;68;"merlean";68;0;100
0;49;"merlee";49;0;100
0;113;"merleen";113;0;100
65;0;"merlen";65;100;0
0;6;"merlena";6;0;100
0;2379;"merlene";2379;0;100
5;10;"merley";15;33.3333333333333;66.6666666666667
0;19;"merli";19;0;100
0;36;"merliah";36;0;100
0;255;"merlie";255;0;100
14440;800;"merlin";15240;94.750656167979;5.249343832021
0;129;"merlina";129;0;100
0;530;"merlinda";530;0;100
0;1079;"merline";1079;0;100
0;5;"merlisa";5;0;100
176;5;"merlon";181;97.2375690607735;2.76243093922652
0;5;"merlot";5;0;100
0;194;"merly";194;0;100
3374;1549;"merlyn";4923;68.5354458663417;31.4645541336583
0;5;"merlyne";5;0;100
0;56;"merlynn";56;0;100
0;2354;"merna";2354;0;100
0;17;"mernie";17;0;100
0;10;"merola";10;0;100
0;13;"merolla";13;0;100
22;370;"meron";392;5.61224489795918;94.3877551020408
0;132;"merranda";132;0;100
0;50;"merredith";50;0;100
259;10;"merrel";269;96.2825278810409;3.71747211895911
1163;155;"merrell";1318;88.2397572078907;11.7602427921093
0;3170;"merri";3170;0;100
0;36;"merriah";36;0;100
0;6;"merrial";6;0;100
0;340;"merriam";340;0;100
0;11;"merrian";11;0;100
0;36;"merriann";36;0;100
0;129;"merrianne";129;0;100
0;53;"merribeth";53;0;100
131;0;"merric";131;100;0
3842;363;"merrick";4205;91.3674197384067;8.63258026159334
0;25;"merridee";25;0;100
0;48;"merrideth";48;0;100
0;59;"merridith";59;0;100
0;35;"merridy";35;0;100
0;2632;"merrie";2632;0;100
13;91;"merriel";104;12.5;87.5
215;5;"merrik";220;97.7272727272727;2.27272727272727
0;5;"merrikay";5;0;100
858;134;"merril";992;86.491935483871;13.508064516129
0;1860;"merrilee";1860;0;100
0;22;"merrilie";22;0;100
12601;2011;"merrill";14612;86.2373391732822;13.7626608267178
0;72;"merrillyn";72;0;100
0;5;"merrilu";5;0;100
0;1026;"merrily";1026;0;100
0;751;"merrilyn";751;0;100
0;29;"merrilynn";29;0;100
10;0;"merriman";10;100;0
0;160;"merrin";160;0;100
0;144;"merrisa";144;0;100
0;177;"merrissa";177;0;100
160;64;"merrit";224;71.4285714285714;28.5714285714286
5038;1669;"merritt";6707;75.1155509169524;24.8844490830476
0;5;"merrium";5;0;100
0;5;"merrlyn";5;0;100
0;10228;"merry";10228;0;100
0;250;"merryl";250;0;100
0;6;"merrylee";6;0;100
0;132;"merryn";132;0;100
0;5;"mersadees";5;0;100
0;248;"mersades";248;0;100
0;97;"mersadez";97;0;100
0;244;"mersadie";244;0;100
0;429;"mersadies";429;0;100
0;5;"mersadiez";5;0;100
0;39;"mersaydes";39;0;100
0;6;"mersaydez";6;0;100
0;75;"mersedes";75;0;100
0;5;"mersiha";5;0;100
368;0;"mert";368;100;0
0;5;"merta";5;0;100
6;0;"merten";6;100;0
0;190;"mertha";190;0;100
0;408;"mertice";408;0;100
0;1228;"mertie";1228;0;100
5;0;"mertin";5;100;0
10;466;"mertis";476;2.10084033613445;97.8991596638655
0;5;"mertle";5;0;100
3960;0;"merton";3960;100;0
5;0;"meru";5;100;0
20;0;"merv";20;100;0
0;42;"merva";42;0;100
0;12;"mervat";12;0;100
0;100;"merve";100;0;100
0;6;"merveille";6;0;100
27;0;"mervel";27;100;0
126;0;"mervil";126;100;0
114;0;"merville";114;100;0
11620;38;"mervin";11658;99.6740435752273;0.325956424772688
1578;5;"mervyn";1583;99.6841440303222;0.315855969677827
1620;5;"merwin";1625;99.6923076923077;0.307692307692308
786;10;"merwyn";796;98.7437185929648;1.25628140703518
0;411;"mery";411;0;100
0;13;"meryah";13;0;100
0;36;"meryam";36;0;100
0;344;"meryem";344;0;100
7;0;"meryk";7;100;0
431;4957;"meryl";5388;7.9992576095026;92.0007423904974
32;397;"meryle";429;7.45920745920746;92.5407925407925
0;6;"meryll";6;0;100
0;159;"meryn";159;0;100
0;23;"meryssa";23;0;100
0;5;"merzedes";5;0;100
0;587;"mesa";587;0;100
5;0;"mesai";5;100;0
0;5;"mesan";5;0;100
0;179;"mescal";179;0;100
0;39;"meschelle";39;0;100
0;1183;"mesha";1183;0;100
490;0;"meshach";490;100;0
15;0;"meshack";15;100;0
0;5;"meshae";5;0;100
32;0;"meshal";32;100;0
0;7;"meshalia";7;0;100
0;6;"meshan";6;0;100
0;6;"meshaun";6;0;100
0;102;"meshawn";102;0;100
0;5;"meshay";5;0;100
0;29;"meshayla";29;0;100
0;5;"meshea";5;0;100
0;5;"meshel";5;0;100
0;495;"meshell";495;0;100
0;309;"meshelle";309;0;100
0;216;"meshia";216;0;100
48;0;"meshilem";48;100;0
0;6;"meshon";6;0;100
0;15;"meshonda";15;0;100
77;0;"meshulem";77;100;0
238;5;"mesiah";243;97.9423868312757;2.05761316872428
0;10;"mesina";10;0;100
16;12;"mesiyah";28;57.1428571428571;42.8571428571429
12;0;"messai";12;100;0
10;0;"messer";10;100;0
113;0;"messi";113;100;0
9383;814;"messiah";10197;92.017259978425;7.98274002157497
10;0;"messias";10;100;0
0;117;"messina";117;0;100
47;10;"messiyah";57;82.4561403508772;17.5438596491228
5;0;"messyah";5;100;0
6;0;"mesut";6;100;0
0;4423;"meta";4423;0;100
74;0;"mete";74;100;0
5;0;"metehan";5;100;0
0;101;"metha";101;0;100
0;20;"methel";20;0;100
24;0;"method";24;100;0
0;29;"methyl";29;0;100
0;5;"meti";5;0;100
24;0;"metin";24;100;0
0;30;"metra";30;0;100
522;0;"metro";522;100;0
0;795;"metta";795;0;100
0;68;"mette";68;0;100
21;0;"metthew";21;100;0
0;699;"mettie";699;0;100
5;0;"metz";5;100;0
0;11;"metzi";11;0;100
0;226;"metzli";226;0;100
0;43;"metzly";43;0;100
0;148;"metztli";148;0;100
0;43;"meuy";43;0;100
0;18;"mevelyn";18;0;100
0;5;"mextli";5;0;100
0;39;"mey";39;0;100
0;721;"meya";721;0;100
0;437;"meyah";437;0;100
0;18;"meyana";18;0;100
0;5;"meyanna";5;0;100
4521;80;"meyer";4601;98.2612475548794;1.73875244512063
6;0;"meyers";6;100;0
0;125;"meygan";125;0;100
0;5;"meyla";5;0;100
0;16;"meylani";16;0;100
0;58;"meyli";58;0;100
0;324;"meylin";324;0;100
0;6;"meyling";6;0;100
0;5;"meyly";5;0;100
0;8;"meyosha";8;0;100
0;10;"meyra";10;0;100
16;0;"meyson";16;100;0
52;0;"meziah";52;100;0
0;13;"mezmariah";13;0;100
0;223;"meztli";223;0;100
0;5;"meztly";5;0;100
5;0;"mezziah";5;100;0
0;5;"mguadalupe";5;0;100
0;5;"mhairi";5;0;100
0;5;"mhari";5;0;100
21;0;"mher";21;100;0
0;48;"mhia";48;0;100
0;5;"mhina";5;0;100
0;5;"mhya";5;0;100
0;685;"mi";685;0;100
268;202943;"mia";203211;0.131882624464227;99.8681173755358
0;81;"miaa";81;0;100
0;5;"miaamor";5;0;100
0;6;"miaandrea";6;0;100
0;1256;"miabella";1256;0;100
0;32;"miabelle";32;0;100
205;0;"miachel";205;100;0
0;29;"miagrace";29;0;100
10;7294;"miah";7304;0.136911281489595;99.8630887185104
0;6;"miaha";6;0;100
0;95;"miaisabella";95;0;100
0;12;"miaisha";12;0;100
0;35;"miaja";35;0;100
0;11;"miajah";11;0;100
0;5;"miakayla";5;0;100
0;5;"miakka";5;0;100
0;179;"miakoda";179;0;100
0;5;"miakota";5;0;100
0;87;"mialani";87;0;100
0;63;"mialee";63;0;100
0;5;"mialuna";5;0;100
0;22;"mialyn";22;0;100
0;112;"mialynn";112;0;100
0;59;"miamarie";59;0;100
0;225;"miami";225;0;100
0;258;"miamor";258;0;100
0;24;"miamore";24;0;100
0;5;"miamour";5;0;100
56;5;"mian";61;91.8032786885246;8.19672131147541
0;501;"miana";501;0;100
0;10;"mianca";10;0;100
0;761;"miangel";761;0;100
0;36;"miani";36;0;100
0;21;"mianicole";21;0;100
0;427;"mianna";427;0;100
0;173;"miara";173;0;100
0;7;"miarae";7;0;100
0;5;"miarah";5;0;100
0;13;"miari";13;0;100
0;189;"miarose";189;0;100
0;114;"miasha";114;0;100
0;514;"miasia";514;0;100
0;6;"miasophia";6;0;100
0;175;"miata";175;0;100
0;25;"miatta";25;0;100
0;5;"miavalentina";5;0;100
0;10;"miavictoria";10;0;100
0;336;"miaya";336;0;100
0;5;"miaysia";5;0;100
26;0;"mic";26;100;0
775;2548;"mica";3323;23.3222991272946;76.6777008727054
8;0;"micaden";8;100;0
661;0;"micael";661;100;0
6;12934;"micaela";12940;0.0463678516228748;99.9536321483771
0;17;"micaelah";17;0;100
0;312;"micaella";312;0;100
85745;11609;"micah";97354;88.0754771247201;11.9245228752799
1413;0;"micahel";1413;100;0
23;0;"micahi";23;100;0
0;5;"micahia";5;0;100
5;0;"micahjoseph";5;100;0
0;40;"micahla";40;0;100
0;45;"micahya";45;0;100
90;0;"micai";90;100;0
2092;1209;"micaiah";3301;63.3747349288095;36.6252650711905
10;0;"micaih";10;100;0
0;144;"micaila";144;0;100
0;13;"micailah";13;0;100
80;0;"micajah";80;100;0
330;160;"mical";490;67.3469387755102;32.6530612244898
0;373;"micala";373;0;100
0;135;"micalah";135;0;100
15;6;"micale";21;71.4285714285714;28.5714285714286
5;0;"micaleb";5;100;0
0;11;"micalyn";11;0;100
37;0;"mican";37;100;0
0;22;"micaya";22;0;100
0;43;"micayah";43;0;100
0;2520;"micayla";2520;0;100
0;79;"micaylah";79;0;100
0;74;"micca";74;0;100
36;6;"miccah";42;85.7142857142857;14.2857142857143
6;0;"micchael";6;100;0
84;0;"micco";84;100;0
0;16;"miceala";16;0;100
0;14;"micel";14;0;100
0;29;"micelle";29;0;100
22;0;"mich";22;100;0
963;1124;"micha";2087;46.1427886919023;53.8572113080978
7;0;"michaael";7;100;0
497;52;"michae";549;90.528233151184;9.47176684881603
135;0;"michaeal";135;100;0
20;0;"michaee";20;100;0
33;0;"michaeel";33;100;0
4330659;21669;"michael";4352328;99.5021285160493;0.497871483950658
69;49260;"michaela";49329;0.139877151371404;99.8601228486286
0;218;"michaelah";218;0;100
5;0;"michaelallen";5;100;0
30;0;"michaelandrew";30;100;0
10;0;"michaelangel";10;100;0
1216;0;"michaelangelo";1216;100;0
0;201;"michaelann";201;0;100
0;59;"michaelanne";59;0;100
541;0;"michaelanthony";541;100;0
5;0;"michaelchristop";5;100;0
50;0;"michaeldavid";50;100;0
21;1816;"michaele";1837;1.14316820903647;98.8568317909635
0;5;"michaelee";5;0;100
0;352;"michaeleen";352;0;100
0;6;"michaelena";6;0;100
0;1430;"michaelene";1430;0;100
6;0;"michaelgabriel";6;100;0
0;141;"michaelia";141;0;100
0;5;"michaelin";5;0;100
0;163;"michaelina";163;0;100
0;936;"michaeline";936;0;100
173;0;"michaeljames";173;100;0
6;0;"michaeljay";6;100;0
235;0;"michaeljohn";235;100;0
96;0;"michaeljoseph";96;100;0
5;0;"michaeljr";5;100;0
403;5;"michaell";408;98.7745098039216;1.22549019607843
0;2080;"michaella";2080;0;100
0;1378;"michaelle";1378;0;100
21;0;"michaellee";21;100;0
5;0;"michaelpatrick";5;100;0
115;0;"michaelpaul";115;100;0
41;0;"michaelray";41;100;0
24;0;"michaelryan";24;100;0
5;0;"michaels";5;100;0
27;0;"michaelthomas";27;100;0
34;0;"michaelvincent";34;100;0
0;700;"michaelyn";700;0;100
0;15;"michaelynn";15;0;100
339;17;"michah";356;95.2247191011236;4.7752808988764
240;0;"michai";240;100;0
0;5;"michaia";5;0;100
88;370;"michaiah";458;19.2139737991266;80.7860262008734
563;0;"michail";563;100;0
0;292;"michaila";292;0;100
3661;3668;"michal";7329;49.9522445081184;50.0477554918816
0;1545;"michala";1545;0;100
0;32;"michalah";32;0;100
0;6;"michalann";6;0;100
3259;344;"michale";3603;90.4524007771302;9.54759922286983
0;45;"michalea";45;0;100
0;13;"michaleen";13;0;100
0;21;"michalena";21;0;100
0;483;"michalene";483;0;100
0;46;"michalia";46;0;100
0;150;"michalina";150;0;100
0;151;"michaline";151;0;100
137;0;"michall";137;100;0
0;136;"michalla";136;0;100
0;294;"michalle";294;0;100
0;18;"michalyn";18;0;100
97;0;"micharl";97;100;0
0;48;"michaya";48;0;100
0;1354;"michayla";1354;0;100
0;5;"michaylah";5;0;100
0;73;"miche";73;0;100
0;30;"michea";30;0;100
152882;1836;"micheal";154718;98.8133248878605;1.18667511213951
0;1429;"micheala";1429;0;100
11;0;"michealangelo";11;100;0
5;0;"michealanthony";5;100;0
0;99;"micheale";99;0;100
0;5;"michealene";5;0;100
0;54;"michealla";54;0;100
0;51;"michealle";51;0;100
21;0;"micheaux";21;100;0
61;0;"micheil";61;100;0
10251;3479;"michel";13730;74.6613255644574;25.3386744355426
0;2084;"michela";2084;0;100
914;0;"michelangelo";914;100;0
0;8;"michelann";8;0;100
2678;223012;"michele";225690;1.18658336656476;98.8134166334353
0;37;"michelee";37;0;100
0;5;"micheleen";5;0;100
0;79;"michelena";79;0;100
0;750;"michelene";750;0;100
0;20;"michelin";20;0;100
0;2040;"michelina";2040;0;100
0;1261;"micheline";1261;0;100
588;6924;"michell";7512;7.82747603833866;92.1725239616613
0;1079;"michella";1079;0;100
3252;807810;"michelle";811062;0.400955783898148;99.5990442161018
0;44;"michelleann";44;0;100
0;5;"michelleanne";5;0;100
0;52;"michellee";52;0;100
0;5;"michellele";5;0;100
0;6;"michellemarie";6;0;100
0;17;"michellene";17;0;100
0;18;"michelli";18;0;100
0;31;"michellie";31;0;100
0;11;"michellle";11;0;100
0;13;"michelly";13;0;100
0;80;"michelyn";80;0;100
0;14;"micheyla";14;0;100
8;144;"michi";152;5.26315789473684;94.7368421052632
0;19;"michia";19;0;100
61;88;"michiah";149;40.9395973154362;59.0604026845638
1123;0;"michial";1123;100;0
6;97;"michie";103;5.8252427184466;94.1747572815534
16;0;"michieal";16;100;0
1030;5;"michiel";1035;99.5169082125604;0.483091787439614
0;5;"michiele";5;0;100
0;44;"michielle";44;0;100
5;0;"michigan";5;100;0
0;983;"michiko";983;0;100
0;132;"michille";132;0;100
90;0;"michio";90;100;0
0;20;"michiya";20;0;100
0;23;"michiye";23;0;100
0;11;"michiyo";11;0;100
0;6;"michla";6;0;100
8;0;"michle";8;100;0
129;0;"michoel";129;100;0
0;65;"michol";65;0;100
217;0;"micholas";217;100;0
0;142;"michole";142;0;100
29;555;"michon";584;4.96575342465753;95.0342465753425
0;10;"michone";10;0;100
0;11;"michonne";11;0;100
5;0;"michuel";5;100;0
0;11;"michyla";11;0;100
0;6;"micia";6;0;100
246;235;"miciah";481;51.1434511434511;48.8565488565489
2130;0;"mick";2130;100;0
1411;11;"mickael";1422;99.2264416315049;0.773558368495077
0;470;"mickaela";470;0;100
5;0;"mickail";5;100;0
0;23;"mickaila";23;0;100
72;0;"mickal";72;100;0
0;299;"mickala";299;0;100
35;0;"mickale";35;100;0
0;5;"mickalla";5;0;100
0;1776;"mickayla";1776;0;100
0;6;"mickaylah";6;0;100
1046;0;"mickeal";1046;100;0
1909;47;"mickel";1956;97.5971370143149;2.40286298568507
0;38;"mickela";38;0;100
0;5;"mickelena";5;0;100
0;5;"mickelina";5;0;100
136;51;"mickell";187;72.7272727272727;27.2727272727273
0;144;"mickelle";144;0;100
0;51;"mickenna";51;0;100
0;5;"mickenzi";5;0;100
44;605;"mickenzie";649;6.77966101694915;93.2203389830508
0;11;"mickenzy";11;0;100
26750;6417;"mickey";33167;80.6524557542135;19.3475442457865
33;2628;"micki";2661;1.24013528748591;98.7598647125141
0;13;"mickia";13;0;100
605;3476;"mickie";4081;14.8247978436658;85.1752021563342
11;0;"mickiel";11;100;0
0;5;"mickinley";5;0;100
0;5;"mickinzie";5;0;100
234;0;"mickle";234;100;0
2480;562;"micky";3042;81.5253122945431;18.4746877054569
0;7;"mickyla";7;0;100
5;0;"mickyle";5;100;0
87;18;"mico";105;82.8571428571429;17.1428571428571
0;16;"micol";16;0;100
0;577;"micole";577;0;100
5;0;"micquel";5;100;0
0;107;"mida";107;0;100
0;59;"midajah";59;0;100
59;0;"midas";59;100;0
0;53;"middie";53;0;100
29;0;"middleton";29;100;0
0;804;"midge";804;0;100
0;30;"midgie";30;0;100
0;10;"midhuna";10;0;100
5;0;"midian";5;100;0
0;8;"midna";8;0;100
0;8;"midnight";8;0;100
0;1126;"midori";1126;0;100
0;18;"midred";18;0;100
0;22;"mie";22;0;100
0;17;"mieasha";17;0;100
0;27;"miechelle";27;0;100
5;0;"miecislaus";5;100;0
95;0;"mieczyslaw";95;100;0
0;56;"mieisha";56;0;100
0;217;"mieka";217;0;100
0;235;"mieke";235;0;100
5;285;"mieko";290;1.72413793103448;98.2758620689655
0;71;"miel";71;0;100
0;83;"miela";83;0;100
0;11;"miella";11;0;100
0;43;"mielle";43;0;100
0;15;"miera";15;0;100
0;11;"mierra";11;0;100
0;2485;"miesha";2485;0;100
0;149;"mieshia";149;0;100
0;234;"miette";234;0;100
0;5;"mieya";5;0;100
5;4263;"migdalia";4268;0.117150890346767;99.8828491096532
1705;0;"migel";1705;100;0
14;0;"migelangel";14;100;0
0;6;"miggie";6;0;100
0;21;"migna";21;0;100
0;2129;"mignon";2129;0;100
0;23;"mignonette";23;0;100
0;110;"mignonne";110;0;100
10;0;"migual";10;100;0
172063;980;"miguel";173043;99.433666776466;0.566333223534035
0;19;"miguela";19;0;100
3498;0;"miguelangel";3498;100;0
10;0;"miguelangelo";10;100;0
16;0;"miguelantonio";16;100;0
0;267;"miguelina";267;0;100
28;0;"miguelito";28;100;0
0;38;"miha";38;0;100
22;0;"mihael";22;100;0
0;50;"mihaela";50;0;100
52;0;"mihai";52;100;0
123;0;"mihail";123;100;0
63;0;"mihailo";63;100;0
33;0;"mihajlo";33;100;0
75;0;"mihcael";75;100;0
0;459;"mihika";459;0;100
1236;0;"mihir";1236;100;0
0;81;"mihira";81;0;100
6;0;"mihit";6;100;0
0;95;"miho";95;0;100
93;0;"mihran";93;100;0
0;7;"mihrimah";7;0;100
0;135;"miia";135;0;100
0;7;"miiangel";7;0;100
5;0;"miichael";5;100;0
0;5;"miika";5;0;100
5;0;"miiking";5;100;0
0;6;"miila";6;0;100
0;5;"miina";5;0;100
0;163;"mija";163;0;100
6;0;"mijael";6;100;0
0;41;"mijah";41;0;100
0;5;"mijoi";5;0;100
0;12;"mijoy";12;0;100
1006;5300;"mika";6306;15.953060577228;84.046939422772
11;0;"mikaal";11;100;0
155;0;"mikaeel";155;100;0
4199;294;"mikael";4493;93.45648787002;6.54351212997997
0;17487;"mikaela";17487;0;100
0;171;"mikaelah";171;0;100
109;0;"mikaele";109;100;0
0;5;"mikaeli";5;0;100
0;533;"mikaella";533;0;100
0;85;"mikaelyn";85;0;100
0;5;"mikaeyla";5;0;100
2265;1381;"mikah";3646;62.1228743828853;37.8771256171147
0;82;"mikahla";82;0;100
503;10;"mikai";513;98.0506822612086;1.94931773879142
0;105;"mikaia";105;0;100
10;69;"mikaiah";79;12.6582278481013;87.3417721518987
812;15;"mikail";827;98.186215235792;1.81378476420798
0;2298;"mikaila";2298;0;100
0;161;"mikailah";161;0;100
0;90;"mikaili";90;0;100
0;10;"mikailyn";10;0;100
0;65;"mikaiya";65;0;100
0;5;"mikaiyah";5;0;100
3091;568;"mikal";3659;84.4766329598251;15.5233670401749
10;3953;"mikala";3963;0.252334090335604;99.7476659096644
0;895;"mikalah";895;0;100
328;39;"mikale";367;89.3732970027248;10.6267029972752
0;21;"mikalee";21;0;100
0;27;"mikali";27;0;100
0;88;"mikalia";88;0;100
0;16;"mikalla";16;0;100
0;52;"mikalya";52;0;100
0;238;"mikalyn";238;0;100
0;34;"mikalynn";34;0;100
0;5;"mikan";5;0;100
0;20;"mikara";20;0;100
0;11;"mikasia";11;0;100
0;444;"mikaya";444;0;100
0;136;"mikayah";136;0;100
0;5;"mikayala";5;0;100
7;0;"mikayeel";7;100;0
34;0;"mikayel";34;100;0
0;86;"mikayela";86;0;100
0;12;"mikayia";12;0;100
11;51824;"mikayla";51835;0.0212211825986303;99.9787788174014
0;1374;"mikaylah";1374;0;100
5;55;"mikayle";60;8.33333333333333;91.6666666666667
0;286;"mikaylee";286;0;100
0;5;"mikayleigh";5;0;100
0;5;"mikaylen";5;0;100
0;40;"mikayli";40;0;100
0;20;"mikaylia";20;0;100
0;27;"mikaylie";27;0;100
0;58;"mikaylin";58;0;100
0;5;"mikaylla";5;0;100
0;7;"mikaylyn";7;0;100
0;5;"mikaylynn";5;0;100
202549;662;"mike";203211;99.6742302335996;0.325769766400441
0;224;"mikea";224;0;100
2292;19;"mikeal";2311;99.1778450887062;0.822154911293812
0;347;"mikeala";347;0;100
0;5;"mikeayla";5;0;100
0;11;"mikecia";11;0;100
5;0;"mikee";5;100;0
5;0;"mikei";5;100;0
0;54;"mikeia";54;0;100
5;0;"mikeil";5;100;0
0;140;"mikeila";140;0;100
0;186;"mikeisha";186;0;100
10503;987;"mikel";11490;91.4099216710183;8.59007832898172
0;758;"mikela";758;0;100
0;6;"mikelann";6;0;100
42;65;"mikele";107;39.2523364485981;60.7476635514019
0;5;"mikelia";5;0;100
1389;534;"mikell";1923;72.2308892355694;27.7691107644306
0;336;"mikella";336;0;100
17;808;"mikelle";825;2.06060606060606;97.9393939393939
0;39;"mikelyn";39;0;100
91;0;"miken";91;100;0
0;65;"mikena";65;0;100
0;7;"mikenlee";7;0;100
0;10;"mikenley";10;0;100
0;907;"mikenna";907;0;100
0;5;"mikenya";5;0;100
0;174;"mikenzi";174;0;100
0;888;"mikenzie";888;0;100
0;38;"mikenzy";38;0;100
5;0;"mikequan";5;100;0
0;50;"mikera";50;0;100
0;138;"mikeria";138;0;100
0;283;"mikesha";283;0;100
0;59;"mikeshia";59;0;100
0;11;"miketa";11;0;100
1226;5;"mikey";1231;99.5938261575955;0.406173842404549
0;300;"mikeya";300;0;100
0;5;"mikeyah";5;0;100
0;10;"mikeyia";10;0;100
0;272;"mikeyla";272;0;100
18;0;"mikha";18;100;0
707;8;"mikhael";715;98.8811188811189;1.11888111888112
0;332;"mikhaela";332;0;100
127;0;"mikhai";127;100;0
3204;24;"mikhail";3228;99.2565055762082;0.743494423791822
0;443;"mikhaila";443;0;100
37;5;"mikhal";42;88.0952380952381;11.9047619047619
0;127;"mikhala";127;0;100
16;0;"mikhale";16;100;0
0;371;"mikhayla";371;0;100
18;0;"mikhel";18;100;0
191;0;"mikhi";191;100;0
0;72;"mikhia";72;0;100
0;5;"mikhiya";5;0;100
73;1715;"miki";1788;4.082774049217;95.917225950783
0;690;"mikia";690;0;100
130;411;"mikiah";541;24.0295748613678;75.9704251386322
17;0;"mikial";17;100;0
0;49;"mikiala";49;0;100
81;0;"mikias";81;100;0
240;37;"mikie";277;86.6425992779783;13.3574007220217
58;0;"mikiel";58;100;0
0;12;"mikiela";12;0;100
0;5;"mikiko";5;0;100
0;37;"mikila";37;0;100
0;5;"mikilah";5;0;100
167;0;"miking";167;100;0
0;5;"mikinlee";5;0;100
0;50;"mikinley";50;0;100
0;13;"mikinzi";13;0;100
0;73;"mikinzie";73;0;100
22;0;"mikio";22;100;0
0;30;"mikira";30;0;100
0;101;"mikisha";101;0;100
0;124;"mikita";124;0;100
0;325;"mikiya";325;0;100
0;394;"mikiyah";394;0;100
32;0;"mikiyas";32;100;0
0;526;"mikka";526;0;100
0;12;"mikkala";12;0;100
0;57;"mikkayla";57;0;100
731;24;"mikkel";755;96.8211920529801;3.17880794701987
11;2051;"mikki";2062;0.533462657613967;99.466537342386
0;11;"mikkia";11;0;100
482;10;"mikko";492;97.9674796747967;2.03252032520325
21;0;"mikkos";21;100;0
111;0;"mikle";111;100;0
234;0;"miklo";234;100;0
204;0;"miklos";204;100;0
507;488;"miko";995;50.9547738693467;49.0452261306533
55;0;"mikol";55;100;0
164;0;"mikolaj";164;100;0
13;0;"mikolas";13;100;0
29;0;"mikos";29;100;0
0;6;"mikoto";6;0;100
0;113;"miku";113;0;100
0;196;"mikya";196;0;100
0;216;"mikyah";216;0;100
17;0;"mikye";17;100;0
0;20;"mikyia";20;0;100
0;997;"mikyla";997;0;100
0;161;"mikylah";161;0;100
229;0;"mikyle";229;100;0
0;10;"mikylee";10;0;100
0;5;"mikylie";5;0;100
0;6;"mikylla";6;0;100
0;8;"mikynlee";8;0;100
0;43;"mikyra";43;0;100
30;27239;"mila";27269;0.11001503538817;99.8899849646118
0;24;"milaan";24;0;100
327;0;"milad";327;100;0
0;36;"milada";36;0;100
0;9;"miladeen";9;0;100
0;5;"miladie";5;0;100
0;130;"milady";130;0;100
26;1435;"milagro";1461;1.77960301163587;98.2203969883641
5;9212;"milagros";9217;0.0542475859824238;99.9457524140176
0;1216;"milah";1216;0;100
0;28;"milahn";28;0;100
0;5;"milahni";5;0;100
0;71;"milaina";71;0;100
182;0;"milam";182;100;0
0;5;"milamarie";5;0;100
9555;5811;"milan";15366;62.1827411167513;37.8172588832487
0;3744;"milana";3744;0;100
0;11;"milanee";11;0;100
0;2684;"milani";2684;0;100
0;2298;"milania";2298;0;100
0;102;"milanie";102;0;100
0;5;"milanii";5;0;100
0;5;"milaniya";5;0;100
0;122;"milanna";122;0;100
0;84;"milanni";84;0;100
57;0;"milano";57;100;0
0;99;"milany";99;0;100
0;68;"milanya";68;0;100
0;5;"milarae";5;0;100
0;8;"milarain";8;0;100
11;0;"milard";11;100;0
0;16;"milarose";16;0;100
459;0;"milas";459;100;0
0;11;"milasia";11;0;100
0;24;"milaun";24;0;100
0;5;"milauni";5;0;100
0;10;"milay";10;0;100
0;170;"milaya";170;0;100
0;122;"milayah";122;0;100
0;168;"milayna";168;0;100
0;31;"milaysia";31;0;100
93;0;"milbern";93;100;0
356;0;"milbert";356;100;0
0;11;"milbra";11;0;100
0;36;"milbrey";36;0;100
2194;0;"milburn";2194;100;0
5;0;"milburne";5;100;0
0;526;"milca";526;0;100
0;87;"milcah";87;0;100
0;807;"milda";807;0;100
0;112;"milderd";112;0;100
0;5;"mildra";5;0;100
0;5;"mildre";5;0;100
1531;433808;"mildred";435339;0.35167995516138;99.6483200448386
0;17;"mildren";17;0;100
0;54;"mildreth";54;0;100
0;36;"mildrid";36;0;100
15;0;"mile";15;100;0
0;117;"milea";117;0;100
0;317;"mileah";317;0;100
0;371;"milee";371;0;100
0;5;"mileen";5;0;100
0;1119;"mileena";1119;0;100
0;27;"milei";27;0;100
0;15;"mileidi";15;0;100
0;176;"mileidy";176;0;100
0;196;"mileigh";196;0;100
24;0;"milek";24;100;0
5;0;"mileke";5;100;0
0;6;"milele";6;0;100
78;20;"milen";98;79.5918367346939;20.4081632653061
0;4561;"milena";4561;0;100
0;60;"milene";60;0;100
0;5;"mileni";5;0;100
0;33;"milenia";33;0;100
0;33;"milenka";33;0;100
7;0;"milenko";7;100;0
0;29;"milenna";29;0;100
0;24;"mileny";24;0;100
73518;203;"miles";73721;99.7246374845702;0.275362515429796
0;10;"milesha";10;0;100
0;94;"milessa";94;0;100
0;5;"milett";5;0;100
0;17;"milette";17;0;100
0;5;"mileva";5;0;100
75;11060;"miley";11135;0.673551863493489;99.3264481365065
0;18;"mileya";18;0;100
0;16;"mileyah";16;0;100
0;122;"mileydi";122;0;100
0;5;"mileyna";5;0;100
0;5;"mileyshka";5;0;100
55;0;"milez";55;100;0
104;0;"milferd";104;100;0
7964;13;"milford";7977;99.8370314654632;0.162968534536793
496;0;"milfred";496;100;0
0;341;"mili";341;0;100
0;191;"milia";191;0;100
0;40;"miliah";40;0;100
8;38;"milian";46;17.3913043478261;82.6086956521739
0;451;"miliana";451;0;100
0;400;"miliani";400;0;100
0;50;"milianna";50;0;100
57;0;"miliano";57;100;0
0;40;"miliany";40;0;100
0;6;"milianys";6;0;100
0;329;"milica";329;0;100
0;101;"milicent";101;0;100
0;37;"milie";37;0;100
117;0;"milik";117;100;0
0;105;"milika";105;0;100
0;43;"mililani";43;0;100
11;0;"milin";11;100;0
0;64;"milina";64;0;100
69;0;"milind";69;100;0
0;1003;"milinda";1003;0;100
0;16;"milini";16;0;100
5;0;"milio";5;100;0
0;23;"milira";23;0;100
0;312;"milisa";312;0;100
0;5;"milisha";5;0;100
0;5;"milisia";5;0;100
0;3003;"milissa";3003;0;100
0;36;"milissia";36;0;100
0;83;"militza";83;0;100
0;94;"miliyah";94;0;100
0;426;"milka";426;0;100
0;1706;"milla";1706;0;100
39;0;"millage";39;100;0
0;7;"millah";7;0;100
132;11;"millan";143;92.3076923076923;7.69230769230769
0;20;"millana";20;0;100
0;40;"millani";40;0;100
15582;33;"millard";15615;99.7886647454371;0.21133525456292
0;5;"mille";5;0;100
260;0;"milledge";260;100;0
0;95;"millee";95;0;100
0;6;"milleigh";6;0;100
26;0;"millen";26;100;0
0;135;"millena";135;0;100
0;86;"millenia";86;0;100
0;7;"millenium";7;0;100
0;5;"millenna";5;0;100
0;54;"millennia";54;0;100
0;32;"millennium";32;0;100
6693;755;"miller";7448;89.8630504833512;10.1369495166488
17;0;"millerd";17;100;0
0;86;"millette";86;0;100
0;59;"milley";59;0;100
0;184;"milli";184;0;100
0;11;"millia";11;0;100
0;17;"millian";17;0;100
0;271;"milliana";271;0;100
0;54;"milliani";54;0;100
0;61;"millianna";61;0;100
43;0;"milliard";43;100;0
0;10533;"millicent";10533;0;100
207;24846;"millie";25053;0.8262483534906;99.1737516465094
0;5;"millinia";5;0;100
128;6;"million";134;95.5223880597015;4.47761194029851
0;5;"milliona";5;0;100
14;0;"millis";14;100;0
0;255;"millisa";255;0;100
0;6;"millison";6;0;100
0;329;"millissa";329;0;100
610;20;"mills";630;96.8253968253968;3.17460317460317
0;2311;"milly";2311;0;100
0;11;"millyana";11;0;100
23;0;"milner";23;100;0
6;0;"milnor";6;100;0
19256;172;"milo";19428;99.1146798435248;0.88532015647519
104;0;"miloh";104;100;0
125;0;"milon";125;100;0
5;0;"milorad";5;100;0
302;0;"milos";302;100;0
5;0;"milosh";5;100;0
6;0;"milosz";6;100;0
6;0;"milous";6;100;0
0;29;"milove";29;0;100
0;11;"milred";11;0;100
5;0;"milroy";5;100;0
70;0;"milt";70;100;0
0;156;"milta";156;0;100
12;0;"milthon";12;100;0
113402;615;"milton";114017;99.4606067516248;0.539393248375242
72;0;"milus";72;100;0
15;0;"milven";15;100;0
0;7;"milvia";7;0;100
15;0;"milvin";15;100;0
0;375;"mily";375;0;100
0;5;"milyana";5;0;100
0;76;"milyn";76;0;100
0;7;"milynda";7;0;100
0;112;"milynn";112;0;100
0;538;"mima";538;0;100
0;6768;"mimi";6768;0;100
0;10;"mimia";10;0;100
0;109;"mimie";109;0;100
0;11;"mimma";11;0;100
0;21;"mimmie";21;0;100
0;5;"mimose";5;0;100
35;0;"mims";35;100;0
380;238;"min";618;61.4886731391586;38.5113268608414
548;13221;"mina";13769;3.97995497131237;96.0200450286876
0;69;"minaal";69;0;100
0;196;"minah";196;0;100
0;175;"minahil";175;0;100
0;7;"minako";7;0;100
0;139;"minal";139;0;100
0;190;"minami";190;0;100
79;0;"minard";79;100;0
82;0;"minas";82;100;0
44;0;"minato";44;100;0
0;28;"minaya";28;0;100
0;1435;"minda";1435;0;100
0;25;"minday";25;0;100
0;23;"minde";23;0;100
0;486;"mindee";486;0;100
0;166;"mindel";166;0;100
0;16;"minden";16;0;100
0;4405;"mindi";4405;0;100
0;487;"mindie";487;0;100
67;41807;"mindy";41874;0.16000382098677;99.8399961790132
0;6;"minea";6;0;100
0;5;"mineko";5;0;100
0;61;"minela";61;0;100
0;5;"minelba";5;0;100
0;32;"minelly";32;0;100
0;5;"minelva";5;0;100
0;5;"minely";5;0;100
0;86;"mineola";86;0;100
232;0;"miner";232;100;0
0;11;"minerba";11;0;100
0;13650;"minerva";13650;0;100
0;53;"minervia";53;0;100
12;0;"minesh";12;100;0
0;11;"minesha";11;0;100
0;100;"minetta";100;0;100
0;691;"minette";691;0;100
321;141;"ming";462;69.4805194805195;30.5194805194805
0;5;"minga";5;0;100
264;0;"mingo";264;100;0
5;0;"mingus";5;100;0
1827;273;"minh";2100;87;13
0;208;"minha";208;0;100
0;5;"minhanh";5;0;100
0;16;"minhchau";16;0;100
5;0;"minho";5;100;0
16;0;"minhquan";16;100;0
0;16;"minhthu";16;0;100
5;0;"minhtri";5;100;0
0;37;"mini";37;0;100
0;28;"minica";28;0;100
0;87;"minie";87;0;100
0;18;"minika";18;0;100
0;15;"minique";15;0;100
0;6;"minisha";6;0;100
0;150;"miniya";150;0;100
0;9;"miniyah";9;0;100
6;0;"minjae";6;100;0
0;45;"minji";45;0;100
5;0;"minjoon";5;100;0
0;299;"minka";299;0;100
0;2287;"minna";2287;0;100
0;173;"minnah";173;0;100
0;5;"minne";5;0;100
0;7;"minneola";7;0;100
0;69;"minnetta";69;0;100
0;527;"minnette";527;0;100
0;5;"minnia";5;0;100
577;112368;"minnie";112945;0.510868121652132;99.4891318783479
0;7;"minnielee";7;0;100
11;0;"minnis";11;100;0
0;129;"minola";129;0;100
1503;12;"minor";1515;99.2079207920792;0.792079207920792
0;54;"minori";54;0;100
675;0;"minoru";675;100;0
40;0;"minos";40;100;0
10;0;"minot";10;100;0
0;45;"minsa";45;0;100
0;6;"minseo";6;0;100
0;955;"minta";955;0;100
56;0;"minter";56;100;0
0;5;"mintha";5;0;100
0;199;"mintie";199;0;100
28;0;"minton";28;100;0
48;0;"minus";48;100;0
17;0;"minwoo";17;100;0
0;12;"minya";12;0;100
5;0;"minyard";5;100;0
0;58;"minyon";58;0;100
38;219;"mio";257;14.7859922178988;85.2140077821012
0;30;"miona";30;0;100
0;72;"mionna";72;0;100
0;19;"miori";19;0;100
0;92;"miosha";92;0;100
0;15;"miosoti";15;0;100
0;76;"miosotis";76;0;100
0;6;"miosoty";6;0;100
129;0;"miquan";129;100;0
232;0;"miqueas";232;100;0
1960;92;"miquel";2052;95.5165692007797;4.48343079922027
0;365;"miquela";365;0;100
0;5;"miquella";5;0;100
0;21;"miquelle";21;0;100
0;6;"miquesha";6;0;100
5;0;"miquez";5;100;0
0;5;"miquisha";5;0;100
406;0;"mir";406;100;0
5;8559;"mira";8564;0.0583839327417095;99.9416160672583
5;0;"miraan";5;100;0
0;16;"mirabai";16;0;100
0;494;"mirabel";494;0;100
0;10;"mirabell";10;0;100
0;762;"mirabella";762;0;100
0;883;"mirabelle";883;0;100
18;0;"mirac";18;100;0
0;5;"miracal";5;0;100
279;14472;"miracle";14751;1.89139719341062;98.1086028065894
0;34;"mirae";34;0;100
5;127;"mirage";132;3.78787878787879;96.2121212121212
0;392;"mirah";392;0;100
0;5;"miraha";5;0;100
0;154;"mirai";154;0;100
94;10;"miraj";104;90.3846153846154;9.61538461538462
0;16;"mirajane";16;0;100
0;6;"mirakal";6;0;100
0;6;"mirakel";6;0;100
0;209;"mirakle";209;0;100
0;154;"miral";154;0;100
0;7;"miralee";7;0;100
0;10;"miram";10;0;100
51;0;"miran";51;100;0
183;109239;"miranda";109422;0.167242419257553;99.8327575807425
0;56;"mirandah";56;0;100
0;12;"mirandy";12;0;100
0;11;"mirannda";11;0;100
0;48;"mirari";48;0;100
0;28;"mirasol";28;0;100
0;65;"miray";65;0;100
0;450;"miraya";450;0;100
0;77;"mirayah";77;0;100
0;71;"mirca";71;0;100
0;44;"mircale";44;0;100
0;21;"mircle";21;0;100
0;5;"mirei";5;0;100
0;12;"mireia";12;0;100
0;12;"mireida";12;0;100
0;671;"mireille";671;0;100
0;23;"mireily";23;0;100
0;521;"mirel";521;0;100
0;104;"mirela";104;0;100
0;2948;"mirella";2948;0;100
0;143;"mirelle";143;0;100
0;93;"mirely";93;0;100
0;22;"mirelys";22;0;100
0;45;"miren";45;0;100
0;21;"mirena";21;0;100
0;79;"mirenda";79;0;100
0;8149;"mireya";8149;0;100
0;77;"mireyah";77;0;100
0;11;"mireyda";11;0;100
0;43;"mireyli";43;0;100
0;16;"mireyna";16;0;100
0;16;"mirha";16;0;100
0;539;"miri";539;0;100
0;105;"miria";105;0;100
0;1802;"miriah";1802;0;100
275;105046;"miriam";105321;0.26110652196618;99.7388934780338
0;5;"miriama";5;0;100
0;3217;"mirian";3217;0;100
0;97;"miriana";97;0;100
0;10;"mirianna";10;0;100
0;15;"mirical";15;0;100
0;6;"miricale";6;0;100
0;55;"miricle";55;0;100
0;5;"miriel";5;0;100
0;5;"miriella";5;0;100
0;274;"mirielle";274;0;100
0;5;"mirin";5;0;100
0;12;"mirina";12;0;100
0;320;"mirinda";320;0;100
0;30;"mirisa";30;0;100
0;222;"mirissa";222;0;100
0;7;"mirium";7;0;100
0;148;"miriya";148;0;100
0;112;"mirjana";112;0;100
0;529;"mirka";529;0;100
142;0;"mirko";142;100;0
87;55;"mirl";142;61.2676056338028;38.7323943661972
0;49;"mirla";49;0;100
0;19;"mirlande";19;0;100
0;5;"mirle";5;0;100
0;5;"mirlene";5;0;100
0;5;"mirlinda";5;0;100
5;3910;"mirna";3915;0.127713920817369;99.8722860791826
5;0;"mirnes";5;100;0
122;0;"miro";122;100;0
0;32;"mirola";32;0;100
266;0;"miron";266;100;0
0;41;"mironda";41;0;100
84;0;"miroslav";84;100;0
0;655;"miroslava";655;0;100
5;0;"miroslaw";5;100;0
0;250;"mirra";250;0;100
0;8;"mirracle";8;0;100
0;33;"mirrah";33;0;100
0;245;"mirranda";245;0;100
0;55;"mirren";55;0;100
0;5;"mirriah";5;0;100
0;196;"mirriam";196;0;100
0;35;"mirsa";35;0;100
5;0;"mirsab";5;100;0
10;0;"mirsad";10;100;0
0;10;"mirsha";10;0;100
0;858;"mirta";858;0;100
0;5;"mirth";5;0;100
0;538;"mirtha";538;0;100
0;142;"mirtie";142;0;100
0;6;"mirtis";6;0;100
0;10;"mirtle";10;0;100
0;5;"mirya";5;0;100
0;71;"miryah";71;0;100
0;765;"miryam";765;0;100
0;17;"miryan";17;0;100
0;6;"mirycal";6;0;100
0;6;"miryea";6;0;100
418;120;"mirza";538;77.6951672862454;22.3048327137546
0;623;"misa";623;0;100
0;18;"misae";18;0;100
7666;16;"misael";7682;99.7917209060141;0.208279093985941
0;221;"misaki";221;0;100
0;85;"misako";85;0;100
0;337;"misao";337;0;100
0;35;"misato";35;0;100
0;5;"misaye";5;0;100
0;11;"misayo";11;0;100
5;118;"misbah";123;4.0650406504065;95.9349593495935
180;1439;"mischa";1619;11.1179740580605;88.8820259419395
0;26;"mischel";26;0;100
0;121;"mischele";121;0;100
0;162;"mischell";162;0;100
0;967;"mischelle";967;0;100
0;13;"misel";13;0;100
0;5;"misgana";5;0;100
390;3443;"misha";3833;10.1747978085051;89.8252021914949
0;65;"mishaal";65;0;100
335;177;"mishael";512;65.4296875;34.5703125
0;28;"mishaela";28;0;100
0;6;"mishaila";6;0;100
5;167;"mishal";172;2.90697674418605;97.0930232558139
0;5;"mishalay";5;0;100
0;6;"mishale";6;0;100
0;6;"mishall";6;0;100
15;0;"mishary";15;100;0
14;0;"mishaun";14;100;0
70;117;"mishawn";187;37.4331550802139;62.5668449197861
0;33;"mishay";33;0;100
0;283;"mishayla";283;0;100
0;6;"mishea";6;0;100
0;45;"misheel";45;0;100
0;5;"misheeta";5;0;100
0;240;"mishel";240;0;100
0;54;"mishele";54;0;100
0;466;"mishell";466;0;100
0;1129;"mishelle";1129;0;100
0;5;"mishia";5;0;100
0;6;"mishie";6;0;100
0;177;"mishika";177;0;100
0;8;"mishita";8;0;100
0;297;"mishka";297;0;100
62;28;"mishon";90;68.8888888888889;31.1111111111111
0;6;"mishonda";6;0;100
0;50;"mishti";50;0;100
0;73;"misk";73;0;100
0;100;"miski";100;0;100
20;0;"mison";20;100;0
0;5;"misri";5;0;100
422;0;"missael";422;100;0
0;5;"missel";5;0;100
0;72;"missey";72;0;100
0;222;"missi";222;0;100
5;0;"missiah";5;100;0
0;742;"missie";742;0;100
0;1059;"missouri";1059;0;100
0;10;"missouria";10;0;100
0;10;"missty";10;0;100
0;5637;"missy";5637;0;100
0;5;"mistala";5;0;100
0;6;"mistaya";6;0;100
0;30;"miste";30;0;100
0;250;"mistee";250;0;100
0;47;"mistelle";47;0;100
586;0;"mister";586;100;0
0;72;"mistey";72;0;100
0;8325;"misti";8325;0;100
0;5;"mistic";5;0;100
0;25;"mistica";25;0;100
0;2240;"mistie";2240;0;100
0;93;"mistina";93;0;100
0;22;"mistique";22;0;100
237;84351;"misty";84588;0.280181586040573;99.7198184139594
0;16;"mistyann";16;0;100
0;39;"mistydawn";39;0;100
0;15;"mistye";15;0;100
0;5;"misue";5;0;100
46;0;"mit";46;100;0
0;56;"mita";56;0;100
5;16;"mital";21;23.8095238095238;76.1904761904762
0;117;"mitali";117;0;100
5469;0;"mitch";5469;100;0
248;0;"mitchael";248;100;0
40;0;"mitchal";40;100;0
267;0;"mitcheal";267;100;0
13026;22;"mitchel";13048;99.8313917841815;0.168608215818516
160511;1117;"mitchell";161628;99.3089068725716;0.691093127428416
160;502;"mitchelle";662;24.1691842900302;75.8308157099698
44;0;"mitchum";44;100;0
148;0;"mitesh";148;100;0
215;0;"mithcell";215;100;0
19;0;"mithil";19;100;0
0;16;"mithila";16;0;100
0;119;"mithra";119;0;100
70;0;"mithran";70;100;0
27;0;"mithun";27;100;0
0;6;"mitia";6;0;100
5;512;"mitra";517;0.967117988394584;99.0328820116054
6;0;"mits";6;100;0
0;7;"mitsi";7;0;100
0;5;"mitsie";5;0;100
0;5;"mitsu";5;0;100
0;358;"mitsue";358;0;100
88;0;"mitsugi";88;100;0
0;11;"mitsuki";11;0;100
0;565;"mitsuko";565;0;100
521;0;"mitsuo";521;100;0
171;5;"mitsuru";176;97.1590909090909;2.84090909090909
0;104;"mitsuye";104;0;100
0;39;"mitsuyo";39;0;100
10;0;"mitsuyoshi";10;100;0
0;204;"mitsy";204;0;100
33;0;"mitt";33;100;0
0;4784;"mittie";4784;0;100
0;5;"mitty";5;0;100
95;0;"mitul";95;100;0
0;5;"mitza";5;0;100
0;29;"mitze";29;0;100
0;24;"mitzel";24;0;100
0;13049;"mitzi";13049;0;100
0;1671;"mitzie";1671;0;100
0;1180;"mitzy";1180;0;100
0;80;"miu";80;0;100
0;12;"miura";12;0;100
25;0;"mivaan";25;100;0
0;55;"miwa";55;0;100
0;67;"mixtli";67;0;100
0;5;"mixtly";5;0;100
0;6328;"miya";6328;0;100
0;30;"miyabi";30;0;100
0;2694;"miyah";2694;0;100
0;153;"miyako";153;0;100
0;7;"miyali";7;0;100
0;475;"miyana";475;0;100
0;27;"miyanah";27;0;100
0;69;"miyani";69;0;100
0;345;"miyanna";345;0;100
0;7;"miyari";7;0;100
0;19;"miye";19;0;100
0;132;"miyeko";132;0;100
0;5;"miyesha";5;0;100
0;14;"miyisha";14;0;100
30;0;"miykael";30;100;0
0;17;"miyla";17;0;100
0;30;"miylah";30;0;100
0;62;"miyo";62;0;100
0;7;"miyoka";7;0;100
0;576;"miyoko";576;0;100
17;0;"miyon";17;100;0
0;40;"miyona";40;0;100
0;223;"miyonna";223;0;100
0;13;"miyosha";13;0;100
0;311;"miyoshi";311;0;100
0;182;"miyu";182;0;100
0;276;"miyuki";276;0;100
420;0;"mizael";420;100;0
6;6;"mizan";12;50;50
0;65;"mizani";65;0;100
59;0;"mizell";59;100;0
108;0;"mizraim";108;100;0
11;266;"mizuki";277;3.97111913357401;96.028880866426
79;0;"mj";79;100;0
0;5;"mkaela";5;0;100
31;0;"mkai";31;100;0
0;5;"mkaila";5;0;100
0;430;"mkayla";430;0;100
0;5;"mkaylah";5;0;100
0;25;"mkenna";25;0;100
0;16;"mkenzi";16;0;100
0;221;"mkenzie";221;0;100
0;10;"mkiyah";10;0;100
0;24;"mkya";24;0;100
0;10;"mkyla";10;0;100
0;6;"mlak";6;0;100
0;5;"mleah";5;0;100
0;10;"mlisa";10;0;100
0;108;"mliss";108;0;100
0;86;"mlissa";86;0;100
0;37;"mlynn";37;0;100
10;0;"mmark";10;100;0
0;5;"mmary";5;0;100
5;0;"mmichael";5;100;0
14;7;"mo";21;66.6666666666667;33.3333333333333
5;0;"moa";5;100;0
5;0;"moaad";5;100;0
29;0;"moaaz";29;100;0
17;0;"moad";17;100;0
0;593;"moana";593;0;100
0;53;"moani";53;0;100
66;0;"moataz";66;100;0
36;0;"moath";36;100;0
20;0;"moayad";20;100;0
7;0;"moayed";7;100;0
13;0;"moaz";13;100;0
21;0;"mobeen";21;100;0
5;0;"mobin";5;100;0
6;0;"mobley";6;100;0
5;0;"mobolaji";5;100;0
0;5;"mocha";5;0;100
10;0;"moctar";10;100;0
17;0;"moctezuma";17;100;0
6;0;"mode";6;100;0
0;311;"modean";311;0;100
9;187;"modell";196;4.59183673469388;95.4081632653061
0;79;"modelle";79;0;100
0;660;"modena";660;0;100
0;217;"modene";217;0;100
0;20;"modenia";20;0;100
0;14;"modesireoluwa";14;0;100
0;65;"modest";65;0;100
0;1591;"modesta";1591;0;100
0;6;"modesti";6;0;100
0;230;"modestine";230;0;100
2459;0;"modesto";2459;100;0
0;445;"modesty";445;0;100
10;0;"modibo";10;100;0
7;42;"modie";49;14.2857142857143;85.7142857142857
0;152;"modine";152;0;100
60;0;"modou";60;100;0
0;64;"modupe";64;0;100
0;5;"modupeoluwa";5;0;100
622;56;"moe";678;91.740412979351;8.25958702064897
16;0;"moeez";16;100;0
0;48;"moeisha";48;0;100
0;6;"moeko";6;0;100
0;16;"moena";16;0;100
0;1067;"moesha";1067;0;100
0;52;"moeshia";52;0;100
0;135;"moet";135;0;100
5;0;"moez";5;100;0
8;0;"mofeoluwa";8;100;0
0;5;"mofetoluwa";5;0;100
6;0;"moffett";6;100;0
0;13;"mofiyinfoluwa";13;0;100
40;0;"mohab";40;100;0
0;17;"mohagany";17;0;100
3013;0;"mohamad";3013;100;0
32;0;"mohamadali";32;100;0
64;0;"mohamadou";64;100;0
14161;0;"mohamed";14161;100;0
48;0;"mohamedali";48;100;0
10;0;"mohamedamiin";10;100;0
149;0;"mohamedamin";149;100;0
5;0;"mohamedamine";5;100;0
12886;10;"mohammad";12896;99.9224565756824;0.0775434243176179
38;0;"mohammadali";38;100;0
12295;0;"mohammed";12295;100;0
60;0;"mohammedali";60;100;0
174;0;"mohamud";174;100;0
225;0;"mohan";225;100;0
144;0;"mohanad";144;100;0
16;0;"mohaned";16;100;0
97;0;"mohannad";97;100;0
87;0;"mohd";87;100;0
41;0;"mohib";41;100;0
159;0;"mohid";159;100;0
0;140;"mohini";140;0;100
418;0;"mohit";418;100;0
23;0;"mohmad";23;100;0
90;0;"mohmed";90;100;0
116;0;"mohmmad";116;100;0
34;0;"mohmmed";34;100;0
40;0;"mohnish";40;100;0
0;64;"mohogany";64;0;100
180;0;"mohsen";180;100;0
345;0;"mohsin";345;100;0
26;0;"moices";26;100;0
0;10;"moina";10;0;100
44;0;"moir";44;100;0
0;6919;"moira";6919;0;100
0;11;"moire";11;0;100
802;0;"moise";802;100;0
26029;52;"moises";26081;99.8006211418274;0.199378858172616
956;0;"moishe";956;100;0
59;0;"moishy";59;100;0
12;0;"moisses";12;100;0
0;5;"moiya";5;0;100
169;0;"moiz";169;100;0
6;19;"mojolaoluwa";25;24;76
5;0;"mojtaba";5;100;0
212;0;"moksh";212;100;0
0;142;"moksha";142;0;100
12;0;"mokshagna";12;100;0
10;0;"mokshith";10;100;0
0;5;"mokshitha";5;0;100
0;49;"molene";49;0;100
0;5;"molette";5;0;100
5;0;"molik";5;100;0
0;5;"molika";5;0;100
0;188;"molina";188;0;100
0;31;"molinda";31;0;100
0;53;"moline";53;0;100
6;0;"molique";6;100;0
0;5;"molissa";5;0;100
0;5;"molla";5;0;100
0;706;"mollee";706;0;100
0;141;"molleigh";141;0;100
0;231;"molley";231;0;100
0;1864;"molli";1864;0;100
46;39130;"mollie";39176;0.117418827853788;99.8825811721462
5;0;"molloy";5;100;0
360;160710;"molly";161070;0.223505308251071;99.7764946917489
0;121;"mollyann";121;0;100
0;26;"mollyanne";26;0;100
0;376;"mollye";376;0;100
0;7;"mollykate";7;0;100
0;5;"mollyrose";5;0;100
5;0;"molton";5;100;0
22;0;"momar";22;100;0
65;0;"momen";65;100;0
0;7;"momie";7;0;100
185;0;"momin";185;100;0
0;137;"momina";137;0;100
0;62;"momo";62;0;100
75;0;"momodou";75;100;0
0;5;"momoe";5;0;100
0;141;"momoka";141;0;100
0;137;"momoko";137;0;100
0;11;"momoyo";11;0;100
10;0;"mon";10;100;0
31;44186;"mona";44217;0.0701087816903001;99.9298912183097
0;87;"monaca";87;0;100
0;1966;"monae";1966;0;100
0;5;"monah";5;0;100
0;172;"monai";172;0;100
0;5;"monajah";5;0;100
0;34;"monalee";34;0;100
0;10;"monali";10;0;100
0;1059;"monalisa";1059;0;100
0;16;"monasha";16;0;100
0;142;"monasia";142;0;100
0;514;"monay";514;0;100
0;12;"monaya";12;0;100
0;65;"monaye";65;0;100
0;10;"monce";10;0;100
0;56;"moncerat";56;0;100
0;17;"moncerath";17;0;100
0;5;"moncerrad";5;0;100
0;366;"moncerrat";366;0;100
0;90;"moncerrath";90;0;100
0;56;"monchel";56;0;100
0;23;"monchell";23;0;100
0;17;"monchelle";17;0;100
6;0;"monchello";6;100;0
0;5;"moncheri";5;0;100
0;424;"moncia";424;0;100
0;252;"monda";252;0;100
21;0;"mondale";21;100;0
24;0;"mondarius";24;100;0
0;30;"monday";30;0;100
43;0;"mondell";43;100;0
33;0;"mondo";33;100;0
5;0;"mondra";5;100;0
29;0;"mondre";29;100;0
41;0;"mondrell";41;100;0
0;509;"mone";509;0;100
0;289;"monea";289;0;100
0;13;"moneak";13;0;100
0;33;"moneca";33;0;100
0;36;"monecia";36;0;100
0;451;"monee";451;0;100
5;0;"moneeb";5;100;0
0;15;"moneek";15;0;100
0;23;"moneeka";23;0;100
5;0;"moneer";5;100;0
0;11;"moneik";11;0;100
0;6;"moneika";6;0;100
0;140;"moneisha";140;0;100
0;6;"monek";6;0;100
0;266;"moneka";266;0;100
0;26;"moneke";26;0;100
0;6;"monekia";6;0;100
5;18;"monell";23;21.7391304347826;78.2608695652174
0;6;"monelle";6;0;100
0;5;"moneque";5;0;100
0;420;"monesha";420;0;100
0;57;"moneshia";57;0;100
6;4192;"monet";4198;0.14292520247737;99.8570747975226
0;47;"moneta";47;0;100
0;228;"monetta";228;0;100
0;1330;"monette";1330;0;100
26;68;"money";94;27.6595744680851;72.3404255319149
0;7;"monez";7;0;100
27;0;"monford";27;100;0
92;18;"mong";110;83.6363636363636;16.3636363636364
0;59;"moni";59;0;100
0;366;"monia";366;0;100
0;509;"monic";509;0;100
982;247044;"monica";248026;0.395926233540032;99.60407376646
0;213;"monice";213;0;100
0;110;"monicia";110;0;100
0;80;"monick";80;0;100
0;66;"monicka";66;0;100
751;17;"monico";768;97.7864583333333;2.21354166666667
0;384;"monie";384;0;100
0;40;"moniece";40;0;100
0;34;"moniesha";34;0;100
0;416;"monifa";416;0;100
0;135;"monifah";135;0;100
0;474;"monigue";474;0;100
0;142;"monik";142;0;100
0;9534;"monika";9534;0;100
0;5;"monikah";5;0;100
0;60;"monike";60;0;100
0;10;"monikia";10;0;100
0;10;"monina";10;0;100
0;5;"monioluwa";5;0;100
0;5;"moniq";5;0;100
0;409;"moniqua";409;0;100
377;78294;"monique";78671;0.4792108909255;99.5207891090745
0;28;"moniquea";28;0;100
0;11;"moniquie";11;0;100
5;0;"monir";5;100;0
0;10;"monira";10;0;100
0;59;"monisa";59;0;100
0;30;"monise";30;0;100
68;0;"monish";68;100;0
0;1248;"monisha";1248;0;100
0;5;"monissa";5;0;100
0;505;"monita";505;0;100
0;29;"moniya";29;0;100
0;22;"moniyah";22;0;100
0;6;"monja";6;0;100
0;1379;"monna";1379;0;100
0;22;"monnette";22;0;100
0;66;"monnica";66;0;100
258;1699;"monnie";1957;13.1834440470107;86.8165559529893
37;0;"monolito";37;100;0
0;60;"monque";60;0;100
5;0;"monquel";5;100;0
17;0;"monquez";17;100;0
0;305;"monquie";305;0;100
0;5;"monquita";5;0;100
5;0;"monrad";5;100;0
0;5;"monreaux";5;0;100
14645;2343;"monroe";16988;86.2079114669178;13.7920885330822
5;0;"monsanto";5;100;0
0;27;"monse";27;0;100
0;388;"monserat";388;0;100
0;144;"monserath";144;0;100
0;86;"monseratt";86;0;100
0;16;"monserrad";16;0;100
26;6416;"monserrat";6442;0.403601366035393;99.5963986339646
34;122;"monserrate";156;21.7948717948718;78.2051282051282
0;977;"monserrath";977;0;100
0;164;"monserratt";164;0;100
0;6;"monserratte";6;0;100
0;5;"monsita";5;0;100
38;0;"monson";38;100;0
0;11;"monsserat";11;0;100
0;24;"monsserrat";24;0;100
732;0;"mont";732;100;0
481;867;"monta";1348;35.6824925816024;64.3175074183976
571;0;"montae";571;100;0
347;0;"montague";347;100;0
3101;7349;"montana";10450;29.6746411483254;70.3253588516747
0;10;"montanah";10;0;100
5;0;"montanez";5;100;0
28;860;"montanna";888;3.15315315315315;96.8468468468468
20;0;"montaque";20;100;0
91;0;"montario";91;100;0
16;0;"montarious";16;100;0
117;0;"montarius";117;100;0
0;183;"montasia";183;0;100
0;53;"montavia";53;0;100
6;0;"montavian";6;100;0
32;0;"montavion";32;100;0
888;0;"montavious";888;100;0
145;0;"montavis";145;100;0
354;0;"montavius";354;100;0
261;0;"montay";261;100;0
0;44;"montaya";44;0;100
5;0;"montaye";5;100;0
0;5;"montaysia";5;0;100
16;0;"montaz";16;100;0
22013;802;"monte";22815;96.4847687924611;3.5152312075389
5;5;"montea";10;50;50
24;0;"monteco";24;100;0
51;0;"montee";51;100;0
0;253;"monteen";253;0;100
50;0;"montego";50;100;0
1454;0;"montel";1454;100;0
823;0;"montell";823;100;0
18;0;"montelle";18;100;0
0;11;"montene";11;0;100
0;8;"montera";8;0;100
0;17;"monterey";17;0;100
0;27;"monteria";27;0;100
306;0;"monterio";306;100;0
5;0;"monterion";5;100;0
38;0;"monterious";38;100;0
96;0;"monterius";96;100;0
49;0;"montero";49;100;0
0;5;"monterra";5;0;100
14;0;"monterrian";14;100;0
112;0;"monterrio";112;100;0
18;0;"monterrious";18;100;0
76;0;"monterrius";76;100;0
5;0;"montese";5;100;0
0;12;"montesha";12;0;100
0;23;"montessa";23;0;100
5;0;"montevious";5;100;0
75;0;"montey";75;100;0
2884;737;"montez";3621;79.6465064899199;20.3534935100801
16;0;"monteze";16;100;0
102;0;"montford";102;100;0
3930;295;"montgomery";4225;93.0177514792899;6.98224852071006
341;180;"monti";521;65.4510556621881;34.5489443378119
0;179;"montia";179;0;100
0;5;"montiara";5;0;100
0;37;"montica";37;0;100
5;0;"montico";5;100;0
1633;810;"montie";2443;66.8440442079411;33.1559557920589
0;5;"montiera";5;0;100
0;214;"montina";214;0;100
0;492;"montine";492;0;100
0;43;"montinique";43;0;100
34;41;"montique";75;45.3333333333333;54.6666666666667
0;16;"montisha";16;0;100
5;0;"montonio";5;100;0
0;10;"montoria";10;0;100
119;520;"montoya";639;18.622848200313;81.377151799687
0;5;"montoyia";5;0;100
11;11;"montra";22;50;50
76;0;"montrae";76;100;0
221;0;"montrail";221;100;0
15;0;"montral";15;100;0
5;0;"montravion";5;100;0
115;0;"montravious";115;100;0
7;0;"montravius";7;100;0
199;0;"montray";199;100;0
347;0;"montre";347;100;0
1036;0;"montreal";1036;100;0
0;6;"montrece";6;0;100
929;0;"montrel";929;100;0
3608;28;"montrell";3636;99.2299229922992;0.77007700770077
102;0;"montrelle";102;100;0
5;22;"montrese";27;18.5185185185185;81.4814814814815
0;29;"montressa";29;0;100
5;0;"montrevious";5;100;0
228;0;"montrey";228;100;0
528;0;"montrez";528;100;0
88;208;"montrice";296;29.7297297297297;70.2702702702703
6;6;"montrose";12;50;50
0;5;"montry";5;0;100
0;7;"montse";7;0;100
0;8;"montserat";8;0;100
0;5;"montserrad";5;0;100
0;3981;"montserrat";3981;0;100
0;100;"montserrath";100;0;100
6;0;"montsho";6;100;0
14738;274;"monty";15012;98.1747934985345;1.82520650146549
0;104;"montzerrat";104;0;100
5;0;"mony";5;100;0
0;663;"monya";663;0;100
5;58;"monyae";63;7.93650793650794;92.0634920634921
0;12;"monyca";12;0;100
0;26;"monye";26;0;100
0;13;"monyea";13;0;100
0;7;"monyetta";7;0;100
0;51;"monyette";51;0;100
0;5;"monyka";5;0;100
0;5;"monzell";5;0;100
0;5;"monzella";5;0;100
0;7;"monzelle";7;0;100
0;63;"monzerat";63;0;100
0;55;"monzerath";55;0;100
0;7;"monzeratt";7;0;100
0;5;"monzerrad";5;0;100
5;501;"monzerrat";506;0.988142292490119;99.0118577075099
0;140;"monzerrath";140;0;100
44;31;"moo";75;58.6666666666667;41.3333333333333
679;0;"moody";679;100;0
26;87;"moon";113;23.0088495575221;76.9911504424779
0;7;"moona";7;0;100
0;5;"moonyean";5;0;100
0;30;"moonyeen";30;0;100
28;0;"moore";28;100;0
0;159;"moorea";159;0;100
172;0;"moosa";172;100;0
5;13;"mor";18;27.7777777777778;72.2222222222222
0;697;"mora";697;0;100
141;0;"morad";141;100;0
5;0;"moraes";5;100;0
0;15;"morag";15;0;100
0;5;"morah";5;0;100
0;287;"moraima";287;0;100
6;0;"moral";6;100;0
52;5;"moran";57;91.2280701754386;8.7719298245614
0;270;"moranda";270;0;100
0;7;"moraya";7;0;100
0;119;"morayma";119;0;100
0;76;"morayo";76;0;100
31;0;"mordcha";31;100;0
5;0;"mordchai";5;100;0
128;0;"mordche";128;100;0
969;0;"mordecai";969;100;0
4550;0;"mordechai";4550;100;0
5;0;"mordechi";5;100;0
24;0;"mordekai";24;100;0
6;0;"mordy";6;100;0
0;21;"morea";21;0;100
0;15;"moree";15;0;100
0;263;"moreen";263;0;100
29;0;"moreland";29;100;0
0;682;"morelia";682;0;100
68;0;"morell";68;100;0
0;15;"morella";15;0;100
0;256;"morena";256;0;100
0;367;"morene";367;0;100
0;120;"morenike";120;0;100
11;0;"moreno";11;100;0
0;5;"moretta";5;0;100
483;0;"morey";483;100;0
0;175;"morgaine";175;0;100
41106;210534;"morgan";251640;16.3352408202194;83.6647591797806
0;539;"morgana";539;0;100
0;25;"morgandy";25;0;100
0;196;"morgane";196;0;100
0;743;"morgann";743;0;100
0;126;"morganna";126;0;100
0;1158;"morganne";1158;0;100
0;5;"morgayne";5;0;100
559;1796;"morgen";2355;23.7367303609342;76.2632696390658
5;1230;"morghan";1235;0.404858299595142;99.5951417004049
0;11;"morghann";11;0;100
0;5;"morghen";5;0;100
0;6;"morghyn";6;0;100
0;127;"morgin";127;0;100
101;42;"morgon";143;70.6293706293706;29.3706293706294
49;0;"morgun";49;100;0
0;817;"morgyn";817;0;100
0;16;"morgynn";16;0;100
23;57;"mori";80;28.75;71.25
0;533;"moria";533;0;100
94;11499;"moriah";11593;0.810834124040369;99.1891658759596
0;5;"moriana";5;0;100
0;7;"morica";7;0;100
30;0;"morice";30;100;0
6;0;"moriel";6;100;0
0;7;"morina";7;0;100
0;341;"morine";341;0;100
100;0;"morio";100;100;0
5;0;"morion";5;100;0
12;16;"morireoluwa";28;42.8571428571429;57.1428571428571
257;0;"moris";257;100;0
0;5;"morisa";5;0;100
14;0;"morise";14;100;0
0;196;"morissa";196;0;100
121;0;"moritz";121;100;0
0;92;"moriya";92;0;100
0;218;"moriyah";218;0;100
0;46;"morjorie";46;0;100
5;0;"morland";5;100;0
0;15;"morlene";15;0;100
517;29;"morley";546;94.6886446886447;5.31135531135531
5;0;"morlon";5;100;0
0;386;"morna";386;0;100
0;157;"morning";157;0;100
0;182;"morningstar";182;0;100
40;0;"morocco";40;100;0
0;5;"morolaoluwa";5;0;100
361;0;"moroni";361;100;0
5;0;"morpheus";5;100;0
5;0;"morrel";5;100;0
687;0;"morrell";687;100;0
5;0;"morrey";5;100;0
0;41;"morriah";41;0;100
325;0;"morrie";325;100;0
0;695;"morrigan";695;0;100
0;37;"morrighan";37;0;100
63;0;"morrill";63;100;0
0;6;"morrine";6;0;100
68000;484;"morris";68484;99.2932655802815;0.706734419718474
0;207;"morrisa";207;0;100
10;0;"morrise";10;100;0
1341;51;"morrison";1392;96.3362068965517;3.66379310344828
5;0;"morriss";5;100;0
0;86;"morrissa";86;0;100
17;5;"morrissey";22;77.2727272727273;22.7272727272727
22;0;"morrow";22;100;0
84;0;"morry";84;100;0
0;6;"morsal";6;0;100
373;0;"morse";373;100;0
129;0;"mort";129;100;0
43;0;"morten";43;100;0
30;0;"mortez";30;100;0
0;47;"morticia";47;0;100
1727;0;"mortimer";1727;100;0
0;15;"mortisha";15;0;100
11919;5;"morton";11924;99.9580677624958;0.0419322375041932
87;0;"morty";87;100;0
73;0;"mory";73;100;0
0;16;"moryah";16;0;100
11;0;"mosa";11;100;0
14;0;"mosby";14;100;0
6529;55;"mose";6584;99.1646415552855;0.835358444714459
0;118;"mosella";118;0;100
0;254;"moselle";254;0;100
36302;45;"moses";36347;99.8761933584615;0.123806641538504
47;0;"mosese";47;100;0
0;62;"mosetta";62;0;100
18;0;"mosha";18;100;0
0;5;"moshay";5;0;100
12501;21;"moshe";12522;99.8322951605175;0.167704839482511
32;0;"mosheh";32;100;0
16;0;"moshood";16;100;0
67;11;"mosi";78;85.8974358974359;14.1025641025641
432;0;"mosiah";432;100;0
64;48;"mosie";112;57.1428571428571;42.8571428571429
19;29;"mosley";48;39.5833333333333;60.4166666666667
390;0;"moss";390;100;0
28;0;"mosses";28;100;0
5;892;"mossie";897;0.557413600891862;99.4425863991081
38;0;"mossimo";38;100;0
591;0;"mostafa";591;100;0
6;0;"mostyn";6;100;0
41;0;"motaz";41;100;0
5;0;"motez";5;100;0
0;5;"motie";5;0;100
10;0;"motley";10;100;0
5;0;"motoki";5;100;0
29;0;"mott";29;100;0
5;0;"motti";5;100;0
70;0;"motty";70;100;0
0;32;"motunrayo";32;0;100
167;0;"moua";167;100;0
23;0;"mouad";23;100;0
12;0;"mouctar";12;100;0
0;6;"moudie";6;0;100
120;0;"mouhamad";120;100;0
287;0;"mouhamadou";287;100;0
515;0;"mouhamed";515;100;0
11;0;"mouhammad";11;100;0
0;26;"moukthika";26;0;100
12;0;"moulton";12;100;0
24;0;"moultrie";24;100;0
0;53;"mouna";53;0;100
0;5;"mounia";5;0;100
84;0;"mounir";84;100;0
13;0;"mount";13;100;0
96;0;"mourad";96;100;0
28;0;"mourice";28;100;0
0;11;"mourine";11;0;100
5;0;"mourya";5;100;0
330;0;"mousa";330;100;0
746;0;"moussa";746;100;0
296;0;"moustafa";296;100;0
272;0;"moustapha";272;100;0
5;0;"moutaz";5;100;0
0;48;"movita";48;0;100
11;0;"mowgli";11;100;0
7;0;"mox";7;100;0
7;0;"moxen";7;100;0
0;301;"moxie";301;0;100
16;6;"moxley";22;72.7272727272727;27.2727272727273
59;0;"moxon";59;100;0
0;16;"moxxi";16;0;100
0;5;"moy";5;0;100
0;615;"moya";615;0;100
19;0;"moyer";19;100;0
0;73;"moyinoluwa";73;0;100
12;12;"moyosoreoluwa";24;50;50
0;43;"moyra";43;0;100
116;0;"moyses";116;100;0
15;0;"mozart";15;100;0
5;218;"mozel";223;2.24215246636771;97.7578475336323
485;3016;"mozell";3501;13.8531848043416;86.1468151956584
0;1769;"mozella";1769;0;100
11;5193;"mozelle";5204;0.211375864719447;99.7886241352806
55;0;"mozes";55;100;0
0;69;"mozetta";69;0;100
34;0;"moziah";34;100;0
0;6;"mozter";6;0;100
5;0;"mr";5;100;0
0;15;"mria";15;0;100
0;41;"mridula";41;0;100
0;5;"mrinalini";5;0;100
85;0;"mrk";85;100;0
0;81;"mry";81;0;100
0;6;"mryah";6;0;100
0;56;"mrytle";56;0;100
0;5;"mtisha";5;0;100
6;0;"mtthew";6;100;0
6;0;"mua";6;100;0
52;0;"muaad";52;100;0
53;0;"muaaz";53;100;0
213;0;"muad";213;100;0
115;0;"muadh";115;100;0
5;0;"muammar";5;100;0
54;0;"muath";54;100;0
188;0;"muaz";188;100;0
310;0;"mubarak";310;100;0
5;0;"mubarik";5;100;0
70;0;"mubashir";70;100;0
33;0;"mubeen";33;100;0
5;0;"mubin";5;100;0
0;30;"mubina";30;0;100
12;0;"mucaad";12;100;0
9;0;"mucad";9;100;0
6;0;"mudaser";6;100;0
13;0;"mudasir";13;100;0
15;0;"mudassir";15;100;0
5;0;"mueed";5;100;0
11;0;"mueez";11;100;0
7;0;"mufasa";7;100;0
0;6;"muffy";6;0;100
0;16;"mugdha";16;0;100
5;0;"mugen";5;100;0
0;5;"muggie";5;0;100
5;0;"mugilan";5;100;0
15;0;"mugisha";15;100;0
0;11;"muguette";11;0;100
6;0;"muhab";6;100;0
5;0;"muhaimin";5;100;0
215;0;"muhamad";215;100;0
6;0;"muhamadou";6;100;0
485;0;"muhamed";485;100;0
11628;0;"muhammad";11628;100;0
78;0;"muhammadali";78;100;0
5;0;"muhammadamin";5;100;0
7;0;"muhammadyusuf";7;100;0
1891;0;"muhammed";1891;100;0
5;0;"muhammedali";5;100;0
53;0;"muhanad";53;100;0
61;0;"muhannad";61;100;0
10;0;"muhib";10;100;0
5;0;"muhmmad";5;100;0
315;0;"muhsin";315;100;0
6;0;"muhtasim";6;100;0
0;5;"mui";5;0;100
0;10;"muireann";10;0;100
26;0;"muiz";26;100;0
15;0;"muizz";15;100;0
273;0;"mujahid";273;100;0
271;0;"mujtaba";271;100;0
5;0;"mukarram";5;100;0
5;0;"mukesh";5;100;0
95;0;"mukhtar";95;100;0
5;0;"mukil";5;100;0
0;23;"mukta";23;0;100
23;0;"muktar";23;100;0
13;0;"mukul";13;100;0
141;0;"mukund";141;100;0
5;0;"mukunda";5;100;0
5;232;"mulan";237;2.10970464135021;97.8902953586498
0;18;"mulani";18;0;100
6;0;"muldrow";6;100;0
23;0;"mulford";23;100;0
0;56;"mulki";56;0;100
101;0;"mumin";101;100;0
0;38;"mumina";38;0;100
0;10;"mumtahina";10;0;100
0;6;"mumtas";6;0;100
0;152;"mumtaz";152;0;100
5;0;"mun";5;100;0
0;948;"muna";948;0;100
11;19;"munachi";30;36.6666666666667;63.3333333333333
54;82;"munachimso";136;39.7058823529412;60.2941176470588
17;45;"munachiso";62;27.4193548387097;72.5806451612903
5;0;"munajj";5;100;0
33;0;"munasar";33;100;0
0;7;"mundi";7;0;100
0;11;"mundy";11;0;100
233;0;"muneeb";233;100;0
186;0;"muneer";186;100;0
0;36;"muneera";36;0;100
0;51;"muneerah";51;0;100
5;0;"muneo";5;100;0
52;0;"mung";52;100;0
0;5;"munha";5;0;100
11;0;"munib";11;100;0
0;15;"muniba";15;0;100
542;0;"munir";542;100;0
0;429;"munira";429;0;100
0;129;"munirah";129;0;100
0;23;"munisa";23;0;100
0;5;"muniza";5;0;100
18;0;"munro";18;100;0
6;0;"munroe";6;100;0
20;0;"munson";20;100;0
0;175;"muntaha";175;0;100
0;43;"muntas";43;0;100
38;0;"muntasir";38;100;0
0;36;"muntaz";36;0;100
0;5;"mura";5;0;100
748;0;"murad";748;100;0
0;5;"mural";5;0;100
5;0;"murali";5;100;0
0;66;"muranda";66;0;100
12;0;"murari";12;100;0
284;0;"murat";284;100;0
0;5;"murdie";5;0;100
0;104;"murdis";104;0;100
25;0;"murdoc";25;100;0
25;0;"murdoch";25;100;0
270;0;"murdock";270;100;0
479;225;"murel";704;68.0397727272727;31.9602272727273
16;0;"murell";16;100;0
0;103;"muriah";103;0;100
0;207;"murial";207;0;100
77;0;"murice";77;100;0
762;53331;"muriel";54093;1.40868504242693;98.5913149575731
0;314;"murielle";314;0;100
28;15;"muril";43;65.1162790697674;34.8837209302326
26;0;"murilo";26;100;0
0;10;"murissa";10;0;100
0;24;"murjani";24;0;100
1896;580;"murl";2476;76.5751211631664;23.4248788368336
6;0;"murland";6;100;0
281;189;"murle";470;59.7872340425532;40.2127659574468
0;73;"murlean";73;0;100
0;23;"murlee";23;0;100
0;16;"murleen";16;0;100
5;0;"murlen";5;100;0
0;616;"murlene";616;0;100
0;12;"murlie";12;0;100
321;0;"murlin";321;100;0
0;374;"murline";374;0;100
20;11;"murlyn";31;64.5161290322581;35.4838709677419
0;72;"murna";72;0;100
0;5;"murnie";5;0;100
0;14;"murphee";14;0;100
10;6;"murphey";16;62.5;37.5
0;15;"murphie";15;0;100
6238;1088;"murphy";7326;85.1487851487852;14.8512148512149
20966;315;"murray";21281;98.5198064000752;1.48019359992482
731;189;"murrel";920;79.4565217391304;20.5434782608696
1093;190;"murrell";1283;85.190958690569;14.809041309431
15;0;"murrey";15;100;0
0;15;"murrie";15;0;100
120;502;"murriel";622;19.2926045016077;80.7073954983923
10;0;"murrill";10;100;0
0;5;"murron";5;0;100
2993;94;"murry";3087;96.9549724651766;3.04502753482345
11;32;"mursal";43;25.5813953488372;74.4186046511628
253;0;"murtaza";253;100;0
5;5;"murtha";10;50;50
0;10;"murtie";10;0;100
0;55;"murtis";55;0;100
20;0;"murton";20;100;0
25;0;"murvel";25;100;0
194;0;"murvin";194;100;0
2563;26;"musa";2589;98.9957512553109;1.00424874468907
21;0;"musaab";21;100;0
440;0;"musab";440;100;0
5;0;"musah";5;100;0
20;0;"musashi";20;100;0
45;0;"muscab";45;100;0
44;0;"muse";44;100;0
0;40;"musetta";40;0;100
0;102;"musette";102;0;100
0;11;"musfirah";11;0;100
0;11;"musheerah";11;0;100
0;324;"mushka";324;0;100
0;5;"mushtaaq";5;0;100
0;31;"mushtaq";31;0;100
6;6;"music";12;50;50
0;5;"musie";5;0;100
32;24;"musiq";56;57.1428571428571;42.8571428571429
0;10;"muska";10;0;100
0;278;"muskaan";278;0;100
0;289;"muskan";289;0;100
5;0;"muslim";5;100;0
0;31;"muslima";31;0;100
0;25;"muslimah";25;0;100
95;0;"mussa";95;100;0
5;0;"musse";5;100;0
48;0;"mussie";48;100;0
94;0;"mustaf";94;100;0
5044;0;"mustafa";5044;100;0
32;0;"mustafaa";32;100;0
5;0;"mustafah";5;100;0
19;0;"mustafe";19;100;0
522;0;"mustapha";522;100;0
5;0;"mustaqeem";5;100;0
55;0;"mutasim";55;100;0
29;0;"mutaz";29;100;0
0;18;"mutsuko";18;0;100
8;0;"mutsuo";8;100;0
11;0;"mutt";11;100;0
0;5;"muyi";5;0;100
90;0;"muzamil";90;100;0
112;0;"muzammil";112;100;0
0;10;"muzette";10;0;100
6;0;"muzik";6;100;0
0;5;"muzna";5;0;100
25;0;"muzzammil";25;100;0
239;1044;"my";1283;18.6282151208106;81.3717848791894
54;51541;"mya";51595;0.10466130438996;99.89533869561
0;19;"myaa";19;0;100
0;19;"myabella";19;0;100
6;8160;"myah";8166;0.0734753857457752;99.9265246142542
0;5;"myair";5;0;100
0;10;"myaira";10;0;100
0;5;"myairah";5;0;100
16;10;"myaire";26;61.5384615384615;38.4615384615385
0;28;"myaisha";28;0;100
0;5;"myajah";5;0;100
0;57;"myalee";57;0;100
0;5;"myalin";5;0;100
0;5;"myalise";5;0;100
0;5;"myalyn";5;0;100
0;99;"myalynn";99;0;100
0;5;"myamarie";5;0;100
0;46;"myami";46;0;100
88;99;"myan";187;47.0588235294118;52.9411764705882
0;434;"myana";434;0;100
0;16;"myanah";16;0;100
0;362;"myangel";362;0;100
0;5;"myanh";5;0;100
0;49;"myani";49;0;100
0;5;"myann";5;0;100
0;494;"myanna";494;0;100
0;6;"myannah";6;0;100
0;10;"myanni";10;0;100
0;31;"myar";31;0;100
0;21;"myara";21;0;100
0;5;"myarose";5;0;100
0;5;"myashia";5;0;100
0;1479;"myasia";1479;0;100
0;30;"myasiah";30;0;100
0;29;"myauna";29;0;100
0;18;"myazia";18;0;100
35;304;"myca";339;10.3244837758112;89.6755162241888
0;10;"mycaela";10;0;100
533;699;"mycah";1232;43.262987012987;56.737012987013
141;0;"mycal";141;100;0
0;87;"mycala";87;0;100
0;20;"mycayla";20;0;100
0;18;"mycha";18;0;100
1258;237;"mychael";1495;84.1471571906354;15.8528428093645
0;362;"mychaela";362;0;100
1939;265;"mychal";2204;87.9764065335753;12.0235934664247
0;28;"mychala";28;0;100
101;0;"mycheal";101;100;0
10;10;"mychel";20;50;50
0;57;"mychele";57;0;100
0;5;"mychell";5;0;100
0;636;"mychelle";636;0;100
0;6;"myckala";6;0;100
5;0;"mycol";5;100;0
0;58;"myda";58;0;100
0;92;"myeasha";92;0;100
0;89;"myeesha";89;0;100
0;1087;"myeisha";1087;0;100
0;14;"myeka";14;0;100
0;10;"myel";10;0;100
0;17;"myella";17;0;100
0;159;"myelle";159;0;100
853;11;"myer";864;98.7268518518518;1.27314814814815
461;23;"myers";484;95.2479338842975;4.75206611570248
0;3374;"myesha";3374;0;100
0;7;"myesheia";7;0;100
0;910;"myeshia";910;0;100
0;5;"myesia";5;0;100
0;79;"myha";79;0;100
0;14;"myhanh";14;0;100
12;0;"myheir";12;100;0
0;2125;"myia";2125;0;100
0;756;"myiah";756;0;100
0;10;"myianna";10;0;100
0;652;"myiesha";652;0;100
6;0;"myion";6;100;0
0;6;"myiona";6;0;100
0;11;"myionna";11;0;100
0;1551;"myisha";1551;0;100
0;56;"myishia";56;0;100
0;20;"myja";20;0;100
0;11;"myjah";11;0;100
0;5;"myjoy";5;0;100
301;2222;"myka";2523;11.9302417756639;88.0697582243361
458;126;"mykael";584;78.4246575342466;21.5753424657534
0;1049;"mykaela";1049;0;100
0;6;"mykaella";6;0;100
684;1010;"mykah";1694;40.3778040141677;59.6221959858323
77;0;"mykai";77;100;0
59;0;"mykail";59;100;0
0;419;"mykaila";419;0;100
0;17;"mykailah";17;0;100
1071;326;"mykal";1397;76.6642806012885;23.3357193987115
0;1286;"mykala";1286;0;100
0;145;"mykalah";145;0;100
130;28;"mykale";158;82.2784810126582;17.7215189873418
0;33;"mykalia";33;0;100
0;5;"mykalla";5;0;100
0;12;"mykaya";12;0;100
0;2531;"mykayla";2531;0;100
0;92;"mykaylah";92;0;100
21;0;"myke";21;100;0
0;55;"mykea";55;0;100
123;13;"mykeal";136;90.4411764705882;9.55882352941176
0;57;"mykeia";57;0;100
10;0;"mykeil";10;100;0
0;81;"mykeisha";81;0;100
2796;675;"mykel";3471;80.5531547104581;19.4468452895419
0;208;"mykela";208;0;100
624;248;"mykell";872;71.5596330275229;28.4403669724771
5;109;"mykelle";114;4.3859649122807;95.6140350877193
37;68;"mykelti";105;35.2380952380952;64.7619047619048
0;12;"mykena";12;0;100
0;287;"mykenna";287;0;100
0;11;"mykenzee";11;0;100
0;152;"mykenzi";152;0;100
0;1079;"mykenzie";1079;0;100
0;11;"mykera";11;0;100
0;121;"mykeria";121;0;100
0;5;"mykerria";5;0;100
0;51;"mykesha";51;0;100
0;10;"mykeshia";10;0;100
0;6;"mykeya";6;0;100
28;0;"mykhael";28;100;0
11;0;"mykhail";11;100;0
15;0;"mykhal";15;100;0
0;5;"mykhala";5;0;100
5;0;"mykhel";5;100;0
56;0;"mykhi";56;100;0
0;82;"mykhia";82;0;100
6;0;"myki";6;100;0
0;909;"mykia";909;0;100
0;250;"mykiah";250;0;100
0;8;"mykila";8;0;100
112;0;"myking";112;100;0
0;87;"mykira";87;0;100
0;24;"mykisha";24;0;100
0;5;"mykita";5;0;100
0;10;"mykiya";10;0;100
0;10;"mykiyah";10;0;100
5;0;"mykl";5;100;0
90;0;"mykle";90;100;0
30;0;"mykol";30;100;0
10;0;"mykola";10;100;0
14;0;"mykolas";14;100;0
0;5;"mykya";5;0;100
0;5;"mykyah";5;0;100
0;23;"mykyla";23;0;100
0;10105;"myla";10105;0;100
0;5;"mylaa";5;0;100
0;2103;"mylah";2103;0;100
840;320;"mylan";1160;72.4137931034483;27.5862068965517
0;5;"mylana";5;0;100
0;128;"mylani";128;0;100
0;19;"mylania";19;0;100
0;5;"mylasha";5;0;100
0;16;"mylashia";16;0;100
0;175;"mylasia";175;0;100
0;9;"mylaya";9;0;100
0;5;"mylayah";5;0;100
0;143;"myldred";143;0;100
0;282;"mylea";282;0;100
0;377;"myleah";377;0;100
0;3493;"mylee";3493;0;100
0;130;"myleen";130;0;100
0;16;"myleena";16;0;100
0;14;"myleene";14;0;100
0;5;"myleesha";5;0;100
0;181;"mylei";181;0;100
0;894;"myleigh";894;0;100
0;23;"myleigha";23;0;100
0;5;"myleisha";5;0;100
5;0;"mylek";5;100;0
0;71;"myleka";71;0;100
87;5;"mylen";92;94.5652173913043;5.43478260869565
0;170;"mylena";170;0;100
0;660;"mylene";660;0;100
5;0;"myler";5;100;0
37846;155;"myles";38001;99.5921159969475;0.407884003052551
0;17;"mylesha";17;0;100
0;143;"myley";143;0;100
115;0;"mylez";115;100;0
0;142;"myli";142;0;100
0;293;"mylia";293;0;100
0;163;"myliah";163;0;100
0;13;"myliana";13;0;100
0;5;"mylicia";5;0;100
0;1577;"mylie";1577;0;100
0;5;"myliegh";5;0;100
0;5;"mylii";5;0;100
113;0;"mylik";113;100;0
0;7;"mylika";7;0;100
44;150;"mylin";194;22.680412371134;77.319587628866
0;20;"mylina";20;0;100
0;808;"mylinda";808;0;100
0;264;"mylinh";264;0;100
0;5;"mylinn";5;0;100
0;101;"mylisa";101;0;100
0;42;"mylisha";42;0;100
0;399;"mylissa";399;0;100
0;130;"myliyah";130;0;100
0;11;"mylla";11;0;100
840;55;"mylo";895;93.854748603352;6.14525139664804
6;0;"myloh";6;100;0
334;0;"mylon";334;100;0
0;44;"mylove";44;0;100
0;5;"mylynda";5;0;100
0;79;"mylynn";79;0;100
64;0;"mylz";64;100;0
0;269;"myna";269;0;100
10;0;"mynard";10;100;0
0;5;"mynasia";5;0;100
0;21;"myndee";21;0;100
0;122;"myndi";122;0;100
0;5;"myneisha";5;0;100
0;34;"mynesha";34;0;100
0;15;"mynette";15;0;100
0;13;"mynia";13;0;100
0;23;"myniah";23;0;100
0;6;"mynika";6;0;100
0;13;"mynisha";13;0;100
603;0;"mynor";603;100;0
33;0;"myon";33;100;0
0;39;"myona";39;0;100
0;50;"myong";50;0;100
0;316;"myonna";316;0;100
0;102;"myosha";102;0;100
0;42;"myoshi";42;0;100
0;12;"myoshia";12;0;100
0;5;"myphuong";5;0;100
76;0;"myquan";76;100;0
0;5;"myquisha";5;0;100
51;56853;"myra";56904;0.0896246309574019;99.9103753690426
0;14;"myraa";14;0;100
0;6;"myrabelle";6;0;100
0;918;"myracle";918;0;100
0;430;"myrah";430;0;100
0;132;"myrakle";132;0;100
0;6;"myraline";6;0;100
77;5;"myran";82;93.9024390243902;6.09756097560976
0;4606;"myranda";4606;0;100
0;5;"myrdell";5;0;100
0;10;"myrdis";10;0;100
0;26;"myree";26;0;100
0;8;"myreen";8;0;100
58;130;"myrel";188;30.8510638297872;69.1489361702128
0;61;"myrella";61;0;100
14;0;"myren";14;100;0
0;188;"myrene";188;0;100
105;0;"myreon";105;100;0
0;17;"myresha";17;0;100
0;5;"myreta";5;0;100
0;16;"myretta";16;0;100
0;6;"myreya";6;0;100
0;527;"myria";527;0;100
0;1889;"myriah";1889;0;100
0;2840;"myriam";2840;0;100
0;167;"myrian";167;0;100
0;15;"myriana";15;0;100
0;5;"myrianna";5;0;100
0;198;"myrical";198;0;100
239;0;"myrick";239;100;0
0;33;"myricle";33;0;100
0;12;"myrie";12;0;100
0;121;"myrikal";121;0;100
0;5;"myrikle";5;0;100
12;5;"myril";17;70.5882352941177;29.4117647058824
6;0;"myrin";6;100;0
20;0;"myrion";20;100;0
0;15;"myrisa";15;0;100
0;358;"myrissa";358;0;100
0;524;"myrka";524;0;100
1238;1671;"myrl";2909;42.5575799243726;57.4424200756274
0;98;"myrla";98;0;100
0;5;"myrlande";5;0;100
703;2197;"myrle";2900;24.2413793103448;75.7586206896552
0;5;"myrlee";5;0;100
0;11;"myrleen";11;0;100
6;0;"myrlen";6;100;0
0;332;"myrlene";332;0;100
15;15;"myrlin";30;50;50
0;6;"myrline";6;0;100
42;31446;"myrna";31488;0.133384146341463;99.8666158536585
0;5;"myrne";5;0;100
43815;463;"myron";44278;98.9543339807579;1.04566601924206
5;0;"myrone";5;100;0
0;5;"myrra";5;0;100
0;5;"myrt";5;0;100
0;672;"myrta";672;0;100
0;5;"myrtes";5;0;100
0;93;"myrth";93;0;100
0;264;"myrtha";264;0;100
0;4154;"myrtice";4154;0;100
0;2990;"myrtie";2990;0;100
5;5860;"myrtis";5865;0.0852514919011083;99.9147485080989
0;10;"myrtise";10;0;100
388;108961;"myrtle";109349;0.35482720463836;99.6451727953616
0;11;"myrtlee";11;0;100
0;32;"myrtlene";32;0;100
17;0;"myrton";17;100;0
0;6;"myrtus";6;0;100
21;0;"mysean";21;100;0
0;385;"mysha";385;0;100
0;6;"myshae";6;0;100
33;0;"myshaun";33;100;0
115;0;"myshawn";115;100;0
0;13;"myshayla";13;0;100
0;20;"myshell";20;0;100
0;38;"myshia";38;0;100
24;0;"myshon";24;100;0
0;12;"mysia";12;0;100
235;0;"myson";235;100;0
6;0;"myssiah";6;100;0
0;10;"mystee";10;0;100
10;0;"myster";10;100;0
0;224;"mystery";224;0;100
0;706;"mysti";706;0;100
0;340;"mystic";340;0;100
0;41;"mystica";41;0;100
0;29;"mystical";29;0;100
0;243;"mystie";243;0;100
0;7;"mystik";7;0;100
17;5;"mystikal";22;77.2727272727273;22.7272727272727
0;438;"mystique";438;0;100
0;66;"mysty";66;0;100
5;0;"mytchell";5;100;0
57;0;"mythias";57;100;0
0;50;"mythili";50;0;100
0;10;"mythri";10;0;100
0;18;"mytia";18;0;100
0;6;"mytien";6;0;100
0;5;"mytisha";5;0;100
8;0;"mytrell";8;100;0
0;11;"myung";11;0;100
0;5;"myunique";5;0;100
0;99;"myya";99;0;100
0;5;"myyah";5;0;100
32;0;"myzel";32;100;0
34;223;"na";257;13.2295719844358;86.7704280155642
0;38;"naa";38;0;100
0;10;"naadia";10;0;100
22;0;"naadir";22;100;0
0;24;"naadira";24;0;100
0;11;"naadirah";11;0;100
18;0;"naail";18;100;0
0;17;"naailah";17;0;100
0;18;"naairah";18;0;100
0;10;"naajia";10;0;100
0;15;"naaliyah";15;0;100
0;225;"naama";225;0;100
0;48;"naamah";48;0;100
785;0;"naaman";785;100;0
0;5;"naami";5;0;100
0;8;"naana";8;0;100
0;134;"naara";134;0;100
0;150;"naarah";150;0;100
0;17;"naariah";17;0;100
0;153;"naasia";153;0;100
268;0;"naasir";268;100;0
48;0;"naason";48;100;0
0;138;"naava";138;0;100
0;30;"naavah";30;0;100
0;49;"naavya";49;0;100
0;14;"naaya";14;0;100
6;0;"naayel";6;100;0
0;17;"naaz";17;0;100
16;0;"naazir";16;100;0
0;165;"naba";165;0;100
0;7;"nabaa";7;0;100
0;233;"nabeeha";233;0;100
975;0;"nabeel";975;100;0
0;36;"nabeela";36;0;100
0;7;"nabeelah";7;0;100
0;19;"nabella";19;0;100
16;0;"nabhan";16;100;0
5;0;"nabhya";5;100;0
15;0;"nabi";15;100;0
0;15;"nabia";15;0;100
0;493;"nabiha";493;0;100
0;37;"nabihah";37;0;100
1563;49;"nabil";1612;96.9602977667494;3.03970223325062
0;586;"nabila";586;0;100
0;82;"nabilah";82;0;100
0;5;"nabile";5;0;100
383;0;"nabor";383;100;0
0;93;"nabria";93;0;100
0;6;"nacala";6;0;100
15;0;"nacari";15;100;0
32;0;"nace";32;100;0
0;5;"nachaly";5;0;100
0;15;"nache";15;0;100
0;5;"nachel";5;0;100
0;5;"nachele";5;0;100
0;449;"nachelle";449;0;100
520;0;"nachman";520;100;0
78;0;"nachmen";78;100;0
56;0;"nacho";56;100;0
0;11;"nachole";11;0;100
5;0;"nachshon";5;100;0
196;0;"nachum";196;100;0
7;0;"nacier";7;100;0
0;5;"nacirema";5;0;100
0;17;"nacola";17;0;100
0;1018;"nacole";1018;0;100
27;0;"nacoma";27;100;0
0;34;"nacona";34;0;100
0;35;"nacy";35;0;100
0;4752;"nada";4752;0;100
0;10;"nadaja";10;0;100
16;0;"nadal";16;100;0
0;126;"nadalee";126;0;100
0;5;"nadaleigh";5;0;100
0;5;"nadalia";5;0;100
0;232;"nadalie";232;0;100
0;17;"nadaly";17;0;100
0;97;"nadalyn";97;0;100
0;35;"nadalynn";35;0;100
5;0;"nadar";5;100;0
0;5;"nadara";5;0;100
31;0;"nadarius";31;100;0
0;5;"nadasha";5;0;100
0;11;"nadasia";11;0;100
582;0;"nadav";582;100;0
0;16;"nadaya";16;0;100
0;64;"nadea";64;0;100
0;1365;"nadean";1365;0;100
0;42;"nadeane";42;0;100
621;0;"nadeem";621;100;0
0;1333;"nadeen";1333;0;100
0;5;"nadeene";5;0;100
0;316;"nadege";316;0;100
0;19;"nadeige";19;0;100
0;35;"nadeja";35;0;100
0;10;"nadelie";10;0;100
0;21;"nadeline";21;0;100
0;5;"nadell";5;0;100
0;70;"nadelyn";70;0;100
0;6;"nadelynn";6;0;100
22;0;"naden";22;100;0
0;1890;"nadene";1890;0;100
1455;0;"nader";1455;100;0
0;20;"nadera";20;0;100
0;10;"naderge";10;0;100
0;24;"nadeya";24;0;100
0;222;"nadezhda";222;0;100
62;40373;"nadia";40435;0.153332508965006;99.846667491035
0;458;"nadiah";458;0;100
0;63;"nadie";63;0;100
0;34;"nadija";34;0;100
0;10;"nadilee";10;0;100
0;8;"nadilyn";8;0;100
0;7;"nadilynn";7;0;100
347;0;"nadim";347;100;0
0;36;"nadin";36;0;100
0;448;"nadina";448;0;100
43;51872;"nadine";51915;0.0828276991235674;99.9171723008764
1055;0;"nadir";1055;100;0
0;896;"nadira";896;0;100
0;817;"nadirah";817;0;100
5;0;"nadiv";5;100;0
0;1202;"nadiya";1202;0;100
0;943;"nadiyah";943;0;100
0;1098;"nadja";1098;0;100
0;22;"nadjah";22;0;100
0;8;"nadolyn";8;0;100
0;290;"nadra";290;0;100
0;5;"nadrea";5;0;100
0;2302;"nadya";2302;0;100
0;60;"nadyah";60;0;100
0;17;"nadyalee";17;0;100
0;26;"nadyia";26;0;100
0;628;"nadyne";628;0;100
0;6;"naedelyn";6;0;100
1574;0;"naeem";1574;100;0
0;237;"naeema";237;0;100
0;582;"naeemah";582;0;100
0;5;"naeisha";5;0;100
382;19;"nael";401;95.2618453865337;4.73815461346633
0;81;"naela";81;0;100
0;6;"naelah";6;0;100
0;67;"naelani";67;0;100
0;23;"naeli";23;0;100
0;56;"naelle";56;0;100
17;0;"naelson";17;100;0
0;23;"naely";23;0;100
0;6;"naelynn";6;0;100
0;57;"naema";57;0;100
0;31;"naeomi";31;0;100
6;0;"naequan";6;100;0
0;87;"naesha";87;0;100
6;0;"naeshaun";6;100;0
19;0;"naeshawn";19;100;0
87;0;"naethan";87;100;0
34;0;"naetochukwu";34;100;0
0;12;"naeva";12;0;100
0;177;"naevia";177;0;100
0;5;"naeyli";5;0;100
0;6;"nafas";6;0;100
5;0;"nafee";5;100;0
42;0;"nafees";42;100;0
0;198;"nafeesa";198;0;100
0;201;"nafeesah";201;0;100
0;13;"nafeesha";13;0;100
43;0;"nafi";43;100;0
0;24;"nafia";24;0;100
515;0;"nafis";515;100;0
0;429;"nafisa";429;0;100
0;121;"nafisah";121;0;100
0;5;"nafiso";5;0;100
0;5;"nafissa";5;0;100
10;0;"nafiz";10;100;0
1411;0;"naftali";1411;100;0
350;0;"naftoli";350;100;0
93;0;"naftula";93;100;0
407;0;"naftuli";407;100;0
22;0;"naftuly";22;100;0
74;0;"nagee";74;100;0
0;5;"nagela";5;0;100
0;8;"nagelly";8;0;100
0;20;"nagely";20;0;100
0;6;"nagham";6;0;100
90;0;"nagi";90;100;0
0;13;"nagisa";13;0;100
13;0;"naguan";13;100;0
0;10;"nagwa";10;0;100
0;73;"nahal";73;0;100
0;78;"nahara";78;0;100
0;5;"nahari";5;0;100
0;8;"nahaven";8;0;100
0;10;"nahayla";10;0;100
0;82;"nahdia";82;0;100
0;11;"naheed";11;0;100
341;0;"naheem";341;100;0
100;0;"naheim";100;100;0
10;0;"nahel";10;100;0
0;5;"nahely";5;0;100
0;8;"nahema";8;0;100
0;98;"nahia";98;0;100
0;63;"nahiara";63;0;100
12;13;"nahid";25;48;52
0;12;"nahida";12;0;100
0;5;"nahide";5;0;100
81;0;"nahiem";81;100;0
0;10;"nahila";10;0;100
49;0;"nahim";49;100;0
0;109;"nahima";109;0;100
12;0;"nahin";12;100;0
0;6;"nahiomy";6;0;100
38;0;"nahir";38;100;0
0;58;"nahja";58;0;100
0;66;"nahjae";66;0;100
0;10;"nahjai";10;0;100
0;5;"nahjay";5;0;100
0;5;"nahje";5;0;100
38;0;"nahjee";38;100;0
13;0;"nahki";13;100;0
0;2115;"nahla";2115;0;100
0;20;"nahlah";20;0;100
0;24;"nahlani";24;0;100
0;150;"nahlia";150;0;100
0;13;"nahliyah";13;0;100
24;0;"nahmir";24;100;0
6;0;"nahoa";6;100;0
692;0;"nahom";692;100;0
66;0;"nahome";66;100;0
0;1104;"nahomi";1104;0;100
0;15;"nahomie";15;0;100
0;905;"nahomy";905;0;100
0;5;"nahrain";5;0;100
0;46;"nahriah";46;0;100
632;0;"nahshon";632;100;0
93;0;"nahsir";93;100;0
0;9;"nahtanha";9;0;100
167;0;"nahuel";167;100;0
1655;0;"nahum";1655;100;0
91;0;"nahun";91;100;0
0;15;"nahya";15;0;100
19;0;"nahyan";19;100;0
0;18;"nahyeli";18;0;100
0;11;"nahyla";11;0;100
0;5;"nahyma";5;0;100
13;0;"nahzier";13;100;0
107;0;"nahzir";107;100;0
71;218;"nai";289;24.5674740484429;75.4325259515571
0;1206;"naia";1206;0;100
0;91;"naiah";91;0;100
0;5;"naiana";5;0;100
0;260;"naiara";260;0;100
0;22;"naibe";22;0;100
0;1680;"naida";1680;0;100
0;6;"naidaly";6;0;100
0;221;"naidelin";221;0;100
0;10;"naideline";10;0;100
0;53;"naidely";53;0;100
0;541;"naidelyn";541;0;100
38;0;"naiden";38;100;0
16;0;"naieem";16;100;0
0;5;"naiely";5;0;100
37;0;"naiem";37;100;0
0;44;"naiema";44;0;100
0;39;"naiesha";39;0;100
95;0;"naif";95;100;0
0;17;"naihla";17;0;100
0;5;"naihomy";5;0;100
30;0;"naiim";30;100;0
0;7;"naiima";7;0;100
0;248;"naija";248;0;100
0;185;"naijah";185;0;100
0;87;"naika";87;0;100
0;6;"naikia";6;0;100
39;0;"nail";39;100;0
0;1834;"naila";1834;0;100
0;3282;"nailah";3282;0;100
0;94;"nailani";94;0;100
0;870;"nailea";870;0;100
0;72;"naileah";72;0;100
0;5;"nailee";5;0;100
0;6;"naileen";6;0;100
0;8;"naileth";8;0;100
0;13;"naily";13;0;100
0;67;"nailyn";67;0;100
1917;0;"naim";1917;100;0
0;3722;"naima";3722;0;100
0;1434;"naimah";1434;0;100
0;5;"naimo";5;0;100
209;0;"nain";209;100;0
0;483;"naina";483;0;100
0;96;"nainika";96;0;100
487;0;"nainoa";487;100;0
0;10;"naioma";10;0;100
0;5;"naiome";5;0;100
0;669;"naiomi";669;0;100
0;74;"naiomy";74;0;100
0;22;"naiovy";22;0;100
0;371;"naira";371;0;100
0;30;"nairah";30;0;100
0;198;"nairi";198;0;100
30;328;"nairobi";358;8.37988826815642;91.6201117318436
0;37;"nairoby";37;0;100
0;5;"nairy";5;0;100
0;11;"naisa";11;0;100
6;0;"naisaiah";6;100;0
5;0;"naisean";5;100;0
0;1273;"naisha";1273;0;100
5;0;"naishaun";5;100;0
11;0;"naishawn";11;100;0
0;5;"naissa";5;0;100
223;0;"naithan";223;100;0
70;0;"naithen";70;100;0
5;0;"naithyn";5;100;0
52;0;"naitik";52;100;0
0;1290;"naiya";1290;0;100
0;259;"naiyah";259;0;100
0;84;"naiyana";84;0;100
0;5;"naiyanna";5;0;100
0;21;"naiyeli";21;0;100
0;13;"naiyla";13;0;100
0;10;"naiylah";10;0;100
5;0;"naiym";5;100;0
0;10;"naiyma";10;0;100
0;7;"naizeth";7;0;100
6;1236;"naja";1242;0.483091787439614;99.5169082125604
0;10;"najaah";10;0;100
0;11;"najada";11;0;100
82;539;"najae";621;13.2045088566828;86.7954911433172
34;1702;"najah";1736;1.95852534562212;98.0414746543779
7;0;"najahwan";7;100;0
40;157;"najai";197;20.3045685279188;79.6954314720812
6;0;"najair";6;100;0
0;5;"najala";5;0;100
5;0;"najam";5;100;0
0;113;"najat";113;0;100
26;26;"najay";52;50;50
0;21;"najaya";21;0;100
0;21;"najayah";21;0;100
32;111;"naje";143;22.3776223776224;77.6223776223776
0;19;"najea";19;0;100
2482;417;"najee";2899;85.6157295619179;14.3842704380821
223;0;"najeeb";223;100;0
0;15;"najeebah";15;0;100
91;0;"najeh";91;100;0
0;11;"najeli";11;0;100
0;5;"najelly";5;0;100
0;52;"najely";52;0;100
0;5;"najera";5;0;100
0;33;"najha";33;0;100
605;0;"naji";605;100;0
0;263;"najia";263;0;100
0;41;"najiah";41;0;100
300;0;"najib";300;100;0
11;0;"najier";11;100;0
5;0;"najih";5;100;0
0;5;"najila";5;0;100
0;5;"najilah";5;0;100
96;0;"najir";96;100;0
0;5;"najirah";5;0;100
0;76;"najiyah";76;0;100
0;23;"najiyyah";23;0;100
44;41;"najja";85;51.7647058823529;48.2352941176471
5;0;"najji";5;100;0
0;559;"najla";559;0;100
33;0;"najm";33;100;0
0;638;"najma";638;0;100
0;63;"najmah";63;0;100
0;75;"najmo";75;0;100
10;0;"najon";10;100;0
5;0;"najuan";5;100;0
0;12;"najuma";12;0;100
0;487;"najwa";487;0;100
0;16;"najya";16;0;100
568;142;"nakai";710;80;20
0;38;"nakaia";38;0;100
0;6;"nakaiah";6;0;100
0;73;"nakaila";73;0;100
0;150;"nakaiya";150;0;100
0;28;"nakaiyah";28;0;100
0;36;"nakala";36;0;100
0;18;"nakara";18;0;100
55;77;"nakari";132;41.6666666666667;58.3333333333333
0;12;"nakaria";12;0;100
0;43;"nakasha";43;0;100
0;7;"nakasia";7;0;100
0;254;"nakaya";254;0;100
0;27;"nakayah";27;0;100
0;5;"nakayia";5;0;100
0;1697;"nakayla";1697;0;100
0;55;"nakaylah";55;0;100
0;6;"nakaylee";6;0;100
0;228;"nakea";228;0;100
0;20;"nakeba";20;0;100
0;23;"nakecia";23;0;100
0;48;"nakeda";48;0;100
0;33;"nakedra";33;0;100
0;5;"nakee";5;0;100
0;10;"nakeea";10;0;100
160;0;"nakeem";160;100;0
0;49;"nakeema";49;0;100
0;5;"nakeena";5;0;100
0;193;"nakeesha";193;0;100
0;99;"nakeeta";99;0;100
0;393;"nakeia";393;0;100
0;27;"nakeira";27;0;100
0;1403;"nakeisha";1403;0;100
0;73;"nakeita";73;0;100
0;82;"nakeitha";82;0;100
0;5;"nakel";5;0;100
0;7;"nakela";7;0;100
0;75;"nakema";75;0;100
0;52;"nakendra";52;0;100
0;67;"nakenya";67;0;100
0;14;"nakenzie";14;0;100
0;30;"nakera";30;0;100
0;52;"nakeria";52;0;100
0;1050;"nakesha";1050;0;100
0;450;"nakeshia";450;0;100
0;30;"nakesia";30;0;100
0;259;"naketa";259;0;100
0;5;"naketta";5;0;100
0;5;"nakevia";5;0;100
0;805;"nakeya";805;0;100
0;22;"nakeyah";22;0;100
0;76;"nakeyia";76;0;100
0;118;"nakeysha";118;0;100
0;5;"nakeyta";5;0;100
6;0;"nakhai";6;100;0
123;0;"nakhi";123;100;0
0;246;"nakhia";246;0;100
0;37;"nakhiya";37;0;100
0;18;"nakhya";18;0;100
50;5;"naki";55;90.9090909090909;9.09090909090909
1991;8576;"nakia";10567;18.8416769187092;81.1583230812908
0;566;"nakiah";566;0;100
0;15;"nakiaya";15;0;100
0;37;"nakida";37;0;100
14;8;"nakie";22;63.6363636363636;36.3636363636364
0;66;"nakiea";66;0;100
0;15;"nakiera";15;0;100
0;260;"nakiesha";260;0;100
0;17;"nakieta";17;0;100
0;5;"nakieya";5;0;100
0;6;"nakijah";6;0;100
0;21;"nakila";21;0;100
0;173;"nakima";173;0;100
0;57;"nakina";57;0;100
5;0;"nakio";5;100;0
0;403;"nakira";403;0;100
0;27;"nakirah";27;0;100
0;5;"nakiria";5;0;100
0;26;"nakisa";26;0;100
0;5;"nakish";5;0;100
0;2459;"nakisha";2459;0;100
0;38;"nakishia";38;0;100
28;2930;"nakita";2958;0.94658553076403;99.053414469236
0;6;"nakitia";6;0;100
0;25;"nakitta";25;0;100
5;1656;"nakiya";1661;0.301023479831427;99.6989765201686
0;1067;"nakiyah";1067;0;100
0;5;"nakiyha";5;0;100
0;5;"nakiyla";5;0;100
0;118;"nakkia";118;0;100
360;5;"nakoa";365;98.6301369863014;1.36986301369863
23;0;"nakoda";23;100;0
36;50;"nakoma";86;41.8604651162791;58.1395348837209
0;15;"nakosha";15;0;100
171;117;"nakota";288;59.375;40.625
170;0;"naksh";170;100;0
0;70;"nakshatra";70;0;100
176;0;"nakul";176;100;0
15;0;"nakuma";15;100;0
0;582;"nakya";582;0;100
0;277;"nakyah";277;0;100
34;0;"nakye";34;100;0
0;220;"nakyia";220;0;100
0;63;"nakyiah";63;0;100
0;385;"nakyla";385;0;100
0;38;"nakylah";38;0;100
0;264;"nakyra";264;0;100
0;12;"nakyrah";12;0;100
0;11;"nakysha";11;0;100
0;2810;"nala";2810;0;100
0;506;"nalah";506;0;100
0;14;"nalaiyah";14;0;100
31;0;"nalan";31;100;0
0;17;"nalana";17;0;100
0;5;"nalanee";5;0;100
0;3367;"nalani";3367;0;100
0;189;"nalanie";189;0;100
0;56;"nalany";56;0;100
0;290;"nalaya";290;0;100
0;280;"nalayah";280;0;100
0;5;"nalayiah";5;0;100
0;17;"nalayna";17;0;100
0;65;"nalaysia";65;0;100
0;89;"nalda";89;0;100
0;53;"nalea";53;0;100
0;289;"naleah";289;0;100
0;12;"naledi";12;0;100
0;76;"nalee";76;0;100
0;5;"naleea";5;0;100
0;6;"nalei";6;0;100
0;20;"naleia";20;0;100
0;52;"naleigh";52;0;100
0;49;"naleigha";49;0;100
5;0;"nalej";5;100;0
26;0;"nalen";26;100;0
0;5;"nalene";5;0;100
0;58;"naleyah";58;0;100
0;41;"nali";41;0;100
0;473;"nalia";473;0;100
0;201;"naliah";201;0;100
0;5;"naliana";5;0;100
0;24;"nalijah";24;0;100
174;28;"nalin";202;86.1386138613861;13.8613861386139
0;88;"nalina";88;0;100
0;286;"nalini";286;0;100
0;10;"nalisa";10;0;100
0;25;"nalisha";25;0;100
0;15;"nalissa";15;0;100
0;128;"naliya";128;0;100
0;792;"naliyah";792;0;100
0;81;"nalla";81;0;100
0;33;"nallah";33;0;100
0;553;"nalleli";553;0;100
0;2795;"nallely";2795;0;100
0;31;"nalley";31;0;100
0;5;"nally";5;0;100
0;12;"nalo";12;0;100
0;41;"naloni";41;0;100
77;0;"nalu";77;100;0
0;63;"naly";63;0;100
0;10;"nalya";10;0;100
0;12;"nalyah";12;0;100
0;5;"nalyjah";5;0;100
0;5;"nalyn";5;0;100
0;5;"nalynn";5;0;100
0;15;"nalyssa";15;0;100
1287;0;"nam";1287;100;0
404;0;"naman";404;100;0
64;26;"namari";90;71.1111111111111;28.8888888888889
14;0;"namarion";14;100;0
5;0;"namath";5;100;0
0;5;"namaya";5;0;100
23;11;"name";34;67.6470588235294;32.3529411764706
69;0;"nameer";69;100;0
0;25;"nameera";25;0;100
0;332;"nami";332;0;100
0;30;"namia";30;0;100
0;124;"namiah";124;0;100
0;11;"namie";11;0;100
0;43;"namiko";43;0;100
0;85;"namine";85;0;100
456;0;"namir";456;100;0
0;71;"namira";71;0;100
0;36;"namirah";36;0;100
77;0;"namish";77;100;0
8;0;"namit";8;100;0
0;135;"namita";135;0;100
0;19;"namitha";19;0;100
0;43;"namiya";43;0;100
0;123;"namiyah";123;0;100
1092;0;"namon";1092;100;0
0;164;"namrata";164;0;100
0;222;"namya";222;0;100
0;6;"namyah";6;0;100
0;6;"namyia";6;0;100
0;9541;"nan";9541;0;100
705;2226;"nana";2931;24.0532241555783;75.9467758444217
0;5;"nanaadwoa";5;0;100
0;12;"nanaakua";12;0;100
0;16;"nanaama";16;0;100
0;73;"nanako";73;0;100
15;0;"nanakwame";15;100;0
0;5;"nanalee";5;0;100
0;198;"nanami";198;0;100
0;49;"nanayaa";49;0;100
29;0;"nanayaw";29;100;0
10;761;"nance";771;1.2970168612192;98.7029831387808
0;1358;"nancee";1358;0;100
0;627;"nancey";627;0;100
0;6469;"nanci";6469;0;100
0;5;"nanciann";5;0;100
0;5;"nancianne";5;0;100
0;3254;"nancie";3254;0;100
0;11;"nancilee";11;0;100
2939;991533;"nancy";994472;0.295533710350819;99.7044662896492
0;416;"nancyann";416;0;100
0;5;"nancyanne";5;0;100
0;1031;"nancye";1031;0;100
0;5;"nancyjane";5;0;100
0;6;"nancyjean";6;0;100
0;102;"nancyjo";102;0;100
0;387;"nancylee";387;0;100
0;19;"nancylou";19;0;100
28;0;"nand";28;100;0
5;65;"nanda";70;7.14285714285714;92.8571428571429
124;0;"nandan";124;100;0
0;108;"nandana";108;0;100
10;0;"nandhan";10;100;0
0;11;"nandhana";11;0;100
0;26;"nandhini";26;0;100
0;707;"nandi";707;0;100
0;74;"nandika";74;0;100
0;762;"nandini";762;0;100
0;233;"nandita";233;0;100
0;13;"nanditha";13;0;100
0;5;"nandni";5;0;100
11;0;"nando";11;100;0
0;27;"nandy";27;0;100
0;162;"nanea";162;0;100
0;5;"naneka";5;0;100
0;5;"nanelle";5;0;100
0;17;"nanett";17;0;100
0;187;"nanetta";187;0;100
0;16825;"nanette";16825;0;100
27;0;"nang";27;100;0
0;438;"nani";438;0;100
0;581;"nanie";581;0;100
0;5;"nanika";5;0;100
0;46;"nanine";46;0;100
0;10;"nanisha";10;0;100
0;58;"nanita";58;0;100
0;20;"nann";20;0;100
0;197;"nanna";197;0;100
0;5;"nannett";5;0;100
0;30;"nannetta";30;0;100
0;6251;"nannette";6251;0;100
20;18796;"nannie";18816;0.106292517006803;99.8937074829932
0;43;"nanny";43;0;100
0;5;"nanor";5;0;100
0;166;"nansi";166;0;100
0;11;"nansy";11;0;100
6;0;"nantambu";6;100;0
16;0;"nanya";16;100;0
0;53;"nanyamka";53;0;100
10;85;"nao";95;10.5263157894737;89.4736842105263
0;5;"naobi";5;0;100
145;0;"naod";145;100;0
7;0;"naoh";7;100;0
0;5;"naohmi";5;0;100
266;10;"naoki";276;96.3768115942029;3.6231884057971
0;61;"naoko";61;0;100
67;0;"naol";67;100;0
0;44;"naola";44;0;100
0;2403;"naoma";2403;0;100
0;94;"naome";94;0;100
0;65;"naomee";65;0;100
273;150231;"naomi";150504;0.181390527826503;99.8186094721735
0;865;"naomia";865;0;100
0;1691;"naomie";1691;0;100
0;5;"naomigrace";5;0;100
0;61;"naomii";61;0;100
0;1493;"naomy";1493;0;100
12;0;"naor";12;100;0
49;0;"naoto";49;100;0
17;0;"naoya";17;100;0
5;0;"napat";5;100;0
198;68;"naphtali";266;74.4360902255639;25.5639097744361
365;0;"napolean";365;100;0
7169;5;"napoleon";7174;99.9303038751045;0.0696961248954558
0;38;"naporsha";38;0;100
0;6;"napua";6;0;100
5;0;"naqeeb";5;100;0
1288;0;"naquan";1288;100;0
0;19;"naquana";19;0;100
0;11;"naquanda";11;0;100
0;13;"naquasha";13;0;100
0;6;"naquasia";6;0;100
0;6;"naquelle";6;0;100
0;32;"naquesha";32;0;100
7;0;"naquille";7;100;0
0;145;"naquisha";145;0;100
0;263;"naquita";263;0;100
0;5;"naquitta";5;0;100
17;0;"naquon";17;100;0
17;606;"nara";623;2.72873194221509;97.2712680577849
201;7;"narada";208;96.6346153846154;3.36538461538462
0;12;"narae";12;0;100
0;32;"narah";32;0;100
0;15;"narai";15;0;100
27;0;"narain";27;100;0
0;39;"narali";39;0;100
0;10;"naralie";10;0;100
0;268;"naraly";268;0;100
0;5;"narasha";5;0;100
0;74;"naraya";74;0;100
0;35;"narayah";35;0;100
222;0;"narayan";222;100;0
17;5;"narayana";22;77.2727272727273;22.7272727272727
0;15;"narayani";15;0;100
0;26;"narcedalia";26;0;100
0;16;"narcie";16;0;100
0;6;"narcille";6;0;100
0;218;"narcisa";218;0;100
5;0;"narcisco";5;100;0
2012;0;"narciso";2012;100;0
0;5;"narciss";5;0;100
0;180;"narcissa";180;0;100
21;0;"narcisse";21;100;0
0;234;"narcissus";234;0;100
5;0;"narcizo";5;100;0
0;655;"narda";655;0;100
0;23;"nardia";23;0;100
0;181;"nardos";181;0;100
0;65;"nare";65;0;100
0;15;"nareen";15;0;100
146;0;"nareg";146;100;0
0;78;"nareh";78;0;100
406;0;"narek";406;100;0
0;5;"nareli";5;0;100
5;0;"narell";5;100;0
0;23;"narelle";23;0;100
0;118;"narely";118;0;100
195;0;"naren";195;100;0
80;0;"naresh";80;100;0
0;21;"narges";21;0;100
0;68;"nargis";68;0;100
0;239;"nari";239;0;100
0;243;"naria";243;0;100
0;2440;"nariah";2440;0;100
0;14;"nariana";14;0;100
0;13;"narice";13;0;100
0;5;"narielle";5;0;100
0;5;"nariman";5;0;100
32;11;"narin";43;74.4186046511628;25.5813953488372
0;48;"narine";48;0;100
0;15;"narisa";15;0;100
0;742;"narissa";742;0;100
0;17;"narita";17;0;100
11;0;"narith";11;100;0
0;322;"nariya";322;0;100
0;1194;"nariyah";1194;0;100
0;43;"narjes";43;0;100
0;89;"narjis";89;0;100
0;12;"narkita";12;0;100
0;12;"narma";12;0;100
0;97;"narmeen";97;0;100
6;0;"narmon";6;100;0
0;6;"narnia";6;0;100
60;0;"naron";60;100;0
6;0;"narong";6;100;0
5;0;"narquise";5;100;0
0;10;"narriah";10;0;100
0;6;"narrissa";6;0;100
0;5;"narsis";5;0;100
5;0;"narsiso";5;100;0
0;15;"narumi";15;0;100
5;0;"naruto";5;100;0
0;17;"narva";17;0;100
128;0;"narvel";128;100;0
22;26;"narvell";48;45.8333333333333;54.1666666666667
0;5;"narvelle";5;0;100
5;16;"narvie";21;23.8095238095238;76.1904761904762
5;0;"narvin";5;100;0
0;19;"narvis";19;0;100
0;153;"nary";153;0;100
0;67;"narya";67;0;100
0;275;"naryah";275;0;100
23;0;"naryan";23;100;0
0;10;"naryia";10;0;100
0;76;"naryiah";76;0;100
69;0;"nas";69;100;0
11;0;"nasai";11;100;0
12;0;"nasaiah";12;100;0
26;0;"nasair";26;100;0
5;0;"nasar";5;100;0
0;36;"nasaria";36;0;100
501;0;"nasario";501;100;0
0;15;"nasasha";15;0;100
0;10;"nasaya";10;0;100
0;6;"nascha";6;0;100
162;0;"nasean";162;100;0
16;0;"nasear";16;100;0
0;6;"naseeb";6;0;100
987;239;"naseem";1226;80.5057096247961;19.4942903752039
362;0;"naseer";362;100;0
5;0;"naseim";5;100;0
6;0;"naseir";6;100;0
354;0;"naser";354;100;0
10;0;"nasere";10;100;0
9633;37;"nash";9670;99.617373319545;0.382626680455016
0;443;"nasha";443;0;100
0;228;"nashae";228;0;100
0;21;"nashai";21;0;100
0;23;"nashalee";23;0;100
0;5;"nashaley";5;0;100
0;132;"nashali";132;0;100
0;76;"nashalie";76;0;100
0;5;"nashally";5;0;100
0;350;"nashaly";350;0;100
6;0;"nashan";6;100;0
0;21;"nashana";21;0;100
0;35;"nashanda";35;0;100
0;75;"nashanti";75;0;100
0;33;"nashara";33;0;100
0;13;"nashari";13;0;100
284;0;"nashaun";284;100;0
844;53;"nashawn";897;94.0914158305463;5.90858416945373
0;384;"nashay";384;0;100
0;56;"nashaya";56;0;100
0;129;"nashayla";129;0;100
0;108;"nashea";108;0;100
60;0;"nasheed";60;100;0
43;0;"nasheem";43;100;0
0;23;"nasheema";23;0;100
0;19;"nasheena";19;0;100
0;38;"nasheka";38;0;100
0;20;"nashell";20;0;100
0;26;"nashelle";26;0;100
0;10;"nashelly";10;0;100
0;38;"nashely";38;0;100
0;188;"nashia";188;0;100
64;0;"nashid";64;100;0
19;0;"nashiem";19;100;0
0;60;"nashika";60;0;100
0;5;"nashima";5;0;100
11;0;"nashir";11;100;0
0;242;"nashira";242;0;100
0;83;"nashiya";83;0;100
0;24;"nashiyah";24;0;100
0;325;"nashla";325;0;100
0;268;"nashley";268;0;100
0;6;"nashli";6;0;100
0;12;"nashlie";12;0;100
0;5;"nashlly";5;0;100
0;229;"nashly";229;0;100
0;5;"nashmia";5;0;100
37;0;"nashoba";37;100;0
373;0;"nashon";373;100;0
0;76;"nashonda";76;0;100
0;5;"nashrah";5;0;100
102;0;"nashton";102;100;0
67;0;"nashua";67;100;0
0;10;"nashwa";10;0;100
26;0;"nashwan";26;100;0
0;119;"nashya";119;0;100
0;10;"nashyah";10;0;100
0;17;"nashyia";17;0;100
0;5;"nashyla";5;0;100
0;17;"nashyra";17;0;100
6;0;"nasi";6;100;0
0;427;"nasia";427;0;100
125;197;"nasiah";322;38.8198757763975;61.1801242236025
12;0;"nasiar";12;100;0
22;0;"nasiem";22;100;0
320;0;"nasier";320;100;0
5;0;"nasiere";5;100;0
62;0;"nasif";62;100;0
0;17;"nasiha";17;0;100
64;0;"nasiir";64;100;0
383;119;"nasim";502;76.2948207171315;23.7051792828685
10598;37;"nasir";10635;99.6520921485661;0.347907851433945
0;240;"nasira";240;0;100
0;88;"nasirah";88;0;100
75;0;"nasire";75;100;0
0;15;"nasiriyah";15;0;100
0;197;"nasiya";197;0;100
0;243;"nasiyah";243;0;100
0;6;"nasjah";6;0;100
0;6;"nasly";6;0;100
0;14;"nasma";14;0;100
446;0;"nason";446;100;0
36;0;"nasr";36;100;0
0;210;"nasra";210;0;100
8;0;"nasrallah";8;100;0
0;302;"nasreen";302;0;100
57;0;"nasri";57;100;0
0;78;"nasrin";78;0;100
0;44;"nasro";44;0;100
5;0;"nasrudin";5;100;0
10;0;"nassar";10;100;0
6;0;"nassem";6;100;0
1056;0;"nasser";1056;100;0
6;12;"nassiah";18;33.3333333333333;66.6666666666667
195;21;"nassim";216;90.2777777777778;9.72222222222222
595;0;"nassir";595;100;0
5;0;"nassor";5;100;0
0;136;"nastacia";136;0;100
0;7;"nastaja";7;0;100
0;414;"nastasha";414;0;100
0;119;"nastashia";119;0;100
0;464;"nastasia";464;0;100
0;10;"nastasja";10;0;100
0;883;"nastassia";883;0;100
0;485;"nastassja";485;0;100
0;5;"nastazia";5;0;100
0;24;"nasteha";24;0;100
0;92;"nasteho";92;0;100
0;5;"nastia";5;0;100
0;725;"nasya";725;0;100
0;27;"nasyah";27;0;100
31;0;"nasyr";31;100;0
36;0;"naszier";36;100;0
151;0;"naszir";151;100;0
6;0;"naszire";6;100;0
1924;0;"nat";1924;100;0
0;14;"nata";14;0;100
0;1372;"natacha";1372;0;100
0;29;"natachia";29;0;100
0;146;"natacia";146;0;100
0;19;"natae";19;0;100
0;6;"natahja";6;0;100
0;62;"natahlia";62;0;100
0;52;"natahsa";52;0;100
0;24;"nataija";24;0;100
0;5;"nataile";5;0;100
0;5;"natailia";5;0;100
0;54;"nataisha";54;0;100
0;31;"nataiya";31;0;100
0;55;"nataja";55;0;100
0;89;"natajah";89;0;100
0;29;"natajha";29;0;100
0;27;"natajia";27;0;100
0;6;"nataka";6;0;100
0;140;"nataki";140;0;100
0;7;"natala";7;0;100
1150;371;"natale";1521;75.6081525312295;24.3918474687705
0;243;"natalea";243;0;100
0;69;"nataleah";69;0;100
0;9073;"natalee";9073;0;100
0;12;"natalei";12;0;100
0;1187;"nataleigh";1187;0;100
0;5;"natalene";5;0;100
0;551;"nataley";551;0;100
0;4340;"natali";4340;0;100
47;60484;"natalia";60531;0.0776461647750739;99.9223538352249
0;290;"nataliah";290;0;100
749;341261;"natalie";342010;0.218999444460688;99.7810005555393
0;11;"natalieann";11;0;100
0;88;"nataliee";88;0;100
0;5;"nataliegh";5;0;100
0;6;"nataliemarie";6;0;100
0;6;"natalierose";6;0;100
0;10;"natalii";10;0;100
0;179;"natalija";179;0;100
0;64;"natalin";64;0;100
0;452;"natalina";452;0;100
0;114;"nataline";114;0;100
5;0;"natalino";5;100;0
174;0;"natalio";174;100;0
0;5;"natalis";5;0;100
0;12;"natalise";12;0;100
0;531;"nataliya";531;0;100
0;114;"nataliyah";114;0;100
0;17;"nataliz";17;0;100
0;21;"natalle";21;0;100
0;143;"natallia";143;0;100
0;510;"natallie";510;0;100
0;403;"natally";403;0;100
10;12884;"nataly";12894;0.077555452148286;99.9224445478517
0;6009;"natalya";6009;0;100
0;188;"natalyah";188;0;100
0;332;"natalye";332;0;100
0;129;"natalyia";129;0;100
0;544;"natalyn";544;0;100
0;310;"natalynn";310;0;100
1086;0;"natan";1086;100;0
1500;0;"natanael";1500;100;0
0;94;"natane";94;0;100
191;0;"natanel";191;100;0
0;10;"natani";10;0;100
0;574;"natania";574;0;100
0;5;"nataniah";5;0;100
528;0;"nataniel";528;100;0
0;5;"nataniela";5;0;100
19;0;"natanim";19;100;0
0;601;"natanya";601;0;100
0;154;"natara";154;0;100
0;7;"nataria";7;0;100
0;501;"natarsha";501;0;100
0;5;"natarshia";5;0;100
26;0;"natas";26;100;0
0;79;"natasa";79;0;100
0;907;"natascha";907;0;100
0;125;"natash";125;0;100
285;94963;"natasha";95248;0.299218881236351;99.7007811187636
0;13;"natashi";13;0;100
0;2631;"natashia";2631;0;100
0;11;"natashua";11;0;100
0;6;"natashya";6;0;100
0;917;"natasia";917;0;100
0;77;"natasja";77;0;100
0;5;"nataska";5;0;100
0;20;"natassha";20;0;100
0;694;"natassia";694;0;100
0;271;"natassja";271;0;100
0;290;"natausha";290;0;100
0;565;"natavia";565;0;100
22;0;"natavion";22;100;0
20;0;"natavious";20;100;0
32;0;"natavius";32;100;0
0;11;"natay";11;0;100
0;655;"nataya";655;0;100
0;66;"natayah";66;0;100
0;5;"natayja";5;0;100
0;69;"natayla";69;0;100
0;7;"nataylia";7;0;100
0;43;"nataysha";43;0;100
0;5;"natayshia";5;0;100
0;28;"nataysia";28;0;100
0;25;"natazia";25;0;100
3619;303;"nate";3922;92.2743498215196;7.72565017848037
0;26;"natea";26;0;100
0;5;"nateal";5;0;100
0;10;"nateasha";10;0;100
0;15;"nateesha";15;0;100
0;69;"nateisha";69;0;100
0;6;"nateka";6;0;100
0;6;"natelee";6;0;100
0;5;"natelege";5;0;100
0;138;"natelie";138;0;100
0;5;"natella";5;0;100
0;5;"natelle";5;0;100
0;12;"natellie";12;0;100
0;7;"nately";7;0;100
0;12;"nateria";12;0;100
0;5;"naterra";5;0;100
0;11;"naterria";11;0;100
0;7;"natesa";7;0;100
0;363;"natesha";363;0;100
0;34;"nateshia";34;0;100
0;27;"natessa";27;0;100
0;6;"nateya";6;0;100
0;5;"nateyah";5;0;100
36;0;"nath";36;100;0
27;250;"natha";277;9.74729241877256;90.2527075812274
5;0;"nathael";5;100;0
49;0;"nathaiel";49;100;0
5;0;"nathain";5;100;0
48;0;"nathainel";48;100;0
0;10;"nathale";10;0;100
0;405;"nathalee";405;0;100
0;16;"nathalene";16;0;100
0;563;"nathali";563;0;100
0;5198;"nathalia";5198;0;100
6;18188;"nathalie";18194;0.0329779048037815;99.9670220951962
0;52;"nathally";52;0;100
0;6211;"nathaly";6211;0;100
0;202;"nathalya";202;0;100
0;47;"nathalye";47;0;100
13;0;"natham";13;100;0
532803;1730;"nathan";534533;99.6763530034628;0.323646996537164
18906;12;"nathanael";18918;99.9365683476055;0.0634316523945449
0;5;"nathanaelle";5;0;100
209;0;"nathanal";209;100;0
25;0;"nathane";25;100;0
872;0;"nathaneal";872;100;0
429;0;"nathaneil";429;100;0
842;0;"nathanel";842;100;0
0;485;"nathania";485;0;100
10264;0;"nathanial";10264;100;0
64;0;"nathanie";64;100;0
259542;1148;"nathaniel";260690;99.5596302121293;0.440369787870651
12;0;"nathanieljames";12;100;0
5;0;"nathaniell";5;100;0
5;0;"nathanielle";5;100;0
5;0;"nathanil";5;100;0
17;0;"nathanim";17;100;0
13;0;"nathanjames";13;100;0
6;0;"nathann";6;100;0
36;0;"nathanual";36;100;0
200;0;"nathanuel";200;100;0
134;0;"nathanyal";134;100;0
240;0;"nathanyel";240;100;0
103;0;"nathanyl";103;100;0
0;11;"nathasa";11;0;100
0;324;"nathasha";324;0;100
0;10;"nathasia";10;0;100
0;5;"nathaya";5;0;100
12;0;"nathean";12;100;0
5;5;"nathel";10;50;50
5849;0;"nathen";5849;100;0
0;16;"nathena";16;0;100
42;0;"nathenial";42;100;0
10;0;"natheniel";10;100;0
10;0;"nathern";10;100;0
0;6;"nathia";6;0;100
94;0;"nathian";94;100;0
23;0;"nathias";23;100;0
16;0;"nathiel";16;100;0
0;61;"nathifa";61;0;100
231;0;"nathin";231;100;0
0;12;"nathina";12;0;100
5;0;"nathinal";5;100;0
45;0;"nathinel";45;100;0
11;0;"nathion";11;100;0
55;0;"nathnael";55;100;0
11;0;"nathniel";11;100;0
1405;0;"nathon";1405;100;0
369;0;"nathyn";369;100;0
0;710;"natia";710;0;100
0;11;"natiana";11;0;100
0;39;"natica";39;0;100
0;5;"naticha";5;0;100
0;32;"naticia";32;0;100
0;10;"natifah";10;0;100
0;293;"natika";293;0;100
0;39;"natile";39;0;100
0;6;"natilea";6;0;100
0;472;"natilee";472;0;100
0;5;"natileigh";5;0;100
0;27;"natiley";27;0;100
0;282;"natilie";282;0;100
0;58;"natily";58;0;100
0;33;"natilyn";33;0;100
0;30;"natilynn";30;0;100
0;179;"natina";179;0;100
180;15;"nation";195;92.3076923076923;7.69230769230769
0;31;"natira";31;0;100
0;6;"natisa";6;0;100
0;1861;"natisha";1861;0;100
0;48;"natishia";48;0;100
1722;1902;"natividad";3624;47.5165562913907;52.4834437086093
0;141;"natiya";141;0;100
0;37;"natiyah";37;0;100
0;13;"natlaie";13;0;100
0;7;"natlee";7;0;100
0;362;"natlie";362;0;100
257;0;"natnael";257;100;0
0;10;"natoma";10;0;100
0;28;"natonia";28;0;100
0;203;"natonya";203;0;100
6;359;"natori";365;1.64383561643836;98.3561643835616
0;196;"natoria";196;0;100
5;0;"natorian";5;100;0
0;3105;"natosha";3105;0;100
0;454;"natoshia";454;0;100
0;607;"natoya";607;0;100
0;22;"natoyia";22;0;100
34;0;"natrell";34;100;0
0;23;"natrice";23;0;100
0;15;"natricia";15;0;100
0;11;"natrina";11;0;100
47;0;"natron";47;100;0
35;0;"natrone";35;100;0
0;115;"natsha";115;0;100
7;0;"natsu";7;100;0
0;29;"natsue";29;0;100
0;28;"natsuki";28;0;100
0;155;"natsuko";155;0;100
0;218;"natsumi";218;0;100
0;5;"natsuyo";5;0;100
0;11;"nattalee";11;0;100
0;214;"nattalie";214;0;100
0;109;"nattaly";109;0;100
29;0;"natthan";29;100;0
49;0;"natthew";49;100;0
0;111;"nattie";111;0;100
10;0;"nattiel";10;100;0
0;5;"natural";5;0;100
64;244;"nature";308;20.7792207792208;79.2207792207792
0;5;"naturell";5;0;100
0;46;"naturelle";46;0;100
0;85;"naturi";85;0;100
0;30;"natusha";30;0;100
0;45;"natya";45;0;100
0;23;"natyia";23;0;100
0;32;"natylee";32;0;100
0;17;"natylie";17;0;100
0;15;"natyra";15;0;100
5;0;"nau";5;100;0
0;1291;"naudia";1291;0;100
0;17;"naudica";17;0;100
0;10;"naudiya";10;0;100
0;12;"naudya";12;0;100
5;0;"naul";5;100;0
11;0;"naum";11;100;0
22;0;"nauman";22;100;0
26;0;"naun";26;100;0
0;5;"naura";5;0;100
0;193;"naureen";193;0;100
0;17;"nausheen";17;0;100
0;81;"nautia";81;0;100
50;2098;"nautica";2148;2.32774674115456;97.6722532588454
0;219;"nautika";219;0;100
0;5;"nautyca";5;0;100
0;871;"nava";871;0;100
6;105;"navada";111;5.40540540540541;94.5945945945946
0;53;"navae";53;0;100
0;1132;"navaeh";1132;0;100
0;5;"navaeha";5;0;100
0;129;"navah";129;0;100
0;13;"navaiah";13;0;100
5;0;"navan";5;100;0
36;0;"navar";36;100;0
5;0;"navario";5;100;0
5;0;"navarion";5;100;0
5;0;"navarius";5;100;0
83;0;"navarre";83;100;0
175;0;"navarro";175;100;0
0;5;"navay";5;0;100
0;250;"navaya";250;0;100
0;194;"navayah";194;0;100
140;125;"navdeep";265;52.8301886792453;47.1698113207547
0;5;"navdia";5;0;100
0;6;"nave";6;0;100
0;113;"navea";113;0;100
0;891;"naveah";891;0;100
0;22;"navee";22;0;100
592;0;"naveed";592;100;0
973;283;"naveen";1256;77.468152866242;22.531847133758
0;93;"naveena";93;0;100
0;56;"naveh";56;0;100
17;0;"navell";17;100;0
92;0;"naven";92;100;0
0;5;"navera";5;0;100
0;26;"navey";26;0;100
0;147;"naveya";147;0;100
0;183;"naveyah";183;0;100
82;387;"navi";469;17.4840085287846;82.5159914712154
0;381;"navia";381;0;100
0;193;"naviah";193;0;100
16;0;"navian";16;100;0
0;13;"naviana";13;0;100
689;26;"navid";715;96.3636363636364;3.63636363636364
0;6;"navidad";6;0;100
0;115;"navie";115;0;100
36;0;"navier";36;100;0
0;52;"navika";52;0;100
5;117;"navil";122;4.0983606557377;95.9016393442623
733;0;"navin";733;100;0
0;70;"navina";70;0;100
6;0;"navindra";6;100;0
39;0;"navion";39;100;0
0;10;"navira";10;0;100
0;11;"navisha";11;0;100
0;39;"naviya";39;0;100
0;74;"naviyah";74;0;100
98;108;"navjot";206;47.5728155339806;52.4271844660194
0;37;"navleen";37;0;100
28;249;"navneet";277;10.1083032490975;89.8916967509025
207;0;"navon";207;100;0
10;0;"navonte";10;100;0
15;0;"navor";15;100;0
0;75;"navpreet";75;0;100
110;0;"navraj";110;100;0
0;54;"navreet";54;0;100
0;10;"navroop";10;0;100
12;0;"navtej";12;100;0
152;720;"navy";872;17.4311926605505;82.5688073394495
0;1222;"navya";1222;0;100
0;75;"naw";75;0;100
0;67;"nawaal";67;0;100
185;0;"nawaf";185;100;0
0;972;"nawal";972;0;100
0;12;"nawana";12;0;100
0;5;"nawar";5;0;100
0;5;"nawatha";5;0;100
5;0;"nawaz";5;100;0
20;0;"naweed";20;100;0
5;0;"nawfal";5;100;0
50;11;"nay";61;81.9672131147541;18.0327868852459
0;3586;"naya";3586;0;100
0;65;"nayab";65;0;100
0;395;"nayah";395;0;100
0;5;"nayala";5;0;100
0;31;"nayalee";31;0;100
0;94;"nayali";94;0;100
0;5;"nayalis";5;0;100
0;17;"nayaliz";17;0;100
0;6;"nayaly";6;0;100
0;5;"nayami";5;0;100
363;5;"nayan";368;98.6413043478261;1.35869565217391
0;490;"nayana";490;0;100
0;5;"nayanah";5;0;100
0;26;"nayani";26;0;100
0;102;"nayanna";102;0;100
0;214;"nayara";214;0;100
0;33;"nayari";33;0;100
0;14;"nayarit";14;0;100
0;250;"nayda";250;0;100
0;42;"naydean";42;0;100
0;78;"naydeen";78;0;100
0;31;"naydeli";31;0;100
0;761;"naydelin";761;0;100
0;80;"naydeline";80;0;100
0;59;"naydelyn";59;0;100
113;0;"nayden";113;100;0
0;66;"naydene";66;0;100
0;12;"naydia";12;0;100
0;55;"naydine";55;0;100
7;0;"nayeem";7;100;0
51;0;"nayef";51;100;0
79;0;"nayel";79;100;0
0;48;"nayela";48;0;100
0;13;"nayele";13;0;100
0;54;"nayelee";54;0;100
14;16968;"nayeli";16982;0.0824402308326463;99.9175597691674
0;452;"nayelie";452;0;100
0;8;"nayelii";8;0;100
0;6;"nayelin";6;0;100
0;389;"nayelis";389;0;100
0;126;"nayeliz";126;0;100
0;11;"nayelle";11;0;100
0;1141;"nayelli";1141;0;100
0;93;"nayellie";93;0;100
0;482;"nayelly";482;0;100
0;2449;"nayely";2449;0;100
0;5;"nayelys";5;0;100
0;5;"nayeri";5;0;100
0;12;"nayha";12;0;100
0;31;"nayia";31;0;100
101;0;"nayib";101;100;0
0;21;"nayima";21;0;100
0;19;"nayirah";19;0;100
0;12;"nayiri";12;0;100
0;6;"nayisha";6;0;100
0;1971;"nayla";1971;0;100
0;14;"naylaa";14;0;100
0;350;"naylah";350;0;100
5;0;"naylan";5;100;0
0;255;"naylani";255;0;100
0;24;"naylanie";24;0;100
0;370;"naylea";370;0;100
0;50;"nayleah";50;0;100
0;88;"naylee";88;0;100
0;227;"nayleen";227;0;100
12;5;"naylen";17;70.5882352941177;29.4117647058824
0;98;"naylene";98;0;100
0;19;"nayli";19;0;100
0;5;"naylia";5;0;100
0;5;"naylie";5;0;100
0;118;"naylin";118;0;100
0;6;"nayloni";6;0;100
5;0;"naylor";5;100;0
0;34;"nayma";34;0;100
6;0;"naymar";6;100;0
7;0;"naymon";7;100;0
0;12;"nayna";12;0;100
0;16;"nayo";16;0;100
0;11;"nayome";11;0;100
0;13;"nayomee";13;0;100
0;810;"nayomi";810;0;100
0;32;"nayomie";32;0;100
0;5;"nayona";5;0;100
0;14;"nayonika";14;0;100
0;52;"nayonna";52;0;100
76;0;"nayquan";76;100;0
0;234;"nayra";234;0;100
0;383;"naysa";383;0;100
5;0;"naysean";5;100;0
0;11;"nayseth";11;0;100
0;229;"naysha";229;0;100
41;0;"nayshaun";41;100;0
146;0;"nayshawn";146;100;0
60;0;"nayson";60;100;0
0;5;"naytasha";5;0;100
675;0;"naythan";675;100;0
146;0;"naythen";146;100;0
23;0;"naython";23;100;0
20;0;"nayvadius";20;100;0
0;19;"nayvee";19;0;100
0;5;"nayvi";5;0;100
0;5;"nayvia";5;0;100
0;46;"nayvie";46;0;100
0;5;"nayya";5;0;100
0;16;"nayyirah";16;0;100
0;137;"nayzeth";137;0;100
8;64;"naz";72;11.1111111111111;88.8888888888889
62;0;"nazaiah";62;100;0
67;0;"nazair";67;100;0
117;0;"nazaire";117;100;0
0;43;"nazalia";43;0;100
0;17;"nazaneen";17;0;100
0;97;"nazanin";97;0;100
379;0;"nazar";379;100;0
0;11;"nazarah";11;0;100
0;5;"nazarena";5;0;100
0;63;"nazarene";63;0;100
5;0;"nazareno";5;100;0
34;139;"nazaret";173;19.6531791907514;80.3468208092486
788;548;"nazareth";1336;58.9820359281437;41.0179640718563
15;38;"nazari";53;28.3018867924528;71.6981132075472
0;370;"nazaria";370;0;100
0;144;"nazariah";144;0;100
801;0;"nazario";801;100;0
26;0;"nazariy";26;100;0
0;15;"nazariyah";15;0;100
0;6;"nazarria";6;0;100
6;0;"nazavier";6;100;0
0;5;"nazaya";5;0;100
0;8;"nazayah";8;0;100
15;0;"nazeef";15;100;0
6;0;"nazeeh";6;100;0
13;0;"nazeem";13;100;0
213;0;"nazeer";213;100;0
11;0;"nazeir";11;100;0
0;6;"nazeli";6;0;100
17;0;"nazere";17;100;0
0;6;"nazhae";6;0;100
11;0;"nazhir";11;100;0
0;352;"nazia";352;0;100
118;244;"naziah";362;32.5966850828729;67.4033149171271
406;0;"nazier";406;100;0
0;118;"nazifa";118;0;100
10;0;"nazih";10;100;0
0;5;"nazik";5;0;100
187;0;"nazim";187;100;0
2249;0;"nazir";2249;100;0
0;56;"nazira";56;0;100
0;140;"nazirah";140;0;100
70;0;"nazire";70;100;0
0;15;"nazish";15;0;100
0;184;"naziya";184;0;100
0;374;"naziyah";374;0;100
0;145;"nazli";145;0;100
0;83;"nazly";83;0;100
5;0;"nazmir";5;100;0
0;11;"nazneen";11;0;100
5;0;"nazr";5;100;0
0;5;"nazuri";5;0;100
0;7;"nazya";7;0;100
0;25;"nazyah";25;0;100
0;190;"nazyia";190;0;100
0;41;"nazyiah";41;0;100
24;0;"nazzareno";24;100;0
5;0;"ncholas";5;100;0
8;0;"nciholas";8;100;0
0;5;"ncole";5;0;100
0;190;"ndea";190;0;100
0;5;"ndey";5;0;100
0;388;"ndeye";388;0;100
0;254;"ndia";254;0;100
0;65;"ndidi";65;0;100
0;10;"ndrea";10;0;100
104;0;"ndrew";104;100;0
0;16;"ndya";16;0;100
0;323;"nea";323;0;100
0;412;"neah";412;0;100
0;5;"neajah";5;0;100
11;0;"neako";11;100;0
53373;257;"neal";53630;99.5207906022748;0.479209397725154
0;496;"neala";496;0;100
916;5;"neale";921;99.457111834962;0.542888165038002
0;15;"nealey";15;0;100
17;585;"nealie";602;2.82392026578073;97.1760797342193
18;0;"nealon";18;100;0
83;266;"nealy";349;23.7822349570201;76.2177650429799
88;0;"neamiah";88;100;0
0;5;"neana";5;0;100
0;37;"neariah";37;0;100
0;5;"neasa";5;0;100
0;42;"neasha";42;0;100
0;67;"neasia";67;0;100
0;5;"neata";5;0;100
0;5;"neatha";5;0;100
0;8;"neavah";8;0;100
0;116;"neave";116;0;100
0;150;"neaveh";150;0;100
23;0;"neaven";23;100;0
5;0;"nebeyu";5;100;0
10;0;"nebil";10;100;0
38;0;"nebiyu";38;100;0
43;37;"nebraska";80;53.75;46.25
0;13;"nebula";13;0;100
39;0;"necalli";39;100;0
0;59;"necha";59;0;100
0;2943;"nechama";2943;0;100
0;295;"nechelle";295;0;100
75;0;"nechemia";75;100;0
5;0;"nechemiah";5;100;0
11;0;"nechemya";11;100;0
0;30;"nechole";30;0;100
0;100;"nechuma";100;0;100
0;21;"nechy";21;0;100
0;8;"neci";8;0;100
0;675;"necia";675;0;100
0;169;"necie";169;0;100
5;0;"necko";5;100;0
170;38;"neco";208;81.7307692307692;18.2692307692308
0;29;"necol";29;0;100
0;64;"necola";64;0;100
0;1346;"necole";1346;0;100
6;0;"nectarios";6;100;0
16560;5;"ned";16565;99.9698158768488;0.0301841231512225
0;2018;"neda";2018;0;100
51;0;"nedal";51;100;0
0;108;"nedda";108;0;100
32;65;"neddie";97;32.9896907216495;67.0103092783505
16;0;"neddy";16;100;0
0;9;"nedenia";9;0;100
0;55;"nedia";55;0;100
84;0;"nedim";84;100;0
0;6;"nedine";6;0;100
0;7104;"nedra";7104;0;100
5;0;"nedrick";5;100;0
7;0;"nedved";7;100;0
0;6;"neeah";6;0;100
0;8;"neecy";8;0;100
297;0;"needham";297;100;0
0;56;"neeharika";56;0;100
0;219;"neeka";219;0;100
256;0;"neeko";256;100;0
2567;0;"neel";2567;100;0
0;949;"neela";949;0;100
0;118;"neelah";118;0;100
0;294;"neelam";294;0;100
12;0;"neelan";12;100;0
0;5;"neelee";5;0;100
51;0;"neelesh";51;100;0
0;383;"neeley";383;0;100
0;23;"neeli";23;0;100
0;19;"neelia";19;0;100
0;90;"neelie";90;0;100
0;7;"neelima";7;0;100
0;8;"neelisha";8;0;100
384;1937;"neely";2321;16.5445928479104;83.4554071520896
256;464;"neema";720;35.5555555555556;64.4444444444444
0;15;"neemah";15;0;100
5;0;"neemias";5;100;0
0;1636;"neena";1636;0;100
0;234;"neenah";234;0;100
0;6;"neepa";6;0;100
44;0;"neer";44;100;0
0;77;"neera";77;0;100
321;0;"neeraj";321;100;0
0;11;"neeraja";11;0;100
39;0;"neerav";39;100;0
0;5;"neeru";5;0;100
0;135;"neesa";135;0;100
0;276;"neesha";276;0;100
16;0;"neeson";16;100;0
0;124;"neeta";124;0;100
0;12;"neethu";12;0;100
0;55;"neeti";55;0;100
0;35;"neetu";35;0;100
383;0;"neev";383;100;0
0;118;"neeva";118;0;100
0;29;"neeve";29;0;100
0;55;"neeya";55;0;100
0;15;"neeyah";15;0;100
0;5;"nefateria";5;0;100
0;41;"nefeli";41;0;100
0;343;"nefertari";343;0;100
0;5;"nefertary";5;0;100
0;6;"neferteria";6;0;100
0;755;"nefertiti";755;0;100
0;5;"nefeteria";5;0;100
6;0;"neff";6;100;0
156;0;"nefi";156;100;0
0;34;"nefretiri";34;0;100
1953;380;"neftali";2333;83.7119588512645;16.2880411487355
359;170;"neftaly";529;67.8638941398866;32.1361058601134
24;6;"negan";30;80;20
0;53;"negar";53;0;100
0;15;"negeen";15;0;100
0;5;"neghan";5;0;100
0;82;"negin";82;0;100
11;0;"negus";11;100;0
0;4112;"neha";4112;0;100
71;142;"nehal";213;33.3333333333333;66.6666666666667
57;0;"nehamiah";57;100;0
65;0;"nehan";65;100;0
0;33;"neharika";33;0;100
43;0;"nehemia";43;100;0
14711;417;"nehemiah";15128;97.2435219460603;2.75647805393971
1025;0;"nehemias";1025;100;0
0;218;"nehemie";218;0;100
16;0;"nehemiyah";16;100;0
49;0;"nehemyah";49;100;0
13;0;"nehimiah";13;100;0
0;34;"nehir";34;0;100
5;0;"nehki";5;100;0
26;0;"nehorai";26;100;0
0;21;"neia";21;0;100
0;5;"neiah";5;0;100
0;22;"neiba";22;0;100
0;5;"neicha";5;0;100
0;1824;"neida";1824;0;100
0;5;"neidelin";5;0;100
0;5;"neidelyn";5;0;100
0;10;"neidi";10;0;100
0;60;"neidra";60;0;100
0;178;"neidy";178;0;100
0;51;"neika";51;0;100
514;0;"neiko";514;100;0
101180;386;"neil";101566;99.6199515585924;0.380048441407558
0;1150;"neila";1150;0;100
0;52;"neilah";52;0;100
87;0;"neilan";87;100;0
0;102;"neilani";102;0;100
0;35;"neile";35;0;100
5;0;"neilesh";5;100;0
0;5;"neili";5;0;100
0;8;"neilie";8;0;100
0;5;"neilina";5;0;100
1811;0;"neill";1811;100;0
0;5;"neilla";5;0;100
15;0;"neilpatrick";15;100;0
78;0;"neils";78;100;0
200;0;"neilson";200;100;0
0;59;"neily";59;0;100
0;10;"neilyn";10;0;100
5;55;"neima";60;8.33333333333333;91.6666666666667
302;5;"neiman";307;98.371335504886;1.62866449511401
50;0;"neimar";50;100;0
15;0;"neimiah";15;100;0
0;17;"neina";17;0;100
0;126;"neira";126;0;100
0;47;"neisa";47;0;100
0;1045;"neisha";1045;0;100
0;6;"neishaly";6;0;100
0;5;"neissa";5;0;100
0;607;"neita";607;0;100
113;0;"neithan";113;100;0
10;0;"neithen";10;100;0
0;102;"neiva";102;0;100
0;6;"neiya";6;0;100
50;0;"neizan";50;100;0
21;0;"neji";21;100;0
0;131;"nejla";131;0;100
0;30;"nejra";30;0;100
0;155;"neka";155;0;100
0;9;"nekaya";9;0;100
0;23;"nekaybaw";23;0;100
0;77;"nekayla";77;0;100
0;20;"nekea";20;0;100
0;10;"nekeda";10;0;100
0;15;"nekedra";15;0;100
0;53;"nekeia";53;0;100
0;23;"nekeidra";23;0;100
0;269;"nekeisha";269;0;100
0;280;"nekesha";280;0;100
0;125;"nekeshia";125;0;100
0;5;"nekesia";5;0;100
0;35;"neketa";35;0;100
0;77;"nekeya";77;0;100
0;6;"nekeysha";6;0;100
129;0;"nekhi";129;100;0
50;811;"nekia";861;5.80720092915215;94.1927990708479
0;6;"nekiesha";6;0;100
0;7;"nekira";7;0;100
0;410;"nekisha";410;0;100
0;10;"nekishia";10;0;100
0;368;"nekita";368;0;100
0;18;"nekiya";18;0;100
0;20;"nekiyah";20;0;100
0;5;"nekki";5;0;100
34;0;"nekko";34;100;0
694;193;"neko";887;78.2412626832018;21.7587373167982
132;26;"nekoda";158;83.5443037974684;16.4556962025316
0;5;"nekol";5;0;100
0;46;"nekole";46;0;100
32;0;"nektarios";32;100;0
0;5;"nekya";5;0;100
0;75;"nel";75;0;100
0;436;"nela";436;0;100
0;25;"nelah";25;0;100
0;57;"nelani";57;0;100
0;5;"nelba";5;0;100
0;11;"nelcy";11;0;100
5;19989;"nelda";19994;0.0250075022506752;99.9749924977493
0;5;"neldean";5;0;100
158;0;"neldon";158;100;0
0;39;"neleah";39;0;100
0;122;"neleh";122;0;100
0;18;"neleigh";18;0;100
0;6;"nelena";6;0;100
0;249;"neli";249;0;100
0;1284;"nelia";1284;0;100
0;51;"neliah";51;0;100
0;1473;"nelida";1473;0;100
0;27;"nelie";27;0;100
0;18;"nelina";18;0;100
0;11;"nelisa";11;0;100
0;169;"nelissa";169;0;100
0;10;"nelita";10;0;100
0;5;"nelitza";5;0;100
0;15;"neliyah";15;0;100
98;23155;"nell";23253;0.421450995570464;99.5785490044295
0;3467;"nella";3467;0;100
0;5;"nellann";5;0;100
0;6;"nellda";6;0;100
0;3513;"nelle";3513;0;100
0;5;"nellean";5;0;100
0;5;"nellee";5;0;100
0;180;"nellene";180;0;100
0;210;"nelli";210;0;100
0;32;"nellia";32;0;100
441;118088;"nellie";118529;0.372060845868944;99.6279391541311
0;18;"nelliel";18;0;100
0;13;"nelliemae";13;0;100
0;75;"nelline";75;0;100
18;18;"nellis";36;50;50
908;18;"nello";926;98.0561555075594;1.9438444924406
0;5;"nellora";5;0;100
0;20;"nellwyn";20;0;100
44;6468;"nelly";6512;0.675675675675676;99.3243243243243
0;60;"nellye";60;0;100
0;1229;"nelma";1229;0;100
5;0;"nelo";5;100;0
0;11;"neloise";11;0;100
0;30;"nelrose";30;0;100
3281;0;"nels";3281;100;0
0;33;"nelsa";33;0;100
28;0;"nelse";28;100;0
0;20;"nelsi";20;0;100
0;120;"nelsie";120;0;100
74700;406;"nelson";75106;99.4594306713179;0.540569328682129
0;223;"nelsy";223;0;100
0;477;"nelta";477;0;100
79;0;"nelton";79;100;0
0;1134;"nelva";1134;0;100
0;23;"nelvia";23;0;100
0;5;"nelvie";5;0;100
320;10;"nelvin";330;96.969696969697;3.03030303030303
0;10;"nelvina";10;0;100
0;657;"nelwyn";657;0;100
0;558;"nely";558;0;100
0;10;"nelya";10;0;100
18;290;"nema";308;5.84415584415584;94.1558441558442
50;0;"nemanja";50;100;0
39;0;"nemecio";39;100;0
69;0;"nemesio";69;100;0
0;155;"nemesis";155;0;100
216;80;"nemiah";296;72.972972972973;27.027027027027
46;0;"nemo";46;100;0
0;6;"nemya";6;0;100
0;4624;"nena";4624;0;100
43;0;"nenad";43;100;0
0;17;"nenah";17;0;100
0;15;"nency";15;0;100
0;127;"nene";127;0;100
0;29;"neneh";29;0;100
0;6;"nenette";6;0;100
78;5;"neng";83;93.9759036144578;6.02409638554217
0;11;"nenia";11;0;100
73;0;"neno";73;100;0
1446;0;"neo";1446;100;0
0;970;"neola";970;0;100
0;6;"neolani";6;0;100
0;3036;"neoma";3036;0;100
0;1691;"neomi";1691;0;100
0;904;"neomia";904;0;100
48;0;"neomiah";48;100;0
0;35;"neomie";35;0;100
0;6;"neomy";6;0;100
17;0;"neon";17;100;0
0;48;"neona";48;0;100
0;5;"neorah";5;0;100
0;204;"neosha";204;0;100
0;6;"neoshia";6;0;100
0;21;"nephateria";21;0;100
659;0;"nephi";659;100;0
125;6;"nephtali";131;95.4198473282443;4.58015267175572
0;39;"nephtalie";39;0;100
10;0;"nepoleon";10;100;0
0;15;"neppie";15;0;100
15;0;"neptali";15;100;0
34;0;"nequan";34;100;0
0;5;"nequila";5;0;100
0;11;"nequita";11;0;100
0;114;"nera";114;0;100
0;63;"nerea";63;0;100
6;3619;"nereida";3625;0.16551724137931;99.8344827586207
0;5;"nerely";5;0;100
0;18;"nerene";18;0;100
21;0;"nereo";21;100;0
0;1127;"nereyda";1127;0;100
565;161;"neri";726;77.8236914600551;22.1763085399449
0;62;"neria";62;0;100
31;1891;"neriah";1922;1.61290322580645;98.3870967741936
14;0;"neric";14;100;0
39;0;"nerick";39;100;0
0;47;"nerida";47;0;100
35;0;"nerik";35;100;0
0;5;"nerina";5;0;100
0;79;"nerine";79;0;100
5;0;"neris";5;100;0
0;10;"nerisa";10;0;100
0;1905;"nerissa";1905;0;100
0;14;"nerita";14;0;100
0;59;"neriya";59;0;100
0;148;"neriyah";148;0;100
0;11;"nerlande";11;0;100
0;5;"nerma";5;0;100
0;51;"nermeen";51;0;100
32;12;"nermin";44;72.7272727272727;27.2727272727273
286;0;"nero";286;100;0
11;0;"neron";11;100;0
0;11;"nerriah";11;0;100
0;10;"nerrissa";10;0;100
8;0;"nerses";8;100;0
0;48;"nerva";48;0;100
0;5;"nervia";5;0;100
0;25;"nervie";25;0;100
1329;267;"nery";1596;83.2706766917293;16.7293233082707
0;5;"nerya";5;0;100
0;5;"nerys";5;0;100
0;95;"nesa";95;0;100
196;0;"nesanel";196;100;0
62;18;"nesbit";80;77.5;22.5
33;0;"nesbitt";33;100;0
16;0;"nesby";16;100;0
12;0;"nesean";12;100;0
0;478;"nesha";478;0;100
0;6;"neshama";6;0;100
0;9;"neshanta";9;0;100
11;0;"neshaun";11;100;0
59;10;"neshawn";69;85.5072463768116;14.4927536231884
0;10;"neshay";10;0;100
0;21;"neshell";21;0;100
0;10;"neshelle";10;0;100
0;81;"neshia";81;0;100
0;18;"nesia";18;0;100
5;83;"nesiah";88;5.68181818181818;94.3181818181818
0;5;"nesita";5;0;100
5;47;"nesly";52;9.61538461538462;90.3846153846154
0;10;"nesma";10;0;100
0;7;"nesochi";7;0;100
0;187;"nesreen";187;0;100
0;7;"nesren";7;0;100
23;0;"ness";23;100;0
0;846;"nessa";846;0;100
31;44;"nessiah";75;41.3333333333333;58.6666666666667
0;87;"nessie";87;0;100
92;80;"nesta";172;53.4883720930233;46.5116279069767
101;0;"nester";101;100;0
9516;0;"nestor";9516;100;0
0;43;"nestora";43;0;100
0;5;"nesya";5;0;100
0;2920;"neta";2920;0;100
318;0;"netanel";318;100;0
0;12;"netania";12;0;100
0;467;"netanya";467;0;100
0;143;"netasha";143;0;100
0;224;"netha";224;0;100
66;0;"nethan";66;100;0
42;0;"nethanel";42;100;0
0;26;"nethania";26;0;100
5;0;"nethaniah";5;100;0
230;0;"nethaniel";230;100;0
0;11;"nether";11;0;100
0;235;"nethra";235;0;100
0;10;"netia";10;0;100
0;25;"netisha";25;0;100
0;175;"netra";175;0;100
0;922;"netta";922;0;100
0;11;"nette";11;0;100
0;10;"netter";10;0;100
78;37423;"nettie";37501;0.207994453481241;99.7920055465188
0;144;"netty";144;0;100
0;71;"nettye";71;0;100
51;0;"neuman";51;100;0
0;16;"nev";16;0;100
6;19109;"neva";19115;0.0313889615485221;99.9686110384515
96;0;"nevaan";96;100;0
0;5;"nevach";5;0;100
636;2625;"nevada";3261;19.5032198712052;80.4967801287949
0;97;"nevae";97;0;100
395;72580;"nevaeh";72975;0.541281260705721;99.4587187392943
0;946;"nevaeha";946;0;100
0;5;"nevaehia";5;0;100
0;10;"nevaehlee";10;0;100
0;17;"nevaehly";17;0;100
0;16;"nevaehlynn";16;0;100
0;19;"nevaehmarie";19;0;100
0;5;"nevaehtnes";5;0;100
0;96;"nevaen";96;0;100
0;205;"nevah";205;0;100
0;6;"nevaha";6;0;100
0;18;"nevaiah";18;0;100
1016;5;"nevan";1021;99.5102840352595;0.489715964740451
0;5;"nevara";5;0;100
0;6;"nevart";6;0;100
0;230;"nevaya";230;0;100
0;262;"nevayah";262;0;100
0;5;"nevayiah";5;0;100
0;1091;"neve";1091;0;100
0;83;"nevea";83;0;100
0;3575;"neveah";3575;0;100
0;26;"neveaha";26;0;100
0;121;"neveen";121;0;100
16;11;"nevel";27;59.2592592592593;40.7407407407407
6;0;"nevelle";6;100;0
0;151;"nevelyn";151;0;100
338;6;"neven";344;98.2558139534884;1.74418604651163
0;59;"nevena";59;0;100
0;34;"neveya";34;0;100
0;88;"neveyah";88;0;100
0;102;"nevia";102;0;100
0;286;"neviah";286;0;100
26;0;"nevil";26;100;0
2239;75;"neville";2314;96.7588591184097;3.24114088159032
5920;94;"nevin";6014;98.4369803791154;1.5630196208846
0;55;"nevina";55;0;100
0;5;"nevine";5;0;100
5;0;"nevins";5;100;0
0;10;"nevis";10;0;100
0;44;"neviyah";44;0;100
22;0;"nevo";22;100;0
54;0;"nevon";54;100;0
115;5;"nevyn";120;95.8333333333333;4.16666666666667
0;13;"newana";13;0;100
5;0;"newbern";5;100;0
18;11;"newborn";29;62.0689655172414;37.9310344827586
130;0;"newel";130;100;0
3095;79;"newell";3174;97.5110270951481;2.48897290485192
22;0;"newland";22;100;0
15;0;"newlin";15;100;0
1781;0;"newman";1781;100;0
6;0;"newsom";6;100;0
565;0;"newt";565;100;0
7024;5;"newton";7029;99.9288661260492;0.0711338739507754
5;0;"nexus";5;100;0
26;0;"ney";26;100;0
0;208;"neya";208;0;100
0;91;"neyah";91;0;100
5;6;"neyamiah";11;45.4545454545455;54.5454545454545
6;0;"neyan";6;100;0
0;8;"neyba";8;0;100
0;665;"neyda";665;0;100
0;26;"neydelin";26;0;100
0;37;"neydi";37;0;100
0;298;"neyla";298;0;100
0;5;"neylah";5;0;100
31;48;"neylan";79;39.2405063291139;60.7594936708861
239;0;"neyland";239;100;0
0;5;"neylani";5;0;100
0;23;"neylin";23;0;100
1961;5;"neymar";1966;99.7456765005087;0.254323499491353
50;0;"neyo";50;100;0
0;80;"neyra";80;0;100
0;1207;"neysa";1207;0;100
0;132;"neysha";132;0;100
104;0;"neythan";104;100;0
0;97;"neytiri";97;0;100
0;48;"neyva";48;0;100
11;0;"neyzer";11;100;0
155;0;"nezar";155;100;0
89;84;"neziah";173;51.4450867052023;48.5549132947977
0;6;"neziyah";6;0;100
0;427;"nezzie";427;0;100
0;349;"nga";349;0;100
66;0;"ngai";66;100;0
0;214;"ngan";214;0;100
28;13;"ngawang";41;68.2926829268293;31.7073170731707
0;53;"ngela";53;0;100
5;22;"nghi";27;18.5185185185185;81.4814814814815
211;5;"nghia";216;97.6851851851852;2.31481481481481
0;77;"ngina";77;0;100
54;640;"ngoc";694;7.78097982708934;92.2190201729107
0;5;"ngocanh";5;0;100
0;6;"ngone";6;0;100
21;443;"ngozi";464;4.52586206896552;95.4741379310345
0;5;"ngozichukwu";5;0;100
5;36;"ngun";41;12.1951219512195;87.8048780487805
437;117;"nguyen";554;78.8808664259928;21.1191335740072
0;73;"nguyet";73;0;100
5;0;"nha";5;100;0
0;5;"nhala";5;0;100
343;5;"nhan";348;98.5632183908046;1.4367816091954
46;0;"nhat";46;100;0
0;977;"nhi";977;0;100
213;32;"nhia";245;86.9387755102041;13.0612244897959
0;361;"nhu";361;0;100
0;215;"nhung";215;0;100
16;0;"nhut";16;100;0
0;8;"nhuy";8;0;100
0;8;"nhya";8;0;100
0;43;"nhyira";43;0;100
0;57;"nhyla";57;0;100
0;22;"ni";22;0;100
10;20538;"nia";20548;0.048666536889235;99.9513334631108
0;1256;"niah";1256;0;100
0;15;"niaimani";15;0;100
0;5;"niaira";5;0;100
0;10;"niaisha";10;0;100
0;183;"niaja";183;0;100
0;159;"niajah";159;0;100
0;5;"niaje";5;0;100
0;5;"niakia";5;0;100
96;0;"nial";96;100;0
0;125;"niala";125;0;100
0;144;"nialah";144;0;100
0;26;"nialani";26;0;100
1330;0;"niall";1330;100;0
0;7;"nialynn";7;0;100
583;0;"niam";583;100;0
0;12;"niama";12;0;100
0;10;"niamalika";10;0;100
0;16;"niamani";16;0;100
0;5;"niamarie";5;0;100
0;260;"niambi";260;0;100
0;1261;"niamh";1261;0;100
0;41;"niamiah";41;0;100
7;0;"niamke";7;100;0
0;10;"niamora";10;0;100
0;73;"niamya";73;0;100
0;7;"nian";7;0;100
0;159;"niana";159;0;100
0;152;"niang";152;0;100
0;214;"niani";214;0;100
0;94;"nianna";94;0;100
0;133;"niaomi";133;0;100
0;866;"niara";866;0;100
0;17;"niarah";17;0;100
0;15;"niari";15;0;100
0;6;"niarose";6;0;100
0;180;"niasha";180;0;100
0;846;"niasia";846;0;100
0;214;"niaya";214;0;100
0;40;"niayla";40;0;100
0;11;"niaylah";11;0;100
6;0;"niaz";6;100;0
77;0;"nic";77;100;0
0;208;"nica";208;0;100
0;15;"nicaela";15;0;100
0;18;"nicala";18;0;100
135;0;"nicandro";135;100;0
740;0;"nicanor";740;100;0
0;5;"nicanora";5;0;100
0;5;"nicara";5;0;100
0;6;"nicasia";6;0;100
249;0;"nicasio";249;100;0
0;5;"nicaya";5;0;100
0;8;"nicayla";8;0;100
0;273;"nicci";273;0;100
845;5;"nicco";850;99.4117647058823;0.588235294117647
0;10;"niccola";10;0;100
184;0;"niccolas";184;100;0
0;1352;"niccole";1352;0;100
6;0;"niccoli";6;100;0
737;0;"niccolo";737;100;0
5;0;"nicere";5;100;0
0;78;"nicey";78;0;100
0;85;"nicha";85;0;100
92;0;"nichael";92;100;0
0;18;"nichaela";18;0;100
280;0;"nichalas";280;100;0
6;0;"nichalaus";6;100;0
485;0;"nichalos";485;100;0
52;0;"nichalous";52;100;0
10;0;"nichalus";10;100;0
5;0;"nichaolas";5;100;0
0;5;"nichcole";5;0;100
0;5;"niche";5;0;100
0;18;"nichel";18;0;100
0;667;"nichele";667;0;100
0;56;"nichell";56;0;100
0;5;"nichella";5;0;100
5;5442;"nichelle";5447;0.0917936478795667;99.9082063521204
0;5;"nichet";5;0;100
268;0;"nichlas";268;100;0
40;0;"nichlaus";40;100;0
43;0;"nichloas";43;100;0
188;0;"nichlos";188;100;0
24;0;"nichlous";24;100;0
5;0;"nicho";5;100;0
0;5;"nichoal";5;0;100
74;0;"nichoals";74;100;0
16;0;"nichoas";16;100;0
0;131;"nichoel";131;0;100
22;2900;"nichol";2922;0.752908966461328;99.2470910335387
127;863;"nichola";990;12.8282828282828;87.1717171717172
20;0;"nicholaas";20;100;0
51;0;"nicholad";51;100;0
818;0;"nicholai";818;100;0
121;0;"nicholaos";121;100;0
888430;3111;"nicholas";891541;99.6510536251277;0.348946374872272
3188;0;"nicholaus";3188;100;0
184;63207;"nichole";63391;0.290262024577621;99.7097379754224
879;0;"nicholes";879;100;0
0;5;"nicholetta";5;0;100
0;1265;"nicholette";1265;0;100
320;0;"nicholi";320;100;0
0;35;"nicholina";35;0;100
732;0;"nicholis";732;100;0
0;171;"nicholl";171;0;100
79;0;"nichollas";79;100;0
0;1837;"nicholle";1837;0;100
0;25;"nichollette";25;0;100
769;0;"nicholos";769;100;0
129;0;"nicholous";129;100;0
753;0;"nichols";753;100;0
6;0;"nicholsa";6;100;0
92;0;"nicholson";92;100;0
754;0;"nicholus";754;100;0
0;54;"nicia";54;0;100
0;5;"niciah";5;0;100
0;179;"nicie";179;0;100
48493;132;"nick";48625;99.7285347043702;0.27146529562982
12;0;"nickai";12;100;0
609;0;"nickalas";609;100;0
281;0;"nickalaus";281;100;0
17;0;"nickales";17;100;0
28;0;"nickali";28;100;0
39;0;"nickalis";39;100;0
265;0;"nickalos";265;100;0
172;0;"nickalous";172;100;0
444;0;"nickalus";444;100;0
31;0;"nickan";31;100;0
0;194;"nickayla";194;0;100
0;5;"nickcola";5;0;100
0;127;"nickcole";127;0;100
0;19;"nickea";19;0;100
43;0;"nickelas";43;100;0
0;11;"nickell";11;0;100
0;49;"nickelle";49;0;100
15;0;"nickelous";15;100;0
0;23;"nickesha";23;0;100
0;10;"nicketa";10;0;100
1661;332;"nickey";1993;83.3416959357752;16.6583040642248
0;55;"nickeya";55;0;100
5;0;"nickhil";5;100;0
94;0;"nickholas";94;100;0
297;6048;"nicki";6345;4.68085106382979;95.3191489361702
0;260;"nickia";260;0;100
1438;3156;"nickie";4594;31.3016978667828;68.6983021332172
0;55;"nickisha";55;0;100
21;40;"nickita";61;34.4262295081967;65.5737704918033
0;16;"nickiya";16;0;100
0;12;"nickiyah";12;0;100
0;38;"nickki";38;0;100
2331;0;"nicklas";2331;100;0
3279;0;"nicklaus";3279;100;0
21;0;"nickles";21;100;0
5;0;"nickloas";5;100;0
277;0;"nicklos";277;100;0
244;0;"nicklous";244;100;0
46;0;"nicklus";46;100;0
235;8;"nicko";243;96.7078189300412;3.29218106995885
5;0;"nickohlas";5;100;0
0;236;"nickol";236;0;100
5;131;"nickola";136;3.67647058823529;96.3235294117647
387;0;"nickolai";387;100;0
149;0;"nickolaos";149;100;0
37730;47;"nickolas";37777;99.8755856738227;0.124414326177304
1775;0;"nickolaus";1775;100;0
0;2505;"nickole";2505;0;100
199;0;"nickoles";199;100;0
0;131;"nickolette";131;0;100
247;0;"nickoli";247;100;0
5;0;"nickolie";5;100;0
258;0;"nickolis";258;100;0
56;0;"nickolos";56;100;0
44;0;"nickolous";44;100;0
477;0;"nickolus";477;100;0
5;0;"nickon";5;100;0
7;0;"nickos";7;100;0
193;0;"nickson";193;100;0
7349;1899;"nicky";9248;79.465830449827;20.534169550173
0;5;"nickyla";5;0;100
80;0;"niclas";80;100;0
10;0;"niclaus";10;100;0
0;87;"nicle";87;0;100
0;146;"nicloe";146;0;100
0;19;"niclole";19;0;100
9647;710;"nico";10357;93.1447330308004;6.85526696919958
18;0;"nicodemo";18;100;0
776;0;"nicodemus";776;100;0
0;6;"nicoe";6;0;100
0;5;"nicoel";5;0;100
40;0;"nicohlas";40;100;0
0;15;"nicohle";15;0;100
28;2057;"nicol";2085;1.34292565947242;98.6570743405276
2722;4950;"nicola";7672;35.4796663190824;64.5203336809176
391;0;"nicolaas";391;100;0
122;0;"nicolae";122;100;0
1375;0;"nicolai";1375;100;0
98;0;"nicolaos";98;100;0
83466;174;"nicolas";83640;99.7919655667145;0.208034433285509
0;1109;"nicolasa";1109;0;100
1095;0;"nicolaus";1095;100;0
1956;584073;"nicole";586029;0.333771878183503;99.6662281218165
0;5;"nicoleann";5;0;100
0;33;"nicoleanne";33;0;100
0;22;"nicolee";22;0;100
0;101;"nicolemarie";101;0;100
0;214;"nicolena";214;0;100
0;6;"nicolene";6;0;100
103;0;"nicoles";103;100;0
0;108;"nicolet";108;0;100
0;31;"nicoleta";31;0;100
0;5;"nicolete";5;0;100
0;31;"nicolett";31;0;100
0;1833;"nicoletta";1833;0;100
5;16030;"nicolette";16035;0.0311817898347365;99.9688182101653
350;42;"nicoli";392;89.2857142857143;10.7142857142857
0;18;"nicolia";18;0;100
0;1630;"nicolina";1630;0;100
0;28;"nicoline";28;0;100
33;0;"nicolino";33;100;0
141;0;"nicolis";141;100;0
0;56;"nicoll";56;0;100
27;0;"nicollas";27;100;0
0;5661;"nicolle";5661;0;100
0;1224;"nicollette";1224;0;100
0;54;"nicolly";54;0;100
1214;0;"nicolo";1214;100;0
17;0;"nicolos";17;100;0
99;0;"nicolus";99;100;0
0;5;"nicoly";5;0;100
0;5;"nicolyn";5;0;100
5;0;"nicomedes";5;100;0
36;0;"nicos";36;100;0
0;58;"nicosha";58;0;100
0;13;"nicosia";13;0;100
0;64;"nicoya";64;0;100
11;0;"nicquan";11;100;0
6;0;"nicson";6;100;0
0;14;"nicte";14;0;100
0;5;"nicteha";5;0;100
0;42;"nicy";42;0;100
0;1357;"nida";1357;0;100
187;0;"nidal";187;100;0
0;1295;"nidhi";1295;0;100
6;0;"nidhish";6;100;0
0;2637;"nidia";2637;0;100
5;0;"nidish";5;100;0
0;44;"nidra";44;0;100
0;77;"nidya";77;0;100
0;13;"nieasha";13;0;100
6;0;"nieco";6;100;0
25;0;"nieem";25;100;0
29;0;"niegel";29;100;0
0;13;"nieisha";13;0;100
0;5;"nieja";5;0;100
0;26;"nieka";26;0;100
0;5;"niekia";5;0;100
213;0;"nieko";213;100;0
1341;0;"niel";1341;100;0
0;51;"niela";51;0;100
0;21;"nielah";21;0;100
0;65;"nielle";65;0;100
1341;0;"niels";1341;100;0
5;0;"nielsen";5;100;0
6;0;"niem";6;100;0
0;464;"niema";464;0;100
0;70;"niemah";70;0;100
6;0;"nieman";6;100;0
0;5;"niera";5;0;100
0;22;"nierra";22;0;100
0;21;"niesa";21;0;100
0;2176;"niesha";2176;0;100
0;161;"nieshia";161;0;100
0;6;"nieta";6;0;100
0;10;"nieva";10;0;100
0;132;"nieve";132;0;100
596;978;"nieves";1574;37.8653113087675;62.1346886912325
0;17;"nieya";17;0;100
16;0;"nigal";16;100;0
5;0;"nigee";5;100;0
11440;85;"nigel";11525;99.2624728850325;0.737527114967462
6;0;"nigell";6;100;0
0;42;"nigella";42;0;100
11;25;"niger";36;30.5555555555556;69.4444444444444
0;769;"nigeria";769;0;100
5;0;"nigiel";5;100;0
91;0;"nigil";91;100;0
153;0;"niguel";153;100;0
0;37;"niha";37;0;100
78;5;"nihaal";83;93.9759036144578;6.02409638554217
13;0;"nihaan";13;100;0
0;5;"nihad";5;0;100
523;128;"nihal";651;80.3379416282642;19.6620583717358
22;0;"nihan";22;100;0
284;0;"nihar";284;100;0
0;7;"nihara";7;0;100
0;314;"niharika";314;0;100
14;0;"nihash";14;100;0
0;130;"nihira";130;0;100
7;0;"nihit";7;100;0
0;17;"nihitha";17;0;100
0;30;"nihla";30;0;100
0;7;"nihya";7;0;100
57;0;"nii";57;100;0
0;6;"niia";6;0;100
25;0;"niilo";25;100;0
19;814;"nija";833;2.28091236494598;97.719087635054
15;169;"nijae";184;8.15217391304348;91.8478260869565
158;1148;"nijah";1306;12.0980091883614;87.9019908116386
0;18;"nijai";18;0;100
38;0;"nijal";38;100;0
6;0;"nijash";6;100;0
41;35;"nijay";76;53.9473684210526;46.0526315789474
0;27;"nijaya";27;0;100
0;11;"nijayah";11;0;100
63;0;"nijee";63;100;0
304;0;"nijel";304;100;0
0;7;"nijeria";7;0;100
0;43;"nijha";43;0;100
0;39;"nijia";39;0;100
0;5;"nijiah";5;0;100
10;0;"nijon";10;100;0
177;0;"nik";177;100;0
5;1935;"nika";1940;0.257731958762887;99.7422680412371
0;68;"nikaela";68;0;100
98;5;"nikai";103;95.1456310679612;4.85436893203883
0;21;"nikaila";21;0;100
0;10;"nikaiya";10;0;100
0;10;"nikaiyah";10;0;100
0;113;"nikala";113;0;100
98;0;"nikalas";98;100;0
0;6;"nikalette";6;0;100
11;0;"nikali";11;100;0
40;0;"nikalus";40;100;0
48;0;"nikan";48;100;0
0;5;"nikara";5;0;100
74;0;"nikash";74;100;0
0;6;"nikasha";6;0;100
0;5;"nikata";5;0;100
0;165;"nikaya";165;0;100
0;5;"nikayah";5;0;100
0;6;"nikayia";6;0;100
0;1138;"nikayla";1138;0;100
0;5;"nikaylah";5;0;100
0;109;"nikcole";109;0;100
119;117;"nike";236;50.4237288135593;49.5762711864407
0;328;"nikea";328;0;100
0;5;"nikeea";5;0;100
5;0;"nikeem";5;100;0
0;17;"nikeesha";17;0;100
0;29;"nikeeta";29;0;100
0;62;"nikeia";62;0;100
0;235;"nikeisha";235;0;100
0;12;"nikeita";12;0;100
10;5;"nikel";15;66.6666666666667;33.3333333333333
0;27;"nikela";27;0;100
0;112;"nikelle";112;0;100
0;38;"nikema";38;0;100
0;52;"nikera";52;0;100
0;156;"nikeria";156;0;100
0;19;"nikerria";19;0;100
104;0;"nikesh";104;100;0
0;464;"nikesha";464;0;100
0;109;"nikeshia";109;0;100
23;0;"niket";23;100;0
0;371;"niketa";371;0;100
10;0;"niketh";10;100;0
0;11;"niketta";11;0;100
0;508;"nikeya";508;0;100
0;5;"nikeyia";5;0;100
0;5;"nikhaule";5;0;100
0;12;"nikhia";12;0;100
4835;0;"nikhil";4835;100;0
0;52;"nikhila";52;0;100
5;0;"nikhilesh";5;100;0
0;260;"nikhita";260;0;100
143;0;"nikholas";143;100;0
229;6891;"niki";7120;3.21629213483146;96.7837078651685
246;3714;"nikia";3960;6.21212121212121;93.7878787878788
0;169;"nikiah";169;0;100
0;35;"nikida";35;0;100
0;191;"nikie";191;0;100
0;7;"nikiea";7;0;100
0;67;"nikiesha";67;0;100
0;10;"nikiki";10;0;100
30;0;"nikil";30;100;0
0;17;"nikila";17;0;100
0;46;"nikima";46;0;100
0;20;"nikina";20;0;100
0;105;"nikira";105;0;100
0;1166;"nikisha";1166;0;100
0;21;"nikishia";21;0;100
12;0;"nikit";12;100;0
2356;10373;"nikita";12729;18.5089166470265;81.4910833529735
73;0;"nikitas";73;100;0
18;0;"nikith";18;100;0
0;279;"nikitha";279;0;100
0;88;"nikitia";88;0;100
0;5;"nikitra";5;0;100
0;64;"nikitta";64;0;100
0;581;"nikiya";581;0;100
0;192;"nikiyah";192;0;100
0;403;"nikka";403;0;100
0;28;"nikkea";28;0;100
0;5;"nikkei";5;0;100
0;16;"nikkeya";16;0;100
890;39512;"nikki";40402;2.20286124449285;97.7971387555071
12;1440;"nikkia";1452;0.826446280991736;99.1735537190083
0;5;"nikkiah";5;0;100
0;730;"nikkie";730;0;100
0;21;"nikkii";21;0;100
0;51;"nikkisha";51;0;100
0;776;"nikkita";776;0;100
0;6;"nikkitta";6;0;100
0;5;"nikkiya";5;0;100
3038;171;"nikko";3209;94.6712371455282;5.3287628544718
0;132;"nikkol";132;0;100
16;0;"nikkolai";16;100;0
468;0;"nikkolas";468;100;0
6;0;"nikkolaus";6;100;0
0;840;"nikkole";840;0;100
0;10;"nikkolette";10;0;100
7;0;"nikkoli";7;100;0
16;0;"nikkos";16;100;0
0;117;"nikky";117;0;100
1583;0;"niklas";1583;100;0
616;0;"niklaus";616;100;0
6502;366;"niko";6868;94.6709376820035;5.32906231799651
86;0;"nikodem";86;100;0
0;11;"nikohl";11;0;100
0;826;"nikol";826;0;100
2266;572;"nikola";2838;79.8449612403101;20.1550387596899
17;0;"nikolaas";17;100;0
6213;0;"nikolai";6213;100;0
74;0;"nikolaj";74;100;0
1640;0;"nikolaos";1640;100;0
20031;15;"nikolas";20046;99.9251721041604;0.074827895839569
2426;0;"nikolaus";2426;100;0
362;0;"nikolay";362;100;0
0;6778;"nikole";6778;0;100
11;0;"nikoles";11;100;0
0;66;"nikoleta";66;0;100
0;10;"nikolett";10;0;100
0;135;"nikoletta";135;0;100
0;475;"nikolette";475;0;100
504;0;"nikoli";504;100;0
11;0;"nikolia";11;100;0
0;6;"nikolija";6;0;100
0;340;"nikolina";340;0;100
122;0;"nikolis";122;100;0
6;0;"nikoll";6;100;0
0;40;"nikolle";40;0;100
217;0;"nikolos";217;100;0
62;0;"nikoloz";62;100;0
174;0;"nikolus";174;100;0
0;5;"nikoma";5;0;100
739;0;"nikos";739;100;0
5;0;"nikshay";5;100;0
18;0;"nikson";18;100;0
0;10;"nikte";10;0;100
6;0;"nikul";6;100;0
28;0;"nikunj";28;100;0
0;246;"nikya";246;0;100
0;127;"nikyah";127;0;100
0;19;"nikyia";19;0;100
0;145;"nikyla";145;0;100
0;16;"nikylah";16;0;100
0;43;"nikyra";43;0;100
0;7;"nikyta";7;0;100
91;31;"nil";122;74.5901639344262;25.4098360655738
0;6001;"nila";6001;0;100
0;971;"nilah";971;0;100
0;51;"nilaja";51;0;100
0;5;"nilajah";5;0;100
0;76;"nilam";76;0;100
85;0;"nilan";85;100;0
0;45;"nilani";45;0;100
220;5;"nilay";225;97.7777777777778;2.22222222222222
0;61;"nilaya";61;0;100
0;19;"nilayah";19;0;100
0;3240;"nilda";3240;0;100
2884;248;"nile";3132;92.0817369093231;7.91826309067688
0;6;"nileah";6;0;100
0;5;"nilene";5;0;100
3932;0;"niles";3932;100;0
177;0;"nilesh";177;100;0
0;64;"niley";64;0;100
0;165;"nili";165;0;100
0;10;"niliyah";10;0;100
0;38;"nilka";38;0;100
0;21;"nilla";21;0;100
0;109;"nillie";109;0;100
36;0;"nilmar";36;100;0
224;0;"nilo";224;100;0
0;12;"nilofar";12;0;100
0;11;"niloofar";11;0;100
0;35;"niloufar";35;0;100
2892;0;"nils";2892;100;0
0;1755;"nilsa";1755;0;100
273;0;"nilson";273;100;0
90;0;"nilton";90;100;0
0;5;"nilufar";5;0;100
0;10;"nilufer";10;0;100
0;5;"nilyn";5;0;100
0;9;"nilyne";9;0;100
0;25;"nilynn";25;0;100
0;66;"nilza";66;0;100
22;0;"nim";22;100;0
929;273;"nima";1202;77.2878535773711;22.712146422629
0;73;"nimah";73;0;100
69;0;"nimai";69;100;0
5;0;"nimalan";5;100;0
0;11;"nimat";11;0;100
0;80;"nimco";80;0;100
67;0;"nimesh";67;100;0
6;0;"nimish";6;100;0
0;133;"nimisha";133;0;100
35;0;"nimit";35;100;0
0;5;"nimmy";5;0;100
0;126;"nimo";126;0;100
0;199;"nimra";199;0;100
0;39;"nimrah";39;0;100
0;107;"nimrat";107;0;100
0;70;"nimrit";70;0;100
315;0;"nimrod";315;100;0
0;138;"nimsi";138;0;100
0;24;"nimsy";24;0;100
0;32;"nimue";32;0;100
0;6;"nin";6;0;100
240;119380;"nina";119620;0.20063534525999;99.79936465474
0;6;"ninabelle";6;0;100
5;0;"ninad";5;100;0
0;189;"ninah";189;0;100
0;175;"ninamarie";175;0;100
0;11;"ninasimone";11;0;100
0;5;"nincy";5;0;100
0;290;"ninel";290;0;100
0;12;"nineth";12;0;100
0;65;"ninetta";65;0;100
0;799;"ninette";799;0;100
0;35;"nineveh";35;0;100
0;2440;"ninfa";2440;0;100
0;164;"nini";164;0;100
0;5;"ninia";5;0;100
0;6;"niniola";6;0;100
0;29;"ninive";29;0;100
0;19;"ninja";19;0;100
0;46;"ninna";46;0;100
0;5;"ninnette";5;0;100
0;65;"ninnie";65;0;100
2333;21;"nino";2354;99.10790144435;0.892098555649957
0;21;"ninon";21;0;100
28;0;"ninos";28;100;0
0;124;"ninoshka";124;0;100
0;106;"ninoska";106;0;100
0;11;"ninotchka";11;0;100
0;27;"ninti";27;0;100
18;0;"nio";18;100;0
0;158;"niobe";158;0;100
0;6;"niobi";6;0;100
0;113;"nioka";113;0;100
0;5;"niola";5;0;100
0;95;"nioma";95;0;100
0;42;"niome";42;0;100
0;779;"niomi";779;0;100
0;47;"niomie";47;0;100
0;5;"niosha";5;0;100
16;0;"nipun";16;100;0
79;0;"niquan";79;100;0
0;5;"niquel";5;0;100
0;5;"niquisha";5;0;100
0;119;"niquita";119;0;100
43;0;"nir";43;100;0
6;640;"nira";646;0.928792569659443;99.0712074303406
0;5;"nirah";5;0;100
325;0;"niraj";325;100;0
17;0;"niral";17;100;0
0;321;"nirali";321;0;100
0;38;"niralya";38;0;100
13;0;"niran";13;100;0
90;0;"niranjan";90;100;0
0;21;"niranjana";21;0;100
456;0;"nirav";456;100;0
0;5;"niree";5;0;100
5;0;"nirek";5;100;0
6;73;"nirel";79;7.59493670886076;92.4050632911392
0;5;"nirgun";5;0;100
0;32;"niria";32;0;100
0;11;"niriah";11;0;100
0;5;"niriyah";5;0;100
0;15;"nirja";15;0;100
32;0;"nirmal";32;100;0
0;11;"nirmala";11;0;100
0;5;"nirmeen";5;0;100
0;12;"nirva";12;0;100
172;0;"nirvaan";172;100;0
188;0;"nirvan";188;100;0
0;800;"nirvana";800;0;100
0;87;"nirvi";87;0;100
6;0;"nirvik";6;100;0
0;1545;"nisa";1545;0;100
0;46;"nisaa";46;0;100
77;0;"nisaiah";77;100;0
5;0;"nisan";5;100;0
10;0;"nisarg";10;100;0
39;0;"nischal";39;100;0
5;0;"nisean";5;100;0
20;0;"nish";20;100;0
0;2857;"nisha";2857;0;100
48;0;"nishaan";48;100;0
31;0;"nishad";31;100;0
25;0;"nishal";25;100;0
285;0;"nishan";285;100;0
570;0;"nishant";570;100;0
197;0;"nishanth";197;100;0
0;167;"nishat";167;0;100
5;0;"nishaun";5;100;0
59;0;"nishawn";59;100;0
0;10;"nishay";10;0;100
0;33;"nishelle";33;0;100
0;241;"nishi";241;0;100
0;11;"nishia";11;0;100
0;154;"nishika";154;0;100
27;0;"nishil";27;100;0
0;135;"nishita";135;0;100
5;0;"nishith";5;100;0
0;22;"nishitha";22;0;100
0;393;"nishka";393;0;100
0;16;"nishma";16;0;100
5;0;"nishon";5;100;0
0;15;"nishta";15;0;100
0;116;"nishtha";116;0;100
0;29;"nisi";29;0;100
6;0;"nisiah";6;100;0
0;15;"nisma";15;0;100
0;313;"nisreen";313;0;100
0;1456;"nissa";1456;0;100
65;5;"nissan";70;92.8571428571429;7.14285714285714
7;0;"nissen";7;100;0
0;400;"nissi";400;0;100
0;5;"nissie";5;0;100
170;0;"nissim";170;100;0
15;0;"nisson";15;100;0
0;5;"nissy";5;0;100
0;13802;"nita";13802;0;100
24;0;"nitai";24;100;0
0;15;"nitalia";15;0;100
0;116;"nitara";116;0;100
0;323;"nitasha";323;0;100
0;15;"nitaya";15;0;100
50;0;"nitesh";50;100;0
0;105;"nithila";105;0;100
41;0;"nithilan";41;100;0
339;0;"nithin";339;100;0
7;0;"nithish";7;100;0
0;622;"nithya";622;0;100
0;71;"niti";71;0;100
0;144;"nitika";144;0;100
625;0;"nitin";625;100;0
83;0;"nitish";83;100;0
0;59;"nitisha";59;0;100
0;48;"nitosha";48;0;100
0;5;"nitoya";5;0;100
0;35;"nitra";35;0;100
0;11;"nitsa";11;0;100
0;11;"nittaya";11;0;100
5;803;"nitya";808;0.618811881188119;99.3811881188119
0;540;"nitza";540;0;100
0;93;"nitzia";93;0;100
0;5;"nitzy";5;0;100
0;5;"niurca";5;0;100
0;260;"niurka";260;0;100
50;0;"niv";50;100;0
0;314;"niva";314;0;100
190;0;"nivaan";190;100;0
0;25;"nivaeh";25;0;100
46;0;"nivan";46;100;0
0;26;"nivaya";26;0;100
0;10;"nivayah";10;0;100
0;1120;"nivea";1120;0;100
0;238;"niveah";238;0;100
37;0;"nived";37;100;0
50;0;"nivedh";50;100;0
0;39;"nivedha";39;0;100
0;85;"nivedita";85;0;100
0;10;"niveditha";10;0;100
0;34;"niveen";34;0;100
120;0;"nivek";120;100;0
24;0;"niven";24;100;0
0;5;"nivetha";5;0;100
0;9;"niveya";9;0;100
0;22;"niveyah";22;0;100
0;541;"nivia";541;0;100
0;20;"niviah";20;0;100
38;0;"nivin";38;100;0
0;40;"nivriti";40;0;100
12;5;"nix";17;70.5882352941177;29.4117647058824
0;10;"nixaliz";10;0;100
44;0;"nixen";44;100;0
0;281;"nixie";281;0;100
26;0;"nixin";26;100;0
0;5;"nixmary";5;0;100
0;6;"nixola";6;0;100
3833;165;"nixon";3998;95.8729364682341;4.12706353176588
36;0;"nixson";36;100;0
52;0;"nixxon";52;100;0
0;7;"nixzaliz";7;0;100
0;3921;"niya";3921;0;100
0;11;"niyae";11;0;100
0;2220;"niyah";2220;0;100
0;6;"niyahlee";6;0;100
0;6;"niyahna";6;0;100
50;0;"niyam";50;100;0
5;0;"niyan";5;100;0
0;307;"niyana";307;0;100
0;7;"niyanah";7;0;100
0;234;"niyanna";234;0;100
0;6;"niyara";6;0;100
0;24;"niyasia";24;0;100
0;5;"niyat";5;0;100
0;36;"niyathi";36;0;100
0;286;"niyati";286;0;100
6;0;"niyaz";6;100;0
0;5;"niyel";5;0;100
0;10;"niyeli";10;0;100
0;13;"niyelle";13;0;100
0;6;"niyema";6;0;100
0;5;"niyia";5;0;100
0;368;"niyla";368;0;100
0;325;"niylah";325;0;100
0;25;"niyoka";25;0;100
0;16;"niyomi";16;0;100
5;0;"niyon";5;100;0
0;11;"niyona";11;0;100
0;101;"niyonna";101;0;100
0;133;"niza";133;0;100
36;0;"nizaiah";36;100;0
5;0;"nizam";5;100;0
279;0;"nizar";279;100;0
5;0;"nizear";5;100;0
0;5;"nizeria";5;0;100
0;610;"nizhoni";610;0;100
0;6;"nizhonii";6;0;100
0;286;"njeri";286;0;100
0;11;"njideka";11;0;100
0;5;"nkao";5;0;100
0;5;"nkara";5;0;100
0;14;"nkauj";14;0;100
0;5;"nkayla";5;0;100
0;175;"nkechi";175;0;100
0;41;"nkechinyere";41;0;100
0;5;"nkem";5;0;100
0;7;"nkemdilim";7;0;100
5;0;"nkemjika";5;100;0
0;122;"nkenge";122;0;100
0;10;"nkiru";10;0;100
0;27;"nkiruka";27;0;100
0;6;"nkiya";6;0;100
0;5;"nkiyah";5;0;100
326;7;"nkosi";333;97.8978978978979;2.1021021021021
27;0;"nkrumah";27;100;0
0;8;"nna";8;0;100
89;0;"nnaemeka";89;100;0
660;0;"nnamdi";660;100;0
5;0;"nnanna";5;100;0
0;1172;"nneka";1172;0;100
0;275;"nnenna";275;0;100
0;196;"nneoma";196;0;100
6;12;"no";18;33.3333333333333;66.6666666666667
1330;4025;"noa";5355;24.8366013071895;75.1633986928105
14;5;"noaah";19;73.6842105263158;26.3157894736842
242;0;"noach";242;100;0
355124;1770;"noah";356894;99.5040544251234;0.495945574876574
12;0;"noahalexander";12;100;0
5;0;"noahanthony";5;100;0
15;0;"noahgabriel";15;100;0
16;0;"noahh";16;100;0
35;0;"noahjames";35;100;0
5;0;"noahmichael";5;100;0
425;0;"noal";425;100;0
0;11;"noalani";11;0;100
1903;209;"noam";2112;90.1041666666667;9.89583333333333
0;805;"noami";805;0;100
37;0;"noan";37;100;0
10;0;"noar";10;100;0
177;0;"nobel";177;100;0
37;0;"nobert";37;100;0
47;0;"noberto";47;100;0
0;21;"nobia";21;0;100
0;456;"nobie";456;0;100
7944;350;"noble";8294;95.7800819869785;4.21991801302146
484;0;"noboru";484;100;0
0;5;"nobu";5;0;100
0;12;"nobue";12;0;100
20;0;"nobuichi";20;100;0
0;371;"nobuko";371;0;100
242;0;"nobuo";242;100;0
0;5;"nobuye";5;0;100
11;0;"nobuyoshi";11;100;0
19;0;"nobuyuki";19;100;0
103;0;"nocholas";103;100;0
177;0;"nochum";177;100;0
0;176;"nocole";176;0;100
11;6;"nocona";17;64.7058823529412;35.2941176470588
0;6;"noda";6;0;100
0;12;"nodia";12;0;100
0;17;"nodie";17;0;100
11;0;"nodin";11;100;0
0;6;"nodra";6;0;100
20383;294;"noe";20677;98.5781302896939;1.42186971030614
100;0;"noeh";100;100;0
0;8;"noehly";8;0;100
0;28;"noehmi";28;0;100
45126;13688;"noel";58814;76.7266297140137;23.2733702859863
0;177;"noela";177;0;100
24;0;"noelan";24;100;0
0;2574;"noelani";2574;0;100
0;5;"noelany";5;0;100
0;135;"noele";135;0;100
0;6;"noelene";6;0;100
0;339;"noeli";339;0;100
0;6433;"noelia";6433;0;100
0;141;"noelie";141;0;100
0;16;"noelis";16;0;100
0;6;"noeliz";6;0;100
71;595;"noell";666;10.6606606606607;89.3393393393393
0;2200;"noella";2200;0;100
65;31642;"noelle";31707;0.2050020500205;99.7949979499795
0;5;"noelli";5;0;100
0;23;"noellia";23;0;100
0;24;"noellie";24;0;100
0;104;"noelly";104;0;100
0;534;"noely";534;0;100
0;14;"noelya";14;0;100
0;10;"noema";10;0;100
0;6;"noeme";6;0;100
69;19293;"noemi";19362;0.356368143786799;99.6436318562132
0;315;"noemie";315;0;100
0;1598;"noemy";1598;0;100
29;0;"noey";29;100;0
14;0;"nofer";14;100;0
0;159;"noga";159;0;100
56;311;"noha";367;15.2588555858311;84.7411444141689
21;0;"nohe";21;100;0
24;86;"nohea";110;21.8181818181818;78.1818181818182
0;173;"nohealani";173;0;100
0;61;"nohelani";61;0;100
0;114;"noheli";114;0;100
0;236;"nohelia";236;0;100
0;5;"nohelly";5;0;100
0;808;"nohely";808;0;100
0;1819;"nohemi";1819;0;100
0;351;"nohemy";351;0;100
23;0;"nohl";23;100;0
66;0;"nohlan";66;100;0
0;14;"noire";14;0;100
10;0;"nojus";10;100;0
0;5;"nokia";5;0;100
0;55;"nokomis";55;0;100
9;20966;"nola";20975;0.0429082240762813;99.9570917759237
0;109;"nolah";109;0;100
88551;290;"nolan";88841;99.6735741380669;0.326425861933116
0;31;"nolana";31;0;100
1545;0;"noland";1545;100;0
0;23;"nolani";23;0;100
84;0;"nolawi";84;100;0
0;12;"nolawit";12;0;100
591;0;"nolberto";591;100;0
0;13;"nolda";13;0;100
167;5;"nole";172;97.0930232558139;2.90697674418605
0;48;"nolee";48;0;100
0;5;"noleen";5;0;100
2825;5;"nolen";2830;99.8233215547703;0.176678445229682
0;58;"nolene";58;0;100
0;19;"noli";19;0;100
0;443;"nolia";443;0;100
7;211;"nolie";218;3.21100917431193;96.7889908256881
369;0;"nolin";369;100;0
0;90;"nolita";90;0;100
55;0;"nollan";55;100;0
86;259;"nollie";345;24.9275362318841;75.0724637681159
142;0;"nolon";142;100;0
115;0;"nolton";115;100;0
488;80;"nolyn";568;85.9154929577465;14.0845070422535
0;33;"nolynn";33;0;100
0;1816;"noma";1816;0;100
57;0;"noman";57;100;0
485;0;"nomar";485;100;0
0;177;"nomi";177;0;100
0;15;"nomia";15;0;100
0;63;"nomie";63;0;100
0;15310;"nona";15310;0;100
0;5;"nonah";5;0;100
11;5;"noname";16;68.75;31.25
0;21;"nonda";21;0;100
0;29;"nondas";29;0;100
0;5;"nondus";5;0;100
5;0;"nong";5;100;0
0;554;"noni";554;0;100
0;28;"nonia";28;0;100
0;1103;"nonie";1103;0;100
0;98;"nonna";98;0;100
0;655;"nonnie";655;0;100
0;28;"nonya";28;0;100
52;0;"nooh";52;100;0
0;28;"noomi";28;0;100
0;21;"noon";21;0;100
704;5176;"noor";5880;11.9727891156463;88.0272108843537
0;517;"noora";517;0;100
0;50;"noorah";50;0;100
0;6;"noorain";6;0;100
0;10;"nooreen";10;0;100
0;5;"noorhan";5;0;100
0;17;"noori";17;0;100
0;5;"nooria";5;0;100
0;11;"nooriya";11;0;100
0;5;"noorjahan";5;0;100
0;6;"noorulain";6;0;100
6;11;"nor";17;35.2941176470588;64.7058823529412
685;123831;"nora";124516;0.550130103761766;99.4498698962382
0;113;"noraa";113;0;100
0;60;"norabelle";60;0;100
129;18228;"norah";18357;0.70272920411832;99.2972707958817
0;21;"noraida";21;0;100
0;5;"norajean";5;0;100
0;5;"norakate";5;0;100
5;0;"noral";5;100;0
0;21;"noralba";21;0;100
0;423;"noralee";423;0;100
0;12;"noraleigh";12;0;100
0;10;"noralie";10;0;100
0;5;"noralva";5;0;100
0;84;"noralyn";84;0;100
0;27;"noralynn";27;0;100
0;35;"noran";35;0;100
0;11;"norann";11;0;100
0;5;"noranne";5;0;100
5;0;"norb";5;100;0
20121;6;"norbert";20127;99.970189297958;0.0298107020420331
0;256;"norberta";256;0;100
4739;0;"norberto";4739;100;0
6;0;"norbu";6;100;0
12;0;"nord";12;100;0
0;5;"norda";5;0;100
5;0;"nordahl";5;100;0
31;5;"nore";36;86.1111111111111;13.8888888888889
0;10;"norea";10;0;100
0;38;"norean";38;0;100
0;17;"noreda";17;0;100
0;5;"noree";5;0;100
0;19855;"noreen";19855;0;100
0;149;"noreene";149;0;100
0;8;"noreeta";8;0;100
0;8;"noreita";8;0;100
0;22;"noreli";22;0;100
0;5;"norelia";5;0;100
0;11;"norelis";11;0;100
15;64;"norell";79;18.9873417721519;81.0126582278481
0;117;"norelle";117;0;100
0;85;"norely";85;0;100
0;5;"norelys";5;0;100
5;0;"noren";5;100;0
0;120;"norena";120;0;100
0;4739;"norene";4739;0;100
0;91;"noreta";91;0;100
0;5;"noretha";5;0;100
0;381;"noretta";381;0;100
77;0;"norfleet";77;100;0
0;50;"norhan";50;0;100
45;983;"nori";1028;4.37743190661479;95.6225680933852
0;31;"noria";31;0;100
0;226;"noriah";226;0;100
5;0;"norian";5;100;0
0;23;"noriana";23;0;100
0;5;"norianna";5;0;100
0;75;"norie";75;0;100
54;5;"noriel";59;91.5254237288136;8.47457627118644
0;27;"norielle";27;0;100
0;5;"noriene";5;0;100
0;6;"norietta";6;0;100
0;5;"norika";5;0;100
0;160;"noriko";160;0;100
0;260;"norina";260;0;100
0;5042;"norine";5042;0;100
0;99;"norinne";99;0;100
19;0;"norio";19;100;0
78;48;"noris";126;61.9047619047619;38.0952380952381
0;57;"norissa";57;0;100
0;799;"norita";799;0;100
0;8;"noritta";8;0;100
0;40;"noriyah";40;0;100
86;0;"norlan";86;100;0
16;0;"norland";16;100;0
0;77;"norleen";77;0;100
0;192;"norlene";192;0;100
15;0;"norlin";15;100;0
0;16;"norlisha";16;0;100
0;15;"norlishia";15;0;100
20;0;"norlyn";20;100;0
563;0;"norm";563;100;0
1279;274805;"norma";276084;0.463264803465612;99.5367351965344
0;10;"normaa";10;0;100
0;97;"normagene";97;0;100
0;449;"normajean";449;0;100
125;45;"normal";170;73.5294117647059;26.4705882352941
0;5;"normalea";5;0;100
0;257;"normalee";257;0;100
0;32;"normalinda";32;0;100
248497;1592;"norman";250089;99.3634266201232;0.636573379876764
5829;0;"normand";5829;100;0
0;50;"normandie";50;0;100
10;0;"normando";10;100;0
0;43;"normandy";43;0;100
10;0;"normen";10;100;0
0;5;"normia";5;0;100
0;21;"normie";21;0;100
263;0;"normon";263;100;0
0;16;"norna";16;0;100
0;12;"norra";12;0;100
0;11;"norrah";11;0;100
0;6;"norreen";6;0;100
5;0;"norrell";5;100;0
0;23;"norrene";23;0;100
0;6;"norreta";6;0;100
0;5;"norretta";5;0;100
0;5;"norri";5;0;100
0;23;"norrie";23;0;100
88;0;"norrin";88;100;0
0;357;"norrine";357;0;100
15993;523;"norris";16516;96.833373698232;3.16662630176798
0;11;"norrisa";11;0;100
0;16;"norrita";16;0;100
242;6;"north";248;97.5806451612903;2.41935483870968
0;16;"northa";16;0;100
45;0;"northern";45;100;0
2238;0;"norton";2238;100;0
0;365;"norva";365;0;100
2321;0;"norval";2321;100;0
26;0;"norvan";26;100;0
841;5;"norvel";846;99.4089834515366;0.591016548463357
1158;117;"norvell";1275;90.8235294117647;9.17647058823529
0;163;"norvella";163;0;100
16;24;"norvelle";40;40;60
0;5;"norvie";5;0;100
71;0;"norvil";71;100;0
324;0;"norville";324;100;0
926;0;"norvin";926;100;0
0;13;"norvis";13;0;100
16;0;"norward";16;100;0
73;0;"norwin";73;100;0
2861;0;"norwood";2861;100;0
0;23;"nory";23;0;100
5;0;"nosakhare";5;100;0
0;10;"nosheen";10;0;100
0;34;"noshin";34;0;100
5;0;"noslen";5;100;0
561;0;"nosson";561;100;0
12;0;"not";12;100;0
0;51;"nota";51;0;100
0;21;"notasha";21;0;100
0;44;"notie";44;0;100
6;0;"notley";6;100;0
722;643;"notnamed";1365;52.8937728937729;47.1062271062271
51;0;"notorious";51;100;0
56;352;"nou";408;13.7254901960784;86.2745098039216
0;16;"nouchee";16;0;100
0;6;"nouci";6;0;100
0;20;"nouf";20;0;100
33;0;"nouh";33;100;0
0;5;"nouha";5;0;100
33;0;"nouman";33;100;0
415;1966;"nour";2381;17.4296514069719;82.5703485930281
0;645;"noura";645;0;100
0;12;"nourah";12;0;100
0;17;"nouran";17;0;100
6;0;"noureddine";6;100;0
0;19;"noureen";19;0;100
0;32;"nourhan";32;0;100
18;6;"nouri";24;75;25
0;5;"nouvelle";5;0;100
1050;12418;"nova";13468;7.7962577962578;92.2037422037422
112;447;"novah";559;20.0357781753131;79.9642218246869
170;0;"novak";170;100;0
11;0;"noval";11;100;0
0;27;"novalea";27;0;100
0;1525;"novalee";1525;0;100
0;36;"novalei";36;0;100
0;284;"novaleigh";284;0;100
0;26;"novalene";26;0;100
0;5;"novaley";5;0;100
0;62;"novali";62;0;100
0;177;"novalie";177;0;100
0;5;"novalise";5;0;100
0;24;"novaly";24;0;100
0;43;"novalyn";43;0;100
0;92;"novalynn";92;0;100
6;0;"novan";6;100;0
0;5;"novarae";5;0;100
0;5;"novaya";5;0;100
42;34;"novel";76;55.2631578947368;44.7368421052632
0;5;"novela";5;0;100
0;5;"novelia";5;0;100
0;34;"noveline";34;0;100
5;41;"novell";46;10.8695652173913;89.1304347826087
0;5541;"novella";5541;0;100
0;132;"novelle";132;0;100
0;602;"november";602;0;100
0;21;"novena";21;0;100
0;11;"noveta";11;0;100
5;39;"novi";44;11.3636363636364;88.6363636363636
0;238;"novia";238;0;100
36;0;"novian";36;100;0
0;107;"novice";107;0;100
6;296;"novie";302;1.98675496688742;98.0132450331126
15;139;"novis";154;9.74025974025974;90.2597402597403
5;0;"nowa";5;100;0
10;0;"nowah";10;100;0
162;0;"nowell";162;100;0
0;11;"nowshin";11;0;100
80;0;"nox";80;100;0
16;0;"noxx";16;100;0
0;22;"noy";22;0;100
0;181;"noya";181;0;100
5;0;"noyan";5;100;0
19;0;"noyes";19;100;0
0;6;"nozanin";6;0;100
0;95;"nozomi";95;0;100
0;12;"nseya";12;0;100
0;17;"nsombi";17;0;100
5;0;"nthan";5;100;0
61;0;"nthony";61;100;0
0;289;"nuala";289;0;100
0;6;"nuam";6;0;100
30;0;"nubaid";30;100;0
0;39;"nube";39;0;100
0;1963;"nubia";1963;0;100
0;22;"nubian";22;0;100
143;0;"nuchem";143;100;0
88;0;"nuel";88;100;0
6;0;"nugent";6;100;0
128;0;"nuh";128;100;0
0;491;"nuha";491;0;100
0;34;"nuhamin";34;0;100
157;61;"numa";218;72.0183486238532;27.9816513761468
58;0;"numair";58;100;0
69;0;"numan";69;100;0
0;6;"nuna";6;0;100
20;0;"nuncio";20;100;0
116;0;"nuno";116;100;0
0;27;"nunziata";27;0;100
18;0;"nunzie";18;100;0
1771;0;"nunzio";1771;100;0
0;5;"nuoyi";5;0;100
0;110;"nupur";110;0;100
123;352;"nur";475;25.8947368421053;74.1052631578947
0;466;"nura";466;0;100
5;0;"nuradin";5;100;0
0;67;"nurah";67;0;100
0;10;"nuran";10;0;100
0;5;"nuray";5;0;100
5;0;"nuraz";5;100;0
0;5;"nureen";5;0;100
266;245;"nuri";511;52.0547945205479;47.945205479452
0;590;"nuria";590;0;100
0;32;"nuriah";32;0;100
55;0;"nuriel";55;100;0
0;5;"nurit";5;0;100
0;56;"nuriya";56;0;100
0;58;"nuriyah";58;0;100
5;0;"nurmuhammad";5;100;0
0;13;"nurto";13;0;100
10;0;"nuru";10;100;0
0;13;"nurul";13;0;100
0;115;"nury";115;0;100
0;77;"nusaiba";77;0;100
0;31;"nusaibah";31;0;100
0;62;"nusayba";62;0;100
0;148;"nusaybah";148;0;100
0;174;"nusrat";174;0;100
56;0;"nussen";56;100;0
33;0;"nute";33;100;0
0;1021;"nuvia";1021;0;100
0;28;"nuzhat";28;0;100
0;5;"nwamaka";5;0;100
0;11;"ny";11;0;100
0;5055;"nya";5055;0;100
0;5;"nyagoa";5;0;100
5;4419;"nyah";4424;0.113019891500904;99.8869801084991
0;11;"nyahlee";11;0;100
0;5;"nyaijah";5;0;100
0;5;"nyailah";5;0;100
72;0;"nyair";72;100;0
0;189;"nyaira";189;0;100
0;43;"nyairah";43;0;100
105;54;"nyaire";159;66.0377358490566;33.9622641509434
0;47;"nyaisa";47;0;100
0;123;"nyaisha";123;0;100
0;129;"nyaja";129;0;100
0;111;"nyajah";111;0;100
0;5;"nyajiah";5;0;100
0;6;"nyakume";6;0;100
96;0;"nyal";96;100;0
0;233;"nyala";233;0;100
0;29;"nyalah";29;0;100
0;37;"nyalee";37;0;100
0;17;"nyalise";17;0;100
0;28;"nyamal";28;0;100
82;0;"nyan";82;100;0
0;379;"nyana";379;0;100
0;12;"nyangel";12;0;100
0;12;"nyani";12;0;100
0;271;"nyanna";271;0;100
0;46;"nyanza";46;0;100
0;6;"nyaomi";6;0;100
0;143;"nyara";143;0;100
0;32;"nyarah";32;0;100
0;23;"nyarai";23;0;100
0;102;"nyari";102;0;100
0;27;"nyarie";27;0;100
0;10;"nyasa";10;0;100
0;635;"nyasha";635;0;100
0;251;"nyashia";251;0;100
0;4925;"nyasia";4925;0;100
0;168;"nyasiah";168;0;100
0;16;"nyauna";16;0;100
0;70;"nyazia";70;0;100
0;5;"nyaziah";5;0;100
0;14;"nybria";14;0;100
79;0;"nycere";79;100;0
0;157;"nychelle";157;0;100
201;0;"nycholas";201;100;0
0;12;"nychole";12;0;100
0;5;"nycia";5;0;100
5;0;"nyckolas";5;100;0
10;0;"nycolas";10;100;0
0;943;"nycole";943;0;100
0;47;"nyda";47;0;100
0;5;"nydaisha";5;0;100
0;7;"nydasia";7;0;100
0;5;"nyderah";5;0;100
0;3625;"nydia";3625;0;100
5;0;"nydir";5;100;0
0;11;"nydirah";11;0;100
0;14;"nydra";14;0;100
10;0;"nye";10;100;0
0;21;"nyeasha";21;0;100
0;5;"nyeasia";5;0;100
275;0;"nyeem";275;100;0
0;160;"nyeema";160;0;100
0;85;"nyeemah";85;0;100
0;57;"nyeesha";57;0;100
5;0;"nyeim";5;100;0
0;450;"nyeisha";450;0;100
0;5;"nyeka";5;0;100
52;16;"nyel";68;76.4705882352941;23.5294117647059
0;201;"nyela";201;0;100
0;72;"nyelah";72;0;100
0;5;"nyele";5;0;100
0;117;"nyeli";117;0;100
0;10;"nyell";10;0;100
0;67;"nyella";67;0;100
0;261;"nyelle";261;0;100
0;102;"nyelli";102;0;100
0;106;"nyellie";106;0;100
0;566;"nyema";566;0;100
0;160;"nyemah";160;0;100
0;5;"nyemia";5;0;100
0;25;"nyemiah";25;0;100
0;48;"nyera";48;0;100
6;0;"nyerere";6;100;0
0;1511;"nyesha";1511;0;100
0;256;"nyeshia";256;0;100
10;0;"nygee";10;100;0
469;0;"nygel";469;100;0
0;171;"nygeria";171;0;100
0;6;"nygia";6;0;100
24;0;"nygil";24;100;0
0;32;"nyha";32;0;100
99;0;"nyheem";99;100;0
77;0;"nyheim";77;100;0
5;0;"nyhiem";5;100;0
0;62;"nyhla";62;0;100
5;640;"nyia";645;0.775193798449612;99.2248062015504
0;216;"nyiah";216;0;100
0;5;"nyiana";5;0;100
0;6;"nyiasia";6;0;100
0;22;"nyiema";22;0;100
16;0;"nyier";16;100;0
0;225;"nyiesha";225;0;100
0;52;"nyila";52;0;100
0;52;"nyilah";52;0;100
0;209;"nyima";209;0;100
0;76;"nyimah";76;0;100
0;38;"nyirah";38;0;100
0;532;"nyisha";532;0;100
0;197;"nyja";197;0;100
0;177;"nyjae";177;0;100
355;537;"nyjah";892;39.7982062780269;60.2017937219731
0;63;"nyjai";63;0;100
12;0;"nyjal";12;100;0
12;0;"nyjee";12;100;0
33;0;"nyjel";33;100;0
0;13;"nyjeria";13;0;100
0;28;"nyjia";28;0;100
17;0;"nyjuan";17;100;0
0;88;"nykayla";88;0;100
0;44;"nykea";44;0;100
0;6;"nykeah";6;0;100
0;26;"nykeba";26;0;100
10;0;"nykee";10;100;0
56;0;"nykeem";56;100;0
0;6;"nykeema";6;0;100
0;12;"nykeemah";12;0;100
0;5;"nykeesha";5;0;100
0;17;"nykeia";17;0;100
0;16;"nykeira";16;0;100
0;54;"nykeisha";54;0;100
39;0;"nykel";39;100;0
7;0;"nykell";7;100;0
0;43;"nykera";43;0;100
0;457;"nykeria";457;0;100
0;80;"nykerria";80;0;100
0;51;"nykesha";51;0;100
0;13;"nykeshia";13;0;100
0;5;"nykeya";5;0;100
0;30;"nykhia";30;0;100
0;980;"nykia";980;0;100
0;73;"nykiah";73;0;100
0;10;"nykiera";10;0;100
0;207;"nykira";207;0;100
0;5;"nykiria";5;0;100
0;40;"nykisha";40;0;100
0;40;"nykita";40;0;100
64;0;"nyko";64;100;0
292;0;"nykolas";292;100;0
0;228;"nykole";228;0;100
0;16489;"nyla";16489;0;100
0;33;"nylaa";33;0;100
0;5;"nylae";5;0;100
0;6976;"nylah";6976;0;100
0;5;"nylajah";5;0;100
274;66;"nylan";340;80.5882352941177;19.4117647058824
0;51;"nylani";51;0;100
0;53;"nylasia";53;0;100
0;28;"nylaya";28;0;100
0;24;"nylayah";24;0;100
1623;31;"nyle";1654;98.1257557436518;1.87424425634825
0;45;"nylea";45;0;100
0;160;"nyleah";160;0;100
0;140;"nylee";140;0;100
0;41;"nyleen";41;0;100
0;5;"nylei";5;0;100
0;7;"nyleigh";7;0;100
56;5;"nylen";61;91.8032786885246;8.19672131147541
0;77;"nylene";77;0;100
661;0;"nyles";661;100;0
0;5;"nyleve";5;0;100
0;210;"nylia";210;0;100
0;179;"nyliah";179;0;100
0;30;"nylie";30;0;100
12;5;"nylin";17;70.5882352941177;29.4117647058824
0;53;"nyliyah";53;0;100
0;22;"nylla";22;0;100
0;19;"nyllah";19;0;100
0;5;"nylyn";5;0;100
0;16;"nymeria";16;0;100
101;0;"nymir";101;100;0
0;155;"nyna";155;0;100
0;31;"nyobi";31;0;100
0;946;"nyoka";946;0;100
0;15;"nyome";15;0;100
0;5;"nyomee";5;0;100
0;1733;"nyomi";1733;0;100
0;140;"nyomie";140;0;100
0;13;"nyomii";13;0;100
0;16;"nyona";16;0;100
0;109;"nyonna";109;0;100
0;5;"nyosha";5;0;100
0;35;"nyota";35;0;100
147;0;"nyquan";147;100;0
0;6;"nyquasha";6;0;100
0;8;"nyquasia";8;0;100
0;545;"nyra";545;0;100
0;69;"nyrah";69;0;100
5;0;"nyran";5;100;0
5;6;"nyre";11;45.4545454545455;54.5454545454545
155;1573;"nyree";1728;8.96990740740741;91.0300925925926
5;0;"nyrek";5;100;0
55;0;"nyrell";55;100;0
0;10;"nyria";10;0;100
0;123;"nyriah";123;0;100
0;97;"nyrie";97;0;100
0;5;"nyrissa";5;0;100
0;21;"nyrobi";21;0;100
112;0;"nyron";112;100;0
0;237;"nysa";237;0;100
28;0;"nysaiah";28;100;0
23;0;"nysean";23;100;0
17;0;"nyseem";17;100;0
0;196;"nysha";196;0;100
0;5;"nyshae";5;0;100
79;0;"nyshaun";79;100;0
183;0;"nyshawn";183;100;0
0;5;"nyshay";5;0;100
0;16;"nyshea";16;0;100
0;53;"nyshia";53;0;100
5;0;"nyshon";5;100;0
0;65;"nysia";65;0;100
206;0;"nysir";206;100;0
6;0;"nysire";6;100;0
5;0;"nyson";5;100;0
0;1625;"nyssa";1625;0;100
0;34;"nytasha";34;0;100
0;22;"nytasia";22;0;100
5;0;"nytavious";5;100;0
0;18;"nyteria";18;0;100
0;28;"nytia";28;0;100
0;6;"nytisha";6;0;100
5;0;"nytrell";5;100;0
0;8;"nyvaeh";8;0;100
0;6;"nyvea";6;0;100
0;21;"nyveah";21;0;100
0;5;"nyvia";5;0;100
6;81;"nyx";87;6.89655172413793;93.1034482758621
31;0;"nyxon";31;100;0
0;37;"nyya";37;0;100
10;0;"nyzae";10;100;0
167;0;"nyzaiah";167;100;0
7;0;"nyzair";7;100;0
6;0;"nyzaire";6;100;0
17;0;"nyzere";17;100;0
0;17;"nyzeria";17;0;100
0;5;"nyzeth";5;0;100
31;0;"nyziah";31;100;0
92;0;"nyzier";92;100;0
215;0;"nyzir";215;100;0
0;291;"nzinga";291;0;100
0;56;"nzingha";56;0;100
0;16;"nzuri";16;0;100
202;0;"oak";202;100;0
30;0;"oaken";30;100;0
56;0;"oakes";56;100;0
5;0;"oakey";5;100;0
10;10;"oakie";20;50;50
30;0;"oaklan";30;100;0
273;26;"oakland";299;91.304347826087;8.69565217391304
0;11;"oaklea";11;0;100
227;959;"oaklee";1186;19.1399662731872;80.8600337268128
0;25;"oaklei";25;0;100
0;516;"oakleigh";516;0;100
81;0;"oaklen";81;100;0
4767;2763;"oakley";7530;63.3067729083665;36.6932270916335
0;18;"oakli";18;0;100
0;290;"oaklie";290;0;100
6;0;"oaklin";6;100;0
11;0;"oakly";11;100;0
31;319;"oaklyn";350;8.85714285714286;91.1428571428572
0;5;"oaklynd";5;0;100
0;244;"oaklynn";244;0;100
27;0;"oaks";27;100;0
0;237;"oanh";237;0;100
5;172;"oasis";177;2.82485875706215;97.1751412429379
0;5;"oatha";5;0;100
427;0;"oather";427;100;0
46;0;"oatis";46;100;0
52;0;"oba";52;100;0
32;0;"obada";32;100;0
1551;0;"obadiah";1551;100;0
5;0;"obafemi";5;100;0
15;0;"obaid";15;100;0
6;0;"obaida";6;100;0
54;0;"obaloluwa";54;100;0
30;0;"obama";30;100;0
5;0;"obasi";5;100;0
296;0;"obbie";296;100;0
0;163;"obdulia";163;0;100
68;0;"obdulio";68;100;0
57;0;"obe";57;100;0
3444;0;"obed";3444;100;0
0;5;"obeda";5;0;100
182;0;"obediah";182;100;0
0;5;"obehi";5;0;100
0;77;"obelia";77;0;100
15;0;"ober";15;100;0
0;216;"obera";216;0;100
0;68;"oberia";68;0;100
64;0;"oberon";64;100;0
609;0;"obert";609;100;0
0;6;"oberta";6;0;100
22;0;"oberyn";22;100;0
26;0;"obet";26;100;0
43;0;"obeth";43;100;0
16;0;"obey";16;100;0
81;0;"obi";81;100;0
0;22;"obianuju";22;0;100
3838;271;"obie";4109;93.4047213433926;6.59527865660745
742;0;"obinna";742;100;0
6;0;"obiora";6;100;0
59;0;"obra";59;100;0
5;0;"obrain";5;100;0
5;0;"obrey";5;100;0
444;0;"obrian";444;100;0
195;0;"obrien";195;100;0
5;0;"obry";5;100;0
279;0;"obryan";279;100;0
31;0;"obryant";31;100;0
6;0;"obsa";6;100;0
5;0;"obsidian";5;100;0
11;0;"oby";11;100;0
24;0;"oc";24;100;0
0;10;"oca";10;0;100
5;0;"ocasio";5;100;0
0;38;"occie";38;0;100
5;0;"oce";5;100;0
0;17;"ocea";17;0;100
0;16;"oceal";16;0;100
1479;1510;"ocean";2989;49.4814319170291;50.5185680829709
0;844;"oceana";844;0;100
0;95;"oceane";95;0;100
0;49;"oceania";49;0;100
0;371;"oceanna";371;0;100
0;32;"ocelia";32;0;100
0;5;"ocella";5;0;100
5;0;"ocelotl";5;100;0
0;21;"oceola";21;0;100
0;6;"ocey";6;0;100
0;111;"ocia";111;0;100
2578;3536;"ocie";6114;42.165521753353;57.834478246647
412;0;"ociel";412;100;0
14;0;"oconnor";14;100;0
0;118;"octa";118;0;100
7;0;"octabio";7;100;0
0;29;"octava";29;0;100
363;0;"octave";363;100;0
139;14581;"octavia";14720;0.94429347826087;99.0557065217391
983;0;"octavian";983;100;0
0;11;"octaviana";11;0;100
665;0;"octaviano";665;100;0
0;110;"octavie";110;0;100
23;0;"octavien";23;100;0
10230;5;"octavio";10235;99.9511480214949;0.0488519785051295
167;0;"octavion";167;100;0
1448;5;"octavious";1453;99.6558843771507;0.344115622849277
289;0;"octavis";289;100;0
2987;15;"octavius";3002;99.5003331112592;0.499666888740839
5;0;"octavus";5;100;0
0;38;"octayvia";38;0;100
0;68;"octivia";68;0;100
6;764;"october";770;0.779220779220779;99.2207792207792
5;0;"od";5;100;0
271;1000;"oda";1271;21.3217938630999;78.6782061369001
79;0;"odai";79;100;0
0;40;"odali";40;0;100
51;2487;"odalis";2538;2.00945626477541;97.9905437352246
0;264;"odaliz";264;0;100
0;77;"odaly";77;0;100
0;3142;"odalys";3142;0;100
0;17;"odalyz";17;0;100
5;0;"odaniel";5;100;0
82;0;"odarius";82;100;0
6;0;"odarrius";6;100;0
148;0;"odas";148;100;0
36;0;"oday";36;100;0
5;0;"odbert";5;100;0
336;250;"oddie";586;57.3378839590444;42.6621160409556
87;0;"oddis";87;100;0
17;0;"ode";17;100;0
0;315;"odeal";315;0;100
351;377;"odean";728;48.2142857142857;51.7857142857143
6;0;"oded";6;100;0
11;0;"odeh";11;100;0
181;5;"odel";186;97.3118279569892;2.68817204301075
0;2302;"odelia";2302;0;100
14528;4078;"odell";18606;78.0823390304203;21.9176609695797
0;788;"odella";788;0;100
10;424;"odelle";434;2.30414746543779;97.6958525345622
840;0;"oden";840;100;0
0;97;"odena";97;0;100
5;36;"odene";41;12.1951219512195;87.8048780487805
5;0;"oder";5;100;0
13;14;"odera";27;48.1481481481481;51.8518518518518
362;0;"odes";362;100;0
0;5;"odesa";5;0;100
154;16706;"odessa";16860;0.913404507710558;99.0865954922894
0;169;"odesser";169;0;100
0;25;"odessey";25;0;100
0;605;"odessia";605;0;100
0;591;"odessie";591;0;100
0;127;"odester";127;0;100
0;7;"odet";7;0;100
0;5;"odete";5;0;100
0;63;"odeth";63;0;100
0;11;"odett";11;0;100
0;618;"odetta";618;0;100
0;2717;"odette";2717;0;100
7;37;"odia";44;15.9090909090909;84.0909090909091
5;0;"odice";5;100;0
2315;1326;"odie";3641;63.5814336720681;36.4185663279319
198;0;"odies";198;100;0
0;5;"odila";5;0;100
0;623;"odile";623;0;100
0;1185;"odilia";1185;0;100
127;0;"odilon";127;100;0
5173;0;"odin";5173;100;0
37;0;"odinn";37;100;0
7986;171;"odis";8157;97.9036410445017;2.09635895549834
37;0;"odom";37;100;0
17;0;"odon";17;100;0
6;0;"odos";6;100;0
0;5;"odra";5;0;100
584;0;"odus";584;100;0
12;5;"ody";17;70.5882352941177;29.4117647058824
94;0;"odyn";94;100;0
200;0;"odysseus";200;100;0
5;489;"odyssey";494;1.01214574898785;98.9878542510121
5;0;"oel";5;100;0
0;5;"oella";5;0;100
5;0;"oen";5;100;0
0;5;"oesha";5;0;100
5;43;"ofa";48;10.4166666666667;89.5833333333333
17;0;"ofek";17;100;0
5;8239;"ofelia";8244;0.0606501698204755;99.9393498301795
144;66;"offie";210;68.5714285714286;31.4285714285714
0;472;"ofilia";472;0;100
46;5;"ofir";51;90.1960784313726;9.80392156862745
0;6;"ofri";6;0;100
685;0;"ogden";685;100;0
0;281;"ogechi";281;0;100
6;51;"ogechukwu";57;10.5263157894737;89.4736842105263
0;5;"oghenemine";5;0;100
16;0;"ogheneruno";16;100;0
0;5;"ogheneruona";5;0;100
5;0;"oghenetega";5;100;0
0;5;"oghosa";5;0;100
15;6;"ogie";21;71.4285714285714;28.5714285714286
113;10;"ogle";123;91.869918699187;8.13008130081301
0;5;"ogochukwu";5;0;100
0;5;"ogreta";5;0;100
10;0;"oguz";10;100;0
5;0;"oh";5;100;0
10;0;"ohad";10;100;0
7;0;"ohagi";7;100;0
6;0;"ohajee";6;100;0
7;0;"ohaji";7;100;0
5;0;"ohan";5;100;0
0;124;"ohana";124;0;100
6;0;"ohani";6;100;0
0;75;"ohanna";75;0;100
6;20;"ohara";26;23.0769230769231;76.9230769230769
0;25;"ohemaa";25;0;100
16;0;"ohene";16;100;0
5;0;"ohitika";5;100;0
5;0;"ohlin";5;100;0
180;0;"ohm";180;100;0
13;0;"ohmer";13;100;0
162;0;"ohn";162;100;0
290;0;"oisin";290;100;0
104;0;"oiva";104;100;0
102;0;"ojani";102;100;0
11;0;"ojany";11;100;0
309;0;"ojas";309;100;0
0;6;"ojasvi";6;0;100
19;0;"ojay";19;100;0
0;6;"ojetta";6;0;100
29;0;"oji";29;100;0
0;35;"ok";35;0;100
0;16;"oka";16;0;100
0;5;"okairy";5;0;100
0;6;"okal";6;0;100
0;23;"okalani";23;0;100
11;0;"okan";11;100;0
100;0;"okechukwu";100;100;0
0;5;"okeema";5;0;100
0;5;"okeima";5;0;100
12;0;"okeith";12;100;0
0;71;"okema";71;0;100
0;9;"okemia";9;0;100
1340;0;"okey";1340;100;0
124;175;"okie";299;41.4715719063545;58.5284280936455
0;27;"okima";27;0;100
16;233;"okla";249;6.42570281124498;93.574297188755
0;5;"oklahoma";5;0;100
129;0;"okley";129;100;0
51;0;"okoye";51;100;0
5;0;"okpara";5;100;0
0;896;"oksana";896;0;100
0;12;"oksanna";12;0;100
0;68;"oktober";68;0;100
545;25450;"ola";25995;2.09655703019811;97.9034429698019
0;5;"olabisi";5;0;100
5;0;"olabode";5;100;0
0;13;"olachi";13;0;100
11;0;"oladapo";11;100;0
5;0;"oladele";5;100;0
33;0;"oladimeji";33;100;0
5;0;"oladipo";5;100;0
5;0;"oladipupo";5;100;0
0;5;"oladis";5;0;100
2192;0;"olaf";2192;100;0
0;10;"olah";10;0;100
0;8;"olaiya";8;0;100
19;0;"olajawon";19;100;0
32;0;"olajide";32;100;0
0;23;"olajumoke";23;0;100
12;0;"olajuwan";12;100;0
583;0;"olajuwon";583;100;0
10;0;"olakunle";10;100;0
17;0;"olalekan";17;100;0
0;182;"olamae";182;0;100
199;248;"olamide";447;44.5190156599553;55.4809843400447
5;0;"olamilekan";5;100;0
14;12;"olamiposi";26;53.8461538461538;46.1538461538462
2504;0;"olan";2504;100;0
0;39;"olana";39;0;100
273;0;"oland";273;100;0
111;80;"olanda";191;58.1151832460733;41.8848167539267
173;0;"olander";173;100;0
604;0;"olando";604;100;0
0;17;"olani";17;0;100
6;0;"olaniyan";6;100;0
0;40;"olanna";40;0;100
70;0;"olanrewaju";70;100;0
141;0;"olaoluwa";141;100;0
0;216;"olar";216;0;100
5;0;"olas";5;100;0
5;0;"olasunkanmi";5;100;0
0;15;"olatokunbo";15;0;100
19;0;"olatunde";19;100;0
10;0;"olatunji";10;100;0
28;0;"olav";28;100;0
41;0;"olavi";41;100;0
92;0;"olawale";92;100;0
0;6;"olaya";6;0;100
44;61;"olayinka";105;41.9047619047619;58.0952380952381
5;0;"olbin";5;100;0
5;0;"oldair";5;100;0
504;0;"olden";504;100;0
22;0;"oldrich";22;100;0
1458;0;"ole";1458;100;0
0;22;"olea";22;0;100
17;856;"olean";873;1.94730813287514;98.0526918671248
0;6;"oleane";6;0;100
0;55;"oleatha";55;0;100
0;11;"oleavia";11;0;100
0;276;"oleda";276;0;100
23;37;"olee";60;38.3333333333333;61.6666666666667
0;44;"oleen";44;0;100
0;57;"oleeta";57;0;100
359;0;"oleg";359;100;0
397;0;"olegario";397;100;0
54;0;"oleh";54;100;0
0;15;"oleita";15;0;100
5;0;"olek";5;100;0
21;0;"oleksandr";21;100;0
15;0;"oleksiy";15;100;0
0;12;"olema";12;0;100
7155;13;"olen";7168;99.8186383928571;0.181361607142857
0;680;"olena";680;0;100
0;1340;"olene";1340;0;100
0;43;"oler";43;0;100
0;5;"olesha";5;0;100
0;47;"olesia";47;0;100
5;0;"olester";5;100;0
0;94;"olesya";94;0;100
0;5434;"oleta";5434;0;100
0;1209;"oletha";1209;0;100
0;5;"olethea";5;0;100
0;47;"olethia";47;0;100
0;337;"oletta";337;0;100
0;200;"oleva";200;0;100
0;1725;"olevia";1725;0;100
0;10;"olexa";10;0;100
0;5;"olexus";5;0;100
342;5;"oley";347;98.5590778097983;1.44092219020173
198;57253;"olga";57451;0.344641520600164;99.6553584793998
0;11;"olgia";11;0;100
0;29;"olgie";29;0;100
0;8;"olha";8;0;100
31;0;"oli";31;100;0
0;215;"olia";215;0;100
0;102;"oliana";102;0;100
0;5;"olianna";5;0;100
5;0;"oliber";5;100;0
0;5;"olibia";5;0;100
52;7;"olice";59;88.135593220339;11.864406779661
0;23;"olicia";23;0;100
0;5;"olida";5;0;100
500;320;"olie";820;60.9756097560976;39.0243902439024
6;0;"olif";6;100;0
11;0;"olijah";11;100;0
0;365;"olimpia";365;0;100
8698;5;"olin";8703;99.9425485464782;0.0574514535217741
0;167;"olina";167;0;100
0;968;"olinda";968;0;100
26;0;"olindo";26;100;0
0;320;"oline";320;0;100
0;21;"olinka";21;0;100
114;35;"olis";149;76.510067114094;23.489932885906
0;56;"olisa";56;0;100
10;0;"olisaemeka";10;100;0
0;25;"olisha";25;0;100
0;142;"olita";142;0;100
32;1718;"oliva";1750;1.82857142857143;98.1714285714286
0;6;"olivama";6;0;100
6;0;"olivander";6;100;0
6;0;"olivar";6;100;0
330;43811;"olive";44141;0.747604268140731;99.2523957318593
0;555;"olivea";555;0;100
0;75;"oliveah";75;0;100
0;124;"olivene";124;0;100
135370;564;"oliver";135934;99.5850927656068;0.414907234393161
0;13;"olivera";13;0;100
205;0;"oliverio";205;100;0
5;0;"oliverjames";5;100;0
5;51;"olivet";56;8.92857142857143;91.0714285714286
0;7;"olivett";7;0;100
0;637;"olivette";637;0;100
685;413797;"olivia";414482;0.16526652544622;99.8347334745538
0;10;"oliviaann";10;0;100
0;113;"oliviagrace";113;0;100
0;558;"oliviah";558;0;100
0;6;"oliviamae";6;0;100
0;40;"oliviamarie";40;0;100
0;178;"oliviana";178;0;100
0;118;"olivianna";118;0;100
0;93;"oliviarose";93;0;100
1484;5;"olivier";1489;99.6642041638684;0.335795836131632
0;5;"olivija";5;0;100
0;115;"olivine";115;0;100
5;0;"olivio";5;100;0
0;66;"oliviya";66;0;100
0;30;"oliviyah";30;0;100
0;303;"olivya";303;0;100
0;5;"olivyah";5;0;100
0;224;"oliwia";224;0;100
0;6;"oliyah";6;0;100
0;483;"olla";483;0;100
7;5;"olle";12;58.3333333333333;41.6666666666667
297;0;"ollen";297;100;0
0;5;"ollene";5;0;100
12;0;"olli";12;100;0
0;18;"ollia";18;0;100
33;0;"ollice";33;100;0
14372;33730;"ollie";48102;29.8781755436364;70.1218244563636
0;6;"olliemae";6;0;100
199;0;"ollin";199;100;0
0;15;"olline";15;0;100
399;0;"ollis";399;100;0
21;0;"ollivander";21;100;0
0;12;"ollive";12;0;100
219;0;"olliver";219;100;0
0;24;"ollivia";24;0;100
0;10;"olliyah";10;0;100
30;5;"olly";35;85.7142857142857;14.2857142857143
0;5;"ollye";5;0;100
0;13;"olma";13;0;100
95;0;"olman";95;100;0
0;5;"olna";5;0;100
187;0;"olney";187;100;0
89;0;"olof";89;100;0
0;21;"ololade";21;0;100
128;0;"olon";128;100;0
149;0;"olsen";149;100;0
146;0;"olson";146;100;0
32;0;"olton";32;100;0
7;0;"olu";7;100;0
0;11;"olubukola";11;0;100
0;52;"olubunmi";52;0;100
0;176;"oluchi";176;0;100
5;0;"oluf";5;100;0
358;0;"olufemi";358;100;0
0;21;"olufunke";21;0;100
0;34;"olufunmilayo";34;0;100
30;0;"olujimi";30;100;0
21;0;"olukayode";21;100;0
0;76;"olukemi";76;0;100
132;0;"olumide";132;100;0
5;0;"olumuyiwa";5;100;0
0;5;"oluremi";5;0;100
6;0;"olurotimi";6;100;0
11;0;"olus";11;100;0
77;0;"olusegun";77;100;0
5;0;"oluseun";5;100;0
33;0;"oluseyi";33;100;0
16;0;"olushola";16;100;0
0;7;"olutosin";7;0;100
0;5;"olutoyin";5;0;100
0;5;"oluwabukola";5;0;100
0;15;"oluwabukunmi";15;0;100
0;5;"oluwabusola";5;0;100
0;11;"oluwadabira";11;0;100
90;0;"oluwadamilare";90;100;0
130;223;"oluwadamilola";353;36.8271954674221;63.1728045325779
5;76;"oluwadara";81;6.17283950617284;93.8271604938272
93;179;"oluwadarasimi";272;34.1911764705882;65.8088235294118
149;78;"oluwademilade";227;65.6387665198238;34.3612334801762
0;15;"oluwadunmininu";15;0;100
6;0;"oluwadurotimi";6;100;0
188;0;"oluwafemi";188;100;0
55;19;"oluwaferanmi";74;74.3243243243243;25.6756756756757
5;0;"oluwafikayo";5;100;0
5;14;"oluwafikayomi";19;26.3157894736842;73.6842105263158
0;5;"oluwafisayo";5;0;100
5;0;"oluwafolahanmi";5;100;0
5;0;"oluwafolajimi";5;100;0
0;18;"oluwafunmilayo";18;0;100
0;5;"oluwafunmilola";5;0;100
15;0;"oluwajoba";15;100;0
22;21;"oluwajomiloju";43;51.1627906976744;48.8372093023256
5;0;"oluwakayode";5;100;0
0;222;"oluwakemi";222;0;100
11;0;"oluwakorede";11;100;0
0;13;"oluwalonimi";13;0;100
5;0;"oluwamayomikun";5;100;0
6;0;"oluwamayowa";6;100;0
119;153;"oluwanifemi";272;43.75;56.25
25;11;"oluwapelumi";36;69.4444444444444;30.5555555555556
17;0;"oluwasegun";17;100;0
65;49;"oluwasemilore";114;57.0175438596491;42.9824561403509
243;135;"oluwaseun";378;64.2857142857143;35.7142857142857
189;85;"oluwaseyi";274;68.978102189781;31.021897810219
5;13;"oluwaseyifunmi";18;27.7777777777778;72.2222222222222
34;136;"oluwatamilore";170;20;80
6;51;"oluwateniola";57;10.5263157894737;89.4736842105263
159;0;"oluwatimilehin";159;100;0
62;0;"oluwatimileyin";62;100;0
20;12;"oluwatise";32;62.5;37.5
0;10;"oluwatishe";10;0;100
451;143;"oluwatobi";594;75.9259259259259;24.0740740740741
146;23;"oluwatobiloba";169;86.3905325443787;13.6094674556213
11;47;"oluwatofunmi";58;18.9655172413793;81.0344827586207
28;21;"oluwatomi";49;57.1428571428571;42.8571428571429
0;5;"oluwatomilola";5;0;100
64;111;"oluwatomisin";175;36.5714285714286;63.4285714285714
57;0;"oluwatomiwa";57;100;0
37;100;"oluwatoni";137;27.007299270073;72.992700729927
5;6;"oluwatoniloba";11;45.4545454545455;54.5454545454545
139;150;"oluwatosin";289;48.0968858131488;51.9031141868512
0;120;"oluwatoyin";120;0;100
0;5;"oluwatoyosi";5;0;100
0;13;"oluwatumininu";13;0;100
0;5;"oluwayemisi";5;0;100
5;0;"oluyemi";5;100;0
5;0;"olva";5;100;0
0;20;"olvia";20;0;100
0;11;"olvie";11;0;100
302;0;"olvin";302;100;0
5;0;"olvis";5;100;0
0;22;"olwen";22;0;100
0;16;"olwyn";16;0;100
0;6;"olya";6;0;100
0;2972;"olympia";2972;0;100
66;0;"olyn";66;100;0
0;5;"olyne";5;0;100
0;33;"olyve";33;0;100
0;10;"olyvea";10;0;100
117;0;"olyver";117;100;0
0;2143;"olyvia";2143;0;100
0;31;"olyviah";31;0;100
1666;0;"om";1666;100;0
175;8326;"oma";8501;2.05858134337137;97.9414186566286
0;13;"omagene";13;0;100
0;132;"omah";132;0;100
19;0;"omaid";19;100;0
0;19;"omaida";19;0;100
259;0;"omair";259;100;0
0;362;"omaira";362;0;100
0;15;"omalee";15;0;100
46;0;"oman";46;100;0
36;35;"omani";71;50.7042253521127;49.2957746478873
93288;456;"omar";93744;99.5135688684076;0.486431131592422
0;187;"omara";187;0;100
0;5;"omarah";5;0;100
82;0;"omare";82;100;0
120;0;"omaree";120;100;0
37;0;"omareon";37;100;0
8244;298;"omari";8542;96.5113556544135;3.48864434558651
0;166;"omaria";166;0;100
0;12;"omariah";12;0;100
282;0;"omarian";282;100;0
0;21;"omariana";21;0;100
0;6;"omarianna";6;0;100
194;12;"omarie";206;94.1747572815534;5.8252427184466
23;0;"omarien";23;100;0
56;0;"omarii";56;100;0
57;0;"omario";57;100;0
3503;5;"omarion";3508;99.8574686431015;0.142531356898518
0;5;"omarionna";5;0;100
12;0;"omarious";12;100;0
0;7;"omaris";7;0;100
78;0;"omarius";78;100;0
18;0;"omariyon";18;100;0
482;0;"omarr";482;100;0
63;0;"omarri";63;100;0
62;0;"omarrion";62;100;0
5;0;"omaru";5;100;0
5;0;"omary";5;100;0
5;0;"omaryon";5;100;0
94;0;"omauri";94;100;0
7;0;"omaurion";7;100;0
13;0;"omaury";13;100;0
0;52;"omaya";52;0;100
0;6;"omayma";6;0;100
0;813;"omayra";813;0;100
10;0;"omead";10;100;0
5;0;"omed";5;100;0
0;19;"omeda";19;0;100
282;0;"omeed";282;100;0
453;2065;"omega";2518;17.9904686258936;82.0095313741064
12;0;"omeir";12;100;0
0;5;"omeisha";5;0;100
0;106;"omeka";106;0;100
0;12;"omekia";12;0;100
0;197;"omelia";197;0;100
6;0;"omen";6;100;0
7620;56;"omer";7676;99.2704533611256;0.729546638874414
0;46;"omera";46;0;100
106;0;"omere";106;100;0
0;5;"omeria";5;0;100
465;0;"omero";465;100;0
0;66;"omesha";66;0;100
0;12;"omeshia";12;0;100
0;10;"ometa";10;0;100
19;5;"omi";24;79.1666666666667;20.8333333333333
0;42;"omia";42;0;100
664;0;"omid";664;100;0
10;976;"omie";986;1.01419878296146;98.9858012170385
0;5;"omika";5;0;100
0;5;"omina";5;0;100
86;0;"omir";86;100;0
0;5;"omiya";5;0;100
0;16;"omiyah";16;0;100
276;0;"omkar";276;100;0
0;5;"omma";5;0;100
26;0;"ommar";26;100;0
0;69;"ommie";69;0;100
18;211;"omni";229;7.86026200873363;92.1397379912664
0;65;"omnia";65;0;100
0;107;"omolara";107;0;100
0;113;"omolola";113;0;100
5;0;"omon";5;100;0
5;0;"omorion";5;100;0
38;0;"omoro";38;100;0
0;17;"omotara";17;0;100
16;10;"omotayo";26;61.5384615384615;38.4615384615385
0;11;"omotola";11;0;100
81;0;"omran";81;100;0
577;15;"omri";592;97.4662162162162;2.53378378378378
0;140;"omunique";140;0;100
0;63;"omya";63;0;100
0;12;"omyra";12;0;100
87;6635;"ona";6722;1.29425766141029;98.7057423385897
0;5;"onah";5;0;100
101;0;"onaje";101;100;0
5;0;"onald";5;100;0
0;903;"onalee";903;0;100
0;7;"onaleigh";7;0;100
19;0;"onan";19;100;0
29;0;"onas";29;100;0
12;0;"onasis";12;100;0
18;0;"onassis";18;100;0
47;0;"onathan";47;100;0
0;22;"onawa";22;0;100
0;5;"onaya";5;0;100
0;117;"onda";117;0;100
0;15;"ondina";15;0;100
0;98;"ondine";98;0;100
92;28;"ondra";120;76.6666666666667;23.3333333333333
12;0;"ondray";12;100;0
0;6;"ondraya";6;0;100
255;0;"ondre";255;100;0
0;788;"ondrea";788;0;100
14;0;"ondrej";14;100;0
0;5;"ondreya";5;0;100
0;85;"ondria";85;0;100
2974;130;"oneal";3104;95.8118556701031;4.18814432989691
0;5;"oneatha";5;0;100
26;0;"onecimo";26;100;0
0;574;"oneda";574;0;100
0;163;"onedia";163;0;100
0;17;"oneeda";17;0;100
0;2216;"oneida";2216;0;100
0;94;"oneika";94;0;100
1668;17;"oneil";1685;98.9910979228487;1.00890207715134
82;0;"oneill";82;100;0
0;251;"oneisha";251;0;100
0;841;"oneita";841;0;100
0;125;"oneka";125;0;100
0;7;"onekki";7;0;100
32;0;"onel";32;100;0
0;129;"onelia";129;0;100
10;62;"onell";72;13.8888888888889;86.1111111111111
0;42;"onella";42;0;100
0;113;"onesha";113;0;100
0;52;"oneshia";52;0;100
575;0;"onesimo";575;100;0
38;0;"onesimus";38;100;0
0;80;"onesti";80;0;100
0;126;"onesty";126;0;100
0;1443;"oneta";1443;0;100
0;79;"onetha";79;0;100
0;5;"onetia";5;0;100
0;181;"onetta";181;0;100
0;12;"oneva";12;0;100
109;55;"oney";164;66.4634146341463;33.5365853658537
0;48;"oneyda";48;0;100
0;52;"ong";52;0;100
0;191;"oni";191;0;100
0;92;"onia";92;0;100
0;259;"onica";259;0;100
0;53;"onida";53;0;100
265;1380;"onie";1645;16.1094224924012;83.8905775075988
196;0;"oniel";196;100;0
0;31;"oniesha";31;0;100
0;618;"onika";618;0;100
263;5;"onis";268;98.134328358209;1.86567164179104
0;89;"onisha";89;0;100
0;13;"onisty";13;0;100
0;1156;"onita";1156;0;100
204;0;"onix";204;100;0
0;57;"oniya";57;0;100
0;62;"oniyah";62;0;100
10;0;"onkar";10;100;0
0;548;"onna";548;0;100
0;10;"onnah";10;0;100
0;21;"onnalee";21;0;100
0;5;"onnaleigh";5;0;100
37;0;"onni";37;100;0
640;1005;"onnie";1645;38.9057750759878;61.0942249240122
0;65;"onnika";65;0;100
0;57;"onnolee";57;0;100
247;0;"onofre";247;100;0
264;0;"onofrio";264;100;0
0;28;"onolee";28;0;100
0;38;"onora";38;0;100
5;0;"onorio";5;100;0
7;0;"onslow";7;100;0
0;5;"ontaria";5;0;100
822;0;"ontario";822;100;0
13;0;"ontarius";13;100;0
38;0;"onterio";38;100;0
36;0;"onterrio";36;100;0
11;0;"ontonio";11;100;0
130;0;"onur";130;100;0
0;175;"onya";175;0;100
0;15;"onyae";15;0;100
0;10;"onyah";10;0;100
0;21;"onye";21;0;100
14;0;"onyedikachi";14;100;0
63;11;"onyekachi";74;85.1351351351351;14.8648648648649
5;0;"onyekachukwu";5;100;0
0;26;"onyinye";26;0;100
0;116;"onyinyechi";116;0;100
0;23;"onyinyechukwu";23;0;100
0;5;"onyka";5;0;100
1029;542;"onyx";1571;65.4996817313813;34.5003182686187
0;12;"onzell";12;0;100
15;0;"onzie";15;100;0
0;1065;"oona";1065;0;100
0;34;"oonagh";34;0;100
706;66816;"opal";67522;1.04558514262018;98.9544148573798
0;10;"opalee";10;0;100
0;46;"opalene";46;0;100
0;190;"opaline";190;0;100
0;277;"opel";277;0;100
19;30;"opeyemi";49;38.7755102040816;61.2244897959184
12;350;"opha";362;3.31491712707182;96.6850828729282
15;15305;"ophelia";15320;0.097911227154047;99.902088772846
0;6;"ophelie";6;0;100
0;145;"ophia";145;0;100
0;84;"ophie";84;0;100
0;15;"ophilia";15;0;100
16;0;"ophir";16;100;0
381;94;"opie";475;80.2105263157895;19.7894736842105
19;279;"ople";298;6.3758389261745;93.6241610738255
5;0;"oplis";5;100;0
0;5;"oppie";5;0;100
0;99;"oprah";99;0;100
5;0;"optimus";5;100;0
16;0;"or";16;100;0
4530;32657;"ora";37187;12.1816763922876;87.8183236077124
0;11;"orabell";11;0;100
0;91;"orabelle";91;0;100
14;0;"orace";14;100;0
421;0;"oracio";421;100;0
0;8;"oracle";8;0;100
0;11;"oradee";11;0;100
0;56;"oradell";56;0;100
0;120;"orah";120;0;100
2626;426;"oral";3052;86.0419397116645;13.9580602883355
0;662;"oralee";662;0;100
0;5;"oralene";5;0;100
5;5665;"oralia";5670;0.0881834215167548;99.9118165784833
10;0;"oram";10;100;0
0;21;"oramae";21;0;100
5;0;"oramel";5;100;0
4111;0;"oran";4111;100;0
475;18;"orange";493;96.3488843813387;3.65111561866126
0;43;"orangie";43;0;100
5;0;"orantes";5;100;0
42;0;"oras";42;100;0
7;0;"orasio";7;100;0
292;0;"orazio";292;100;0
44;34;"orba";78;56.4102564102564;43.5897435897436
44;0;"orban";44;100;0
10;0;"orbelin";10;100;0
36;0;"orben";36;100;0
609;51;"orbie";660;92.2727272727273;7.72727272727273
451;0;"orbin";451;100;0
42;0;"orbra";42;100;0
151;0;"orby";151;100;0
0;5;"orcella";5;0;100
0;215;"orchid";215;0;100
20;0;"ord";20;100;0
0;15;"orda";15;0;100
5;0;"ordan";5;100;0
161;0;"ordean";161;100;0
185;53;"ordell";238;77.7310924369748;22.2689075630252
0;36;"ordella";36;0;100
7;0;"orden";7;100;0
26;5;"ordie";31;83.8709677419355;16.1290322580645
7;0;"ordis";7;100;0
12;12;"ore";24;50;50
10;32;"orea";42;23.8095238095238;76.1904761904762
0;23;"oreal";23;0;100
16;102;"orean";118;13.5593220338983;86.4406779661017
0;23;"oreana";23;0;100
0;5;"oreane";5;0;100
0;11;"oreanna";11;0;100
0;151;"oreatha";151;0;100
0;51;"oreda";51;0;100
235;152;"oree";387;60.7235142118863;39.2764857881137
0;5;"oreen";5;0;100
521;136;"orel";657;79.2998477929985;20.7001522070015
0;884;"orelia";884;0;100
158;44;"orell";202;78.2178217821782;21.7821782178218
0;108;"orella";108;0;100
7875;35;"oren";7910;99.5575221238938;0.442477876106195
0;306;"orena";306;0;100
0;30;"orenda";30;0;100
0;1004;"orene";1004;0;100
6;0;"orentha";6;100;0
277;0;"orenthal";277;100;0
5;0;"orenthia";5;100;0
29;0;"orenthial";29;100;0
0;5;"oreofeoluwa";5;0;100
110;185;"oreoluwa";295;37.2881355932203;62.7118644067797
12;0;"ores";12;100;0
254;0;"orest";254;100;0
356;0;"oreste";356;100;0
328;0;"orestes";328;100;0
17;0;"oresto";17;100;0
5;0;"orestus";5;100;0
0;220;"oreta";220;0;100
0;1158;"oretha";1158;0;100
0;221;"oretta";221;0;100
0;6;"oreva";6;0;100
79;0;"orey";79;100;0
0;15;"orfa";15;0;100
0;6;"orfalinda";6;0;100
0;30;"orfelinda";30;0;100
99;0;"orhan";99;100;0
971;121;"ori";1092;88.9194139194139;11.0805860805861
29;228;"oria";257;11.284046692607;88.715953307393
5;218;"oriah";223;2.24215246636771;97.7578475336323
550;69;"orian";619;88.8529886914378;11.1470113085622
0;2893;"oriana";2893;0;100
0;16;"oriane";16;0;100
0;1017;"orianna";1017;0;100
0;5;"orianne";5;0;100
0;7;"orianthi";7;0;100
12;0;"orice";12;100;0
1535;378;"orie";1913;80.2404600104548;19.7595399895452
144;130;"oriel";274;52.5547445255474;47.4452554744526
0;37;"orielle";37;0;100
477;5;"orien";482;98.9626556016597;1.03734439834025
0;5;"orietta";5;0;100
18;0;"oril";18;100;0
0;175;"orilla";175;0;100
5271;11;"orin";5282;99.7917455509277;0.208254449072321
0;5;"orina";5;0;100
0;17;"orinda";17;0;100
0;167;"orine";167;0;100
0;5;"oriole";5;0;100
13711;373;"orion";14084;97.3516046577677;2.64839534223232
0;8;"oriona";8;0;100
0;23;"orionna";23;0;100
1622;232;"oris";1854;87.4865156418554;12.5134843581446
5;5;"orise";10;50;50
0;11;"orisha";11;0;100
41;0;"orison";41;100;0
0;61;"orissa";61;0;100
0;111;"orit";111;0;100
0;15;"orita";15;0;100
0;53;"oriya";53;0;100
0;70;"oriyah";70;0;100
5;0;"oriyan";5;100;0
0;5;"oriyana";5;0;100
213;738;"orla";951;22.397476340694;77.602523659306
0;6;"orlagh";6;0;100
0;11;"orlaith";11;0;100
911;0;"orlan";911;100;0
2021;5;"orland";2026;99.7532082922014;0.246791707798618
538;253;"orlanda";791;68.0151706700379;31.9848293299621
160;0;"orlander";160;100;0
80;0;"orlandis";80;100;0
46246;242;"orlando";46488;99.4794355532611;0.520564446738943
0;14;"orlandra";14;0;100
0;8;"orlandrea";8;0;100
0;85;"orlandria";85;0;100
116;0;"orlandus";116;100;0
0;11;"orlantha";11;0;100
22;526;"orlean";548;4.01459854014599;95.985401459854
5;41;"orlee";46;10.8695652173913;89.1304347826087
0;5;"orleen";5;0;100
259;0;"orlen";259;100;0
0;552;"orlena";552;0;100
0;5;"orlenda";5;0;100
0;402;"orlene";402;0;100
0;37;"orletta";37;0;100
401;0;"orley";401;100;0
0;309;"orli";309;0;100
0;5;"orlidia";5;0;100
335;12;"orlie";347;96.5417867435158;3.45821325648415
1523;0;"orlin";1523;100;0
0;321;"orlinda";321;0;100
0;58;"orline";58;0;100
5;0;"orlis";5;100;0
834;0;"orlo";834;100;0
76;0;"orlondo";76;100;0
0;590;"orly";590;0;100
282;0;"orlyn";282;100;0
0;672;"orma";672;0;100
0;11;"ormah";11;0;100
24;0;"ormal";24;100;0
886;0;"orman";886;100;0
206;0;"ormand";206;100;0
0;5;"ormi";5;0;100
513;0;"ormond";513;100;0
0;42;"orna";42;0;100
0;169;"ornella";169;0;100
0;6;"orneta";6;0;100
10;0;"ornie";10;100;0
78;0;"oron";78;100;0
292;0;"oronde";292;100;0
0;5;"orothy";5;0;100
0;102;"orpah";102;0;100
0;4746;"orpha";4746;0;100
76;0;"orpheus";76;100;0
0;96;"orphia";96;0;100
0;24;"orphie";24;0;100
6;0;"orphus";6;100;0
0;48;"orquidea";48;0;100
0;44;"orquidia";44;0;100
40;5;"orr";45;88.8888888888889;11.1111111111111
12;71;"orra";83;14.4578313253012;85.5421686746988
5;0;"orral";5;100;0
15;0;"orran";15;100;0
10;0;"orrel";10;100;0
10;0;"orrell";10;100;0
813;0;"orren";813;100;0
5;0;"orrey";5;100;0
609;255;"orrie";864;70.4861111111111;29.5138888888889
5164;0;"orrin";5164;100;0
921;49;"orris";970;94.9484536082474;5.05154639175258
348;0;"orry";348;100;0
5;0;"orryn";5;100;0
5;0;"orsen";5;100;0
0;5;"orsola";5;0;100
1662;0;"orson";1662;100;0
6;0;"ortega";6;100;0
0;316;"ortencia";316;0;100
0;44;"ortensia";44;0;100
0;254;"ortha";254;0;100
16;0;"ortis";16;100;0
7;0;"ortiz";7;100;0
210;0;"orton";210;100;0
0;6;"ortrude";6;0;100
5;0;"orum";5;100;0
16;0;"orus";16;100;0
100;480;"orva";580;17.2413793103448;82.7586206896552
7551;12;"orval";7563;99.8413328044427;0.158667195557319
47;0;"orvall";47;100;0
16;0;"orvalle";16;100;0
143;0;"orvan";143;100;0
1137;0;"orvel";1137;100;0
135;0;"orvell";135;100;0
0;68;"orvella";68;0;100
42;0;"orven";42;100;0
0;159;"orvetta";159;0;100
27;0;"orvid";27;100;0
136;0;"orvie";136;100;0
1915;0;"orvil";1915;100;0
118;0;"orvile";118;100;0
224;0;"orvill";224;100;0
0;238;"orvilla";238;0;100
33450;155;"orville";33605;99.5387591132272;0.461240886772802
1109;0;"orvin";1109;100;0
5;0;"orvind";5;100;0
929;0;"orvis";929;100;0
6;0;"orvo";6;100;0
49;0;"orwin";49;100;0
147;0;"ory";147;100;0
0;10;"orya";10;0;100
843;0;"oryan";843;100;0
38;0;"oryn";38;100;0
83;0;"oryon";83;100;0
0;11;"orysia";11;0;100
82;428;"osa";510;16.078431372549;83.921568627451
36;0;"osagie";36;100;0
16;0;"osahon";16;100;0
856;0;"osama";856;100;0
98;0;"osamah";98;100;0
94;0;"osamu";94;100;0
0;5;"osanna";5;0;100
6;0;"osaretin";6;100;0
0;5;"osariemen";5;0;100
87;0;"osaze";87;100;0
2948;0;"osbaldo";2948;100;0
11;0;"osbert";11;100;0
12;0;"osbie";12;100;0
30;0;"osbon";30;100;0
516;0;"osborn";516;100;0
1550;0;"osborne";1550;100;0
23;0;"osbourne";23;100;0
51;0;"osburn";51;100;0
150;0;"osby";150;100;0
185192;1043;"oscar";186235;99.4399548956963;0.560045104303702
5;0;"oscardaniel";5;100;0
5;0;"oscarjr";5;100;0
61;148;"osceola";209;29.1866028708134;70.8133971291866
26;0;"oscer";26;100;0
5;0;"osciel";5;100;0
12;0;"osco";12;100;0
12;0;"oscor";12;100;0
5;0;"ose";5;100;0
5;0;"osean";5;100;0
239;0;"oseas";239;100;0
0;5;"osee";5;0;100
204;0;"osei";204;100;0
10;0;"oseias";10;100;0
67;0;"oseph";67;100;0
18;0;"osgood";18;100;0
75;274;"osha";349;21.4899713467049;78.5100286532951
159;0;"oshae";159;100;0
18;10;"oshai";28;64.2857142857143;35.7142857142857
41;0;"oshane";41;100;0
0;5;"oshanique";5;0;100
0;5;"oshanna";5;0;100
17;0;"oshawn";17;100;0
337;39;"oshay";376;89.6276595744681;10.3723404255319
10;0;"oshaye";10;100;0
749;44;"oshea";793;94.4514501891551;5.54854981084489
0;11;"osheana";11;0;100
0;22;"osheanna";22;0;100
70;5;"oshen";75;93.3333333333333;6.66666666666667
156;0;"osher";156;100;0
0;11;"oshia";11;0;100
0;7;"oshiana";7;0;100
0;5;"oshie";5;0;100
95;0;"oshua";95;100;0
0;10;"oshun";10;0;100
0;30;"oshyn";30;0;100
0;30;"osia";30;0;100
57;0;"osiah";57;100;0
0;5;"osiana";5;0;100
174;0;"osias";174;100;0
724;1127;"osie";1851;39.1139924365208;60.8860075634792
2040;0;"osiel";2040;100;0
46;16;"osinachi";62;74.1935483870968;25.8064516129032
0;5;"osiria";5;0;100
1623;769;"osiris";2392;67.8511705685619;32.1488294314381
49;0;"osirus";49;100;0
0;10;"osirys";10;0;100
0;5;"osiyo";5;0;100
2125;0;"oskar";2125;100;0
205;0;"osker";205;100;0
5;0;"osler";5;100;0
86;0;"oslo";86;100;0
2274;0;"osman";2274;100;0
56;0;"osmani";56;100;0
123;0;"osmany";123;100;0
1796;0;"osmar";1796;100;0
0;283;"osmara";283;0;100
0;22;"osmary";22;0;100
111;0;"osmel";111;100;0
12;0;"osmer";12;100;0
413;0;"osmin";413;100;0
13;0;"osmo";13;100;0
5;0;"osmon";5;100;0
359;0;"osmond";359;100;0
13;0;"osmund";13;100;0
0;5;"osnas";5;0;100
104;0;"osric";104;100;0
23;0;"ossama";23;100;0
29;0;"ossian";29;100;0
1586;2702;"ossie";4288;36.9869402985075;63.0130597014925
88;0;"ossiel";88;100;0
5;0;"ostap";5;100;0
0;11;"ostara";11;0;100
5;0;"osteen";5;100;0
7;0;"ostell";7;100;0
144;0;"osten";144;100;0
251;0;"ostin";251;100;0
16;0;"ostyn";16;100;0
388;0;"osualdo";388;100;0
13309;12;"osvaldo";13321;99.9099166729224;0.0900833270775467
41;0;"osvin";41;100;0
3718;0;"oswald";3718;100;0
5483;0;"oswaldo";5483;100;0
79;0;"oswell";79;100;0
184;53;"oswin";237;77.6371308016878;22.3628691983122
0;6;"oswyn";6;0;100
15;0;"osyris";15;100;0
5;0;"osyrus";5;100;0
0;120;"ota";120;0;100
0;17;"otavia";17;0;100
34;0;"otavio";34;100;0
5;0;"otavious";5;100;0
0;5;"oteka";5;0;100
0;1084;"otelia";1084;0;100
0;50;"otella";50;0;100
5;0;"otello";5;100;0
0;21;"oteria";21;0;100
17;0;"otey";17;100;0
6160;1333;"otha";7493;82.2100627252102;17.7899372747898
174;5;"othal";179;97.2067039106145;2.79329608938547
5;0;"othan";5;100;0
97;0;"othar";97;100;0
732;154;"othel";886;82.6185101580135;17.3814898419865
0;319;"othelia";319;0;100
165;75;"othell";240;68.75;31.25
0;701;"othella";701;0;100
582;116;"othello";698;83.3810888252149;16.6189111747851
190;0;"other";190;100;0
29;0;"othie";29;100;0
284;0;"othman";284;100;0
188;0;"othmar";188;100;0
325;0;"othniel";325;100;0
2937;0;"otho";2937;100;0
70;0;"othon";70;100;0
37;0;"othoniel";37;100;0
21;0;"othor";21;100;0
42;81;"otie";123;34.1463414634146;65.8536585365854
17;0;"oties";17;100;0
0;504;"otila";504;0;100
0;1571;"otilia";1571;0;100
359;0;"otilio";359;100;0
0;10;"otilla";10;0;100
0;85;"otillia";85;0;100
0;10;"otillie";10;0;100
55219;851;"otis";56070;98.482254324951;1.51774567504905
0;160;"otisha";160;0;100
5;0;"otley";5;100;0
5;0;"otman";5;100;0
16;0;"otmer";16;100;0
83;0;"otniel";83;100;0
0;5;"otome";5;0;100
923;0;"otoniel";923;100;0
0;5;"otsie";5;0;100
62;0;"ott";62;100;0
0;33;"otta";33;0;100
0;13;"ottavia";13;0;100
73;0;"ottavio";73;100;0
5;0;"ottaway";5;100;0
0;5;"ottelia";5;0;100
15;0;"ottice";15;100;0
546;973;"ottie";1519;35.9447004608295;64.0552995391705
0;308;"ottilia";308;0;100
0;425;"ottilie";425;0;100
4218;163;"ottis";4381;96.2793882675188;3.72061173248117
13;0;"ottmar";13;100;0
26110;84;"otto";26194;99.6793158738642;0.320684126135756
5;0;"ottomar";5;100;0
17;0;"ottoniel";17;100;0
5;0;"otway";5;100;0
0;16;"otylia";16;0;100
0;35;"oudia";35;0;100
0;4749;"ouida";4749;0;100
5;0;"ouinton";5;100;0
0;88;"ouita";88;0;100
490;0;"oumar";490;100;0
0;8;"oumie";8;0;100
0;481;"oumou";481;0;100
0;21;"oumy";21;0;100
0;110;"ourania";110;0;100
0;5;"ourtney";5;0;100
10;0;"ousainou";10;100;0
263;0;"ousman";263;100;0
442;0;"ousmane";442;100;0
6;0;"oussama";6;100;0
517;1115;"ova";1632;31.6789215686274;68.3210784313726
0;12;"ovada";12;0;100
49;0;"ovadia";49;100;0
500;96;"oval";596;83.8926174496644;16.1073825503356
0;7;"ovalee";7;0;100
0;6;"ovalene";6;0;100
0;46;"ovaline";46;0;100
40;0;"ove";40;100;0
60;0;"oved";60;100;0
0;205;"oveda";205;0;100
0;11;"ovedia";11;0;100
0;12;"ovee";12;0;100
0;7;"oveida";7;0;100
28;5;"ovel";33;84.8484848484848;15.1515151515152
0;60;"ovelia";60;0;100
0;12;"oveline";12;0;100
16;34;"ovell";50;32;68
0;413;"ovella";413;0;100
0;6;"ovena";6;0;100
0;28;"overa";28;0;100
521;0;"overton";521;100;0
0;216;"oveta";216;0;100
0;118;"ovetta";118;0;100
11;0;"ovey";11;100;0
0;18;"ovi";18;0;100
0;7;"ovia";7;0;100
728;0;"ovid";728;100;0
0;182;"ovida";182;0;100
140;0;"ovide";140;100;0
905;0;"ovidio";905;100;0
396;333;"ovie";729;54.320987654321;45.679012345679
222;0;"ovila";222;100;0
5;5;"ovis";10;50;50
0;142;"oviya";142;0;100
117;0;"owain";117;100;0
207;0;"owais";207;100;0
7;0;"owan";7;100;0
0;44;"oweda";44;0;100
167063;420;"owen";167483;99.7492282798851;0.250771720114877
0;11;"owena";11;0;100
61;0;"owenn";61;100;0
666;0;"owens";666;100;0
0;10;"oweta";10;0;100
0;5;"owetta";5;0;100
149;0;"owin";149;100;0
551;21;"owyn";572;96.3286713286713;3.67132867132867
111;24;"owynn";135;82.2222222222222;17.7777777777778
0;10;"oxana";10;0;100
32;0;"oxford";32;100;0
25;0;"oxley";25;100;0
5;0;"oyd";5;100;0
5;78;"oyindamola";83;6.02409638554217;93.9759036144578
0;80;"oyinkansola";80;0;100
0;5;"oyinlola";5;0;100
0;159;"oyuki";159;0;100
0;59;"oyuky";59;0;100
341;0;"oz";341;100;0
26;147;"oza";173;15.028901734104;84.9710982658959
46;0;"ozair";46;100;0
178;0;"ozan";178;100;0
0;5;"ozara";5;0;100
0;10;"ozaria";10;0;100
0;6;"ozeal";6;0;100
11;5;"ozel";16;68.75;31.25
0;41;"ozelia";41;0;100
1709;1116;"ozell";2825;60.4955752212389;39.5044247787611
0;2151;"ozella";2151;0;100
0;10;"ozellar";10;0;100
0;343;"ozelle";343;0;100
0;18;"ozelma";18;0;100
0;5;"ozena";5;0;100
0;87;"ozetta";87;0;100
6;0;"ozia";6;100;0
123;0;"oziah";123;100;0
397;0;"ozias";397;100;0
933;1158;"ozie";2091;44.6197991391679;55.3802008608321
1622;0;"oziel";1622;100;0
82;0;"ozil";82;100;0
0;44;"ozioma";44;0;100
5;0;"ozion";5;100;0
0;10;"ozite";10;0;100
5;0;"ozkar";5;100;0
0;10;"ozlem";10;0;100
5;0;"ozlo";5;100;0
22;0;"ozmar";22;100;0
8;0;"ozric";8;100;0
66;0;"ozro";66;100;0
6;0;"ozvaldo";6;100;0
2275;667;"ozzie";2942;77.3283480625425;22.6716519374575
23;0;"ozziel";23;100;0
1249;0;"ozzy";1249;100;0
5;1338;"pa";1343;0.372300819061802;99.6276991809382
14;0;"paal";14;100;0
114;0;"paarth";114;100;0
0;10;"paayal";10;0;100
22;0;"pabel";22;100;0
0;51;"pabla";51;0;100
0;54;"pablita";54;0;100
21;0;"pablito";21;100;0
43117;69;"pablo";43186;99.8402259991664;0.159774000833603
577;22;"pace";599;96.3272120200334;3.67278797996661
72;0;"pacen";72;100;0
78;0;"pacer";78;100;0
530;228;"pacey";758;69.9208443271768;30.0791556728232
0;7;"pacha";7;0;100
0;200;"pachia";200;0;100
0;28;"pacie";28;0;100
0;25;"pacience";25;0;100
0;6;"pacifica";6;0;100
5;0;"pacifico";5;100;0
0;46;"pacita";46;0;100
5;0;"packard";5;100;0
30;0;"packer";30;100;0
291;0;"paco";291;100;0
0;5;"pada";5;0;100
81;248;"paddy";329;24.6200607902736;75.3799392097264
0;22;"padee";22;0;100
1597;193;"paden";1790;89.2178770949721;10.7821229050279
0;17;"pader";17;0;100
0;10;"padgett";10;0;100
0;40;"padma";40;0;100
0;96;"padme";96;0;100
0;5;"padmini";5;0;100
5;0;"padon";5;100;0
949;0;"padraic";949;100;0
704;0;"padraig";704;100;0
5;0;"padriac";5;100;0
12;0;"padric";12;100;0
5;0;"padrick";5;100;0
5;0;"padro";5;100;0
0;5;"padyn";5;0;100
0;29;"paedyn";29;0;100
0;68;"paelyn";68;0;100
0;22;"paelynn";22;0;100
0;16;"paesyn";16;0;100
0;5;"paeten";5;0;100
0;5;"paetin";5;0;100
86;408;"paeton";494;17.4089068825911;82.5910931174089
0;6;"paetra";6;0;100
11;792;"paetyn";803;1.36986301369863;98.6301369863014
0;33;"paetynn";33;0;100
0;59;"paeyton";59;0;100
0;45;"pagan";45;0;100
1468;3856;"page";5324;27.5732531930879;72.4267468069121
0;5;"pageant";5;0;100
0;5;"pagen";5;0;100
0;44;"paget";44;0;100
0;19;"pagie";19;0;100
0;25;"pahal";25;0;100
0;193;"pahola";193;0;100
0;148;"pahoua";148;0;100
0;6;"pai";6;0;100
96;109;"paiden";205;46.8292682926829;53.1707317073171
0;49;"paidyn";49;0;100
0;5;"paig";5;0;100
1330;136342;"paige";137672;0.966064268696612;99.0339357313034
0;27;"paigelyn";27;0;100
0;15;"paigelynn";15;0;100
0;323;"paighton";323;0;100
0;6;"paightyn";6;0;100
0;5;"paij";5;0;100
0;227;"paije";227;0;100
0;13;"paikea";13;0;100
0;37;"pailey";37;0;100
0;5;"paili";5;0;100
0;101;"pailyn";101;0;100
0;67;"pailynn";67;0;100
0;142;"pairlee";142;0;100
0;46;"paisely";46;0;100
0;5;"paisha";5;0;100
0;6;"paishance";6;0;100
0;20;"paishence";20;0;100
0;61;"paislea";61;0;100
0;4695;"paislee";4695;0;100
0;67;"paislei";67;0;100
0;1014;"paisleigh";1014;0;100
29;28121;"paisley";28150;0.103019538188277;99.8969804618117
0;12;"paisleyann";12;0;100
0;5;"paisleyanne";5;0;100
0;5;"paisleyjo";5;0;100
0;5;"paisleymae";5;0;100
0;5;"paisleyrose";5;0;100
0;65;"paisli";65;0;100
0;315;"paislie";315;0;100
0;145;"paisly";145;0;100
0;57;"paislyn";57;0;100
0;79;"paislynn";79;0;100
0;13;"paison";13;0;100
0;149;"paisyn";149;0;100
0;6;"paisynn";6;0;100
15;403;"paiten";418;3.58851674641148;96.4114832535885
0;28;"paitin";28;0;100
0;54;"paitlyn";54;0;100
0;6;"paitlynn";6;0;100
165;1119;"paiton";1284;12.8504672897196;87.1495327102804
24;4392;"paityn";4416;0.543478260869565;99.4565217391304
0;218;"paitynn";218;0;100
0;40;"paiyton";40;0;100
0;7;"paizlea";7;0;100
0;600;"paizlee";600;0;100
0;116;"paizleigh";116;0;100
0;852;"paizley";852;0;100
0;21;"paizli";21;0;100
0;51;"paizlie";51;0;100
0;20;"paizly";20;0;100
0;6;"paizlyn";6;0;100
0;11;"paj";11;0;100
0;6;"paje";6;0;100
13;0;"pajtim";13;100;0
46;0;"pake";46;100;0
0;5;"pakhi";5;0;100
0;148;"pakou";148;0;100
187;10;"pal";197;94.9238578680203;5.0761421319797
0;18;"pala";18;0;100
31;0;"paladin";31;100;0
5;289;"palak";294;1.70068027210884;98.2993197278912
30;0;"palani";30;100;0
17;0;"palash";17;100;0
0;169;"palestine";169;0;100
0;17;"paley";17;0;100
0;143;"palin";143;0;100
0;74;"pallas";74;0;100
0;353;"pallavi";353;0;100
0;117;"pallie";117;0;100
0;3468;"palma";3468;0;100
0;5;"palmena";5;0;100
7254;1387;"palmer";8641;83.9486170582109;16.0513829417891
0;5;"palmera";5;0;100
0;273;"palmina";273;0;100
0;850;"palmira";850;0;100
0;66;"palmyra";66;0;100
0;8119;"paloma";8119;0;100
0;102;"palyn";102;0;100
0;39;"palynn";39;0;100
23;33127;"pam";33150;0.0693815987933635;99.9306184012066
0;182;"pama";182;0;100
0;7355;"pamala";7355;0;100
0;35;"pamale";35;0;100
0;63;"pamalee";63;0;100
0;5;"pamalia";5;0;100
0;23;"pamalla";23;0;100
0;5;"pamara";5;0;100
0;5;"pameal";5;0;100
0;48;"pamel";48;0;100
1387;594007;"pamela";595394;0.232954984430478;99.7670450155695
0;2224;"pamelia";2224;0;100
0;3166;"pamella";3166;0;100
0;118;"pamelyn";118;0;100
0;87;"pami";87;0;100
0;28;"pamie";28;0;100
0;755;"pamila";755;0;100
0;44;"pamilla";44;0;100
0;5;"pamilyn";5;0;100
0;795;"pamla";795;0;100
0;102;"pamlea";102;0;100
0;25;"pamler";25;0;100
0;5;"pamlia";5;0;100
0;5;"pamlyn";5;0;100
0;21;"pamm";21;0;100
0;5;"pamma";5;0;100
0;6;"pammela";6;0;100
0;5;"pammi";5;0;100
0;101;"pammie";101;0;100
0;379;"pammy";379;0;100
0;696;"pamula";696;0;100
0;525;"panagiota";525;0;100
6;0;"panagiotes";6;100;0
1153;0;"panagiotis";1153;100;0
31;0;"panav";31;100;0
0;91;"panayiota";91;0;100
249;0;"panayiotis";249;100;0
5;0;"panayotis";5;100;0
0;5;"panchita";5;0;100
196;0;"pancho";196;100;0
0;88;"panda";88;0;100
0;5;"pandi";5;0;100
0;2757;"pandora";2757;0;100
0;5;"pandoria";5;0;100
0;5;"pandra";5;0;100
0;14;"pandy";14;0;100
0;5;"panela";5;0;100
218;0;"panfilo";218;100;0
11;615;"pang";626;1.75718849840256;98.2428115015974
0;97;"panhia";97;0;100
0;45;"pankie";45;0;100
0;5;"pannie";5;0;100
22;0;"panos";22;100;0
0;80;"pansey";80;0;100
0;78;"pansie";78;0;100
0;9911;"pansy";9911;0;100
0;5;"pansye";5;0;100
60;0;"pantaleon";60;100;0
5;0;"pantalion";5;100;0
194;0;"pantelis";194;100;0
0;87;"pantera";87;0;100
16;0;"panth";16;100;0
0;10;"panthea";10;0;100
0;5;"pany";5;0;100
0;29;"panya";29;0;100
0;5;"panyia";5;0;100
0;23;"panzie";23;0;100
0;92;"panzy";92;0;100
301;0;"pao";301;100;0
148;22115;"paola";22263;0.664780128464268;99.3352198715357
0;143;"paolina";143;0;100
3163;0;"paolo";3163;100;0
210;0;"papa";210;100;0
110;0;"pape";110;100;0
0;188;"paquita";188;0;100
0;15;"par";15;0;100
0;353;"para";353;0;100
0;11;"paradice";11;0;100
0;905;"paradise";905;0;100
0;5;"paradyce";5;0;100
199;0;"parag";199;100;0
0;999;"paralee";999;0;100
242;0;"param";242;100;0
11;0;"paramveer";11;100;0
260;0;"paras";260;100;0
5;0;"paraskevas";5;100;0
0;7;"paraskeve";7;0;100
0;229;"paraskevi";229;0;100
53;0;"pardeep";53;100;0
0;5;"pardis";5;0;100
0;15;"paree";15;0;100
0;16;"pareesa";16;0;100
32;0;"paresh";32;100;0
10;0;"parham";10;100;0
0;649;"pari";649;0;100
0;6;"paria";6;0;100
0;18;"paricia";18;0;100
5;0;"parick";5;100;0
0;20;"paridhi";20;0;100
0;5;"parie";5;0;100
0;15;"pariis";15;0;100
0;106;"parilee";106;0;100
44;0;"parin";44;100;0
0;6;"parina";6;0;100
0;11;"parinita";11;0;100
8511;26756;"paris";35267;24.133042220773;75.866957779227
0;866;"parisa";866;0;100
0;5;"parise";5;0;100
845;283;"parish";1128;74.9113475177305;25.0886524822695
0;73;"parisha";73;0;100
0;5;"parishay";5;0;100
5;181;"pariss";186;2.68817204301075;97.3118279569892
0;92;"parissa";92;0;100
0;5;"parita";5;0;100
0;16;"pariz";16;0;100
0;7;"pariza";7;0;100
0;17;"parizoda";17;0;100
1420;0;"park";1420;100;0
620;0;"parke";620;100;0
95844;13291;"parker";109135;87.8215054748706;12.1784945251294
988;0;"parks";988;100;0
0;6;"parkyr";6;0;100
0;341;"parlee";341;0;100
0;5;"parleen";5;0;100
586;0;"parley";586;100;0
0;16;"parlie";16;0;100
0;33;"parma";33;0;100
5;0;"parmanand";5;100;0
5;0;"parmeet";5;100;0
7;0;"parmer";7;100;0
0;21;"parmida";21;0;100
16;15;"parminder";31;51.6129032258064;48.3870967741936
0;33;"parmis";33;0;100
10;0;"parmveer";10;100;0
0;136;"parneet";136;0;100
1414;57;"parnell";1471;96.1250849762067;3.87491502379334
0;5;"parniece";5;0;100
0;165;"parnika";165;0;100
6;0;"parren";6;100;0
0;5;"parri";5;0;100
0;92;"parrie";92;0;100
1833;1528;"parris";3361;54.5373400773579;45.4626599226421
2581;431;"parrish";3012;85.6905710491368;14.3094289508632
508;0;"parry";508;100;0
8;0;"pars";8;100;0
549;0;"parsa";549;100;0
5;0;"parshva";5;100;0
38;0;"parson";38;100;0
1834;0;"parth";1834;100;0
21;0;"partha";21;100;0
0;82;"parthena";82;0;100
0;1243;"parthenia";1243;0;100
0;11;"parthina";11;0;100
91;0;"parthiv";91;100;0
0;111;"particia";111;0;100
209;0;"partick";209;100;0
0;98;"parul";98;0;100
56;0;"parv";56;100;0
0;12;"parvaneh";12;0;100
0;5;"parvathi";5;0;100
0;11;"parvathy";11;0;100
0;12;"parvati";12;0;100
0;33;"parveen";33;0;100
144;0;"parvin";144;100;0
0;10;"parvina";10;0;100
17;0;"parx";17;100;0
5;250;"parys";255;1.96078431372549;98.0392156862745
0;12;"paryss";12;0;100
2201;6;"pascal";2207;99.7281377435433;0.271862256456729
0;598;"pascale";598;0;100
0;214;"pascha";214;0;100
570;0;"paschal";570;100;0
432;0;"pasco";432;100;0
2739;0;"pascual";2739;100;0
0;158;"pascuala";158;0;100
301;498;"pasha";799;37.6720901126408;62.3279098873592
0;25;"pashance";25;0;100
0;22;"pashen";22;0;100
0;42;"pashence";42;0;100
0;13;"pashia";13;0;100
0;5;"pashience";5;0;100
0;57;"pashion";57;0;100
0;6;"pashun";6;0;100
0;13;"pashyn";13;0;100
0;5;"pasiley";5;0;100
16;0;"paskel";16;100;0
0;22;"pasleigh";22;0;100
0;5;"pasley";5;0;100
28;0;"pason";28;100;0
0;16;"pasqua";16;0;100
613;0;"pasqual";613;100;0
9935;0;"pasquale";9935;100;0
0;6;"pasqualena";6;0;100
0;634;"pasqualina";634;0;100
0;16;"pasqualine";16;0;100
29;0;"pasqualino";29;100;0
5;0;"pasquinel";5;100;0
0;2129;"passion";2129;0;100
0;5;"passionae";5;0;100
0;5;"passionate";5;0;100
145;0;"pastor";145;100;0
0;136;"pasty";136;0;100
26246;40112;"pat";66358;39.5521263449772;60.4478736550228
0;16;"patarica";16;0;100
0;13;"pataricia";13;0;100
10;0;"patch";10;100;0
0;151;"patches";151;0;100
232;0;"pate";232;100;0
13;0;"paten";13;100;0
17;0;"pater";17;100;0
0;28;"paterica";28;0;100
0;22;"patericia";22;0;100
0;403;"pati";403;0;100
0;50;"patia";50;0;100
0;36;"patiance";36;0;100
0;215;"paticia";215;0;100
47;0;"patick";47;100;0
17;10423;"patience";10440;0.162835249042146;99.8371647509579
0;282;"patina";282;0;100
0;92;"patirica";92;0;100
81;0;"paton";81;100;0
0;517;"patra";517;0;100
0;11;"patracia";11;0;100
0;99;"patrcia";99;0;100
0;10;"patrea";10;0;100
0;325;"patrece";325;0;100
0;614;"patrecia";614;0;100
0;42;"patreece";42;0;100
16;0;"patrell";16;100;0
0;92;"patrena";92;0;100
0;15;"patrenia";15;0;100
0;26;"patresa";26;0;100
0;123;"patrese";123;0;100
0;6;"patress";6;0;100
0;483;"patria";483;0;100
0;6;"patriana";6;0;100
3005;73;"patric";3078;97.6283300844704;2.37166991552956
10;9144;"patrica";9154;0.10924186148132;99.8907581385187
0;6;"patriccia";6;0;100
755;33997;"patrice";34752;2.17253683241252;97.8274631675875
76;0;"patrich";76;100;0
0;39;"patricha";39;0;100
0;5;"patrichia";5;0;100
0;222;"patrici";222;0;100
4963;1570990;"patricia";1575953;0.314920559179113;99.6850794408209
0;12;"patriciaa";12;0;100
0;369;"patriciaann";369;0;100
0;5;"patriciaanne";5;0;100
0;30;"patriciajo";30;0;100
0;10;"patrician";10;0;100
0;69;"patriciann";69;0;100
0;75;"patricie";75;0;100
17;0;"patricik";17;100;0
4020;5;"patricio";4025;99.8757763975155;0.124223602484472
665617;2829;"patrick";668446;99.5767795753135;0.423220424686512
0;18;"patricka";18;0;100
23;0;"patrickjames";23;100;0
7;0;"patrickjohn";7;100;0
5;0;"patrickjoseph";5;100;0
0;85;"patriece";85;0;100
639;0;"patrik";639;100;0
0;22;"patrika";22;0;100
0;2063;"patrina";2063;0;100
0;19;"patrinia";19;0;100
36;0;"patriot";36;100;0
0;5;"patrisa";5;0;100
0;28;"patrise";28;0;100
0;1077;"patrisha";1077;0;100
0;410;"patrisia";410;0;100
5;0;"patrisio";5;100;0
0;5;"patritia";5;0;100
0;401;"patrizia";401;0;100
5;0;"patrizio";5;100;0
0;10;"patrocinia";10;0;100
6;0;"patrocinio";6;100;0
11;0;"patron";11;100;0
0;7;"patrricia";7;0;100
0;114;"patryce";114;0;100
0;48;"patrycia";48;0;100
0;227;"patrycja";227;0;100
74;0;"patryck";74;100;0
959;0;"patryk";959;100;0
5;507;"patsey";512;0.9765625;99.0234375
0;56;"patsi";56;0;100
0;555;"patsie";555;0;100
7687;118861;"patsy";126548;6.07437494073395;93.9256250592661
0;7;"patsyann";7;0;100
0;152;"patsye";152;0;100
10;400;"patt";410;2.4390243902439;97.5609756097561
0;94;"patte";94;0;100
490;20;"patterson";510;96.078431372549;3.92156862745098
46;44665;"patti";44711;0.102882959450694;99.8971170405493
0;169;"pattiann";169;0;100
0;27;"pattianne";27;0;100
5;8935;"pattie";8940;0.0559284116331096;99.9440715883669
0;6;"pattii";6;0;100
0;88;"pattijo";88;0;100
0;6;"pattina";6;0;100
1164;73;"patton";1237;94.0986257073565;5.90137429264349
0;87;"pattricia";87;0;100
89;0;"pattrick";89;100;0
0;43;"pattsy";43;0;100
247;62366;"patty";62613;0.394486767923594;99.6055132320764
0;22;"pattyann";22;0;100
0;297;"pattye";297;0;100
0;5;"paty";5;0;100
0;5;"patyn";5;0;100
0;40;"patzy";40;0;100
200;0;"pau";200;100;0
0;5;"paublita";5;0;100
78;0;"paublo";78;100;0
1372732;5772;"paul";1378504;99.5812852193392;0.418714780660774
893;277079;"paula";277972;0.321255378239535;99.6787446217605
0;25;"paulann";25;0;100
0;22;"paulanne";22;0;100
136;0;"paulanthony";136;100;0
0;18;"paule";18;0;100
0;49;"paulean";49;0;100
0;142;"pauleen";142;0;100
0;126;"paulena";126;0;100
0;1416;"paulene";1416;0;100
0;47;"paulet";47;0;100
0;5;"pauleta";5;0;100
0;6;"pauleth";6;0;100
0;396;"paulett";396;0;100
0;2522;"pauletta";2522;0;100
65;45968;"paulette";46033;0.14120304998588;99.8587969500141
0;26;"pauli";26;0;100
0;15;"paulia";15;0;100
47;11;"paulie";58;81.0344827586207;18.9655172413793
15;0;"paulin";15;100;0
5;16874;"paulina";16879;0.0296226079744061;99.9703773920256
0;5;"paulinda";5;0;100
758;216647;"pauline";217405;0.348658034543824;99.6513419654562
1643;0;"paulino";1643;100;0
0;46;"paulisha";46;0;100
0;986;"paulita";986;0;100
11;0;"pauljohn";11;100;0
6;0;"pauljoseph";6;100;0
17;0;"paull";17;100;0
0;262;"paulla";262;0;100
0;182;"paullette";182;0;100
0;5;"paullina";5;0;100
182;0;"paulmichael";182;100;0
4194;0;"paulo";4194;100;0
22;0;"paulos";22;100;0
7;0;"paulson";7;100;0
21;0;"paulus";21;100;0
0;5;"paulyn";5;0;100
0;5;"paulyna";5;0;100
0;321;"paulyne";321;0;100
531;0;"pavan";531;100;0
0;31;"pavani";31;0;100
1239;0;"pavel";1239;100;0
0;5;"pavelle";5;0;100
0;7;"pavi";7;0;100
0;131;"pavielle";131;0;100
5;0;"pavin";5;100;0
0;49;"pavithra";49;0;100
0;6;"pavitra";6;0;100
84;0;"pavle";84;100;0
0;5;"pavlina";5;0;100
37;0;"pavlo";37;100;0
104;0;"pavlos";104;100;0
10;0;"pavly";10;100;0
0;5;"pavneet";5;0;100
0;5;"pavni";5;0;100
0;157;"paw";157;0;100
43;0;"pawan";43;100;0
449;0;"pawel";449;100;0
0;15;"pawnee";15;0;100
429;23;"pax";452;94.9115044247788;5.08849557522124
0;5;"paxley";5;0;100
290;0;"paxon";290;100;0
285;0;"paxson";285;100;0
5;0;"paxston";5;100;0
172;31;"paxten";203;84.7290640394089;15.2709359605911
35;0;"paxtin";35;100;0
15541;1459;"paxton";17000;91.4176470588235;8.58235294117647
207;238;"paxtyn";445;46.5168539325843;53.4831460674157
0;673;"payal";673;0;100
193;0;"payam";193;100;0
32;0;"payce";32;100;0
0;14;"paycee";14;0;100
27;42;"paycen";69;39.1304347826087;60.8695652173913
0;5;"paycie";5;0;100
1182;606;"payden";1788;66.1073825503356;33.8926174496644
6;0;"paydin";6;100;0
120;0;"paydon";120;100;0
0;6;"payeng";6;0;100
0;75;"payeton";75;0;100
0;1077;"payge";1077;0;100
0;25;"paying";25;0;100
0;6;"paylan";6;0;100
0;5;"paylee";5;0;100
0;34;"paylen";34;0;100
0;119;"paylin";119;0;100
5;0;"payman";5;100;0
57;0;"paymon";57;100;0
1159;11;"payne";1170;99.0598290598291;0.94017094017094
60;144;"paysen";204;29.4117647058824;70.5882352941177
0;6;"payshance";6;0;100
0;42;"payshence";42;0;100
0;224;"payslee";224;0;100
0;5;"payslei";5;0;100
0;23;"paysleigh";23;0;100
0;60;"paysley";60;0;100
0;25;"paysli";25;0;100
0;97;"payslie";97;0;100
1007;717;"payson";1724;58.4106728538283;41.5893271461717
7;170;"paytan";177;3.95480225988701;96.045197740113
590;2943;"payten";3533;16.6996886498726;83.3003113501274
0;60;"paytience";60;0;100
36;500;"paytin";536;6.71641791044776;93.2835820895522
0;52;"paytn";52;0;100
23165;49355;"payton";72520;31.9429123000552;68.0570876999448
0;5;"paytten";5;0;100
0;34;"paytton";34;0;100
0;421;"paytyn";421;0;100
0;6;"paytynn";6;0;100
0;147;"payzlee";147;0;100
0;13;"payzleigh";13;0;100
0;23;"payzley";23;0;100
0;13;"payzli";13;0;100
0;45;"payzlie";45;0;100
166;498;"paz";664;25;75
0;13;"pazley";13;0;100
0;10;"pazong";10;0;100
87;372;"peace";459;18.9542483660131;81.0457516339869
0;741;"peaches";741;0;100
0;110;"peachie";110;0;100
0;6;"pear";6;0;100
981;12;"pearce";993;98.7915407854985;1.20845921450151
2886;125644;"pearl";128530;2.24539018128063;97.7546098187194
0;498;"pearla";498;0;100
0;5;"pearlann";5;0;100
0;1891;"pearle";1891;0;100
0;1061;"pearlean";1061;0;100
0;224;"pearlee";224;0;100
0;51;"pearleen";51;0;100
0;336;"pearlena";336;0;100
0;1957;"pearlene";1957;0;100
0;5;"pearletha";5;0;100
0;5;"pearletta";5;0;100
0;22;"pearlette";22;0;100
156;634;"pearley";790;19.746835443038;80.253164556962
0;46;"pearlia";46;0;100
657;16764;"pearlie";17421;3.77131048734286;96.2286895126571
0;163;"pearlina";163;0;100
0;6207;"pearline";6207;0;100
208;1584;"pearly";1792;11.6071428571429;88.3928571428571
168;0;"pearse";168;100;0
1148;63;"pearson";1211;94.7976878612717;5.20231213872832
6;0;"peary";6;100;0
8;0;"peat";8;100;0
0;306;"pebble";306;0;100
0;874;"pebbles";874;0;100
0;788;"pecola";788;0;100
0;490;"pecolia";490;0;100
25;0;"pecos";25;100;0
788;0;"peder";788;100;0
0;12;"pedra";12;0;100
65;0;"pedram";65;100;0
27;0;"pedrito";27;100;0
86669;499;"pedro";87168;99.4275422173275;0.57245778267254
99;0;"pedrohenrique";99;100;0
6;0;"pedrojose";6;100;0
5;0;"pedrojr";5;100;0
6;0;"pedroluis";6;100;0
5;0;"pedrum";5;100;0
23;0;"peer";23;100;0
6;0;"peerless";6;100;0
0;840;"peg";840;0;100
0;75;"pegah";75;0;100
0;12;"pegan";12;0;100
0;202;"pegeen";202;0;100
0;246;"pegge";246;0;100
0;723;"peggi";723;0;100
0;7320;"peggie";7320;0;100
799;292079;"peggy";292878;0.272809838909034;99.727190161091
0;300;"peggyann";300;0;100
0;16;"peggyanne";16;0;100
0;298;"peggye";298;0;100
0;6;"peggyjo";6;0;100
0;5;"peggylee";5;0;100
0;54;"peggysue";54;0;100
0;156;"pegi";156;0;100
0;18;"pei";18;0;100
0;11;"peighten";11;0;100
77;2165;"peighton";2242;3.43443354148082;96.5655664585192
0;139;"peightyn";139;0;100
89;0;"peirce";89;100;0
24;0;"peirre";24;100;0
0;25;"peiton";25;0;100
0;90;"peityn";90;0;100
23;61;"peja";84;27.3809523809524;72.6190476190476
5;0;"pejman";5;100;0
6;0;"pejmon";6;100;0
0;11;"pela";11;0;100
0;63;"pelagia";63;0;100
46;40;"pele";86;53.4883720930233;46.5116279069767
5;0;"peleg";5;100;0
123;0;"pelham";123;100;0
0;7;"pelia";7;0;100
0;54;"pelin";54;0;100
0;24;"pella";24;0;100
97;0;"pellegrino";97;100;0
0;20;"pelma";20;0;100
0;135;"pema";135;0;100
0;38;"pemberley";38;0;100
0;5;"pemela";5;0;100
0;21;"pencie";21;0;100
0;70;"penda";70;0;100
6;0;"pender";6;100;0
30;7;"pendleton";37;81.0810810810811;18.9189189189189
0;5;"pene";5;0;100
0;5;"penella";5;0;100
0;23;"penellope";23;0;100
14;52392;"penelope";52406;0.0267144983398847;99.9732855016601
0;11;"penelopea";11;0;100
0;13;"peneloperose";13;0;100
0;47;"penelopi";47;0;100
0;10;"penelopie";10;0;100
0;38;"penelopy";38;0;100
227;0;"peng";227;100;0
5;144;"peni";149;3.35570469798658;96.6442953020134
95;74;"peniel";169;56.2130177514793;43.7869822485207
0;765;"penina";765;0;100
13;0;"penisimani";13;100;0
0;28;"penley";28;0;100
679;10;"penn";689;98.5486211901306;1.45137880986938
0;485;"penne";485;0;100
0;29;"pennee";29;0;100
0;245;"pennelope";245;0;100
0;1937;"penney";1937;0;100
0;2580;"penni";2580;0;100
0;5594;"pennie";5594;0;100
12;6;"pennington";18;66.6666666666667;33.3333333333333
388;97105;"penny";97493;0.397977290677279;99.6020227093227
0;5;"pennyann";5;0;100
0;223;"pennye";223;0;100
0;40;"pennylane";40;0;100
0;6;"penola";6;0;100
21;6;"penrose";27;77.7777777777778;22.2222222222222
0;5;"pensacola";5;0;100
0;64;"peola";64;0;100
0;43;"peony";43;0;100
155;0;"pepe";155;100;0
10;0;"pepi";10;100;0
211;2098;"pepper";2309;9.13815504547423;90.8618449545258
5;13;"peppi";18;27.7777777777778;72.2222222222222
5;0;"peppino";5;100;0
0;44;"pepsi";44;0;100
355;0;"per";355;100;0
15;0;"percel";15;100;0
1064;0;"percell";1064;100;0
39;0;"percey";39;100;0
46;30;"percie";76;60.5263157894737;39.4736842105263
0;561;"percilla";561;0;100
0;5;"percious";5;0;100
878;0;"percival";878;100;0
28591;547;"percy";29138;98.1227263367424;1.8772736632576
0;31;"perdita";31;0;100
29;0;"peregrin";29;100;0
0;5;"peregrina";5;0;100
108;33;"peregrine";141;76.5957446808511;23.4042553191489
0;530;"perel";530;0;100
0;16;"perette";16;0;100
71;0;"peretz";71;100;0
528;0;"perez";528;100;0
0;5;"perfect";5;0;100
0;25;"perfecta";25;0;100
876;0;"perfecto";876;100;0
10;2173;"peri";2183;0.458085203847916;99.5419147961521
0;5;"peria";5;0;100
0;73;"perian";73;0;100
0;32;"periann";32;0;100
0;5;"perianne";5;0;100
67;0;"pericles";67;100;0
0;7;"perilla";7;0;100
0;96;"perina";96;0;100
6;22;"peris";28;21.4285714285714;78.5714285714286
79;0;"perkins";79;100;0
70;375;"perl";445;15.7303370786517;84.2696629213483
30;18757;"perla";18787;0.15968488848672;99.8403151115133
75;192;"perle";267;28.0898876404494;71.9101123595506
0;25;"perlean";25;0;100
0;12;"perlena";12;0;100
0;56;"perlene";56;0;100
814;27;"perley";841;96.7895362663496;3.21046373365042
73;526;"perlie";599;12.1869782971619;87.8130217028381
0;28;"perlina";28;0;100
0;216;"perline";216;0;100
0;306;"perlita";306;0;100
0;12;"perma";12;0;100
24;0;"perman";24;100;0
0;433;"permelia";433;0;100
0;23;"perna";23;0;100
2971;275;"pernell";3246;91.5280345040049;8.47196549599507
0;99;"pernella";99;0;100
0;10;"pernetta";10;0;100
0;10;"pernia";10;0;100
0;321;"pernie";321;0;100
5;0;"peron";5;100;0
0;62;"perpetua";62;0;100
114;2118;"perri";2232;5.10752688172043;94.8924731182796
0;12;"perriann";12;0;100
44;239;"perrie";283;15.547703180212;84.452296819788
5;0;"perrier";5;100;0
1238;390;"perrin";1628;76.0442260442261;23.955773955774
0;18;"perrine";18;0;100
167;0;"perrion";167;100;0
174;115;"perris";289;60.2076124567474;39.7923875432526
6;0;"perrish";6;100;0
72470;2777;"perry";75247;96.3094874214254;3.69051257857456
20;6;"perryn";26;76.9230769230769;23.0769230769231
0;42;"persaeus";42;0;100
0;80;"persais";80;0;100
0;18;"persaius";18;0;100
0;8;"persaus";8;0;100
0;5;"persaya";5;0;100
0;15;"persayis";15;0;100
0;50;"persayus";50;0;100
0;5;"perscilla";5;0;100
0;24;"perseis";24;0;100
5;0;"persell";5;100;0
0;126;"persephanie";126;0;100
0;17;"persephany";17;0;100
0;1941;"persephone";1941;0;100
0;8;"persephoni";8;0;100
0;77;"persephonie";77;0;100
0;12;"persephony";12;0;100
323;27;"perseus";350;92.2857142857143;7.71428571428571
10;0;"persey";10;100;0
599;0;"pershing";599;100;0
0;688;"persia";688;0;100
0;474;"persis";474;0;100
0;5;"personna";5;0;100
0;11;"pertina";11;0;100
0;5;"pertrina";5;0;100
10;0;"pervie";10;100;0
873;0;"pervis";873;100;0
0;10;"peryl";10;0;100
77;0;"pesach";77;100;0
0;16;"pesha";16;0;100
0;10;"peshy";10;0;100
0;42;"pessel";42;0;100
0;11;"pessi";11;0;100
0;29;"pessie";29;0;100
0;742;"pessy";742;0;100
10;10;"pet";20;50;50
0;6;"peta";6;0;100
0;24;"petal";24;0;100
510;0;"petar";510;100;0
41807;170;"pete";41977;99.5950163184601;0.404983681539891
564451;1926;"peter";566377;99.6599438183401;0.340056181659919
5;0;"peteris";5;100;0
5;0;"peterjames";5;100;0
44;0;"peterjohn";44;100;0
735;0;"peterson";735;100;0
26;0;"petey";26;100;0
21;0;"petie";21;100;0
0;119;"petina";119;0;100
0;5;"petite";5;0;100
93;0;"petr";93;100;0
67;12749;"petra";12816;0.522784019975031;99.477215980025
5;0;"petre";5;100;0
0;63;"petrea";63;0;100
0;5;"petria";5;0;100
0;173;"petrice";173;0;100
5;0;"petrick";5;100;0
0;2107;"petrina";2107;0;100
5;0;"petrit";5;100;0
0;69;"petrita";69;0;100
165;0;"petro";165;100;0
0;198;"petrona";198;0;100
0;325;"petronella";325;0;100
0;43;"petronia";43;0;100
0;32;"petronila";32;0;100
0;57;"petronilla";57;0;100
57;0;"petronilo";57;100;0
601;0;"petros";601;100;0
5;0;"petrus";5;100;0
55;0;"petter";55;100;0
6;0;"pettus";6;100;0
0;20;"petty";20;0;100
0;179;"petula";179;0;100
0;5;"petunia";5;0;100
0;5;"petyon";5;0;100
5;16;"peyden";21;23.8095238095238;76.1904761904762
24;0;"peydon";24;100;0
79;107;"peyson";186;42.4731182795699;57.5268817204301
0;268;"peytan";268;0;100
131;458;"peyten";589;22.2410865874363;77.7589134125637
23;210;"peytin";233;9.87124463519313;90.1287553648069
46628;65980;"peyton";112608;41.4073600454675;58.5926399545325
0;6;"peytonmarie";6;0;100
0;5;"peytonn";5;0;100
0;225;"peytyn";225;0;100
0;10;"peytynn";10;0;100
0;16;"pfeiffer";16;0;100
49;0;"phabian";49;100;0
0;15;"phadra";15;0;100
0;1710;"phaedra";1710;0;100
0;8;"phaidra";8;0;100
0;48;"phaith";48;0;100
0;7;"phajja";7;0;100
0;162;"phala";162;0;100
21;18;"phalen";39;53.8461538461538;46.1538461538462
0;5;"phalicia";5;0;100
0;7;"phalla";7;0;100
0;5;"phallen";5;0;100
0;121;"phallon";121;0;100
0;18;"phallyn";18;0;100
15;37;"phalon";52;28.8461538461538;71.1538461538462
0;40;"phalyn";40;0;100
0;10;"phalynn";10;0;100
20;15;"phan";35;57.1428571428571;42.8571428571429
0;7;"phanta";7;0;100
0;59;"phantasia";59;0;100
16;0;"phanuel";16;100;0
0;21;"phara";21;0;100
0;31;"pharah";31;0;100
751;0;"pharaoh";751;100;0
182;0;"pharell";182;100;0
219;0;"phares";219;100;0
17;0;"pharez";17;100;0
23;0;"pharis";23;100;0
456;0;"pharoah";456;100;0
27;0;"pharoh";27;100;0
6;5;"pharon";11;54.5454545454545;45.4545454545455
0;117;"pharrah";117;0;100
340;0;"pharrell";340;100;0
0;5;"pharren";5;0;100
0;5;"pharyn";5;0;100
124;0;"phat";124;100;0
0;21;"phatima";21;0;100
0;5;"phawn";5;0;100
5;0;"phazon";5;100;0
0;17;"pheadra";17;0;100
0;48;"pheba";48;0;100
0;2312;"phebe";2312;0;100
0;5;"phebee";5;0;100
0;6;"phebia";6;0;100
0;22;"phebie";22;0;100
0;5;"pheby";5;0;100
0;47;"phedra";47;0;100
501;63;"phelan";564;88.8297872340426;11.1702127659574
0;6;"phelecia";6;0;100
0;202;"phelicia";202;0;100
0;10;"phelicity";10;0;100
0;10;"phelisha";10;0;100
116;0;"phelix";116;100;0
59;0;"phelps";59;100;0
436;0;"pheng";436;100;0
0;26;"phenicia";26;0;100
5;0;"phenious";5;100;0
292;176;"phenix";468;62.3931623931624;37.6068376068376
0;30;"phenyx";30;0;100
0;886;"pheobe";886;0;100
0;7;"pheobie";7;0;100
0;47;"pheona";47;0;100
376;286;"pheonix";662;56.797583081571;43.202416918429
474;45;"phi";519;91.3294797687861;8.67052023121387
0;5;"phia";5;0;100
19589;73;"phil";19662;99.6287254602787;0.37127453972129
0;47;"phila";47;0;100
0;34;"philadelphia";34;0;100
0;89;"philamena";89;0;100
0;332;"philana";332;0;100
297;0;"philander";297;100;0
14;0;"philant";14;100;0
797;0;"philbert";797;100;0
0;6;"philece";6;0;100
0;33;"philecia";33;0;100
810;0;"philemon";810;100;0
0;133;"philena";133;0;100
0;11;"philene";11;0;100
0;7;"philesha";7;0;100
20;0;"philias";20;100;0
5;0;"philibert";5;100;0
0;502;"philicia";502;0;100
0;6;"philicity";6;0;100
0;19;"philina";19;0;100
334265;1131;"philip";335396;99.6627866760486;0.337213323951389
147;0;"philipe";147;100;0
886;0;"philipp";886;100;0
0;1228;"philippa";1228;0;100
2871;0;"philippe";2871;100;0
0;16;"philippine";16;0;100
15;0;"philippos";15;100;0
16;0;"philips";16;100;0
0;217;"philis";217;0;100
0;17;"philisa";17;0;100
0;109;"philisha";109;0;100
0;5;"philistine";5;0;100
5;0;"philix";5;100;0
623;0;"phill";623;100;0
0;34;"phillicia";34;0;100
0;46;"phillina";46;0;100
304801;1332;"phillip";306133;99.5648949966191;0.435105003380883
0;97;"phillipa";97;0;100
612;0;"phillipe";612;100;0
21;0;"philliph";21;100;0
12;0;"phillipmichael";12;100;0
31;0;"phillipp";31;100;0
0;66;"phillippa";66;0;100
217;0;"phillippe";217;100;0
1305;0;"phillips";1305;100;0
6;3609;"phillis";3615;0.16597510373444;99.8340248962656
0;7;"phillisa";7;0;100
0;11;"phillisha";11;0;100
0;5;"phillistine";5;0;100
64;0;"phillp";64;100;0
5;0;"philly";5;100;0
0;16;"phillys";16;0;100
5;0;"philmon";5;100;0
349;0;"philmore";349;100;0
286;0;"philo";286;100;0
0;5;"philomen";5;0;100
0;8703;"philomena";8703;0;100
0;430;"philomene";430;0;100
0;15;"philomenia";15;0;100
0;47;"philomina";47;0;100
0;11;"philomine";11;0;100
93;0;"philopateer";93;100;0
61;0;"philopater";61;100;0
5;0;"philp";5;100;0
5;0;"philson";5;100;0
5;0;"phin";5;100;0
1718;0;"phineas";1718;100;0
255;0;"phinehas";255;100;0
17;0;"phineus";17;100;0
5;0;"phinizy";5;100;0
13;54;"phinley";67;19.4029850746269;80.5970149253731
17;0;"phinn";17;100;0
13;0;"phinnaeus";13;100;0
100;0;"phinneas";100;100;0
6;0;"phinneaus";6;100;0
0;79;"phiona";79;0;100
0;20;"phoeba";20;0;100
5;29998;"phoebe";30003;0.01666500016665;99.9833349998333
0;25;"phoebee";25;0;100
0;5;"phoebi";5;0;100
0;48;"phoebie";48;0;100
0;122;"phoenicia";122;0;100
12455;7877;"phoenix";20332;61.2581152862483;38.7418847137517
8;11;"phoenixx";19;42.1052631578947;57.8947368421053
145;295;"phoenyx";440;32.9545454545455;67.0454545454545
0;5;"phonesavanh";5;0;100
948;5;"phong";953;99.4753410283316;0.524658971668415
0;99;"phoua";99;0;100
0;5;"phoung";5;0;100
0;32;"phronia";32;0;100
0;24;"phronsie";24;0;100
270;0;"phu";270;100;0
272;7;"phuc";279;97.4910394265233;2.5089605734767
16;163;"phung";179;8.93854748603352;91.0614525139665
135;0;"phuoc";135;100;0
282;1033;"phuong";1315;21.4448669201521;78.5551330798479
0;5;"phuonganh";5;0;100
0;6;"phuongvy";6;0;100
0;70;"phyillis";70;0;100
0;6;"phylea";6;0;100
0;22;"phylecia";22;0;100
0;11;"phylica";11;0;100
0;2380;"phylicia";2380;0;100
0;3337;"phylis";3337;0;100
0;6;"phylisa";6;0;100
0;135;"phylisha";135;0;100
0;5;"phylisia";5;0;100
0;2406;"phyliss";2406;0;100
0;135;"phyllicia";135;0;100
92;0;"phyllip";92;100;0
871;321556;"phyllis";322427;0.270138667047115;99.7298613329529
0;17;"phyllisann";17;0;100
0;11;"phyllisha";11;0;100
0;10;"phyllisia";10;0;100
0;597;"phylliss";597;0;100
0;80;"phyllistine";80;0;100
0;22;"phyllys";22;0;100
31;84;"phynix";115;26.9565217391304;73.0434782608696
6;0;"phynn";6;100;0
0;2856;"pia";2856;0;100
0;5;"picabo";5;0;100
0;309;"piccola";309;0;100
11;0;"pickens";11;100;0
0;10;"picola";10;0;100
0;252;"piedad";252;0;100
0;163;"pieper";163;0;100
109;364;"pier";473;23.0443974630021;76.9556025369979
0;65;"piera";65;0;100
14875;186;"pierce";15061;98.765022242879;1.23497775712104
151;0;"piercen";151;100;0
31;0;"pierceson";31;100;0
40;0;"piere";40;100;0
0;6;"pierette";6;0;100
0;257;"pierina";257;0;100
18;0;"pierino";18;100;0
608;0;"piero";608;100;0
0;56;"pierra";56;0;100
17271;74;"pierre";17345;99.573364081868;0.426635918132027
0;240;"pierrette";240;0;100
13;0;"pierrie";13;100;0
241;0;"piers";241;100;0
23;0;"piersen";23;100;0
2263;42;"pierson";2305;98.177874186551;1.82212581344902
5;0;"pierston";5;100;0
973;0;"pieter";973;100;0
0;97;"pietra";97;0;100
0;81;"pietrina";81;0;100
2056;0;"pietro";2056;100;0
0;14;"piffany";14;0;100
0;49;"pihu";49;0;100
0;5;"piilani";5;0;100
134;0;"pike";134;100;0
753;5053;"pilar";5806;12.969342059938;87.030657940062
113;0;"pilot";113;100;0
0;332;"pina";332;0;100
0;17;"pinar";17;0;100
823;0;"pinchas";823;100;0
28;0;"pinches";28;100;0
247;0;"pinchos";247;100;0
495;0;"pinchus";495;100;0
42;0;"pinckney";42;100;0
52;0;"pincus";52;100;0
0;36;"piney";36;0;100
6;10;"ping";16;37.5;62.5
719;20;"pink";739;97.2936400541272;2.7063599458728
6;476;"pinkey";482;1.2448132780083;98.7551867219917
11;3230;"pinkie";3241;0.339401419315026;99.660598580685
418;0;"pinkney";418;100;0
0;335;"pinky";335;0;100
6;0;"pinny";6;100;0
10;0;"pino";10;100;0
243;0;"pio";243;100;0
5;0;"pioet";5;100;0
5;0;"pioquinto";5;100;0
715;0;"piotr";715;100;0
179;38606;"piper";38785;0.461518628335697;99.5384813716643
0;818;"pippa";818;0;100
0;36;"pipper";36;0;100
0;6;"pippi";6;0;100
5;24;"pippin";29;17.2413793103448;82.7586206896552
0;15;"pirl";15;0;100
0;5;"pirley";5;0;100
56;19;"pistol";75;74.6666666666667;25.3333333333333
11;43;"pita";54;20.3703703703704;79.6296296296296
16;0;"pittman";16;100;0
393;0;"pius";393;100;0
0;509;"pixie";509;0;100
0;5;"pixley";5;0;100
0;91;"piya";91;0;100
35;0;"piyush";35;100;0
187;0;"pj";187;100;0
0;152;"placida";152;0;100
5;0;"placide";5;100;0
1099;0;"placido";1099;100;0
5;0;"plas";5;100;0
0;5;"plassie";5;0;100
0;5;"platinum";5;0;100
216;0;"plato";216;100;0
85;0;"platon";85;100;0
5;0;"platt";5;100;0
5;0;"playford";5;100;0
699;0;"pleas";699;100;0
468;53;"pleasant";521;89.8272552783109;10.1727447216891
0;11;"pleasure";11;0;100
24;0;"pledger";24;100;0
305;0;"ples";305;100;0
0;210;"pleshette";210;0;100
101;0;"plez";101;100;0
6;0;"pleze";6;100;0
0;11;"plina";11;0;100
5;0;"plinio";5;100;0
10;0;"pliny";10;100;0
0;5;"plum";5;0;100
0;384;"pluma";384;0;100
72;24;"plumer";96;75;25
0;10;"plumie";10;0;100
411;0;"plummer";411;100;0
0;15;"plummie";15;0;100
24;0;"plutarco";24;100;0
0;22;"pnina";22;0;100
5;0;"po";5;100;0
0;198;"pocahontas";198;0;100
26;5;"poe";31;83.8709677419355;16.1290322580645
0;6;"poem";6;0;100
38;107;"poet";145;26.2068965517241;73.7931034482759
0;5;"poetri";5;0;100
0;107;"poetry";107;0;100
15;0;"pol";15;100;0
0;586;"pola";586;0;100
0;5;"polaris";5;0;100
0;47;"polet";47;0;100
0;23;"poleth";23;0;100
0;15;"polett";15;0;100
0;101;"polette";101;0;100
27;0;"policarpio";27;100;0
0;851;"polina";851;0;100
0;5;"polixeni";5;0;100
63;0;"polk";63;100;0
22;0;"pollard";22;100;0
0;5;"polley";5;0;100
0;13;"polli";13;0;100
0;1027;"pollie";1027;0;100
23;0;"pollux";23;100;0
24;27957;"polly";27981;0.0857724884743219;99.9142275115257
0;166;"pollyann";166;0;100
0;1034;"pollyanna";1034;0;100
0;22;"pollyanne";22;0;100
0;22;"pollye";22;0;100
495;0;"polo";495;100;0
0;10;"pomaikai";10;0;100
6;0;"pompey";6;100;0
0;6;"pomposa";6;0;100
5;0;"pomposo";5;100;0
140;0;"ponce";140;100;0
5;0;"poncho";5;100;0
264;0;"ponciano";264;100;0
0;46;"ponda";46;0;100
0;5;"pondra";5;0;100
21;0;"pong";21;100;0
25;0;"pono";25;100;0
0;1970;"pooja";1970;0;100
5;0;"poojan";5;100;0
76;0;"pookela";76;100;0
0;260;"poonam";260;0;100
0;5;"poorna";5;0;100
0;30;"poorvi";30;0;100
5;0;"pooya";5;100;0
73;0;"pope";73;100;0
0;51;"poppi";51;0;100
0;6;"poppie";6;0;100
0;2452;"poppy";2452;0;100
0;865;"porcha";865;0;100
0;7;"porchae";7;0;100
0;748;"porche";748;0;100
0;116;"porchea";116;0;100
0;11;"porcher";11;0;100
0;528;"porchia";528;0;100
0;167;"porcia";167;0;100
0;24;"porcsha";24;0;100
0;235;"porfiria";235;0;100
3420;0;"porfirio";3420;100;0
0;1452;"porscha";1452;0;100
0;2103;"porsche";2103;0;100
0;139;"porschea";139;0;100
0;242;"porschia";242;0;100
6;3978;"porsha";3984;0.150602409638554;99.8493975903614
0;30;"porshae";30;0;100
0;42;"porshay";42;0;100
0;270;"porshe";270;0;100
0;63;"porshea";63;0;100
0;608;"porshia";608;0;100
0;5;"porsia";5;0;100
18;0;"port";18;100;0
14484;426;"porter";14910;97.1428571428571;2.85714285714286
8;10395;"portia";10403;0.0769008939728924;99.9230991060271
28;97;"portland";125;22.4;77.6
0;18;"portlyn";18;0;100
0;11;"portlynn";11;0;100
114;0;"poseidon";114;100;0
367;209;"posey";576;63.7152777777778;36.2847222222222
60;54;"posie";114;52.6315789473684;47.3684210526316
0;32;"posy";32;0;100
0;33;"pota";33;0;100
5;5;"potter";10;50;50
0;7;"poua";7;0;100
39;0;"poul";39;100;0
6;0;"pouya";6;100;0
1358;6;"powell";1364;99.5601173020528;0.439882697947214
17;0;"power";17;100;0
17;0;"powers";17;100;0
34;0;"poyraz";34;100;0
0;10;"ppatricia";10;0;100
5;0;"prabal";5;100;0
5;0;"prabhas";5;100;0
6;0;"prabhat";6;100;0
85;0;"prabhav";85;100;0
18;0;"prabhdeep";18;100;0
128;23;"prabhjot";151;84.7682119205298;15.2317880794702
0;60;"prabhleen";60;0;100
23;28;"prabhnoor";51;45.0980392156863;54.9019607843137
5;0;"prabin";5;100;0
5;0;"prabjot";5;100;0
0;412;"prachi";412;0;100
0;5;"pracilla";5;0;100
62;0;"pradeep";62;100;0
5;0;"pradhyun";5;100;0
17;0;"pradyumna";17;100;0
83;0;"pradyun";83;100;0
0;18;"pragathi";18;0;100
0;9;"pragati";9;0;100
0;54;"pragna";54;0;100
0;40;"pragnya";40;0;100
0;142;"pragya";142;0;100
17;0;"pragyan";17;100;0
5;0;"praharsh";5;100;0
51;0;"prahlad";51;100;0
0;261;"prairie";261;0;100
179;499;"praise";678;26.401179941003;73.598820058997
5;0;"prajedes";5;100;0
5;0;"prajin";5;100;0
21;0;"prajit";21;100;0
0;91;"prajna";91;0;100
73;0;"prajwal";73;100;0
57;0;"prakash";57;100;0
11;0;"prakhar";11;100;0
5;0;"prakrit";5;100;0
0;60;"prakriti";60;0;100
0;5;"prakruti";5;0;100
5;0;"pramit";5;100;0
16;0;"pramod";16;100;0
0;133;"pranathi";133;0;100
0;60;"pranati";60;0;100
3509;0;"pranav";3509;100;0
0;366;"pranavi";366;0;100
401;0;"pranay";401;100;0
0;29;"pranaya";29;0;100
189;0;"praneel";189;100;0
12;0;"praneet";12;100;0
105;0;"praneeth";105;100;0
31;0;"pranesh";31;100;0
0;48;"pranika";48;0;100
11;0;"pranil";11;100;0
46;0;"pranish";46;100;0
0;24;"pranisha";24;0;100
75;0;"pranit";75;100;0
0;35;"pranita";35;0;100
20;0;"pranith";20;100;0
0;5;"pranitha";5;0;100
23;29;"pranjal";52;44.2307692307692;55.7692307692308
0;28;"pranshi";28;0;100
57;0;"pranshu";57;100;0
0;5;"pranvi";5;0;100
0;54;"prapti";54;0;100
0;53;"prarthana";53;0;100
5;0;"prasad";5;100;0
278;0;"prashant";278;100;0
6;0;"prashanth";6;100;0
5;0;"prasoon";5;100;0
223;0;"prateek";223;100;0
348;0;"pratham";348;100;0
32;0;"pratheek";32;100;0
65;0;"prather";65;100;0
87;0;"prathik";87;100;0
516;0;"pratik";516;100;0
0;6;"pratiksha";6;0;100
0;10;"pratima";10;0;100
80;0;"pratt";80;100;0
132;0;"pratyush";132;100;0
0;5;"pratyusha";5;0;100
0;5;"pravallika";5;0;100
217;0;"praveen";217;100;0
5;0;"praveer";5;100;0
63;0;"pravin";63;100;0
5;0;"praxedis";5;100;0
21;0;"praxton";21;100;0
6;0;"pray";6;100;0
32;0;"prayag";32;100;0
49;0;"prayan";49;100;0
6;0;"prayas";6;100;0
5;0;"prayash";5;100;0
0;35;"prayer";35;0;100
0;15;"praylee";15;0;100
0;6;"prayze";6;0;100
0;5;"preana";5;0;100
0;15;"preanna";15;0;100
0;13;"prebble";13;0;100
5;0;"precieux";5;100;0
65;0;"preciliano";65;100;0
0;670;"precilla";670;0;100
0;150;"preciosa";150;0;100
135;18632;"precious";18767;0.719347791335855;99.2806522086642
0;5;"preciousa";5;0;100
0;5;"precius";5;0;100
0;5;"precyous";5;0;100
5;0;"predrag";5;100;0
0;36;"preesha";36;0;100
141;82;"preet";223;63.2286995515695;36.7713004484305
5;0;"preetam";5;100;0
6;0;"preetham";6;100;0
0;188;"preethi";188;0;100
0;360;"preeti";360;0;100
0;65;"preeya";65;0;100
0;17;"preksha";17;0;100
439;0;"prem";439;100;0
0;48;"prema";48;0;100
10;0;"premal";10;100;0
17;0;"premier";17;100;0
5;0;"premiere";5;100;0
16;0;"prenell";16;100;0
0;5;"prenella";5;0;100
0;5;"prenisha";5;0;100
3804;57;"prentice";3861;98.5236985236985;1.47630147630148
1255;0;"prentis";1255;100;0
2661;60;"prentiss";2721;97.7949283351709;2.20507166482911
0;6;"preonda";6;0;100
0;63;"prerana";63;0;100
0;73;"prerna";73;0;100
5;0;"presciliano";5;100;0
0;1037;"prescilla";1037;0;100
0;76;"prescious";76;0;100
1400;15;"prescott";1415;98.9399293286219;1.06007067137809
0;59;"preshus";59;0;100
39;0;"president";39;100;0
0;6;"presila";6;0;100
15;0;"presiliano";15;100;0
0;5;"presilla";5;0;100
0;43;"presious";43;0;100
0;107;"preslea";107;0;100
42;2382;"preslee";2424;1.73267326732673;98.2673267326733
0;83;"preslei";83;0;100
0;1237;"presleigh";1237;0;100
3869;18906;"presley";22775;16.9879253567508;83.0120746432492
0;407;"presli";407;0;100
0;1406;"preslie";1406;0;100
0;141;"presly";141;0;100
0;81;"preslyn";81;0;100
0;46;"preslynn";46;0;100
153;0;"press";153;100;0
0;12;"pressie";12;0;100
299;439;"pressley";738;40.5149051490515;59.4850948509485
0;10;"presslie";10;0;100
0;37;"pressly";37;0;100
46;0;"prestan";46;100;0
535;0;"presten";535;100;0
650;0;"prestin";650;100;0
0;79;"prestina";79;0;100
0;15;"prestine";15;0;100
0;10;"prestley";10;0;100
108205;642;"preston";108847;99.4101812636085;0.589818736391449
614;162;"prestyn";776;79.1237113402062;20.8762886597938
0;5;"pretto";5;0;100
0;58;"pretty";58;0;100
68;0;"previn";68;100;0
0;35;"preya";35;0;100
0;18;"prezlee";18;0;100
0;11;"prezleigh";11;0;100
0;52;"prezley";52;0;100
0;314;"pria";314;0;100
13;0;"priam";13;100;0
0;39;"prianka";39;0;100
0;16;"prianna";16;0;100
5;0;"priansh";5;100;0
3244;40;"price";3284;98.7819732034105;1.21802679658952
0;86;"pricella";86;0;100
0;29;"pricie";29;0;100
0;1105;"pricila";1105;0;100
0;4343;"pricilla";4343;0;100
0;45;"pricillia";45;0;100
0;5;"pricsila";5;0;100
0;68;"pricsilla";68;0;100
83;0;"pride";83;100;0
0;5;"priella";5;0;100
287;0;"priest";287;100;0
6;0;"priestly";6;100;0
0;62;"prim";62;0;100
0;102;"prima";102;0;100
0;27;"primavera";27;0;100
5;0;"prime";5;100;0
739;0;"primitivo";739;100;0
824;0;"primo";824;100;0
0;291;"primrose";291;0;100
172;0;"primus";172;100;0
0;10;"prina";10;0;100
14617;550;"prince";15167;96.373706072394;3.62629392760599
15;0;"princeamir";15;100;0
5;0;"princeanthony";5;100;0
10;0;"princecharles";10;100;0
12;0;"princedavid";12;100;0
5;0;"princeelijah";5;100;0
5;0;"princejames";5;100;0
6;0;"princejohn";6;100;0
0;625;"princella";625;0;100
21;0;"princemichael";21;100;0
0;81;"princes";81;0;100
0;336;"princesa";336;0;100
7;13168;"princess";13175;0.0531309297912713;99.9468690702087
0;167;"princessa";167;0;100
203;0;"princeston";203;100;0
11;0;"princeten";11;100;0
13;0;"princetin";13;100;0
4507;0;"princeton";4507;100;0
0;148;"princetta";148;0;100
13;0;"princetyn";13;100;0
10;0;"princewill";10;100;0
5;0;"princewilliam";5;100;0
0;36;"princie";36;0;100
0;5;"princilla";5;0;100
6;0;"princton";6;100;0
0;5;"princy";5;0;100
7;0;"pringle";7;100;0
0;7;"prinsesa";7;0;100
62;0;"prinston";62;100;0
29;0;"printes";29;100;0
34;0;"printess";34;100;0
59;0;"printice";59;100;0
42;0;"printis";42;100;0
5;0;"printiss";5;100;0
5;0;"prinz";5;100;0
0;366;"prisca";366;0;100
0;1019;"priscella";1019;0;100
0;4134;"priscila";4134;0;100
0;9;"priscilia";9;0;100
0;7;"priscill";7;0;100
245;117269;"priscilla";117514;0.208485797436901;99.7915142025631
0;212;"priscille";212;0;100
0;433;"priscillia";433;0;100
0;6;"priscyla";6;0;100
0;22;"priscylla";22;0;100
0;126;"priseis";126;0;100
30;0;"prish";30;100;0
0;1446;"prisha";1446;0;100
0;7;"prisicilla";7;0;100
0;771;"prisila";771;0;100
0;637;"prisilla";637;0;100
0;382;"prisma";382;0;100
0;17;"prissila";17;0;100
0;28;"prissy";28;0;100
0;11;"pristina";11;0;100
0;53;"pristine";53;0;100
20;0;"prit";20;100;0
11;0;"pritam";11;100;0
57;0;"pritesh";57;100;0
0;23;"prithika";23;0;100
6;0;"prithiv";6;100;0
278;0;"prithvi";278;100;0
0;259;"priti";259;0;100
0;58;"pritika";58;0;100
0;5452;"priya";5452;0;100
0;52;"priyah";52;0;100
0;129;"priyal";129;0;100
20;0;"priyam";20;100;0
17;0;"priyan";17;100;0
0;60;"priyana";60;0;100
5;0;"priyank";5;100;0
0;1649;"priyanka";1649;0;100
38;0;"priyansh";38;100;0
0;33;"priyanshi";33;0;100
6;0;"priyanshu";6;100;0
0;17;"priyasha";17;0;100
39;0;"procopio";39;100;0
240;0;"proctor";240;100;0
19;0;"prodigy";19;100;0
26;0;"prometheus";26;100;0
200;3423;"promise";3623;5.52028705492686;94.4797129450731
0;64;"promiss";64;0;100
0;7;"promisse";7;0;100
0;25;"promize";25;0;100
0;28;"promyce";28;0;100
0;251;"promyse";251;0;100
0;5;"promyss";5;0;100
154;0;"prophet";154;100;0
356;0;"prosper";356;100;0
0;82;"prosperity";82;0;100
71;0;"prospero";71;100;0
0;653;"providence";653;0;100
0;119;"providencia";119;0;100
0;11;"providenza";11;0;100
0;11;"pruda";11;0;100
0;5;"prudance";5;0;100
0;5147;"prudence";5147;0;100
0;43;"prudencia";43;0;100
401;0;"prudencio";401;100;0
0;237;"prudie";237;0;100
0;215;"prudy";215;0;100
6;11;"prue";17;35.2941176470588;64.7058823529412
52;0;"pruitt";52;100;0
0;5;"prutha";5;0;100
816;29;"pryce";845;96.5680473372781;3.43195266272189
0;10;"pryia";10;0;100
179;0;"prynce";179;100;0
0;28;"pryncess";28;0;100
34;0;"prynceton";34;100;0
0;5;"prynn";5;0;100
263;5;"pryor";268;98.134328358209;1.86567164179104
0;21;"pryscilla";21;0;100
0;6;"prysilla";6;0;100
65;86;"psalm";151;43.046357615894;56.953642384106
20;54;"psalms";74;27.027027027027;72.972972972973
10;0;"psymon";10;100;0
27;0;"ptolemy";27;100;0
0;10;"ptosha";10;0;100
42;0;"pual";42;100;0
0;117;"pualani";117;0;100
0;67;"puanani";67;0;100
0;5;"puaolena";5;0;100
0;10;"pui";10;0;100
0;818;"puja";818;0;100
42;0;"pujan";42;100;0
0;55;"punam";55;0;100
160;163;"puneet";323;49.5356037151703;50.4643962848297
22;0;"punit";22;100;0
0;173;"pura";173;0;100
5;0;"purab";5;100;0
56;0;"purav";56;100;0
454;0;"purcell";454;100;0
14;0;"purdy";14;100;0
0;200;"purity";200;0;100
58;0;"purl";58;100;0
0;5;"purlie";5;0;100
762;6;"purnell";768;99.21875;0.78125
0;5;"purnima";5;0;100
0;11;"purpose";11;0;100
0;64;"purva";64;0;100
0;265;"purvi";265;0;100
968;0;"purvis";968;100;0
0;6;"pushti";6;0;100
0;2358;"pyper";2358;0;100
0;5;"pypper";5;0;100
93;0;"qaadir";93;100;0
27;0;"qaasim";27;100;0
0;5;"qadeera";5;0;100
339;0;"qadir";339;100;0
0;57;"qadira";57;0;100
0;40;"qadirah";40;0;100
24;0;"qadree";24;100;0
0;41;"qadriyyah";41;0;100
34;0;"qadry";34;100;0
10;0;"qaiden";10;100;0
199;0;"qais";199;100;0
6;0;"qalid";6;100;0
125;99;"qamar";224;55.8035714285714;44.1964285714286
6;0;"qamari";6;100;0
30;0;"qasem";30;100;0
787;0;"qasim";787;100;0
7;0;"qassam";7;100;0
34;0;"qays";34;100;0
23;5;"qi";28;82.1428571428571;17.8571428571429
20;0;"qian";20;100;0
0;2551;"qiana";2551;0;100
0;165;"qianna";165;0;100
0;104;"qiara";104;0;100
0;5;"qiarah";5;0;100
0;5;"qierra";5;0;100
0;5;"qing";5;0;100
0;6;"qiona";6;0;100
0;34;"qirat";34;0;100
0;5;"qiuana";5;0;100
10;0;"qmari";10;100;0
0;7;"qorianka";7;0;100
10;0;"qua";10;100;0
10;0;"quaadir";10;100;0
11;0;"quaashie";11;100;0
5;0;"quacy";5;100;0
12;0;"quadair";12;100;0
0;16;"quadaisha";16;0;100
19;0;"quadarious";19;100;0
359;0;"quadarius";359;100;0
5;0;"quadarrious";5;100;0
23;0;"quadarrius";23;100;0
0;28;"quadasha";28;0;100
0;84;"quadasia";84;0;100
958;0;"quade";958;100;0
6;0;"quadeer";6;100;0
10;0;"quadell";10;100;0
12;0;"quadere";12;100;0
0;5;"quadeshia";5;0;100
5;0;"quadier";5;100;0
0;6;"quadijah";6;0;100
1388;0;"quadir";1388;100;0
0;35;"quadira";35;0;100
0;21;"quadirah";21;0;100
187;0;"quadre";187;100;0
60;0;"quadree";60;100;0
0;5;"quadreka";5;0;100
13;0;"quadrell";13;100;0
6;0;"quadrevion";6;100;0
25;0;"quadri";25;100;0
67;0;"quadry";67;100;0
5;0;"quaheem";5;100;0
716;0;"quaid";716;100;0
0;10;"quala";10;0;100
12;0;"qualan";12;100;0
16;0;"qualee";16;100;0
10;0;"qualen";10;100;0
0;5;"qualesha";5;0;100
6;0;"quali";6;100;0
6;0;"qualiek";6;100;0
20;0;"qualik";20;100;0
58;0;"qualin";58;100;0
0;6;"qualisha";6;0;100
0;14;"qualiyah";14;0;100
19;0;"qualon";19;100;0
57;0;"qualyn";57;100;0
12;0;"quamae";12;100;0
23;0;"quamain";23;100;0
347;0;"quamaine";347;100;0
45;0;"quamane";45;100;0
40;0;"quamar";40;100;0
43;0;"quamari";43;100;0
18;0;"quamarion";18;100;0
10;0;"quamayne";10;100;0
65;0;"quame";65;100;0
5;0;"quameek";5;100;0
11;0;"quameer";11;100;0
5;0;"quameir";5;100;0
0;16;"quameisha";16;0;100
118;0;"quamel";118;100;0
10;0;"quamell";10;100;0
104;0;"quamere";104;100;0
0;68;"quamesha";68;0;100
0;12;"quameshia";12;0;100
5;0;"quamine";5;100;0
446;0;"quamir";446;100;0
5;0;"quamire";5;100;0
0;6;"quamisha";6;0;100
5;0;"quamon";5;100;0
0;5;"quamya";5;0;100
1276;39;"quan";1315;97.0342205323194;2.96577946768061
0;260;"quana";260;0;100
0;30;"quanae";30;0;100
186;40;"quanah";226;82.3008849557522;17.6991150442478
0;5;"quanaisha";5;0;100
0;11;"quanasha";11;0;100
0;184;"quanasia";184;0;100
0;502;"quanda";502;0;100
16;0;"quandarious";16;100;0
246;0;"quandarius";246;100;0
5;0;"quandarrius";5;100;0
41;0;"quandell";41;100;0
0;211;"quandra";211;0;100
115;0;"quandre";115;100;0
0;10;"quanecia";10;0;100
0;5;"quaneeka";5;0;100
0;45;"quaneesha";45;0;100
0;354;"quaneisha";354;0;100
0;15;"quaneka";15;0;100
62;0;"quanell";62;100;0
0;687;"quanesha";687;0;100
0;185;"quaneshia";185;0;100
0;7;"quanesia";7;0;100
0;5;"quanessa";5;0;100
0;5;"quanetra";5;0;100
0;127;"quanetta";127;0;100
0;7;"quanette";7;0;100
716;0;"quang";716;100;0
0;5;"quanice";5;0;100
0;5;"quanicia";5;0;100
0;27;"quaniece";27;0;100
0;50;"quaniesha";50;0;100
0;126;"quanika";126;0;100
0;26;"quaniqua";26;0;100
0;30;"quanique";30;0;100
0;5;"quanise";5;0;100
0;1535;"quanisha";1535;0;100
0;5;"quanishia";5;0;100
0;547;"quanita";547;0;100
0;97;"quaniya";97;0;100
0;94;"quaniyah";94;0;100
0;58;"quanna";58;0;100
0;5;"quannah";5;0;100
5;0;"quannell";5;100;0
0;6;"quannisha";6;0;100
0;6;"quanshae";6;0;100
0;6;"quanshay";6;0;100
70;93;"quanta";163;42.9447852760736;57.0552147239264
209;0;"quantae";209;100;0
117;0;"quantarius";117;100;0
12;0;"quantas";12;100;0
0;5;"quantasha";5;0;100
0;6;"quantashia";6;0;100
0;119;"quantasia";119;0;100
0;78;"quantavia";78;0;100
481;0;"quantavious";481;100;0
101;0;"quantavis";101;100;0
272;0;"quantavius";272;100;0
71;0;"quantay";71;100;0
0;21;"quantaya";21;0;100
288;6;"quante";294;97.9591836734694;2.04081632653061
76;0;"quantel";76;100;0
0;24;"quantella";24;0;100
0;58;"quanteria";58;0;100
12;0;"quanterious";12;100;0
15;0;"quanterius";15;100;0
0;7;"quanterra";7;0;100
10;0;"quanterrious";10;100;0
14;0;"quanterrius";14;100;0
0;11;"quantesha";11;0;100
604;0;"quantez";604;100;0
0;102;"quantia";102;0;100
0;5;"quantiana";5;0;100
0;225;"quantina";225;0;100
5;0;"quantis";5;100;0
0;117;"quantisha";117;0;100
16;0;"quantravious";16;100;0
10;0;"quantre";10;100;0
19;0;"quantrel";19;100;0
397;0;"quantrell";397;100;0
5;0;"quantrez";5;100;0
0;5;"quanya";5;0;100
11;0;"quanye";11;100;0
0;5;"quanza";5;0;100
5;0;"quanzell";5;100;0
5;0;"quanzie";5;100;0
81;0;"quaran";81;100;0
6;0;"quarmaine";6;100;0
161;0;"quaron";161;100;0
11;0;"quarterrio";11;100;0
5;0;"quartey";5;100;0
363;0;"quartez";363;100;0
0;24;"quartney";24;0;100
5;0;"quartterio";5;100;0
76;0;"quasean";76;100;0
6;0;"quaseem";6;100;0
0;32;"quasha";32;0;100
5;0;"quashan";5;100;0
0;16;"quashana";16;0;100
0;5;"quashanda";5;0;100
0;5;"quashanna";5;0;100
186;0;"quashaun";186;100;0
658;5;"quashawn";663;99.2458521870287;0.754147812971342
0;14;"quashawna";14;0;100
0;10;"quashay";10;0;100
0;6;"quashayla";6;0;100
0;5;"quasheema";5;0;100
0;7;"quashia";7;0;100
151;0;"quashon";151;100;0
0;21;"quashonda";21;0;100
38;0;"quashun";38;100;0
0;51;"quasia";51;0;100
125;0;"quasim";125;100;0
22;0;"quasir";22;100;0
28;0;"quason";28;100;0
0;5;"quatashia";5;0;100
0;55;"quatasia";55;0;100
0;24;"quatavia";24;0;100
66;0;"quatavious";66;100;0
32;0;"quatavius";32;100;0
0;17;"quateria";17;0;100
5;0;"quaterius";5;100;0
5;0;"quaterrius";5;100;0
0;36;"quatesha";36;0;100
36;0;"quatez";36;100;0
0;11;"quatia";11;0;100
0;53;"quatina";53;0;100
0;118;"quatisha";118;0;100
5;0;"quatravious";5;100;0
17;0;"quatrell";17;100;0
0;5;"quatrina";5;0;100
22;0;"quaveon";22;100;0
196;0;"quavion";196;100;0
10;0;"quavious";10;100;0
59;0;"quavis";59;100;0
5;0;"quavius";5;100;0
422;0;"quavon";422;100;0
6;0;"quavonte";6;100;0
352;15;"quay";367;95.9128065395095;4.08719346049046
5;0;"quayden";5;100;0
0;27;"quayla";27;0;100
5;0;"quaylan";5;100;0
11;0;"quaylen";11;100;0
13;0;"quaylin";13;100;0
51;0;"quaylon";51;100;0
16;0;"quayon";16;100;0
11;0;"quaysean";11;100;0
150;0;"quayshaun";150;100;0
172;5;"quayshawn";177;97.1751412429379;2.82485875706215
10;0;"quayshon";10;100;0
14;0;"quayshun";14;100;0
53;0;"quayvon";53;100;0
5;0;"quazar";5;100;0
5;0;"quazi";5;100;0
0;5;"qubilah";5;0;100
6;0;"qudarius";6;100;0
66;0;"que";66;100;0
0;11;"queana";11;0;100
0;11;"queanna";11;0;100
31;13807;"queen";13838;0.224020812256106;99.7759791877439
0;608;"queena";608;0;100
0;16;"queenasia";16;0;100
0;5;"queency";5;0;100
0;5;"queene";5;0;100
0;5;"queenell";5;0;100
0;33;"queenester";33;0;100
0;3385;"queenie";3385;0;100
0;9;"queenisha";9;0;100
0;5;"quella";5;0;100
127;0;"quency";127;100;0
5;0;"quendarious";5;100;0
59;0;"quendarius";59;100;0
0;5;"queneisha";5;0;100
0;70;"quenesha";70;0;100
0;5;"queneshia";5;0;100
0;43;"quenetta";43;0;100
0;5;"quenette";5;0;100
0;21;"quenia";21;0;100
0;191;"quenisha";191;0;100
0;16;"quenita";16;0;100
0;142;"quenna";142;0;100
47;0;"quennel";47;100;0
5;0;"quennell";5;100;0
0;5;"quennie";5;0;100
46;0;"quent";46;100;0
25;0;"quentarius";25;100;0
0;50;"quentasia";50;0;100
0;5;"quentavia";5;0;100
184;0;"quentavious";184;100;0
30;0;"quentavius";30;100;0
24;0;"quentel";24;100;0
0;23;"quentella";23;0;100
715;0;"quenten";715;100;0
76;0;"quentez";76;100;0
39540;190;"quentin";39730;99.521771960735;0.478228039265039
0;140;"quentina";140;0;100
45;0;"quentine";45;100;0
71;0;"quention";71;100;0
0;6;"quentisha";6;0;100
3026;0;"quenton";3026;100;0
40;0;"quentrell";40;100;0
198;0;"quentyn";198;100;0
0;5;"queren";5;0;100
0;127;"querida";127;0;100
5;0;"quesean";5;100;0
0;5;"quesha";5;0;100
5;0;"queshaun";5;100;0
53;0;"queshawn";53;100;0
5;0;"queshon";5;100;0
16;0;"quess";16;100;0
0;15;"quessie";15;0;100
450;9;"quest";459;98.0392156862745;1.96078431372549
10;0;"queston";10;100;0
0;6;"queta";6;0;100
0;51;"quetcy";51;0;100
31;0;"quetin";31;100;0
45;64;"quetzal";109;41.2844036697248;58.7155963302752
10;0;"quetzalcoatl";10;100;0
0;244;"quetzali";244;0;100
0;534;"quetzalli";534;0;100
0;61;"quetzally";61;0;100
0;260;"quetzaly";260;0;100
0;5;"quetzy";5;0;100
21;0;"quevin";21;100;0
40;0;"quevon";40;100;0
23;0;"qui";23;100;0
11;10;"quian";21;52.3809523809524;47.6190476190476
0;3944;"quiana";3944;0;100
0;5;"quiandra";5;0;100
0;876;"quianna";876;0;100
0;312;"quiara";312;0;100
0;118;"quida";118;0;100
18;0;"quido";18;100;0
11;0;"quiency";11;100;0
6;0;"quienten";6;100;0
69;0;"quientin";69;100;0
20;0;"quienton";20;100;0
0;114;"quiera";114;0;100
0;168;"quierra";168;0;100
0;12;"quiesha";12;0;100
5;0;"quigley";5;100;0
0;12;"quila";12;0;100
55;0;"quill";55;100;0
16;150;"quilla";166;9.63855421686747;90.3614457831325
274;0;"quillan";274;100;0
5;0;"quillar";5;100;0
25;0;"quillen";25;100;0
31;0;"quillian";31;100;0
47;36;"quillie";83;56.6265060240964;43.3734939759036
5;0;"quillon";5;100;0
0;5;"quimora";5;0;100
1405;400;"quin";1805;77.8393351800554;22.1606648199446
0;68;"quina";68;0;100
0;36;"quinasia";36;0;100
0;5;"quinaya";5;0;100
533;0;"quince";533;100;0
15;219;"quincee";234;6.41025641025641;93.5897435897436
0;10;"quincella";10;0;100
1691;562;"quincey";2253;75.0554815801154;24.9445184198846
37;267;"quinci";304;12.1710526315789;87.8289473684211
5;240;"quincie";245;2.04081632653061;97.9591836734694
23761;3383;"quincy";27144;87.5368405540819;12.4631594459181
12;0;"quindale";12;100;0
0;17;"quindara";17;0;100
55;0;"quindarious";55;100;0
437;0;"quindarius";437;100;0
69;0;"quindarrius";69;100;0
161;0;"quindell";161;100;0
16;0;"quinden";16;100;0
114;0;"quindon";114;100;0
0;40;"quineisha";40;0;100
0;5;"quineka";5;0;100
28;0;"quinell";28;100;0
0;409;"quinesha";409;0;100
0;53;"quineshia";53;0;100
0;5;"quinessa";5;0;100
0;373;"quinetta";373;0;100
0;189;"quinette";189;0;100
0;288;"quinisha";288;0;100
0;117;"quinita";117;0;100
0;37;"quiniya";37;0;100
0;33;"quiniyah";33;0;100
2223;585;"quinlan";2808;79.1666666666667;20.8333333333333
0;79;"quinlee";79;0;100
0;5;"quinleigh";5;0;100
15;0;"quinlen";15;100;0
0;262;"quinley";262;0;100
189;5;"quinlin";194;97.4226804123711;2.57731958762887
6;359;"quinlyn";365;1.64383561643836;98.3561643835616
0;133;"quinlynn";133;0;100
30329;24697;"quinn";55026;55.1175807799949;44.8824192200051
0;20;"quinna";20;0;100
10;5;"quinncy";15;66.6666666666667;33.3333333333333
0;133;"quinne";133;0;100
5;0;"quinnel";5;100;0
5;0;"quinnell";5;100;0
0;47;"quinnesha";47;0;100
0;5;"quinneshia";5;0;100
0;85;"quinnetta";85;0;100
0;5;"quinnette";5;0;100
5;73;"quinnie";78;6.41025641025641;93.5897435897436
0;43;"quinnisha";43;0;100
0;5;"quinnita";5;0;100
107;27;"quinnlan";134;79.8507462686567;20.1492537313433
0;20;"quinnlee";20;0;100
0;17;"quinnleigh";17;0;100
0;102;"quinnley";102;0;100
0;29;"quinnly";29;0;100
0;202;"quinnlyn";202;0;100
0;18;"quinnlynn";18;0;100
5;0;"quinnshawn";5;100;0
89;0;"quinnten";89;100;0
134;0;"quinntin";134;100;0
360;0;"quinnton";360;100;0
0;10;"quinsha";10;0;100
44;0;"quinshawn";44;100;0
0;10;"quinshay";10;0;100
5;0;"quinshon";5;100;0
18;0;"quinston";18;100;0
626;0;"quint";626;100;0
41;201;"quinta";242;16.9421487603306;83.0578512396694
5;0;"quintae";5;100;0
302;0;"quintan";302;100;0
0;201;"quintana";201;0;100
0;103;"quintara";103;0;100
60;0;"quintarious";60;100;0
370;0;"quintarius";370;100;0
15;0;"quintarus";15;100;0
0;53;"quintasha";53;0;100
0;5;"quintashia";5;0;100
0;206;"quintasia";206;0;100
0;71;"quintavia";71;0;100
39;0;"quintavion";39;100;0
782;0;"quintavious";782;100;0
112;0;"quintavis";112;100;0
396;0;"quintavius";396;100;0
6;0;"quintay";6;100;0
0;7;"quintaya";7;0;100
6;0;"quinte";6;100;0
294;0;"quintel";294;100;0
175;5;"quintell";180;97.2222222222222;2.77777777777778
0;526;"quintella";526;0;100
7116;0;"quinten";7116;100;0
0;40;"quintera";40;0;100
0;85;"quinteria";85;0;100
101;0;"quinterious";101;100;0
96;0;"quinterius";96;100;0
7;0;"quintero";7;100;0
0;46;"quinterra";46;0;100
0;16;"quinterria";16;0;100
12;0;"quinterrious";12;100;0
117;0;"quinterrius";117;100;0
0;5;"quintesa";5;0;100
0;12;"quintesha";12;0;100
0;393;"quintessa";393;0;100
610;0;"quintez";610;100;0
0;10;"quintia";10;0;100
14279;7;"quintin";14286;99.9510009799804;0.0489990200195996
0;1017;"quintina";1017;0;100
5;0;"quintine";5;100;0
5;0;"quintion";5;100;0
0;43;"quintisha";43;0;100
98;0;"quinto";98;100;0
28325;42;"quinton";28367;99.8519406352452;0.148059364754821
0;11;"quintonia";11;0;100
10;0;"quintonio";10;100;0
0;38;"quintoria";38;0;100
20;0;"quintrel";20;100;0
428;0;"quintrell";428;100;0
386;0;"quintus";386;100;0
345;0;"quintyn";345;100;0
0;26;"quinya";26;0;100
12;0;"quinzel";12;100;0
59;0;"quinzell";59;100;0
52;0;"quion";52;100;0
0;44;"quiona";44;0;100
0;17;"quionna";17;0;100
0;5;"quiriat";5;0;100
222;0;"quirino";222;100;0
6;0;"quirt";6;100;0
6;0;"quisean";6;100;0
0;58;"quisha";58;0;100
23;0;"quishawn";23;100;0
9;0;"quisto";9;100;0
0;140;"quita";140;0;100
5;0;"quitin";5;100;0
428;0;"quitman";428;100;0
22;0;"quiton";22;100;0
0;23;"quiyana";23;0;100
5;0;"qujuan";5;100;0
13;0;"qumari";13;100;0
0;6;"quneisha";6;0;100
0;26;"qunesha";26;0;100
58;0;"qunicy";58;100;0
0;85;"qunisha";85;0;100
0;22;"qunita";22;0;100
0;11;"qunnie";11;0;100
488;0;"quoc";488;100;0
6;0;"quon";6;100;0
20;0;"quontavious";20;100;0
12;0;"quontez";12;100;0
0;5;"quora";5;0;100
0;174;"quorra";174;0;100
0;5;"quortney";5;0;100
0;16;"quovadis";16;0;100
12;0;"quraan";12;100;0
1690;34;"quran";1724;98.0278422273782;1.97215777262181
315;0;"quron";315;100;0
121;0;"qusai";121;100;0
65;0;"qusay";65;100;0
20;0;"qushawn";20;100;0
6;0;"quvondo";6;100;0
5;0;"quwan";5;100;0
0;11;"quwana";11;0;100
0;11;"quwanda";11;0;100
0;6;"quwanna";6;0;100
111;0;"quy";111;100;0
42;328;"quyen";370;11.3513513513514;88.6486486486487
0;267;"quynh";267;0;100
0;10;"quynhanh";10;0;100
0;12;"quynhnhu";12;0;100
0;155;"quynn";155;0;100
5;0;"quynton";5;100;0
0;6;"qwana";6;0;100
0;10;"qwanda";10;0;100
51;0;"qwanell";51;100;0
0;8;"qwanesha";8;0;100
0;23;"qwanisha";23;0;100
5;0;"qwen";5;100;0
0;10;"qwendolyn";10;0;100
48;0;"qwentin";48;100;0
10;0;"qwenton";10;100;0
5;0;"qwintin";5;100;0
21;0;"qwinton";21;100;0
0;27;"qwynn";27;0;100
0;5;"qynn";5;0;100
80;20;"ra";100;80;20
101;0;"raad";101;100;0
5;0;"raaed";5;100;0
7;0;"raafay";7;100;0
0;66;"raaga";66;0;100
47;0;"raaghav";47;100;0
5;57;"raahi";62;8.06451612903226;91.9354838709677
53;0;"raahil";53;100;0
66;0;"raahim";66;100;0
5;0;"raahul";5;100;0
5;0;"raaid";5;100;0
0;12;"raaina";12;0;100
34;0;"raam";34;100;0
6;0;"raamond";6;100;0
0;5;"raana";5;0;100
21;0;"raanan";21;100;0
5;0;"raashan";5;100;0
0;8;"raashi";8;0;100
10;0;"raashid";10;100;0
0;27;"raashida";27;0;100
0;13;"raavi";13;0;100
0;22;"raaya";22;0;100
20;0;"raayan";20;100;0
5;0;"raaziq";5;100;0
0;110;"rabab";110;0;100
0;868;"rabecca";868;0;100
0;67;"rabecka";67;0;100
0;35;"rabeka";35;0;100
0;50;"rabekah";50;0;100
0;5;"rabekka";5;0;100
5;0;"rabert";5;100;0
12;0;"rabi";12;100;0
0;741;"rabia";741;0;100
0;81;"rabiah";81;0;100
30;0;"rabih";30;100;0
0;5;"rabihah";5;0;100
0;26;"rabiya";26;0;100
286;0;"rabon";286;100;0
23;0;"rabun";23;100;0
49;0;"raburn";49;100;0
16;0;"raby";16;100;0
1314;0;"race";1314;100;0
0;10;"racel";10;0;100
0;5;"racelyn";5;0;100
11;0;"racen";11;100;0
91;0;"racer";91;100;0
0;5;"racey";5;0;100
38;0;"rachad";38;100;0
0;18;"rachae";18;0;100
181;81561;"rachael";81742;0.22142839666267;99.7785716033373
0;1323;"rachal";1323;0;100
0;33;"rachale";33;0;100
0;265;"rachana";265;0;100
103;0;"rachard";103;100;0
0;74;"rache";74;0;100
0;10453;"racheal";10453;0;100
1781;555924;"rachel";557705;0.319344456298581;99.6806555437014
0;146;"rachelann";146;0;100
0;85;"rachelanne";85;0;100
0;3311;"rachele";3311;0;100
0;3748;"rachell";3748;0;100
0;91;"rachella";91;0;100
37;33464;"rachelle";33501;0.110444464344348;99.8895555356556
0;5;"rachelleann";5;0;100
0;5;"rachelleanne";5;0;100
0;23;"rachelmarie";23;0;100
0;5;"rachely";5;0;100
58;0;"rachid";58;100;0
0;44;"rachiel";44;0;100
100;0;"rachit";100;100;0
0;5;"rachita";5;0;100
5;0;"rachmiel";5;100;0
0;213;"rachna";213;0;100
0;5;"rachon";5;0;100
0;191;"rachyl";191;0;100
0;11;"racie";11;0;100
71;0;"raciel";71;100;0
10;0;"racin";10;100;0
5;595;"racine";600;0.833333333333333;99.1666666666667
0;6;"racio";6;0;100
0;5;"rackel";5;0;100
15;0;"rackwon";15;100;0
0;5;"racqual";5;0;100
5;4693;"racquel";4698;0.106428267347808;99.8935717326522
0;35;"racquell";35;0;100
0;114;"racquelle";114;0;100
0;6;"racy";6;0;100
17;0;"racyn";17;100;0
122;0;"rad";122;100;0
0;415;"rada";415;0;100
5;0;"radame";5;100;0
5;0;"radamel";5;100;0
805;0;"radames";805;100;0
22;0;"radarius";22;100;0
22;0;"radcliffe";22;100;0
19;0;"rade";19;100;0
5;0;"radee";5;100;0
16;0;"radeen";16;100;0
133;0;"radek";133;100;0
6;5;"radell";11;54.5454545454545;45.4545454545455
126;0;"raden";126;100;0
0;32;"radene";32;0;100
32;0;"rader";32;100;0
1141;0;"radford";1141;100;0
0;725;"radha";725;0;100
49;0;"radhames";49;100;0
0;973;"radhika";973;0;100
6;0;"radi";6;100;0
0;22;"radia";22;0;100
0;108;"radiah";108;0;100
0;226;"radiance";226;0;100
6;150;"radie";156;3.84615384615385;96.1538461538462
55;0;"radin";55;100;0
0;21;"radine";21;0;100
0;24;"radiya";24;0;100
27;5;"radlee";32;84.375;15.625
928;49;"radley";977;94.9846468781986;5.01535312180143
6;0;"radly";6;100;0
0;5;"radoika";5;0;100
0;335;"radonna";335;0;100
5;0;"radoslav";5;100;0
10;0;"radric";10;100;0
25;0;"radu";25;100;0
0;20;"radwa";20;0;100
87;0;"radwan";87;100;0
11;0;"radyn";11;100;0
869;20702;"rae";21571;4.02855685874554;95.9714431412545
0;67;"raea";67;0;100
0;27;"raeah";27;0;100
0;228;"raeana";228;0;100
0;5;"raeanah";5;0;100
0;3735;"raeann";3735;0;100
0;1602;"raeanna";1602;0;100
0;1724;"raeanne";1724;0;100
42;0;"raeburn";42;100;0
0;86;"raechal";86;0;100
0;2268;"raechel";2268;0;100
0;67;"raechell";67;0;100
0;589;"raechelle";589;0;100
337;0;"raed";337;100;0
0;21;"raedawn";21;0;100
0;58;"raedean";58;0;100
142;74;"raeden";216;65.7407407407407;34.2592592592593
0;28;"raedene";28;0;100
5;0;"raedon";5;100;0
91;172;"raedyn";263;34.6007604562738;65.3992395437262
10;0;"raeed";10;100;0
17;0;"raees";17;100;0
0;28;"raeesah";28;0;100
296;0;"raef";296;100;0
613;0;"raeford";613;100;0
165;16035;"raegan";16200;1.01851851851852;98.9814814814815
0;42;"raegann";42;0;100
5;728;"raegen";733;0.682128240109141;99.3178717598909
0;22;"raegene";22;0;100
0;345;"raeghan";345;0;100
0;30;"raegin";30;0;100
0;6;"raegina";6;0;100
0;6;"raegine";6;0;100
0;247;"raegyn";247;0;100
0;7;"raehanna";7;0;100
0;19;"raeisha";19;0;100
0;371;"raejean";371;0;100
58;0;"raejon";58;100;0
68;0;"raekwan";68;100;0
2139;6;"raekwon";2145;99.7202797202797;0.27972027972028
166;155;"rael";321;51.7133956386293;48.2866043613707
0;151;"raela";151;0;100
0;5;"raelah";5;0;100
5;79;"raelan";84;5.95238095238095;94.0476190476191
0;10;"raelani";10;0;100
0;61;"raelea";61;0;100
0;8;"raeleah";8;0;100
0;5;"raelean";5;0;100
0;1213;"raelee";1213;0;100
0;517;"raeleen";517;0;100
0;25;"raelei";25;0;100
0;1372;"raeleigh";1372;0;100
0;32;"raelen";32;0;100
0;37;"raelena";37;0;100
0;2356;"raelene";2356;0;100
0;212;"raeley";212;0;100
0;82;"raeli";82;0;100
0;80;"raelie";80;0;100
0;5;"raeliegh";5;0;100
0;590;"raelin";590;0;100
0;10;"raelina";10;0;100
0;37;"raelinn";37;0;100
0;212;"raelle";212;0;100
0;5;"raellen";5;0;100
0;46;"raely";46;0;100
20;8225;"raelyn";8245;0.242571255306246;99.7574287446938
0;44;"raelyne";44;0;100
13;11786;"raelynn";11799;0.110178828714298;99.8898211712857
0;412;"raelynne";412;0;100
0;5;"raemarie";5;0;100
0;12;"raemi";12;0;100
31;0;"raemon";31;100;0
0;5;"raemona";5;0;100
26;0;"raemond";26;100;0
0;6;"raen";6;0;100
0;1313;"raena";1313;0;100
0;5;"raenada";5;0;100
0;5;"raenae";5;0;100
0;63;"raenah";63;0;100
0;5;"raene";5;0;100
0;15;"raenee";15;0;100
0;8;"raeneisha";8;0;100
0;257;"raenell";257;0;100
0;37;"raenelle";37;0;100
0;20;"raenesha";20;0;100
0;76;"raenette";76;0;100
0;22;"raengel";22;0;100
0;20;"raenisha";20;0;100
0;5;"raeniyah";5;0;100
0;6;"raenna";6;0;100
0;5;"raeola";5;0;100
0;5;"raeona";5;0;100
0;118;"raeonna";118;0;100
484;0;"raequan";484;100;0
6;0;"raequawn";6;100;0
0;5;"raequel";5;0;100
67;0;"raequon";67;100;0
14;0;"raeqwan";14;100;0
74;0;"raeqwon";74;100;0
78;0;"raesean";78;100;0
0;78;"raesha";78;0;100
147;0;"raeshaun";147;100;0
305;124;"raeshawn";429;71.0955710955711;28.9044289044289
0;42;"raeshell";42;0;100
0;15;"raeshelle";15;0;100
48;0;"raeshon";48;100;0
0;98;"raetta";98;0;100
0;31;"raevan";31;0;100
0;724;"raeven";724;0;100
0;128;"raevin";128;0;100
101;11;"raevon";112;90.1785714285714;9.82142857142857
0;544;"raevyn";544;0;100
0;15;"raevynn";15;0;100
0;16;"raewyn";16;0;100
5;0;"raey";5;100;0
0;272;"raeya";272;0;100
0;12;"raeyah";12;0;100
0;5;"raeyana";5;0;100
0;5;"raeyanna";5;0;100
0;13;"raeyonna";13;0;100
24;34;"rafa";58;41.3793103448276;58.6206896551724
75885;569;"rafael";76454;99.2557616344469;0.744238365553143
0;3039;"rafaela";3039;0;100
0;72;"rafaelita";72;0;100
0;458;"rafaella";458;0;100
0;5;"rafaila";5;0;100
194;0;"rafal";194;100;0
89;0;"rafan";89;100;0
40;0;"rafat";40;100;0
194;0;"rafay";194;100;0
1954;0;"rafe";1954;100;0
911;0;"rafeal";911;100;0
5;0;"rafee";5;100;0
0;65;"rafeef";65;0;100
5;0;"rafeek";5;100;0
33;0;"rafeeq";33;100;0
125;0;"rafel";125;100;0
0;11;"rafela";11;0;100
0;44;"rafelita";44;0;100
34;0;"rafer";34;100;0
57;0;"raffael";57;100;0
0;735;"raffaela";735;0;100
950;0;"raffaele";950;100;0
0;341;"raffaella";341;0;100
15;0;"raffeal";15;100;0
164;0;"rafferty";164;100;0
714;0;"raffi";714;100;0
5;23;"raffie";28;17.8571428571429;82.1428571428571
5;0;"raffiel";5;100;0
0;38;"raffinee";38;0;100
5;0;"raffy";5;100;0
5;0;"rafhael";5;100;0
483;0;"rafi";483;100;0
0;100;"rafia";100;0;100
55;0;"rafid";55;100;0
86;0;"rafiel";86;100;0
0;12;"rafif";12;0;100
53;0;"rafik";53;100;0
350;0;"rafiq";350;100;0
169;0;"raford";169;100;0
14;0;"rafuel";14;100;0
0;24;"ragad";24;0;100
376;1769;"ragan";2145;17.5291375291375;82.4708624708625
5;0;"ragav";5;100;0
80;0;"rage";80;100;0
15;549;"ragen";564;2.65957446808511;97.3404255319149
0;66;"ragena";66;0;100
9;45;"ragene";54;16.6666666666667;83.3333333333333
0;5;"ragenia";5;0;100
0;218;"raghad";218;0;100
923;0;"raghav";923;100;0
0;5;"raghavi";5;0;100
20;0;"raghib";20;100;0
0;6;"ragin";6;0;100
0;370;"ragina";370;0;100
0;57;"ragine";57;0;100
0;21;"ragini";21;0;100
0;116;"ragna";116;0;100
143;0;"ragnar";143;100;0
0;60;"ragnhild";60;0;100
0;313;"raguel";313;0;100
0;138;"raha";138;0;100
0;23;"rahab";23;0;100
0;404;"rahaf";404;0;100
0;11;"rahama";11;0;100
11;0;"rahaman";11;100;0
0;10;"rahanna";10;0;100
0;5;"rahasia";5;0;100
46;5;"rahat";51;90.1960784313726;9.80392156862745
0;128;"rahcel";128;0;100
16;0;"raheam";16;100;0
233;15;"raheel";248;93.9516129032258;6.04838709677419
7069;6;"raheem";7075;99.9151943462898;0.0848056537102474
0;26;"raheema";26;0;100
0;6;"raheemah";6;0;100
400;0;"raheen";400;100;0
782;0;"raheim";782;100;0
0;415;"rahel";415;0;100
0;6;"rahela";6;0;100
33;0;"rahem";33;100;0
0;16;"rahf";16;0;100
20;98;"rahi";118;16.9491525423729;83.0508474576271
6;0;"rahib";6;100;0
576;0;"rahiem";576;100;0
428;17;"rahil";445;96.1797752808989;3.82022471910112
0;8;"rahila";8;0;100
1493;0;"rahim";1493;100;0
0;118;"rahima";118;0;100
0;22;"rahini";22;0;100
7;6;"rahja";13;53.8461538461538;46.1538461538462
0;5;"rahjae";5;0;100
24;0;"rahjon";24;100;0
256;0;"rahkeem";256;100;0
0;5;"rahkia";5;0;100
85;0;"rahkim";85;100;0
69;0;"rahm";69;100;0
0;848;"rahma";848;0;100
43;0;"rahmaan";43;100;0
6;0;"rahmad";6;100;0
0;102;"rahmah";102;0;100
1087;0;"rahman";1087;100;0
0;7;"rahmat";7;0;100
28;0;"rahmeek";28;100;0
17;0;"rahmeir";17;100;0
635;0;"rahmel";635;100;0
7;0;"rahmell";7;100;0
44;0;"rahmere";44;100;0
5;0;"rahmi";5;100;0
5;0;"rahmin";5;100;0
383;0;"rahmir";383;100;0
0;6;"rahmo";6;0;100
63;0;"rahmon";63;100;0
0;15;"rahmya";15;0;100
348;0;"rahn";348;100;0
0;5;"rahna";5;0;100
0;5;"rahnasia";5;0;100
0;9;"rahneisha";9;0;100
0;23;"rahni";23;0;100
0;56;"rahniya";56;0;100
0;17;"rahniyah";17;0;100
11;0;"rahquan";11;100;0
1533;6;"rahsaan";1539;99.6101364522417;0.389863547758285
56;0;"rahsan";56;100;0
10;0;"rahsaun";10;100;0
27;0;"rahsean";27;100;0
18;0;"rahshad";18;100;0
11;0;"rahshan";11;100;0
90;0;"rahshawn";90;100;0
12;0;"rahsheed";12;100;0
16;0;"rahsheen";16;100;0
0;5;"rahshida";5;0;100
18;0;"rahshon";18;100;0
11;0;"rahson";11;100;0
3250;0;"rahul";3250;100;0
0;29;"rahwa";29;0;100
6;0;"rahyl";6;100;0
40;0;"rahzel";40;100;0
183;81;"rai";264;69.3181818181818;30.6818181818182
0;203;"raia";203;0;100
0;46;"raiah";46;0;100
5;0;"raian";5;100;0
0;93;"raiana";93;0;100
0;116;"raianna";116;0;100
0;20;"raianne";20;0;100
7;0;"raice";7;100;0
0;46;"raichel";46;0;100
0;12;"raichelle";12;0;100
16;0;"raid";16;100;0
0;12;"raida";12;0;100
37;0;"raidan";37;100;0
17;0;"raidel";17;100;0
5592;201;"raiden";5793;96.5302951838426;3.46970481615743
301;0;"raider";301;100;0
134;0;"raidon";134;100;0
275;45;"raidyn";320;85.9375;14.0625
0;19;"raielle";19;0;100
0;6;"raiesha";6;0;100
250;0;"raif";250;100;0
0;7;"raifa";7;0;100
0;6;"raifah";6;0;100
64;0;"raife";64;100;0
594;0;"raiford";594;100;0
0;765;"raigan";765;0;100
0;277;"raigen";277;0;100
0;40;"raighan";40;0;100
0;5;"raighlyn";5;0;100
0;15;"raigyn";15;0;100
5;0;"raihaan";5;100;0
0;5;"raihaanah";5;0;100
181;0;"raihan";181;100;0
0;61;"raihana";61;0;100
0;13;"raihanna";13;0;100
0;16;"raija";16;0;100
64;0;"raijon";64;100;0
0;5;"raika";5;0;100
0;222;"railee";222;0;100
0;5;"raileen";5;0;100
0;160;"raileigh";160;0;100
48;605;"railey";653;7.35068912710567;92.6493108728943
7;5;"raily";12;58.3333333333333;41.6666666666667
0;536;"railyn";536;0;100
0;440;"railynn";440;0;100
0;5;"railynne";5;0;100
0;158;"raima";158;0;100
0;52;"raime";52;0;100
0;54;"raimee";54;0;100
0;28;"raimey";28;0;100
0;56;"raimi";56;0;100
27;0;"raimon";27;100;0
27;0;"raimond";27;100;0
12;0;"raimondo";12;100;0
7;0;"raimund";7;100;0
278;0;"raimundo";278;100;0
598;2209;"rain";2807;21.3038831492697;78.6961168507303
0;9629;"raina";9629;0;100
0;281;"rainah";281;0;100
10;0;"rainan";10;100;0
0;425;"rainbow";425;0;100
409;1968;"raine";2377;17.2065628944047;82.7934371055953
0;550;"rainee";550;0;100
0;38;"rainell";38;0;100
0;148;"rainelle";148;0;100
76;0;"rainen";76;100;0
850;10;"rainer";860;98.8372093023256;1.16279069767442
13;0;"raines";13;100;0
438;1530;"rainey";1968;22.2560975609756;77.7439024390244
53;429;"raini";482;10.9958506224066;89.0041493775934
0;538;"rainie";538;0;100
571;8;"rainier";579;98.6183074265976;1.38169257340242
61;85;"rainn";146;41.7808219178082;58.2191780821918
0;206;"rainna";206;0;100
0;11;"rainne";11;0;100
0;843;"rainy";843;0;100
0;60;"raionna";60;0;100
0;5;"raiqa";5;0;100
89;0;"raiquan";89;100;0
5;0;"rais";5;100;0
0;1093;"raisa";1093;0;100
0;6;"raisah";6;0;100
6;0;"raisean";6;100;0
0;142;"raisha";142;0;100
22;0;"raishaun";22;100;0
45;0;"raishawn";45;100;0
0;495;"raissa";495;0;100
355;0;"raistlin";355;100;0
39;0;"raith";39;100;0
0;380;"raiven";380;0;100
0;122;"raivyn";122;0;100
0;269;"raiya";269;0;100
0;45;"raiyah";45;0;100
238;0;"raiyan";238;100;0
0;5;"raiyana";5;0;100
0;28;"raiyn";28;0;100
0;6;"raiyna";6;0;100
0;27;"raiyne";27;0;100
0;323;"raiza";323;0;100
0;1195;"raizel";1195;0;100
42;0;"raizo";42;100;0
0;1695;"raizy";1695;0;100
1934;0;"raj";1934;100;0
708;332;"raja";1040;68.0769230769231;31.9230769230769
0;17;"rajaa";17;0;100
7;0;"rajab";7;100;0
42;22;"rajae";64;65.625;34.375
15;0;"rajaee";15;100;0
328;161;"rajah";489;67.0756646216769;32.9243353783231
29;0;"rajahn";29;100;0
35;0;"rajai";35;100;0
948;0;"rajan";948;100;0
0;6;"rajana";6;0;100
0;154;"rajanae";154;0;100
0;9;"rajane";9;0;100
0;68;"rajanee";68;0;100
0;5;"rajani";5;0;100
108;0;"rajat";108;100;0
17;0;"rajaun";17;100;0
30;0;"rajbir";30;100;0
41;11;"rajdeep";52;78.8461538461538;21.1538461538462
0;63;"rajean";63;0;100
0;16;"rajeana";16;0;100
0;7;"rajeen";7;0;100
0;17;"rajeeni";17;0;100
503;0;"rajeev";503;100;0
0;10;"rajeeyah";10;0;100
5;0;"rajen";5;100;0
76;0;"rajendra";76;100;0
0;22;"rajene";22;0;100
683;0;"rajesh";683;100;0
117;0;"raji";117;100;0
23;0;"rajinder";23;100;0
14;0;"rajit";14;100;0
806;0;"rajiv";806;100;0
15;0;"rajko";15;100;0
5;0;"rajkumar";5;100;0
6;0;"rajneesh";6;100;0
0;17;"rajni";17;0;100
85;0;"rajohn";85;100;0
711;0;"rajon";711;100;0
6;0;"raju";6;100;0
20;0;"rajuan";20;100;0
328;0;"rajveer";328;100;0
0;45;"rajvi";45;0;100
135;0;"rajvir";135;100;0
5;0;"rakai";5;100;0
452;0;"rakan";452;100;0
5;0;"rakari";5;100;0
0;16;"rakaya";16;0;100
0;240;"rakayla";240;0;100
0;98;"rakeb";98;0;100
5;0;"rakee";5;100;0
1871;0;"rakeem";1871;100;0
84;0;"rakeen";84;100;0
0;12;"rakeia";12;0;100
29;0;"rakeim";29;100;0
0;185;"rakeisha";185;0;100
0;290;"rakel";290;0;100
0;49;"rakell";49;0;100
0;21;"rakelle";21;0;100
26;0;"rakem";26;100;0
0;6;"rakeria";6;0;100
440;0;"rakesh";440;100;0
0;123;"rakesha";123;0;100
0;53;"rakeshia";53;0;100
0;65;"rakeya";65;0;100
0;22;"rakhee";22;0;100
5;54;"rakhi";59;8.47457627118644;91.5254237288136
0;37;"rakhia";37;0;100
0;504;"rakia";504;0;100
0;59;"rakiah";59;0;100
6;0;"rakib";6;100;0
25;0;"rakiem";25;100;0
0;5;"rakiesha";5;0;100
1134;0;"rakim";1134;100;0
112;0;"rakin";112;100;0
7;0;"raking";7;100;0
0;35;"rakira";35;0;100
0;173;"rakisha";173;0;100
0;42;"rakita";42;0;100
0;399;"rakiya";399;0;100
0;384;"rakiyah";384;0;100
0;101;"raksha";101;0;100
34;0;"rakshan";34;100;0
0;6;"rakshana";6;0;100
0;5;"rakshitha";5;0;100
0;5;"raksmey";5;0;100
13;0;"rakwan";13;100;0
90;0;"rakwon";90;100;0
0;36;"rakya";36;0;100
0;48;"rakyah";48;0;100
10;0;"rakye";10;100;0
0;22;"rakyia";22;0;100
0;15;"rakyla";15;0;100
6;0;"ral";6;100;0
0;6;"ralana";6;0;100
10;0;"raland";10;100;0
0;20;"ralanda";20;0;100
0;6;"ralayah";6;0;100
0;18;"ralee";18;0;100
0;5;"raleen";5;0;100
8245;1854;"raleigh";10099;81.6417467075948;18.3582532924052
26;0;"ralen";26;100;0
0;17;"ralena";17;0;100
0;252;"ralene";252;0;100
0;323;"raley";323;0;100
298;0;"ralf";298;100;0
259;0;"raliegh";259;100;0
12;0;"raliek";12;100;0
42;0;"ralik";42;100;0
0;35;"ralinda";35;0;100
6;0;"ralique";6;100;0
0;21;"ralisha";21;0;100
0;75;"raliyah";75;0;100
5;0;"rallie";5;100;0
5;0;"ralls";5;100;0
67;5;"rally";72;93.0555555555556;6.94444444444444
0;24;"ralna";24;0;100
5;0;"ralon";5;100;0
0;145;"ralonda";145;0;100
401007;1790;"ralph";402797;99.5556074151496;0.444392584850433
0;11;"ralpha";11;0;100
404;0;"ralphael";404;100;0
5;0;"ralphe";5;100;0
241;0;"ralpheal";241;100;0
25;0;"ralphel";25;100;0
5;0;"ralphell";5;100;0
94;0;"ralphie";94;100;0
0;82;"ralphine";82;0;100
55;0;"ralphy";55;100;0
857;0;"ralston";857;100;0
0;131;"ralyn";131;0;100
0;185;"ralynn";185;0;100
740;0;"ram";740;100;0
202;1027;"rama";1229;16.4361269324654;83.5638730675346
0;5;"ramada";5;0;100
221;0;"ramadan";221;100;0
0;237;"ramah";237;0;100
94;0;"ramaj";94;100;0
105;0;"ramal";105;100;0
307;0;"raman";307;100;0
5;0;"ramana";5;100;0
0;204;"ramanda";204;0;100
16;87;"ramandeep";103;15.5339805825243;84.4660194174757
0;123;"ramani";123;0;100
262;0;"ramar";262;100;0
86;5;"ramari";91;94.5054945054945;5.49450549450549
12;0;"ramario";12;100;0
33;0;"ramarion";33;100;0
0;120;"ramata";120;0;100
0;8;"ramatou";8;0;100
0;134;"ramatoulaye";134;0;100
0;5;"ramatoulie";5;0;100
0;5;"ramatu";5;0;100
0;181;"ramaya";181;0;100
0;6;"ramayah";6;0;100
11;0;"ramazan";11;100;0
89;0;"rambo";89;100;0
99;0;"ramces";99;100;0
6;7;"ramee";13;46.1538461538462;53.8461538461538
30;0;"rameek";30;100;0
5;0;"rameel";5;100;0
105;198;"rameen";303;34.6534653465347;65.3465346534654
21;0;"rameer";21;100;0
26;0;"rameez";26;100;0
16;0;"rameir";16;100;0
0;5;"rameisha";5;0;100
0;37;"rameka";37;0;100
1425;0;"ramel";1425;100;0
364;0;"ramell";364;100;0
11;47;"ramelle";58;18.9655172413793;81.0344827586207
161;0;"ramello";161;100;0
77;0;"ramelo";77;100;0
15;0;"ramen";15;100;0
70;0;"ramere";70;100;0
22;0;"ramero";22;100;0
158;0;"rameses";158;100;0
181;0;"ramesh";181;100;0
0;74;"ramesha";74;0;100
74;0;"ramesses";74;100;0
553;366;"ramey";919;60.1741022850925;39.8258977149075
133;0;"ramez";133;100;0
2598;212;"rami";2810;92.4555160142349;7.54448398576512
0;197;"ramia";197;0;100
14;406;"ramiah";420;3.33333333333333;96.6666666666667
257;666;"ramie";923;27.8439869989166;72.1560130010834
53;0;"ramiel";53;100;0
0;10;"ramiele";10;0;100
0;17;"ramielle";17;0;100
48;0;"ramier";48;100;0
5;0;"ramik";5;100;0
0;35;"ramika";35;0;100
137;0;"ramil";137;100;0
601;0;"ramin";601;100;0
0;61;"ramina";61;0;100
556;0;"ramir";556;100;0
0;44;"ramira";44;0;100
0;5;"ramirah";5;0;100
11;0;"ramire";11;100;0
55;0;"ramirez";55;100;0
24195;28;"ramiro";24223;99.8844073814143;0.115592618585642
20;0;"ramis";20;100;0
0;73;"ramisa";73;0;100
0;36;"ramisha";36;0;100
0;315;"ramiya";315;0;100
0;756;"ramiyah";756;0;100
185;0;"ramiz";185;100;0
0;178;"ramla";178;0;100
0;5;"ramlah";5;0;100
10;0;"rammy";10;100;0
11;0;"ramo";11;100;0
5;0;"ramoan";5;100;0
0;10;"ramola";10;0;100
74148;534;"ramon";74682;99.2849682654455;0.715031734554511
249;67470;"ramona";67719;0.36769591990431;99.6323040800957
0;11;"ramoncita";11;0;100
1797;0;"ramond";1797;100;0
0;324;"ramonda";324;0;100
89;0;"ramondo";89;100;0
2250;12;"ramone";2262;99.4694960212202;0.530503978779841
0;386;"ramonia";386;0;100
0;118;"ramonica";118;0;100
0;522;"ramonita";522;0;100
57;0;"ramont";57;100;0
69;0;"ramonte";69;100;0
39;0;"ramos";39;100;0
293;39;"ramsay";332;88.2530120481928;11.7469879518072
5;0;"ramsen";5;100;0
2440;0;"ramses";2440;100;0
5527;1406;"ramsey";6933;79.7201788547526;20.2798211452474
0;120;"ramsha";120;0;100
0;11;"ramsi";11;0;100
0;67;"ramsie";67;0;100
5;0;"ramson";5;100;0
19;0;"ramsses";19;100;0
5;0;"ramsy";5;100;0
842;0;"ramy";842;100;0
0;1047;"ramya";1047;0;100
0;133;"ramyah";133;0;100
0;38;"ramyia";38;0;100
0;43;"ramyiah";43;0;100
12;5;"ramzee";17;70.5882352941177;29.4117647058824
5;0;"ramzes";5;100;0
150;0;"ramzey";150;100;0
693;5;"ramzi";698;99.2836676217765;0.716332378223496
0;12;"ramzie";12;0;100
341;0;"ramzy";341;100;0
79;10;"ran";89;88.7640449438202;11.2359550561798
94;4076;"rana";4170;2.25419664268585;97.7458033573142
0;5;"ranaa";5;0;100
0;309;"ranada";309;0;100
0;2389;"ranae";2389;0;100
0;6;"ranaiya";6;0;100
0;6;"ranajah";6;0;100
111;0;"ranald";111;100;0
38;0;"ranaldo";38;100;0
64;0;"ranard";64;100;0
0;13;"ranarda";13;0;100
16;0;"ranardo";16;100;0
0;41;"ranasia";41;0;100
0;80;"ranata";80;0;100
0;89;"ranay";89;0;100
0;53;"ranaya";53;0;100
0;6;"ranayah";6;0;100
0;11;"ranaye";11;0;100
124;0;"ranbir";124;100;0
2882;0;"rance";2882;100;0
8;0;"rancel";8;100;0
17;0;"rances";17;100;0
2805;105;"rand";2910;96.3917525773196;3.60824742268041
0;3623;"randa";3623;0;100
53;0;"randahl";53;100;0
28976;132;"randal";29108;99.5465164216023;0.453483578397691
412;0;"randale";412;100;0
196883;1155;"randall";198038;99.4167785980468;0.583221401953161
0;5;"randalle";5;0;100
30;0;"randalph";30;100;0
0;74;"randalyn";74;0;100
0;5;"randalynn";5;0;100
49;0;"randarius";49;100;0
429;188;"rande";617;69.5299837925446;30.4700162074554
179;2815;"randee";2994;5.97862391449566;94.0213760855043
0;5;"randeen";5;0;100
50;0;"randeep";50;100;0
0;5;"randeisha";5;0;100
3623;25;"randel";3648;99.3146929824561;0.68530701754386
9883;148;"randell";10031;98.5245738211544;1.47542617884558
0;22;"randelle";22;0;100
274;0;"randen";274;100;0
0;5;"randene";5;0;100
0;5;"randesha";5;0;100
31;0;"randey";31;100;0
1131;29149;"randi";30280;3.73513870541612;96.2648612945839
516;1522;"randie";2038;25.3189401373896;74.6810598626104
15;0;"randiel";15;100;0
0;31;"randilee";31;0;100
0;96;"randilyn";96;0;100
0;41;"randilynn";41;0;100
5;0;"randin";5;100;0
0;22;"randine";22;0;100
0;17;"randisha";17;0;100
2891;7;"randle";2898;99.7584541062802;0.241545893719807
5;0;"randll";5;100;0
53;0;"randloph";53;100;0
571;0;"randol";571;100;0
974;0;"randolf";974;100;0
5;0;"randolfo";5;100;0
35;0;"randoll";35;100;0
48725;112;"randolph";48837;99.7706656838053;0.229334316194688
0;18;"randolyn";18;0;100
135;0;"random";135;100;0
1712;10;"randon";1722;99.4192799070848;0.580720092915215
16;0;"randoph";16;100;0
326891;4982;"randy";331873;98.4988233450748;1.50117665492523
0;134;"randye";134;0;100
55;11;"randyl";66;83.3333333333333;16.6666666666667
56;0;"randyn";56;100;0
183;124;"rane";307;59.6091205211726;40.3908794788274
0;59;"ranea";59;0;100
0;5;"ranecia";5;0;100
0;1393;"ranee";1393;0;100
0;530;"raneem";530;0;100
0;159;"raneen";159;0;100
0;19;"raneesha";19;0;100
0;345;"raneisha";345;0;100
0;38;"raneka";38;0;100
6;0;"ranel";6;100;0
62;290;"ranell";352;17.6136363636364;82.3863636363636
0;414;"ranelle";414;0;100
107;0;"ranen";107;100;0
0;464;"ranesha";464;0;100
0;96;"raneshia";96;0;100
0;72;"ranessa";72;0;100
0;114;"ranetta";114;0;100
0;104;"ranette";104;0;100
71;314;"raney";385;18.4415584415584;81.5584415584416
0;12;"ranezmae";12;0;100
0;12;"ranezmay";12;0;100
138;0;"ranferi";138;100;0
6;0;"ranford";6;100;0
6;0;"range";6;100;0
114;0;"rangel";114;100;0
572;0;"ranger";572;100;0
5;0;"rangler";5;100;0
180;1667;"rani";1847;9.74553329723877;90.2544667027612
0;2354;"rania";2354;0;100
0;313;"raniah";313;0;100
0;120;"ranie";120;0;100
24;0;"raniel";24;100;0
199;0;"ranier";199;100;0
0;50;"raniesha";50;0;100
0;45;"ranijah";45;0;100
0;143;"ranika";143;0;100
0;19;"ranim";19;0;100
0;17;"raniqua";17;0;100
0;34;"ranique";34;0;100
0;584;"ranisha";584;0;100
0;450;"ranita";450;0;100
0;1235;"raniya";1235;0;100
0;1562;"raniyah";1562;0;100
0;7;"raniyha";7;0;100
6;0;"ranjan";6;100;0
0;5;"ranjana";5;0;100
0;10;"ranjani";10;0;100
10;0;"ranjeet";10;100;0
154;0;"ranjit";154;100;0
310;0;"rankin";310;100;0
0;53;"ranna";53;0;100
0;21;"rannah";21;0;100
5;0;"ranndy";5;100;0
205;45;"rannie";250;82;18
21;0;"rannon";21;100;0
275;5;"ranny";280;98.2142857142857;1.78571428571429
0;9;"ranoda";9;0;100
5;0;"ranold";5;100;0
59;0;"ranon";59;100;0
0;6;"ranota";6;0;100
8;0;"ransel";8;100;0
5;0;"ransen";5;100;0
23;0;"ransford";23;100;0
3756;5;"ransom";3761;99.867056633874;0.13294336612603
151;0;"ransome";151;100;0
338;0;"ranson";338;100;0
116;0;"ranulfo";116;100;0
296;0;"ranveer";296;100;0
5;0;"ranvijay";5;100;0
161;0;"ranvir";161;100;0
21;10;"rany";31;67.741935483871;32.258064516129
0;827;"ranya";827;0;100
0;148;"ranyah";148;0;100
0;63;"ranyia";63;0;100
0;35;"ranyiah";35;0;100
0;34;"ranyla";34;0;100
0;10;"ranylah";10;0;100
6;0;"ranzel";6;100;0
5;0;"ranzino";5;100;0
5;0;"ranzy";5;100;0
5;0;"raoof";5;100;0
2820;0;"raoul";2820;100;0
7;0;"rapha";7;100;0
18475;318;"raphael";18793;98.3078805938381;1.69211940616187
0;393;"raphaela";393;0;100
0;228;"raphaella";228;0;100
0;35;"raphaelle";35;0;100
1476;0;"rapheal";1476;100;0
162;0;"raphel";162;100;0
53;0;"raphiel";53;100;0
0;9;"rapunzel";9;0;100
5;0;"raqeeb";5;100;0
6;0;"raqib";6;100;0
0;10;"raqiya";10;0;100
0;5;"raquael";5;0;100
0;59;"raqual";59;0;100
1296;0;"raquan";1296;100;0
5;0;"raquane";5;100;0
8;0;"raquawn";8;100;0
0;55;"raqueal";55;0;100
281;48196;"raquel";48477;0.579656331868721;99.4203436681313
0;7;"raquela";7;0;100
0;6;"raquele";6;0;100
0;24;"raquelin";24;0;100
0;201;"raquell";201;0;100
0;777;"raquelle";777;0;100
16;0;"raquez";16;100;0
0;5;"raquia";5;0;100
0;5;"raquisha";5;0;100
0;36;"raquita";36;0;100
73;0;"raquon";73;100;0
13;0;"raqwan";13;100;0
6;0;"raqwon";6;100;0
0;32;"rarity";32;0;100
341;0;"ras";341;100;0
0;97;"rasa";97;0;100
213;0;"rasaan";213;100;0
34;0;"rasan";34;100;0
54;0;"rasaun";54;100;0
5;0;"raschad";5;100;0
0;51;"raschel";51;0;100
0;6;"raschell";6;0;100
0;105;"raschelle";105;0;100
5;0;"rascoe";5;100;0
659;0;"rasean";659;100;0
0;50;"raseel";50;0;100
37;625;"rasha";662;5.58912386706949;94.4108761329305
3108;0;"rashaad";3108;100;0
1132;28;"rashaan";1160;97.5862068965517;2.41379310344828
14912;85;"rashad";14997;99.4332199773288;0.566780022671201
0;172;"rashada";172;0;100
24;0;"rashadd";24;100;0
5;0;"rashade";5;100;0
0;231;"rashae";231;0;100
0;10;"rashael";10;0;100
6;0;"rashamel";6;100;0
893;66;"rashan";959;93.1178310740355;6.88216892596455
0;286;"rashana";286;0;100
5;0;"rashand";5;100;0
0;695;"rashanda";695;0;100
0;16;"rashandra";16;0;100
0;6;"rashanique";6;0;100
59;0;"rashann";59;100;0
0;183;"rashanna";183;0;100
0;26;"rashanti";26;0;100
0;6;"rashara";6;0;100
2555;0;"rashard";2555;100;0
1190;0;"rashaud";1190;100;0
2929;182;"rashaun";3111;94.1497910639666;5.85020893603343
0;190;"rashauna";190;0;100
0;253;"rashaunda";253;0;100
0;13;"rashaundra";13;0;100
74;0;"rashawd";74;100;0
5955;709;"rashawn";6664;89.3607442977191;10.6392557022809
0;349;"rashawna";349;0;100
0;376;"rashawnda";376;0;100
0;158;"rashay";158;0;100
0;6;"rashaya";6;0;100
0;18;"rashayla";18;0;100
11;0;"rashe";11;100;0
5;145;"rashea";150;3.33333333333333;96.6666666666667
9;0;"rashean";9;100;0
0;5;"rasheba";5;0;100
425;0;"rashed";425;100;0
0;994;"rasheda";994;0;100
155;0;"rashee";155;100;0
4512;34;"rasheed";4546;99.2520897492301;0.747910250769908
10;1695;"rasheeda";1705;0.586510263929619;99.4134897360704
0;930;"rasheedah";930;0;100
0;5;"rasheedat";5;0;100
0;5;"rasheeka";5;0;100
1244;0;"rasheem";1244;100;0
0;113;"rasheema";113;0;100
1342;95;"rasheen";1437;93.3890048712596;6.61099512874043
0;358;"rasheena";358;0;100
0;23;"rasheeta";23;0;100
10;0;"rasheid";10;100;0
0;68;"rasheida";68;0;100
0;35;"rasheika";35;0;100
31;0;"rasheim";31;100;0
0;117;"rasheka";117;0;100
0;1123;"rashel";1123;0;100
0;41;"rashele";41;0;100
0;1191;"rashell";1191;0;100
0;1352;"rashelle";1352;0;100
11;0;"rashem";11;100;0
0;62;"rashema";62;0;100
0;62;"rashena";62;0;100
5;0;"rashene";5;100;0
0;36;"rasheta";36;0;100
0;24;"rashetta";24;0;100
129;201;"rashi";330;39.0909090909091;60.9090909090909
0;135;"rashia";135;0;100
2244;0;"rashid";2244;100;0
6;2970;"rashida";2976;0.201612903225806;99.7983870967742
0;342;"rashidah";342;0;100
0;12;"rashidat";12;0;100
90;0;"rashidi";90;100;0
122;0;"rashied";122;100;0
0;10;"rashieda";10;0;100
0;5;"rashieka";5;0;100
45;0;"rashiem";45;100;0
5;0;"rashik";5;100;0
0;135;"rashika";135;0;100
5;0;"rashim";5;100;0
0;44;"rashima";44;0;100
0;15;"rashina";15;0;100
11;0;"rashine";11;100;0
0;33;"rashita";33;0;100
0;85;"rashiya";85;0;100
0;10;"rashiyah";10;0;100
0;302;"rashmi";302;0;100
0;18;"rashmika";18;0;100
901;0;"rashod";901;100;0
5;0;"rashodd";5;100;0
1770;118;"rashon";1888;93.75;6.25
0;22;"rashona";22;0;100
0;1498;"rashonda";1498;0;100
0;5;"rashondra";5;0;100
28;6;"rashone";34;82.3529411764706;17.6470588235294
0;43;"rashonna";43;0;100
536;18;"rashun";554;96.7509025270758;3.24909747292419
0;349;"rashunda";349;0;100
0;21;"rashundra";21;0;100
0;21;"rashya";21;0;100
0;12;"rashyia";12;0;100
0;8;"rasia";8;0;100
0;27;"rasika";27;0;100
7;0;"rasim";7;100;0
0;5;"rasiyah";5;0;100
0;6;"rasleen";6;0;100
0;5;"rasmine";5;0;100
58;0;"rasmus";58;100;0
59;0;"rason";59;100;0
114;0;"rasool";114;100;0
5;0;"rass";5;100;0
29;0;"rassan";29;100;0
20;5;"rassie";25;80;20
106;0;"rastus";106;100;0
326;0;"rasul";326;100;0
5;0;"rasun";5;100;0
5;0;"ratan";5;100;0
14;0;"ratana";14;100;0
0;80;"ratasha";80;0;100
0;5;"ratchel";5;0;100
0;47;"rateel";47;0;100
0;5;"ratesha";5;0;100
50;18;"ratha";68;73.5294117647059;26.4705882352941
51;13;"rathana";64;79.6875;20.3125
19;0;"rathanak";19;100;0
0;5;"rathany";5;0;100
0;36;"ratisha";36;0;100
0;10;"ratonya";10;0;100
7;0;"rattana";7;100;0
0;17;"ratzy";17;0;100
0;6;"rauchelle";6;0;100
881;0;"raudel";881;100;0
5;0;"rauf";5;100;0
0;7;"rauha";7;0;100
83445;483;"raul";83928;99.4245067200458;0.575493279954246
5;0;"raulie";5;100;0
11;0;"raulin";11;100;0
5;0;"rauljr";5;100;0
129;0;"raun";129;100;0
143;0;"raunak";143;100;0
0;5;"raunda";5;0;100
64;0;"raunel";64;100;0
5;0;"rauni";5;100;0
5;13;"rauri";18;27.7777777777778;72.2222222222222
5;0;"raury";5;100;0
33;0;"raushan";33;100;0
0;11;"raushana";11;0;100
0;164;"raushanah";164;0;100
5;0;"raushaun";5;100;0
0;11;"rava";11;0;100
0;33;"ravae";33;0;100
0;231;"ravan";231;0;100
29;0;"ravaughn";29;100;0
0;407;"raveen";407;0;100
0;279;"raveena";279;0;100
2939;37927;"raven";40866;7.19179758234229;92.8082024176577
0;10;"ravena";10;0;100
0;13;"ravene";13;0;100
0;5;"ravenel";5;0;100
0;16;"ravenell";16;0;100
0;262;"ravenna";262;0;100
0;61;"ravenne";61;0;100
0;11;"ravensimone";11;0;100
0;56;"ravensymone";56;0;100
2718;5;"ravi";2723;99.8163789937569;0.183621006243114
0;5;"ravien";5;0;100
242;944;"ravin";1186;20.4047217537943;79.5952782462057
0;76;"ravina";76;0;100
93;5;"ravinder";98;94.8979591836735;5.10204081632653
113;0;"ravindra";113;100;0
0;5;"ravine";5;0;100
47;12;"ravion";59;79.6610169491525;20.3389830508475
59;0;"ravis";59;100;0
6;0;"raviv";6;100;0
0;44;"ravleen";44;0;100
7;166;"ravneet";173;4.04624277456647;95.9537572254335
856;264;"ravon";1120;76.4285714285714;23.5714285714286
0;86;"ravonda";86;0;100
0;5;"ravonne";5;0;100
7;0;"ravonte";7;100;0
5;0;"ravy";5;100;0
0;18;"ravya";18;0;100
14;2027;"ravyn";2041;0.6859382655561;99.3140617344439
0;70;"ravynn";70;0;100
0;11;"rawa";11;0;100
48;0;"rawad";48;100;0
0;1033;"rawan";1033;0;100
0;28;"rawda";28;0;100
51;0;"rawland";51;100;0
11;0;"rawle";11;100;0
215;0;"rawleigh";215;100;0
380;0;"rawley";380;100;0
170;0;"rawlin";170;100;0
6;0;"rawling";6;100;0
25;0;"rawlings";25;100;0
38;0;"rawlins";38;100;0
6;0;"rawly";6;100;0
110;0;"rawn";110;100;0
0;14;"rawnie";14;0;100
79;0;"rawson";79;100;0
12;0;"raxton";12;100;0
195617;4839;"ray";200456;97.5860039110827;2.41399608891727
0;3027;"raya";3027;0;100
538;106;"rayaan";644;83.5403726708074;16.4596273291925
0;720;"rayah";720;0;100
0;43;"rayahna";43;0;100
4625;712;"rayan";5337;86.6591718193742;13.3408281806258
0;932;"rayana";932;0;100
0;14;"rayanah";14;0;100
110;7;"rayane";117;94.017094017094;5.98290598290598
5;1501;"rayann";1506;0.332005312084993;99.667994687915
0;1940;"rayanna";1940;0;100
0;30;"rayannah";30;0;100
0;1171;"rayanne";1171;0;100
108;0;"rayansh";108;100;0
36;0;"rayanthony";36;100;0
0;28;"rayauna";28;0;100
6;0;"raybert";6;100;0
198;0;"raybon";198;100;0
48;0;"rayborn";48;100;0
2600;0;"rayburn";2600;100;0
1162;11;"rayce";1173;99.0622335890878;0.937766410912191
28;0;"raycen";28;100;0
0;5;"raychael";5;0;100
0;1464;"raychel";1464;0;100
0;10;"raychele";10;0;100
0;163;"raychell";163;0;100
0;603;"raychelle";603;0;100
5;0;"raycin";5;100;0
0;5;"raycine";5;0;100
0;10;"rayda";10;0;100
69;0;"raydan";69;100;0
5;5;"raydean";10;50;50
114;0;"raydel";114;100;0
151;10;"raydell";161;93.7888198757764;6.2111801242236
3407;233;"rayden";3640;93.5989010989011;6.4010989010989
0;29;"raydene";29;0;100
94;0;"rayder";94;100;0
96;0;"raydin";96;100;0
206;0;"raydon";206;100;0
6;0;"raydrick";6;100;0
51;0;"raydyn";51;100;0
306;2141;"raye";2447;12.5051082958725;87.4948917041275
0;5;"rayea";5;0;100
0;13;"rayeann";13;0;100
0;5;"rayeanna";5;0;100
0;5;"rayegan";5;0;100
6;55;"rayel";61;9.83606557377049;90.1639344262295
0;12;"rayella";12;0;100
0;216;"rayelle";216;0;100
0;15;"rayelyn";15;0;100
0;64;"rayelynn";64;0;100
79;97;"rayen";176;44.8863636363636;55.1136363636364
0;666;"rayetta";666;0;100
0;137;"rayette";137;0;100
5;0;"rayfe";5;100;0
1856;0;"rayfield";1856;100;0
5483;0;"rayford";5483;100;0
42;0;"rayfus";42;100;0
40;871;"raygan";911;4.39077936333699;95.609220636663
53;471;"raygen";524;10.1145038167939;89.8854961832061
0;12;"raygene";12;0;100
0;6;"raygina";6;0;100
0;5;"raygine";5;0;100
0;5;"rayha";5;0;100
74;0;"rayhaan";74;100;0
620;5;"rayhan";625;99.2;0.8
0;107;"rayhana";107;0;100
0;35;"rayhanna";35;0;100
0;5;"rayhona";5;0;100
0;8;"rayia";8;0;100
5;0;"rayion";5;100;0
0;11;"rayiona";11;0;100
10;0;"rayirth";10;100;0
0;7;"rayisha";7;0;100
0;6;"rayjanae";6;0;100
10;0;"rayjay";10;100;0
0;16;"rayjean";16;0;100
19;0;"rayjohn";19;100;0
144;0;"rayjon";144;100;0
6;0;"raykwan";6;100;0
93;0;"raykwon";93;100;0
0;707;"rayla";707;0;100
0;16;"raylah";16;0;100
3270;272;"raylan";3542;92.3207227555054;7.67927724449464
352;0;"rayland";352;100;0
0;140;"raylea";140;0;100
0;11;"rayleah";11;0;100
0;5;"raylean";5;0;100
81;2977;"raylee";3058;2.648790058862;97.351209941138
0;1038;"rayleen";1038;0;100
0;67;"raylei";67;0;100
5;1477;"rayleigh";1482;0.337381916329285;99.6626180836707
799;463;"raylen";1262;63.3122028526149;36.6877971473851
0;39;"raylena";39;0;100
5;0;"raylend";5;100;0
0;3828;"raylene";3828;0;100
0;10;"raylenn";10;0;100
0;136;"rayley";136;0;100
20;77;"rayli";97;20.6185567010309;79.3814432989691
0;265;"raylie";265;0;100
317;834;"raylin";1151;27.5412684622068;72.4587315377932
0;15;"raylina";15;0;100
0;96;"raylinn";96;0;100
0;5;"rayln";5;0;100
0;6;"raylnn";6;0;100
819;0;"raylon";819;100;0
53;718;"raylyn";771;6.87418936446174;93.1258106355383
25;1969;"raylynn";1994;1.25376128385155;98.7462387161485
0;68;"raylynne";68;0;100
0;1040;"rayma";1040;0;100
0;5;"raymah";5;0;100
160;0;"rayman";160;100;0
53;0;"raymand";53;100;0
141;0;"raymar";141;100;0
12;0;"raymarion";12;100;0
12;0;"raymart";12;100;0
26;62;"rayme";88;29.5454545454545;70.4545454545455
5;0;"raymeir";5;100;0
75;0;"raymel";75;100;0
10;11;"raymell";21;47.6190476190476;52.3809523809524
0;5;"raymelle";5;0;100
33;0;"raymen";33;100;0
5;0;"raymer";5;100;0
45;0;"raymere";45;100;0
0;5;"raymesha";5;0;100
0;16;"raymi";16;0;100
0;5;"raymiah";5;0;100
112;175;"raymie";287;39.0243902439024;60.9756097560976
6;0;"raymier";6;100;0
49;0;"raymir";49;100;0
6;0;"raymod";6;100;0
7686;0;"raymon";7686;100;0
0;438;"raymona";438;0;100
759903;3501;"raymond";763404;99.541396167691;0.458603832308974
0;172;"raymonda";172;0;100
0;97;"raymonde";97;0;100
368;0;"raymondo";368;100;0
643;0;"raymone";643;100;0
0;5;"raymoni";5;0;100
301;0;"raymont";301;100;0
11;0;"raymonte";11;100;0
156;0;"raymound";156;100;0
567;0;"raymund";567;100;0
0;5;"raymunda";5;0;100
8948;0;"raymundo";8948;100;0
482;407;"rayn";889;54.2182227221597;45.7817772778403
0;9827;"rayna";9827;0;100
0;5;"raynae";5;0;100
0;218;"raynah";218;0;100
10;0;"raynal";10;100;0
99;0;"raynald";99;100;0
1527;0;"raynaldo";1527;100;0
2991;0;"raynard";2991;100;0
7;0;"raynathan";7;100;0
24;0;"raynav";24;100;0
809;5055;"rayne";5864;13.7960436562074;86.2039563437926
0;403;"raynee";403;0;100
0;139;"rayneisha";139;0;100
39;5;"raynel";44;88.6363636363636;11.3636363636364
424;710;"raynell";1134;37.3897707231041;62.6102292768959
0;226;"raynelle";226;0;100
26;0;"raynen";26;100;0
207;0;"rayner";207;100;0
0;216;"raynesha";216;0;100
0;12;"rayneshia";12;0;100
0;242;"raynetta";242;0;100
0;686;"raynette";686;0;100
0;109;"rayni";109;0;100
0;29;"raynia";29;0;100
0;52;"rayniah";52;0;100
0;185;"raynie";185;0;100
38;0;"rayniel";38;100;0
22;0;"raynier";22;100;0
0;11;"raynika";11;0;100
0;11;"raynique";11;0;100
0;222;"raynisha";222;0;100
0;24;"raynita";24;0;100
0;32;"rayniya";32;0;100
0;47;"rayniyah";47;0;100
0;31;"raynna";31;0;100
0;5;"raynne";5;0;100
596;0;"raynold";596;100;0
5;0;"raynoldo";5;100;0
412;0;"raynor";412;100;0
5;0;"rayo";5;100;0
0;180;"rayola";180;0;100
432;11;"rayon";443;97.5169300225734;2.48306997742664
0;353;"rayona";353;0;100
0;5;"rayonah";5;0;100
0;5;"rayonda";5;0;100
0;5;"rayonia";5;0;100
0;885;"rayonna";885;0;100
1126;0;"rayquan";1126;100;0
5;0;"rayquann";5;100;0
70;0;"rayquon";70;100;0
11;0;"rayqwan";11;100;0
10;0;"rayqwon";10;100;0
0;121;"raysa";121;0;100
495;0;"raysean";495;100;0
5;0;"raysen";5;100;0
0;98;"raysha";98;0;100
208;0;"rayshad";208;100;0
22;0;"rayshan";22;100;0
132;0;"rayshard";132;100;0
21;0;"rayshaud";21;100;0
922;0;"rayshaun";922;100;0
3613;179;"rayshawn";3792;95.2795358649789;4.7204641350211
0;21;"rayshawna";21;0;100
0;5;"rayshawnda";5;0;100
0;188;"rayshell";188;0;100
0;11;"rayshelle";11;0;100
26;0;"rayshod";26;100;0
730;0;"rayshon";730;100;0
0;55;"rayshonda";55;0;100
5;0;"rayshone";5;100;0
340;0;"rayshun";340;100;0
152;0;"rayson";152;100;0
0;77;"rayssa";77;0;100
5;0;"raytheon";5;100;0
0;12;"rayva";12;0;100
0;18;"rayvan";18;0;100
35;0;"rayvaughn";35;100;0
133;2472;"rayven";2605;5.10556621880998;94.89443378119
29;0;"rayveon";29;100;0
6;323;"rayvin";329;1.82370820668693;98.1762917933131
70;0;"rayvion";70;100;0
0;66;"rayvn";66;0;100
1835;61;"rayvon";1896;96.7827004219409;3.21729957805907
16;0;"rayvone";16;100;0
5;0;"rayvonn";5;100;0
0;12;"rayvyn";12;0;100
68;0;"raywood";68;100;0
0;142;"rayya";142;0;100
28;0;"rayyaan";28;100;0
1809;137;"rayyan";1946;92.9599177800617;7.04008221993833
0;40;"rayza";40;0;100
34;0;"raz";34;100;0
292;0;"raza";292;100;0
0;658;"razan";658;0;100
0;6;"razaria";6;0;100
0;5;"razariah";5;0;100
26;0;"razeen";26;100;0
0;5;"razel";5;0;100
0;5;"razhane";5;0;100
86;0;"razi";86;100;0
0;70;"razia";70;0;100
0;159;"raziah";159;0;100
966;24;"raziel";990;97.5757575757576;2.42424242424242
0;5;"raziela";5;0;100
10;0;"razin";10;100;0
0;282;"raziya";282;0;100
0;179;"raziyah";179;0;100
6;0;"razmig";6;100;0
10;0;"rb";10;100;0
0;5;"rbecca";5;0;100
96;0;"rc";96;100;0
0;10;"rchel";10;0;100
17;0;"rd";17;100;0
190;1660;"rea";1850;10.2702702702703;89.7297297297297
84;37;"reace";121;69.4214876033058;30.5785123966942
0;21;"reachel";21;0;100
308;0;"read";308;100;0
0;19;"reada";19;0;100
141;0;"reade";141;100;0
0;22;"readie";22;0;100
5;0;"readus";5;100;0
40;0;"reaford";40;100;0
6433;46229;"reagan";52662;12.2156393604497;87.7843606395503
0;85;"reagann";85;0;100
0;10;"reaganne";10;0;100
71;565;"reagen";636;11.1635220125786;88.8364779874214
0;919;"reaghan";919;0;100
0;41;"reagin";41;0;100
0;25;"reagon";25;0;100
0;175;"reagyn";175;0;100
0;349;"reah";349;0;100
0;6;"reahanna";6;0;100
0;10;"reahna";10;0;100
0;10;"reaiah";10;0;100
6;0;"reaksmey";6;100;0
73;0;"reakwon";73;100;0
338;26;"real";364;92.8571428571429;7.14285714285714
0;220;"reality";220;0;100
0;5;"realyn";5;0;100
0;38;"realynn";38;0;100
0;23;"ream";23;0;100
10;0;"reamer";10;100;0
0;5;"rean";5;0;100
0;676;"reana";676;0;100
0;5;"reanda";5;0;100
0;15;"reanee";15;0;100
0;5;"reaner";5;0;100
0;11;"reanetta";11;0;100
0;466;"reann";466;0;100
0;5451;"reanna";5451;0;100
0;158;"reannah";158;0;100
0;6;"reannan";6;0;100
0;646;"reanne";646;0;100
0;15;"reannen";15;0;100
0;260;"reannon";260;0;100
80;62;"rease";142;56.3380281690141;43.6619718309859
0;10;"reasia";10;0;100
89;10;"reason";99;89.8989898989899;10.1010101010101
0;90;"reata";90;0;100
0;2601;"reatha";2601;0;100
6;127;"reathel";133;4.51127819548872;95.4887218045113
5;905;"reather";910;0.549450549450549;99.4505494505495
0;13;"reatta";13;0;100
0;35;"reauna";35;0;100
0;6;"reaven";6;0;100
0;38;"reaver";38;0;100
12;0;"reaves";12;100;0
29;0;"reavis";29;100;0
60;34177;"reba";34237;0.175248999620294;99.8247510003797
0;101;"rebacca";101;0;100
0;128;"rebakah";128;0;100
0;27;"rebba";27;0;100
0;929;"rebbeca";929;0;100
0;2315;"rebbecca";2315;0;100
0;90;"rebbie";90;0;100
0;27;"rebcca";27;0;100
0;5;"rebe";5;0;100
5;12619;"rebeca";12624;0.0396070975918885;99.9603929024081
0;6;"rebecaa";6;0;100
0;213;"rebecah";213;0;100
0;6;"rebecc";6;0;100
2105;738959;"rebecca";741064;0.284051040126089;99.7159489598739
0;16;"rebeccaann";16;0;100
0;1558;"rebeccah";1558;0;100
0;6;"rebeccajo";6;0;100
0;60;"rebeccalynn";60;0;100
0;3263;"rebecka";3263;0;100
0;652;"rebeckah";652;0;100
0;6;"rebecker";6;0;100
0;2522;"rebeka";2522;0;100
119;72499;"rebekah";72618;0.163871216502795;99.8361287834972
0;30;"rebekan";30;0;100
0;73;"rebekha";73;0;100
0;2022;"rebekka";2022;0;100
0;1571;"rebekkah";1571;0;100
551;756;"rebel";1307;42.1576128538638;57.8423871461362
0;15;"rebella";15;0;100
0;24;"rebelle";24;0;100
0;31;"reber";31;0;100
5;0;"rebert";5;100;0
0;28;"reberta";28;0;100
0;5;"rebertha";5;0;100
0;43;"rebia";43;0;100
0;216;"rebie";216;0;100
0;18;"reble";18;0;100
0;6;"reby";6;0;100
0;5;"rebyl";5;0;100
0;23;"reca";23;0;100
660;0;"recardo";660;100;0
50;0;"recco";50;100;0
461;5;"rece";466;98.9270386266094;1.07296137339056
0;26;"rececca";26;0;100
33;0;"rechard";33;100;0
5;0;"reche";5;100;0
0;150;"rechel";150;0;100
0;5;"rechele";5;0;100
0;43;"rechell";43;0;100
0;628;"rechelle";628;0;100
0;5;"rechetta";5;0;100
0;54;"rechy";54;0;100
0;64;"recia";64;0;100
5;142;"recie";147;3.40136054421769;96.5986394557823
10;0;"recil";10;100;0
0;5;"recina";5;0;100
1185;0;"reco";1185;100;0
6;0;"record";6;100;0
101;0;"rector";101;100;0
269;0;"red";269;100;0
253;1843;"reda";2096;12.0706106870229;87.9293893129771
42;0;"redd";42;100;0
20;0;"redden";20;100;0
25;0;"reddick";25;100;0
123;5;"redding";128;96.09375;3.90625
31;0;"reddington";31;100;0
248;73;"redell";321;77.2585669781931;22.7414330218069
0;23;"redena";23;0;100
5;0;"rederick";5;100;0
84;0;"redford";84;100;0
24;0;"redge";24;100;0
36;0;"redgie";36;100;0
6;0;"redginald";6;100;0
0;43;"redia";43;0;100
13;0;"redick";13;100;0
0;42;"rediet";42;0;100
0;68;"redina";68;0;100
0;78;"redith";78;0;100
5;0;"redman";5;100;0
5;0;"redmon";5;100;0
640;0;"redmond";640;100;0
0;33;"redonda";33;0;100
0;191;"redonna";191;0;100
26;0;"redrick";26;100;0
10;0;"redus";10;100;0
5;0;"redwan";5;100;0
5;283;"ree";288;1.73611111111111;98.2638888888889
0;5;"reeana";5;0;100
0;61;"reeanna";61;0;100
0;11;"reeba";11;0;100
0;12;"reeca";12;0;100
16897;3584;"reece";20481;82.5008544504663;17.4991455495337
5;60;"reecie";65;7.69230769230769;92.3076923076923
28922;702;"reed";29624;97.6302997569538;2.36970024304618
0;410;"reeda";410;0;100
82;0;"reeder";82;100;0
10;5;"reedie";15;66.6666666666667;33.3333333333333
71;0;"reedy";71;100;0
738;12;"reef";750;98.4;1.6
289;1055;"reegan";1344;21.5029761904762;78.4970238095238
0;29;"reeghan";29;0;100
0;5;"reeham";5;0;100
0;2452;"reem";2452;0;100
0;1222;"reema";1222;0;100
0;34;"reemas";34;0;100
0;2131;"reena";2131;0;100
0;118;"reene";118;0;100
0;40;"reenie";40;0;100
909;114;"rees";1023;88.8563049853372;11.1436950146628
0;703;"reesa";703;0;100
15856;29004;"reese";44860;35.3455193936692;64.6544806063308
0;10;"reeselyn";10;0;100
0;7;"reeselynn";7;0;100
0;76;"reesha";76;0;100
0;23;"reesheda";23;0;100
0;121;"reeshemah";121;0;100
0;5;"reesie";5;0;100
0;191;"reet";191;0;100
0;152;"reeta";152;0;100
0;11;"reetal";11;0;100
0;5;"reetha";5;0;100
0;442;"reeva";442;0;100
634;150;"reeve";784;80.8673469387755;19.1326530612245
666;19;"reeves";685;97.2262773722628;2.77372262773723
0;185;"reeya";185;0;100
13;0;"reeyan";13;100;0
0;7;"refa";7;0;100
154;0;"refael";154;100;0
111;0;"refoel";111;100;0
116;0;"reford";116;100;0
5;1256;"refugia";1261;0.396510705789056;99.6034892942109
3908;831;"refugio";4739;82.4646549905043;17.5353450094957
0;29;"refujia";29;0;100
328;5;"refujio";333;98.4984984984985;1.5015015015015
209;0;"reg";209;100;0
34;0;"regal";34;100;0
3464;15214;"regan";18678;18.5458828568369;81.4541171431631
0;68;"regana";68;0;100
0;38;"regann";38;0;100
0;225;"reganne";225;0;100
5;0;"rege";5;100;0
0;44;"regeana";44;0;100
0;22;"regeina";22;0;100
6;10;"regen";16;37.5;62.5
0;2730;"regena";2730;0;100
6;0;"regenal";6;100;0
50;0;"regenald";50;100;0
0;94;"regene";94;0;100
0;2620;"regenia";2620;0;100
0;33;"regenna";33;0;100
0;6;"regetta";6;0;100
0;5;"reggan";5;0;100
11582;449;"reggie";12031;96.267974399468;3.73202560053196
0;19;"reggina";19;0;100
0;13;"regginae";13;0;100
15;0;"regginal";15;100;0
130;0;"regginald";130;100;0
52;0;"reggy";52;100;0
0;834;"reghan";834;0;100
16;0;"regi";16;100;0
82;0;"regie";82;100;0
0;7;"regin";7;0;100
564;174983;"regina";175547;0.321281480173401;99.6787185198266
0;650;"reginae";650;0;100
2568;5;"reginal";2573;99.8056743101438;0.194325689856199
109253;757;"reginald";110010;99.3118807381147;0.688119261885283
401;0;"reginaldo";401;100;0
0;5;"reginamarie";5;0;100
0;1378;"regine";1378;0;100
0;5;"reginea";5;0;100
0;1316;"reginia";1316;0;100
0;5;"reginique";5;0;100
0;96;"reginna";96;0;100
811;0;"regino";811;100;0
523;0;"reginold";523;100;0
22;0;"regional";22;100;0
46;0;"regionald";46;100;0
5097;343;"regis";5440;93.6948529411765;6.30514705882353
0;65;"regla";65;0;100
0;5;"regna";5;0;100
58;0;"regnald";58;100;0
0;56;"regnia";56;0;100
24;0;"regniald";24;100;0
5;0;"regnold";5;100;0
16;0;"regory";16;100;0
10;0;"regulo";10;100;0
0;55;"reha";55;0;100
206;0;"rehaan";206;100;0
0;20;"rehab";20;0;100
0;266;"reham";266;0;100
1067;6;"rehan";1073;99.4408201304753;0.559179869524697
0;283;"rehana";283;0;100
0;215;"rehanna";215;0;100
6;0;"rehansh";6;100;0
0;98;"rehema";98;0;100
0;10;"rehgan";10;0;100
0;15;"rehma";15;0;100
141;0;"rehman";141;100;0
0;19;"rehmat";19;0;100
246;258;"rei";504;48.8095238095238;51.1904761904762
0;103;"reia";103;0;100
0;74;"reiana";74;0;100
0;102;"reianna";102;0;100
112;7;"reice";119;94.1176470588235;5.88235294117647
72;0;"reichen";72;100;0
5;0;"reicher";5;100;0
10;0;"reico";10;100;0
30521;662;"reid";31183;97.8770483917519;2.12295160824808
0;311;"reida";311;0;100
16;0;"reidar";16;100;0
15;0;"reide";15;100;0
39;0;"reiden";39;100;0
17;0;"reider";17;100;0
29;0;"reif";29;100;0
0;210;"reigan";210;0;100
0;6;"reigha";6;0;100
0;86;"reighan";86;0;100
0;93;"reighlyn";93;0;100
0;71;"reighlynn";71;0;100
5;41;"reighn";46;10.8695652173913;89.1304347826087
0;6;"reighna";6;0;100
710;1422;"reign";2132;33.3020637898687;66.6979362101313
0;145;"reigna";145;0;100
32;0;"reik";32;100;0
0;99;"reika";99;0;100
10;0;"reiken";10;100;0
12;624;"reiko";636;1.88679245283019;98.1132075471698
0;5;"reilani";5;0;100
0;21;"reilee";21;0;100
0;26;"reileigh";26;0;100
307;554;"reiley";861;35.6562137049942;64.3437862950058
6;5;"reili";11;54.5454545454545;45.4545454545455
107;180;"reilley";287;37.2822299651568;62.7177700348432
4030;4910;"reilly";8940;45.0782997762864;54.9217002237136
514;331;"reily";845;60.8284023668639;39.1715976331361
0;117;"reilyn";117;0;100
0;122;"reilynn";122;0;100
0;7;"reimi";7;0;100
10;0;"reimundo";10;100;0
84;42;"rein";126;66.6666666666667;33.3333333333333
0;9736;"reina";9736;0;100
21;0;"reinald";21;100;0
0;11;"reinalda";11;0;100
3806;0;"reinaldo";3806;100;0
0;5;"reinaliz";5;0;100
5;0;"reinard";5;100;0
5;0;"reinardo";5;100;0
0;352;"reine";352;0;100
185;0;"reiner";185;100;0
0;73;"reinette";73;0;100
428;0;"reinhard";428;100;0
234;0;"reinhardt";234;100;0
196;0;"reinhart";196;100;0
1333;0;"reinhold";1333;100;0
11;0;"reinholdt";11;100;0
21;0;"reinier";21;100;0
0;5;"reinna";5;0;100
706;0;"reino";706;100;0
55;0;"reinold";55;100;0
0;5;"reiny";5;0;100
5;0;"reion";5;100;0
0;10;"reionna";10;0;100
672;103;"reis";775;86.7096774193548;13.2903225806452
0;60;"reisa";60;0;100
122;98;"reise";220;55.4545454545455;44.5454545454545
0;135;"reisha";135;0;100
158;49;"reiss";207;76.3285024154589;23.6714975845411
0;1340;"reita";1340;0;100
12;0;"reiter";12;100;0
0;60;"reitha";60;0;100
0;18;"reiya";18;0;100
0;90;"reizel";90;0;100
0;51;"reizy";51;0;100
0;6;"reja";6;0;100
0;5;"rejanae";5;0;100
0;5;"rejane";5;0;100
18;8;"rejean";26;69.2307692307692;30.7692307692308
0;278;"rejeana";278;0;100
0;10;"rejeania";10;0;100
0;35;"rejeanne";35;0;100
0;6;"rejena";6;0;100
0;11;"rejetta";11;0;100
0;72;"rejina";72;0;100
0;5;"rejine";5;0;100
27;0;"rejino";27;100;0
0;104;"rejoice";104;0;100
19;0;"rejon";19;100;0
0;7;"rejoyce";7;0;100
0;257;"reka";257;0;100
0;5;"rekayla";5;0;100
0;23;"rekeisha";23;0;100
0;17;"rekesha";17;0;100
0;212;"rekha";212;0;100
0;62;"rekia";62;0;100
0;5;"rekik";5;0;100
0;7;"rekina";7;0;100
0;66;"rekisha";66;0;100
0;82;"rekita";82;0;100
0;12;"rekiya";12;0;100
0;6;"rekiyah";6;0;100
15;0;"rekker";15;100;0
31;0;"reko";31;100;0
0;5;"rela";5;0;100
0;6;"relanda";6;0;100
6;0;"relando";6;100;0
0;565;"relda";565;0;100
5;0;"reldon";5;100;0
0;59;"relena";59;0;100
5;0;"relford";5;100;0
0;27;"relia";27;0;100
12;0;"relic";12;100;0
0;17;"relina";17;0;100
0;45;"relinda";45;0;100
5;0;"relis";5;100;0
12;5;"rell";17;70.5882352941177;29.4117647058824
0;1086;"rella";1086;0;100
0;32;"relma";32;0;100
0;11;"relonda";11;0;100
0;5;"relynn";5;0;100
10;0;"rem";10;100;0
10;1134;"rema";1144;0.874125874125874;99.1258741258741
0;145;"remas";145;0;100
5;0;"rember";5;100;0
432;0;"rembert";432;100;0
79;0;"remberto";79;100;0
15;0;"rembrandt";15;100;0
17;0;"reme";17;100;0
0;14;"remedi";14;0;100
0;94;"remedios";94;0;100
5;225;"remedy";230;2.17391304347826;97.8260869565217
0;38;"remee";38;0;100
0;5;"remeigh";5;0;100
0;5;"remeka";5;0;100
0;21;"remel";21;0;100
0;5;"remelda";5;0;100
0;62;"remell";62;0;100
113;0;"remer";113;100;0
10;10;"remey";20;50;50
1602;4962;"remi";6564;24.4058500914077;75.5941499085923
0;5;"remia";5;0;100
0;32;"remiah";32;0;100
20;0;"remick";20;100;0
5;259;"remie";264;1.89393939393939;98.1060606060606
92;0;"remiel";92;100;0
0;5;"remigia";5;0;100
766;0;"remigio";766;100;0
5;0;"remigius";5;100;0
0;23;"remii";23;0;100
80;0;"remijio";80;100;0
0;5;"remika";5;0;100
0;10;"remilda";10;0;100
0;12;"remilynn";12;0;100
5;0;"remingtin";5;100;0
11076;3189;"remington";14265;77.6445846477392;22.3554153522608
0;42;"remingtyn";42;0;100
0;21;"remini";21;0;100
0;30;"reminisce";30;0;100
0;25;"remiyah";25;0;100
0;6;"remley";6;0;100
18;0;"remmel";18;100;0
6;168;"remmi";174;3.44827586206897;96.551724137931
0;108;"remmie";108;0;100
223;107;"remmington";330;67.5757575757576;32.4242424242424
212;118;"remmy";330;64.2424242424242;35.7575757575758
952;0;"remo";952;100;0
161;0;"remon";161;100;0
0;1393;"remona";1393;0;100
33;0;"remond";33;100;0
0;16;"remonda";16;0;100
21;0;"remone";21;100;0
0;426;"remonia";426;0;100
0;36;"remonica";36;0;100
6;0;"remsen";6;100;0
760;0;"remus";760;100;0
5226;3657;"remy";8883;58.8314758527524;41.1685241472476
0;29;"remya";29;0;100
8;10;"remyngton";18;44.4444444444444;55.5555555555556
1431;211;"ren";1642;87.1498172959805;12.8501827040195
123;35234;"rena";35357;0.347880193455327;99.6521198065447
0;168;"renad";168;0;100
0;710;"renada";710;0;100
5;0;"renado";5;100;0
33;13733;"renae";13766;0.239721051866918;99.7602789481331
0;15;"renaee";15;0;100
0;5;"renah";5;0;100
0;82;"renai";82;0;100
518;0;"renald";518;100;0
0;69;"renalda";69;0;100
2796;0;"renaldo";2796;100;0
306;0;"renan";306;100;0
2639;0;"renard";2639;100;0
5;141;"renarda";146;3.42465753424658;96.5753424657534
769;12;"renardo";781;98.4635083226632;1.53649167733675
0;9;"renarta";9;0;100
0;5;"renasha";5;0;100
0;27;"renasia";27;0;100
6;0;"renat";6;100;0
6;8951;"renata";8957;0.0669867143016635;99.9330132856983
0;1247;"renate";1247;0;100
0;58;"renatha";58;0;100
2903;6;"renato";2909;99.7937435544861;0.206256445513922
0;427;"renatta";427;0;100
55;0;"renaud";55;100;0
0;15;"renauda";15;0;100
39;0;"renauld";39;100;0
5;0;"renauldo";5;100;0
24;0;"renault";24;100;0
0;6;"renauta";6;0;100
24;1936;"renay";1960;1.22448979591837;98.7755102040816
0;44;"renaya";44;0;100
0;144;"renaye";144;0;100
0;1190;"renda";1190;0;100
47;0;"rendall";47;100;0
599;0;"rendell";599;100;0
59;0;"render";59;100;0
0;135;"rendi";135;0;100
65;0;"rendon";65;100;0
17;141;"rendy";158;10.7594936708861;89.2405063291139
48759;21620;"rene";70379;69.2806092726524;30.7193907273476
0;4259;"renea";4259;0;100
0;34;"reneasha";34;0;100
0;50;"renecia";50;0;100
0;8;"reneda";8;0;100
1593;183675;"renee";185268;0.859835481572641;99.1401645184274
10;0;"renegade";10;100;0
0;236;"reneisha";236;0;100
0;142;"reneka";142;0;100
62;16;"renel";78;79.4871794871795;20.5128205128205
0;189;"renelda";189;0;100
154;553;"renell";707;21.7821782178218;78.2178217821782
0;149;"renella";149;0;100
0;414;"renelle";414;0;100
0;17;"rener";17;0;100
0;425;"renesha";425;0;100
0;74;"reneshia";74;0;100
0;140;"renesmae";140;0;100
0;41;"renesmay";41;0;100
0;78;"renesme";78;0;100
0;709;"renesmee";709;0;100
0;194;"renessa";194;0;100
0;172;"reneta";172;0;100
0;22;"renetha";22;0;100
0;6;"renetia";6;0;100
0;1573;"renetta";1573;0;100
0;567;"renette";567;0;100
5;0;"reney";5;100;0
0;72;"renezmae";72;0;100
0;18;"renezmay";18;0;100
0;11;"renezme";11;0;100
0;22;"renezmee";22;0;100
41;0;"renford";41;100;0
10;0;"renfred";10;100;0
0;113;"reni";113;0;100
0;657;"renia";657;0;100
0;86;"reniah";86;0;100
0;32;"renica";32;0;100
0;54;"renice";54;0;100
10;0;"renick";10;100;0
0;5;"renida";5;0;100
6;609;"renie";615;0.975609756097561;99.0243902439024
0;5;"reniece";5;0;100
5;0;"reniel";5;100;0
21;0;"renier";21;100;0
0;6;"reniesha";6;0;100
0;359;"renika";359;0;100
0;11;"renina";11;0;100
0;6;"reniqua";6;0;100
0;128;"renise";128;0;100
0;735;"renisha";735;0;100
0;7388;"renita";7388;0;100
0;5;"renitha";5;0;100
0;5;"renitia";5;0;100
0;28;"renitta";28;0;100
0;302;"reniya";302;0;100
0;287;"reniyah";287;0;100
46;0;"renji";46;100;0
0;38;"renlee";38;0;100
0;30;"renleigh";30;0;100
44;78;"renley";122;36.0655737704918;63.9344262295082
97;25;"renly";122;79.5081967213115;20.4918032786885
233;43;"renn";276;84.4202898550725;15.5797101449275
0;1180;"renna";1180;0;100
0;133;"rennae";133;0;100
5;0;"rennan";5;100;0
59;0;"rennard";59;100;0
0;12;"rennata";12;0;100
61;573;"renne";634;9.62145110410095;90.3785488958991
0;153;"rennee";153;0;100
5;0;"rennen";5;100;0
326;18;"renner";344;94.7674418604651;5.23255813953488
0;17;"rennetta";17;0;100
0;35;"rennette";35;0;100
42;0;"rennick";42;100;0
984;838;"rennie";1822;54.006586169045;45.993413830955
5;0;"rennis";5;100;0
613;66;"renny";679;90.279823269514;9.72017673048601
3889;22;"reno";3911;99.4374840194324;0.56251598056763
0;26;"renoda";26;0;100
63;0;"renold";63;100;0
0;36;"renona";36;0;100
0;11;"renorda";11;0;100
0;49;"renota";49;0;100
0;22;"renotta";22;0;100
64;0;"renso";64;100;0
80;0;"renton";80;100;0
0;71;"renu";71;0;100
0;91;"renuka";91;0;100
533;0;"renwick";533;100;0
11;6;"reny";17;64.7058823529412;35.2941176470588
0;43;"renya";43;0;100
0;7;"renyah";7;0;100
18;0;"renz";18;100;0
5;0;"renza";5;100;0
5;0;"renzel";5;100;0
5;0;"renzie";5;100;0
1607;0;"renzo";1607;100;0
719;27;"reo";746;96.3806970509383;3.61930294906166
0;810;"reola";810;0;100
108;0;"reon";108;100;0
0;163;"reona";163;0;100
0;277;"reonna";277;0;100
45;0;"rephael";45;100;0
5;0;"reppard";5;100;0
74;0;"requan";74;100;0
0;53;"requel";53;0;100
0;22;"requita";22;0;100
0;1046;"resa";1046;0;100
62;0;"resean";62;100;0
0;257;"resha";257;0;100
166;0;"reshad";166;100;0
0;5;"reshae";5;0;100
0;5;"resham";5;0;100
0;5;"reshana";5;0;100
0;78;"reshanda";78;0;100
338;0;"reshard";338;100;0
12;0;"reshaud";12;100;0
130;0;"reshaun";130;100;0
0;5;"reshaunda";5;0;100
411;43;"reshawn";454;90.5286343612335;9.47136563876652
0;16;"reshawna";16;0;100
0;19;"reshawnda";19;0;100
0;14;"reshay";14;0;100
0;15;"reshea";15;0;100
0;12;"resheda";12;0;100
0;11;"resheena";11;0;100
0;5;"resheka";5;0;100
0;50;"reshell";50;0;100
0;11;"reshelle";11;0;100
0;5;"reshia";5;0;100
0;6;"reshika";6;0;100
0;441;"reshma";441;0;100
0;5;"reshmi";5;0;100
5;0;"reshod";5;100;0
18;5;"reshon";23;78.2608695652174;21.7391304347826
0;299;"reshonda";299;0;100
0;74;"reshunda";74;0;100
0;5;"resia";5;0;100
0;41;"ressa";41;0;100
18;1617;"ressie";1635;1.10091743119266;98.8990825688073
30;0;"reston";30;100;0
0;8328;"reta";8328;0;100
0;5;"retag";5;0;100
0;5;"retage";5;0;100
0;131;"retaj";131;0;100
0;122;"retal";122;0;100
0;10384;"retha";10384;0;100
0;5;"rethal";5;0;100
0;11;"rethea";11;0;100
0;88;"rethel";88;0;100
0;133;"rether";133;0;100
0;37;"rethia";37;0;100
0;70;"retia";70;0;100
0;158;"retina";158;0;100
0;6;"retisha";6;0;100
0;6;"retonia";6;0;100
0;5;"retonya";5;0;100
103;0;"rett";103;100;0
0;2807;"retta";2807;0;100
0;79;"rettie";79;0;100
28079;45;"reuben";28124;99.8399943109088;0.160005689091168
0;10;"reubena";10;0;100
610;0;"reubin";610;100;0
750;0;"reuel";750;100;0
11;0;"reus";11;100;0
0;5;"reut";5;0;100
714;0;"reuven";714;100;0
10;0;"rev";10;100;0
11;15217;"reva";15228;0.0722353559232992;99.9277646440767
5;0;"revaan";5;100;0
0;31;"revae";31;0;100
291;7;"revan";298;97.6510067114094;2.3489932885906
8;0;"revansh";8;100;0
68;0;"revanth";68;100;0
0;6;"revathi";6;0;100
0;5;"revati";5;0;100
19;60;"reve";79;24.0506329113924;75.9493670886076
0;5;"revea";5;0;100
0;102;"reveca";102;0;100
0;54;"revecca";54;0;100
0;17;"reveille";17;0;100
176;27;"revel";203;86.6995073891626;13.3004926108374
5;0;"revelation";5;100;0
27;0;"revell";27;100;0
0;74;"revella";74;0;100
10;0;"revelle";10;100;0
42;6;"reven";48;87.5;12.5
0;10;"revena";10;0;100
0;65;"rever";65;0;100
42;0;"revere";42;100;0
0;66;"reverie";66;0;100
0;63;"revia";63;0;100
0;5;"revie";5;0;100
92;0;"revin";92;100;0
0;13;"revina";13;0;100
382;0;"revis";382;100;0
22;5;"revon";27;81.4814814814815;18.5185185185185
0;767;"revonda";767;0;100
7;8;"revyn";15;46.6666666666667;53.3333333333333
0;145;"rewa";145;0;100
56565;140;"rex";56705;99.7531081915175;0.246891808482497
24;0;"rexall";24;100;0
0;6;"rexalynn";6;0;100
0;124;"rexann";124;0;100
0;107;"rexanna";107;0;100
0;220;"rexanne";220;0;100
0;37;"rexene";37;0;100
2431;0;"rexford";2431;100;0
32;38;"rexie";70;45.7142857142857;54.2857142857143
0;122;"rexine";122;0;100
234;0;"rexton";234;100;0
25;0;"rexx";25;100;0
6990;63;"rey";7053;99.1067630795406;0.893236920459379
0;1019;"reya";1019;0;100
117;0;"reyaan";117;100;0
85;0;"reyaansh";85;100;0
16;0;"reyad";16;100;0
0;99;"reyah";99;0;100
214;10;"reyan";224;95.5357142857143;4.46428571428571
0;269;"reyana";269;0;100
0;86;"reyann";86;0;100
0;460;"reyanna";460;0;100
0;73;"reyanne";73;0;100
1237;0;"reyansh";1237;100;0
0;5;"reyanshi";5;0;100
5;0;"reyburn";5;100;0
69;12;"reyce";81;85.1851851851852;14.8148148148148
5;0;"reyd";5;100;0
12;0;"reydan";12;100;0
12;0;"reydavid";12;100;0
149;0;"reyden";149;100;0
5;0;"reydon";5;100;0
0;10;"reyelle";10;0;100
5529;706;"reyes";6235;88.6768243785084;11.3231756214916
10;0;"reyez";10;100;0
0;319;"reygan";319;0;100
100;24;"reyhan";124;80.6451612903226;19.3548387096774
0;21;"reyhana";21;0;100
51;0;"reylan";51;100;0
5;0;"reyland";5;100;0
0;18;"reylee";18;0;100
0;6;"reyleigh";6;0;100
5;0;"reylen";5;100;0
0;100;"reylene";100;0;100
735;13;"reyli";748;98.2620320855615;1.7379679144385
5;23;"reylin";28;17.8571428571429;82.1428571428571
42;0;"reyly";42;100;0
0;5;"reylyn";5;0;100
0;52;"reylynn";52;0;100
5;0;"reymi";5;100;0
58;0;"reymon";58;100;0
543;0;"reymond";543;100;0
4074;0;"reymundo";4074;100;0
237;13;"reyn";250;94.8;5.2
32;14085;"reyna";14117;0.226677056031735;99.7733229439683
0;24;"reynah";24;0;100
151;0;"reynald";151;100;0
0;338;"reynalda";338;0;100
19460;23;"reynaldo";19483;99.8819483652415;0.118051634758507
0;7;"reynaliz";7;0;100
701;0;"reynard";701;100;0
20;0;"reynardo";20;100;0
6;0;"reynaud";6;100;0
0;224;"reyne";224;0;100
42;0;"reynel";42;100;0
0;29;"reynelda";29;0;100
0;6;"reynell";6;0;100
5;0;"reyner";5;100;0
30;0;"reyniel";30;100;0
11;0;"reynier";11;100;0
79;0;"reynol";79;100;0
4568;0;"reynold";4568;100;0
71;0;"reynoldo";71;100;0
1514;39;"reynolds";1553;97.4887314874437;2.51126851255634
15;0;"reyon";15;100;0
0;13;"reyona";13;0;100
0;99;"reyonna";99;0;100
0;11;"reyse";11;0;100
16;0;"reyshawn";16;100;0
0;5;"reyyan";5;0;100
865;0;"reza";865;100;0
101;0;"reznor";101;100;0
5;0;"rezon";5;100;0
0;46;"rhae";46;0;100
0;50;"rhaegan";50;0;100
0;53;"rhaelyn";53;0;100
0;16;"rhaelynn";16;0;100
5;0;"rhaheem";5;100;0
26;0;"rhakeem";26;100;0
26;0;"rhamel";26;100;0
10;0;"rhamir";10;100;0
0;17;"rhana";17;0;100
0;5;"rhanada";5;0;100
0;146;"rhanda";146;0;100
0;135;"rhandi";135;0;100
30;0;"rhandy";30;100;0
0;6;"rhania";6;0;100
0;38;"rhaniya";38;0;100
0;12;"rhaniyah";12;0;100
0;82;"rhapsody";82;0;100
14;0;"rhasaan";14;100;0
23;0;"rhashad";23;100;0
6;0;"rhasheen";6;100;0
0;28;"rhaven";28;0;100
0;5;"rhavyn";5;0;100
0;40;"rhawnie";40;0;100
0;85;"rhaya";85;0;100
0;14;"rhayna";14;0;100
0;79;"rhayne";79;0;100
403;15081;"rhea";15484;2.60268664427796;97.397313355722
0;5;"rheaann";5;0;100
0;521;"rheagan";521;0;100
0;51;"rhealyn";51;0;100
0;90;"rhealynn";90;0;100
0;248;"rheana";248;0;100
0;55;"rheann";55;0;100
0;1752;"rheanna";1752;0;100
0;146;"rheanne";146;0;100
0;440;"rheannon";440;0;100
0;5;"rheanon";5;0;100
0;6;"rheata";6;0;100
0;1207;"rheba";1207;0;100
0;240;"rheda";240;0;100
0;5;"rhedyn";5;0;100
5;0;"rheece";5;100;0
0;5;"rheese";5;0;100
0;9;"rheeta";9;0;100
0;254;"rhegan";254;0;100
0;5;"rheia";5;0;100
0;37;"rhelda";37;0;100
0;678;"rhema";678;0;100
5;72;"rhemi";77;6.49350649350649;93.5064935064935
5;27;"rhemy";32;15.625;84.375
132;40;"rhen";172;76.7441860465116;23.2558139534884
0;149;"rhena";149;0;100
0;167;"rhenda";167;0;100
5;0;"rheo";5;100;0
0;134;"rhesa";134;0;100
158;0;"rhet";158;100;0
0;1195;"rheta";1195;0;100
0;5;"rhetha";5;0;100
16090;92;"rhett";16182;99.4314670621678;0.568532937832159
0;574;"rhetta";574;0;100
16;0;"rheuben";16;100;0
0;35;"rheva";35;0;100
0;237;"rheya";237;0;100
0;5;"rheyanna";5;0;100
0;12;"rheyna";12;0;100
0;109;"rhia";109;0;100
102;742;"rhian";844;12.085308056872;87.914691943128
0;1053;"rhiana";1053;0;100
0;10;"rhianah";10;0;100
0;5;"rhiane";5;0;100
0;131;"rhiann";131;0;100
0;5614;"rhianna";5614;0;100
0;18;"rhiannah";18;0;100
0;171;"rhiannan";171;0;100
0;216;"rhianne";216;0;100
0;11;"rhiannen";11;0;100
5;13785;"rhiannon";13790;0.0362581580855693;99.9637418419144
0;355;"rhianon";355;0;100
0;11;"rhiauna";11;0;100
0;126;"rhilee";126;0;100
0;5;"rhileigh";5;0;100
240;649;"rhiley";889;26.9966254218223;73.0033745781777
0;66;"rhilyn";66;0;100
0;167;"rhilynn";167;0;100
0;106;"rhina";106;0;100
0;5;"rhinda";5;0;100
6;0;"rhion";6;100;0
0;35;"rhionna";35;0;100
5;0;"rhiver";5;100;0
0;43;"rhiya";43;0;100
0;21;"rhiyan";21;0;100
0;7;"rhiyana";7;0;100
0;30;"rhiyanna";30;0;100
0;5;"rhnea";5;0;100
5;0;"rhoads";5;100;0
26;0;"rhoan";26;100;0
0;5;"rhochelle";5;0;100
0;23200;"rhoda";23200;0;100
0;5;"rhode";5;0;100
5;0;"rhodell";5;100;0
0;10;"rhodella";10;0;100
0;5;"rhodena";5;0;100
57;0;"rhoderick";57;100;0
543;12;"rhodes";555;97.8378378378378;2.16216216216216
0;95;"rhodesia";95;0;100
0;70;"rhodia";70;0;100
5;120;"rhodie";125;4;96
39;0;"rhodney";39;100;0
0;5;"rhodonna";5;0;100
0;36;"rhodora";36;0;100
30;0;"rhody";30;100;0
16;0;"rhoen";16;100;0
0;6;"rhoena";6;0;100
11;0;"rhoman";11;100;0
17;0;"rhome";17;100;0
36;0;"rhon";36;100;0
0;1643;"rhona";1643;0;100
30;0;"rhonald";30;100;0
26;0;"rhonan";26;100;0
0;5;"rhond";5;0;100
590;207917;"rhonda";208507;0.282964121108644;99.7170358788914
0;137;"rhondalyn";137;0;100
0;11;"rhondda";11;0;100
0;59;"rhondi";59;0;100
0;32;"rhondia";32;0;100
116;7;"rhone";123;94.3089430894309;5.69105691056911
0;7;"rhonesha";7;0;100
0;17;"rhoni";17;0;100
69;0;"rhonin";69;100;0
0;17;"rhonisha";17;0;100
0;159;"rhonna";159;0;100
15;0;"rhonnie";15;100;0
11;0;"rhory";11;100;0
0;6;"rhoslyn";6;0;100
5;0;"rhowen";5;100;0
0;6;"rhowyn";6;0;100
13;0;"rhuben";13;100;0
0;17;"rhudine";17;0;100
0;41;"rhunette";41;0;100
0;175;"rhya";175;0;100
1271;2089;"rhyan";3360;37.8273809523809;62.1726190476191
0;50;"rhyana";50;0;100
0;6;"rhyane";6;0;100
0;338;"rhyann";338;0;100
0;313;"rhyanna";313;0;100
0;37;"rhyanne";37;0;100
0;36;"rhyannon";36;0;100
13;0;"rhyatt";13;100;0
46;0;"rhyden";46;100;0
717;68;"rhyder";785;91.3375796178344;8.6624203821656
100;0;"rhydian";100;100;0
5;0;"rhye";5;100;0
44;120;"rhyen";164;26.8292682926829;73.1707317073171
18;0;"rhyett";18;100;0
0;5;"rhyin";5;0;100
13;0;"rhyis";13;100;0
180;0;"rhyker";180;100;0
0;24;"rhyla";24;0;100
351;196;"rhylan";547;64.1681901279707;35.8318098720293
117;13;"rhyland";130;90;10
0;38;"rhylea";38;0;100
170;1275;"rhylee";1445;11.7647058823529;88.2352941176471
0;70;"rhylei";70;0;100
0;318;"rhyleigh";318;0;100
102;48;"rhylen";150;68;32
18;30;"rhyley";48;37.5;62.5
0;58;"rhyli";58;0;100
0;393;"rhylie";393;0;100
50;104;"rhylin";154;32.4675324675325;67.5324675324675
0;11;"rhylinn";11;0;100
5;0;"rhylon";5;100;0
0;81;"rhylynn";81;0;100
51;0;"rhyne";51;100;0
22;7;"rhyon";29;75.8620689655172;24.1379310344828
7529;491;"rhys";8020;93.8778054862843;6.12219451371571
157;69;"rhyse";226;69.4690265486726;30.5309734513274
15;0;"rhyson";15;100;0
221;174;"rhythm";395;55.9493670886076;44.0506329113924
6;0;"rhyus";6;100;0
0;3356;"ria";3356;0;100
643;0;"riaan";643;100;0
164;0;"riad";164;100;0
5;348;"riah";353;1.41643059490085;98.5835694050991
0;10;"riahanna";10;0;100
0;30;"riahna";30;0;100
0;20;"riahnna";20;0;100
32;0;"rial";32;100;0
0;11;"rialey";11;0;100
4160;2793;"rian";6953;59.8302890838487;40.1697109161513
0;2009;"riana";2009;0;100
0;13;"rianah";13;0;100
5;524;"riane";529;0.945179584120983;99.054820415879
0;665;"riann";665;0;100
0;3588;"rianna";3588;0;100
0;77;"riannah";77;0;100
0;855;"rianne";855;0;100
0;250;"riannon";250;0;100
0;6;"rianny";6;0;100
0;5;"rianon";5;0;100
11;0;"riansh";11;100;0
0;20;"rianshi";20;0;100
0;5;"rias";5;0;100
0;75;"riata";75;0;100
0;27;"riayn";27;0;100
99;0;"riaz";99;100;0
13;0;"ribaldo";13;100;0
5;0;"ribhi";5;100;0
1270;0;"ric";1270;100;0
0;520;"rica";520;0;100
5;0;"ricado";5;100;0
207;0;"ricahrd";207;100;0
419;0;"ricard";419;100;0
0;737;"ricarda";737;0;100
137650;713;"ricardo";138363;99.4846888257699;0.515311174230105
5;0;"ricari";5;100;0
0;5;"ricaria";5;0;100
0;6;"ricayla";6;0;100
0;72;"ricca";72;0;100
1454;0;"riccardo";1454;100;0
873;839;"ricci";1712;50.9929906542056;49.0070093457944
1365;0;"ricco";1365;100;0
225;0;"rice";225;100;0
4050;0;"rich";4050;100;0
0;633;"richa";633;0;100
5;0;"richaad";5;100;0
386;0;"richad";386;100;0
0;10;"richae";10;0;100
0;24;"richael";24;0;100
0;5;"richana";5;0;100
5;0;"richand";5;100;0
0;58;"richanda";58;0;100
311;0;"richar";311;100;0
0;6;"richara";6;0;100
2546188;9461;"richard";2555649;99.6298004929472;0.370199507052807
0;31;"richarda";31;0;100
31;0;"richardd";31;100;0
0;45;"richardean";45;0;100
0;146;"richardine";146;0;100
5;0;"richardjames";5;100;0
2053;0;"richardo";2053;100;0
119;0;"richards";119;100;0
585;0;"richardson";585;100;0
6;0;"richaud";6;100;0
0;110;"richel";110;0;100
0;751;"richele";751;0;100
0;166;"richell";166;0;100
0;23;"richella";23;0;100
0;8325;"richelle";8325;0;100
0;16;"richenda";16;0;100
20;0;"richer";20;100;0
241;0;"richerd";241;100;0
0;212;"richetta";212;0;100
0;5;"richette";5;0;100
474;0;"richey";474;100;0
22;0;"richi";22;100;0
0;5;"richia";5;0;100
6523;395;"richie";6918;94.2902572997976;5.70974270020237
0;12;"richlyn";12;0;100
0;7;"richlynn";7;0;100
5;0;"richman";5;100;0
5;0;"richmon";5;100;0
3916;0;"richmond";3916;100;0
11;0;"richon";11;100;0
410;0;"richrd";410;100;0
23;0;"richter";23;100;0
666;0;"richy";666;100;0
0;7;"rici";7;0;100
0;11;"ricia";11;0;100
81406;135;"rick";81541;99.8344391165181;0.165560883481929
0;84;"ricka";84;0;100
626;0;"rickard";626;100;0
79;0;"rickardo";79;100;0
0;159;"rickayla";159;0;100
192;0;"ricke";192;100;0
0;26;"rickea";26;0;100
5;0;"rickeem";5;100;0
0;5;"rickeeta";5;0;100
0;36;"rickeisha";36;0;100
0;37;"rickel";37;0;100
0;159;"rickell";159;0;100
0;287;"rickelle";287;0;100
0;115;"rickesha";115;0;100
0;18;"rickeshia";18;0;100
0;12;"ricketa";12;0;100
0;83;"ricketta";83;0;100
61164;674;"rickey";61838;98.910055305799;1.08994469420098
0;100;"rickeya";100;0;100
18;0;"rickford";18;100;0
2285;4179;"ricki";6464;35.3496287128713;64.6503712871287
0;463;"rickia";463;0;100
0;12;"rickiah";12;0;100
16203;1763;"rickie";17966;90.1870199265279;9.81298007347211
0;5;"rickiesha";5;0;100
0;6;"rickira";6;0;100
0;48;"rickisha";48;0;100
0;121;"rickita";121;0;100
0;83;"rickiya";83;0;100
0;41;"rickiyah";41;0;100
0;5;"rickki";5;0;100
5;0;"rickman";5;100;0
50;0;"ricko";50;100;0
5;0;"ricks";5;100;0
40;0;"rickson";40;100;0
220104;1858;"ricky";221962;99.1629197790613;0.837080220938719
0;33;"rickya";33;0;100
0;16;"rickyah";16;0;100
47;0;"rickye";47;100;0
0;5;"rickyia";5;0;100
5;0;"rickyy";5;100;0
8851;45;"rico";8896;99.494154676259;0.505845323741007
7;0;"ricoh";7;100;0
0;37;"ricole";37;0;100
24;0;"ricquan";24;100;0
0;134;"ricquel";134;0;100
0;5;"ricquita";5;0;100
5;0;"rictavious";5;100;0
0;5;"rictoria";5;0;100
56;812;"rida";868;6.45161290322581;93.5483870967742
6;0;"ridaan";6;100;0
0;16;"ridah";16;0;100
0;485;"riddhi";485;0;100
0;46;"riddhima";46;0;100
6;0;"riddhish";6;100;0
5;0;"riddic";5;100;0
455;0;"riddick";455;100;0
67;0;"riddik";67;100;0
977;0;"rider";977;100;0
3550;0;"ridge";3550;100;0
69;5;"ridgely";74;93.2432432432432;6.75675675675676
15;0;"ridger";15;100;0
11;0;"ridgeway";11;100;0
17;0;"ridgley";17;100;0
6;0;"ridgway";6;100;0
23;49;"ridha";72;31.9444444444444;68.0555555555556
86;0;"ridhaan";86;100;0
0;296;"ridhi";296;0;100
0;143;"ridhima";143;0;100
41;0;"ridhwan";41;100;0
0;11;"ridlee";11;0;100
0;12;"ridleigh";12;0;100
834;445;"ridley";1279;65.2071931196247;34.7928068803753
5;0;"ridwaan";5;100;0
435;22;"ridwan";457;95.1859956236324;4.81400437636762
0;79;"rie";79;0;100
0;21;"rieanna";21;0;100
21;10;"riece";31;67.741935483871;32.258064516129
5;0;"rieker";5;100;0
60;18;"riel";78;76.9230769230769;23.0769230769231
0;17;"rielee";17;0;100
0;5;"rieleigh";5;0;100
111;203;"rieley";314;35.3503184713376;64.6496815286624
0;24;"riella";24;0;100
0;343;"rielle";343;0;100
0;5;"rielley";5;0;100
196;249;"rielly";445;44.0449438202247;55.9550561797753
177;182;"riely";359;49.3036211699164;50.6963788300836
5;183;"rielyn";188;2.65957446808511;97.3404255319149
0;149;"rielynn";149;0;100
96;29;"rien";125;76.8;23.2
0;22;"riena";22;0;100
5;0;"rienhold";5;100;0
0;10;"rienna";10;0;100
44;0;"ries";44;100;0
0;10;"riesa";10;0;100
64;38;"riese";102;62.7450980392157;37.2549019607843
0;15;"riesha";15;0;100
0;20;"rieta";20;0;100
0;28;"rietta";28;0;100
0;10;"rifa";10;0;100
56;0;"rifat";56;100;0
0;629;"rifka";629;0;100
0;390;"rifky";390;0;100
200;48;"rigby";248;80.6451612903226;19.3548387096774
16;0;"rigden";16;100;0
136;0;"rigdon";136;100;0
434;10;"rigel";444;97.7477477477478;2.25225225225225
12;0;"rigg";12;100;0
7;0;"riggan";7;100;0
23;0;"riggen";23;100;0
337;0;"riggin";337;100;0
243;5;"riggins";248;97.9838709677419;2.01612903225806
551;0;"riggs";551;100;0
0;5;"righley";5;0;100
104;10;"righteous";114;91.2280701754386;8.7719298245614
0;7;"rigina";7;0;100
75;26;"rigley";101;74.2574257425743;25.7425742574257
1564;0;"rigo";1564;100;0
10715;7;"rigoberto";10722;99.9347136728222;0.0652863271777653
37;0;"rigoverto";37;100;0
17;0;"rigsby";17;100;0
6;0;"rigved";6;100;0
0;15;"riha";15;0;100
129;0;"rihaan";129;100;0
0;5;"rihab";5;0;100
0;82;"riham";82;0;100
75;39;"rihan";114;65.7894736842105;34.2105263157895
0;591;"rihana";591;0;100
5;5369;"rihanna";5374;0.0930405656866394;99.9069594343134
0;20;"rihannah";20;0;100
12;0;"rihansh";12;100;0
10;0;"rihcard";10;100;0
0;12;"riho";12;0;100
0;42;"rihonna";42;0;100
10;0;"riis";10;100;0
0;28;"rija";28;0;100
10;0;"rijad";10;100;0
0;5;"rijja";5;0;100
20;0;"rijul";20;100;0
278;0;"rik";278;100;0
0;525;"rika";525;0;100
0;10;"rikako";10;0;100
17;0;"rikardo";17;100;0
0;83;"rikayla";83;0;100
0;5;"rikeisha";5;0;100
5;0;"rikelme";5;100;0
6;0;"riken";6;100;0
591;0;"riker";591;100;0
6;0;"rikesh";6;100;0
0;23;"rikesha";23;0;100
0;5;"riketa";5;0;100
0;5;"rikhia";5;0;100
35;0;"rikhil";35;100;0
428;1125;"riki";1553;27.5595621377978;72.4404378622022
0;110;"rikia";110;0;100
0;5;"rikiah";5;0;100
10;0;"rikin";10;100;0
5;0;"rikio";5;100;0
0;17;"rikisha";17;0;100
10;6;"rikishi";16;62.5;37.5
0;93;"rikita";93;0;100
0;49;"rikiya";49;0;100
0;48;"rikiyah";48;0;100
0;54;"rikka";54;0;100
0;16;"rikke";16;0;100
626;6657;"rikki";7283;8.59535905533434;91.4046409446657
0;53;"rikkia";53;0;100
0;20;"rikkie";20;0;100
0;7;"rikkilee";7;0;100
0;5;"rikkilynn";5;0;100
0;6;"rikkita";6;0;100
0;5;"rikku";5;0;100
5;0;"rikky";5;100;0
40;73;"riko";113;35.3982300884956;64.6017699115044
315;0;"riku";315;100;0
24;0;"rikuto";24;100;0
35;0;"riky";35;100;0
0;7;"rikya";7;0;100
0;5;"rikyah";5;0;100
0;5;"rilah";5;0;100
169;15;"rilan";184;91.8478260869565;8.15217391304348
12;0;"riland";12;100;0
0;315;"rilda";315;0;100
0;80;"rilea";80;0;100
0;6;"rileah";6;0;100
351;2715;"rilee";3066;11.4481409001957;88.5518590998043
0;71;"rilei";71;0;100
50;3359;"rileigh";3409;1.46670577882077;98.5332942211792
103;0;"rilen";103;100;0
90472;94493;"riley";184965;48.9130376017084;51.0869623982916
0;141;"rileyann";141;0;100
0;30;"rileyanne";30;0;100
0;6;"rileymae";6;0;100
0;7;"rileyn";7;0;100
0;241;"rilie";241;0;100
0;7;"riliegh";7;0;100
0;1979;"rilla";1979;0;100
69;61;"rilley";130;53.0769230769231;46.9230769230769
0;11;"rillia";11;0;100
0;51;"rillie";51;0;100
0;5;"rilma";5;0;100
16;6;"rilo";22;72.7272727272727;27.2727272727273
0;5;"riloh";5;0;100
10;0;"rilwan";10;100;0
16;58;"rily";74;21.6216216216216;78.3783783783784
0;61;"rilya";61;0;100
109;848;"rilyn";957;11.3897596656217;88.6102403343783
46;1869;"rilynn";1915;2.40208877284595;97.597911227154
0;94;"rilynne";94;0;100
0;75;"rim";75;0;100
0;1392;"rima";1392;0;100
6;0;"rimantas";6;100;0
65;27;"rimas";92;70.6521739130435;29.3478260869565
0;6;"rimi";6;0;100
0;107;"rimsha";107;0;100
0;6;"rimya";6;0;100
0;129;"rin";129;0;100
0;4184;"rina";4184;0;100
0;26;"rinad";26;0;100
0;14;"rinah";14;0;100
722;0;"rinaldo";722;100;0
0;6;"rinata";6;0;100
0;827;"rinda";827;0;100
0;92;"rindi";92;0;100
0;119;"rindy";119;0;100
11;0;"rinehart";11;100;0
0;5;"rinesa";5;0;100
0;5;"rinesha";5;0;100
0;10;"rinette";10;0;100
220;0;"ringo";220;100;0
0;60;"rini";60;0;100
0;11;"riniya";11;0;100
0;58;"riniyah";58;0;100
0;28;"rinka";28;0;100
0;31;"rinley";31;0;100
0;32;"rinna";32;0;100
0;105;"rinnah";105;0;100
5;0;"rinnie";5;100;0
211;5;"rino";216;97.6851851851852;2.31481481481481
0;299;"rinoa";299;0;100
5;0;"rinor";5;100;0
15;0;"rintaro";15;100;0
0;5;"rinya";5;0;100
0;6;"rinyah";6;0;100
2119;1387;"rio";3506;60.4392470051341;39.5607529948659
1170;230;"rion";1400;83.5714285714286;16.4285714285714
0;399;"riona";399;0;100
0;166;"rionna";166;0;100
226;0;"riordan";226;100;0
389;50;"riot";439;88.6104783599089;11.3895216400911
39;0;"riott";39;100;0
192;0;"rip";192;100;0
5;0;"ripal";5;100;0
127;0;"ripken";127;100;0
0;10;"riplee";10;0;100
286;864;"ripley";1150;24.8695652173913;75.1304347826087
0;5;"ripsi";5;0;100
0;25;"riquel";25;0;100
56;0;"riquelme";56;100;0
14;0;"riquelmer";14;100;0
0;19;"riqui";19;0;100
0;4015;"risa";4015;0;100
0;31;"risako";31;0;100
5;1077;"rise";1082;0.462107208872458;99.5378927911275
6;0;"riser";6;100;0
5;0;"rish";5;100;0
0;783;"risha";783;0;100
558;0;"rishaan";558;100;0
559;0;"rishab";559;100;0
802;0;"rishabh";802;100;0
56;0;"rishad";56;100;0
224;0;"rishan";224;100;0
5;0;"rishank";5;100;0
230;0;"rishard";230;100;0
5;0;"rishaun";5;100;0
152;0;"rishav";152;100;0
137;0;"rishawn";137;100;0
3619;0;"rishi";3619;100;0
291;0;"rishik";291;100;0
0;463;"rishika";463;0;100
87;0;"rishikesh";87;100;0
14;0;"rishil";14;100;0
0;6;"rishima";6;0;100
7;0;"rishin";7;100;0
106;0;"rishit";106;100;0
0;140;"rishita";140;0;100
75;0;"rishith";75;100;0
0;18;"rishitha";18;0;100
200;0;"rishon";200;100;0
0;10;"rishona";10;0;100
5;0;"rishvik";5;100;0
0;286;"rissa";286;0;100
0;115;"rissie";115;0;100
0;12;"risten";12;0;100
0;5;"ristin";5;0;100
0;15;"ristina";15;0;100
38;0;"riston";38;100;0
778;281472;"rita";282250;0.275642161204606;99.7243578387954
0;36;"ritaann";36;0;100
0;6;"ritage";6;0;100
0;88;"ritaj";88;0;100
0;41;"rital";41;0;100
0;47;"ritamae";47;0;100
0;122;"ritamarie";122;0;100
0;6;"ritanya";6;0;100
25;0;"ritch";25;100;0
82;0;"ritchard";82;100;0
19;0;"ritchey";19;100;0
3833;50;"ritchie";3883;98.7123358228174;1.28766417718259
5;0;"ritchy";5;100;0
171;0;"ritesh";171;100;0
5;0;"rith";5;100;0
0;140;"ritha";140;0;100
0;19;"rithanya";19;0;100
0;5;"rithi";5;0;100
293;0;"rithik";293;100;0
0;344;"rithika";344;0;100
0;5;"rithu";5;0;100
589;0;"rithvik";589;100;0
0;17;"rithvika";17;0;100
114;0;"rithwik";114;100;0
64;0;"rithy";64;100;0
0;78;"riti";78;0;100
64;0;"ritik";64;100;0
0;532;"ritika";532;0;100
0;69;"ritisha";69;0;100
0;5;"ritney";5;0;100
1427;0;"rito";1427;100;0
0;6;"ritsuko";6;0;100
0;159;"ritta";159;0;100
0;10;"rittal";10;0;100
0;44;"rittany";44;0;100
77;0;"ritter";77;100;0
0;15;"rittie";15;0;100
0;15;"rittney";15;0;100
0;341;"ritu";341;0;100
0;5;"ritvi";5;0;100
420;0;"ritvik";420;100;0
0;15;"ritvika";15;0;100
50;0;"ritwik";50;100;0
0;5;"ritzy";5;0;100
0;5;"riuka";5;0;100
0;1266;"riva";1266;0;100
94;0;"rivaan";94;100;0
220;0;"rivaldo";220;100;0
91;0;"rivan";91;100;0
53;47;"riven";100;53;47
13972;5881;"river";19853;70.3772729562283;29.6227270437717
0;5;"rivera";5;0;100
0;6;"riverlee";6;0;100
0;9;"riverly";9;0;100
0;14;"riverlyn";14;0;100
0;21;"riverlynn";21;0;100
1186;478;"rivers";1664;71.2740384615385;28.7259615384615
10;0;"rives";10;100;0
0;11;"rivian";11;0;100
0;36;"riviera";36;0;100
0;6648;"rivka";6648;0;100
0;937;"rivkah";937;0;100
0;1335;"rivky";1335;0;100
10;0;"rix";10;100;0
34;0;"rixon";34;100;0
25;0;"rixton";25;100;0
0;4431;"riya";4431;0;100
156;24;"riyaan";180;86.6666666666667;13.3333333333333
5;0;"riyaansh";5;100;0
291;0;"riyad";291;100;0
48;0;"riyadh";48;100;0
0;332;"riyah";332;0;100
438;380;"riyan";818;53.5452322738386;46.4547677261614
0;202;"riyana";202;0;100
0;10;"riyann";10;0;100
0;180;"riyanna";180;0;100
125;0;"riyansh";125;100;0
0;36;"riyanshi";36;0;100
0;5;"riyansika";5;0;100
0;13;"riyaq";13;0;100
15;0;"riyaz";15;100;0
0;22;"riylee";22;0;100
19;0;"riyon";19;100;0
0;6;"riyonna";6;0;100
0;51;"riza";51;0;100
5;0;"rizal";5;100;0
0;5;"rizelle";5;0;100
366;0;"rizwan";366;100;0
0;5;"rizwana";5;0;100
0;6;"rizza";6;0;100
7;0;"rizzo";7;100;0
613;0;"rj";613;100;0
67;0;"rjay";67;100;0
15;0;"rl";15;100;0
73;185;"rmani";258;28.2945736434109;71.7054263565892
6;0;"rmon";6;100;0
5;69;"rmoni";74;6.75675675675676;93.2432432432432
0;5;"rmonie";5;0;100
9;0;"rmontay";9;100;0
0;12;"ro";12;0;100
0;31;"roaa";31;0;100
189;0;"roald";189;100;0
5;0;"roam";5;100;0
1566;135;"roan";1701;92.0634920634921;7.93650793650794
16;0;"roanan";16;100;0
5;0;"roandy";5;100;0
31;0;"roane";31;100;0
44;0;"roanin";44;100;0
20;0;"roanld";20;100;0
0;238;"roann";238;0;100
0;440;"roanna";440;0;100
0;396;"roanne";396;0;100
0;5;"roarie";5;0;100
386;0;"roark";386;100;0
261;0;"roarke";261;100;0
41;0;"roary";41;100;0
8676;0;"rob";8676;100;0
0;11;"roba";11;0;100
13;0;"robah";13;100;0
0;7;"robann";7;0;100
23;0;"robart";23;100;0
3185;0;"robb";3185;100;0
23;6;"robbe";29;79.3103448275862;20.6896551724138
85;45;"robben";130;65.3846153846154;34.6153846153846
580;0;"robbert";580;100;0
6;0;"robbey";6;100;0
312;1533;"robbi";1845;16.9105691056911;83.0894308943089
20779;21887;"robbie";42666;48.7015422115971;51.2984577884029
1779;8574;"robbin";10353;17.1834250941756;82.8165749058244
5;0;"robbins";5;100;0
10361;216;"robby";10577;97.9578330339416;2.04216696605843
0;445;"robbye";445;0;100
0;1053;"robbyn";1053;0;100
0;163;"robecca";163;0;100
16;0;"robeert";16;100;0
562;0;"robel";562;100;0
130;314;"roben";444;29.2792792792793;70.7207207207207
0;578;"robena";578;0;100
0;12;"robenia";12;0;100
10;0;"robenson";10;100;0
421;0;"rober";421;100;0
5;0;"robere";5;100;0
5;0;"roberick";5;100;0
11;0;"roberrt";11;100;0
13;0;"roberson";13;100;0
4758955;19808;"robert";4778763;99.5854994273623;0.414500572637731
782;169358;"roberta";170140;0.4596214881862;99.5403785118138
30;0;"robertanthony";30;100;0
5;0;"robertcharles";5;100;0
5;0;"roberte";5;100;0
76;0;"roberth";76;100;0
0;548;"robertha";548;0;100
0;21;"robertia";21;0;100
0;10;"robertina";10;0;100
0;268;"robertine";268;0;100
37;0;"robertjames";37;100;0
45;0;"robertjohn";45;100;0
6;0;"robertjr";6;100;0
76;0;"robertlee";76;100;0
17;0;"robertmichael";17;100;0
106975;835;"roberto";107810;99.2254892867081;0.774510713291902
30;0;"robertocarlos";30;100;0
423;0;"roberts";423;100;0
477;0;"robertson";477;100;0
66;0;"robertt";66;100;0
0;77;"robertta";77;0;100
951;0;"robet";951;100;0
10;0;"robeto";10;100;0
0;12;"robette";12;0;100
139;0;"robey";139;100;0
116;356;"robi";472;24.5762711864407;75.4237288135593
0;20;"robia";20;0;100
1171;637;"robie";1808;64.7676991150443;35.2323008849558
44369;289143;"robin";333512;13.3035692868622;86.6964307131378
0;628;"robina";628;0;100
0;17;"robinann";17;0;100
0;37;"robine";37;0;100
0;10;"robinetta";10;0;100
0;776;"robinette";776;0;100
5;0;"robinho";5;100;0
0;13;"robinique";13;0;100
0;71;"robinn";71;0;100
10;0;"robins";10;100;0
2572;0;"robinson";2572;100;0
0;17;"robiya";17;0;100
10;0;"roble";10;100;0
362;0;"robley";362;100;0
0;59;"roblyn";59;0;100
5;0;"robney";5;100;0
10;0;"robret";10;100;0
5;0;"robrick";5;100;0
22;0;"robroy";22;100;0
22;0;"robrt";22;100;0
5;0;"robsan";5;100;0
111;0;"robson";111;100;0
450;0;"robt";450;100;0
2359;118;"roby";2477;95.2361727896649;4.76382721033508
1171;61533;"robyn";62704;1.86750446542485;98.1324955345751
0;666;"robyne";666;0;100
0;1212;"robynn";1212;0;100
0;358;"robynne";358;0;100
222;0;"roc";222;100;0
22;0;"rocci";22;100;0
26070;5;"rocco";26075;99.9808245445829;0.0191754554170662
0;28;"rocelia";28;0;100
0;6;"rocelin";6;0;100
0;37;"rocelyn";37;0;100
236;0;"roch";236;100;0
0;5;"rochan";5;0;100
0;62;"rochanda";62;0;100
5;0;"rochard";5;100;0
26;15;"roche";41;63.4146341463415;36.5853658536585
0;15;"rocheal";15;0;100
0;2994;"rochel";2994;0;100
0;512;"rochele";512;0;100
92;1619;"rochell";1711;5.37697253068381;94.6230274693162
0;253;"rochella";253;0;100
401;46672;"rochelle";47073;0.851868374652136;99.1481316253479
0;5;"rochelly";5;0;100
0;11;"rochely";11;0;100
463;0;"rochester";463;100;0
5;5;"rochon";10;50;50
5;0;"rochus";5;100;0
426;12708;"rocio";13134;3.24349017816355;96.7565098218365
2517;0;"rock";2517;100;0
46;0;"rocke";46;100;0
19;0;"rockeem";19;100;0
0;211;"rockell";211;0;100
0;234;"rockelle";234;0;100
5;0;"rocker";5;100;0
179;18;"rocket";197;90.8629441624365;9.13705583756345
934;0;"rockey";934;100;0
608;0;"rockford";608;100;0
5;5;"rocki";10;50;50
929;66;"rockie";995;93.3668341708543;6.63316582914573
15;0;"rocklan";15;100;0
175;0;"rockland";175;100;0
86;0;"rocklin";86;100;0
24;71;"rocklyn";95;25.2631578947368;74.7368421052632
0;19;"rocklynn";19;0;100
399;0;"rockne";399;100;0
109;0;"rockney";109;100;0
154;0;"rocko";154;100;0
5;0;"rockson";5;100;0
6;0;"rockston";6;100;0
1022;0;"rockwell";1022;100;0
25954;209;"rocky";26163;99.20116194626;0.798838053740014
0;113;"rocquel";113;0;100
0;82;"rocsi";82;0;100
118;0;"roczen";118;100;0
8735;0;"rod";8735;100;0
0;96;"roda";96;0;100
0;5;"rodaina";5;0;100
0;5;"rodaisha";5;0;100
145;0;"rodarius";145;100;0
0;19;"rodas";19;0;100
771;0;"rodd";771;100;0
11;0;"roddell";11;100;0
232;0;"rodderick";232;100;0
12;0;"roddey";12;100;0
12;0;"roddick";12;100;0
303;5;"roddie";308;98.3766233766234;1.62337662337662
6;0;"roddney";6;100;0
836;0;"roddrick";836;100;0
2494;0;"roddy";2494;100;0
5;0;"rodeen";5;100;0
97;0;"rodel";97;100;0
807;11;"rodell";818;98.6552567237164;1.34474327628362
0;49;"rodella";49;0;100
0;17;"rodena";17;0;100
23;0;"rodeny";23;100;0
2290;0;"roderic";2290;100;0
0;135;"roderica";135;0;100
16;0;"roderich";16;100;0
46051;263;"roderick";46314;99.4321371507535;0.567862849246448
0;25;"rodericka";25;0;100
5;0;"rodericus";5;100;0
5;0;"roderiquez";5;100;0
46;0;"roderrick";46;100;0
161;0;"rodert";161;100;0
0;57;"rodessa";57;0;100
21384;0;"rodger";21384;100;0
110;0;"rodgerick";110;100;0
541;0;"rodgers";541;100;0
5;0;"rodick";5;100;0
10;15;"rodie";25;40;60
24;0;"rodin";24;100;0
0;95;"rodina";95;0;100
11;0;"rodion";11;100;0
0;16;"rodjanae";16;0;100
5;0;"rodley";5;100;0
1321;0;"rodman";1321;100;0
0;6;"rodna";6;0;100
5;0;"rodne";5;100;0
0;10;"rodnecia";10;0;100
10;0;"rodnee";10;100;0
0;174;"rodneisha";174;0;100
0;11;"rodneka";11;0;100
5;0;"rodnell";5;100;0
49;0;"rodner";49;100;0
0;225;"rodnesha";225;0;100
0;75;"rodneshia";75;0;100
0;7;"rodnesia";7;0;100
244707;1176;"rodney";245883;99.52172374666;0.478276253340003
0;5;"rodneysha";5;0;100
41;0;"rodnie";41;100;0
0;35;"rodnika";35;0;100
0;69;"rodnisha";69;0;100
60;0;"rodny";60;100;0
32458;83;"rodolfo";32541;99.7449371562029;0.255062843797056
189;0;"rodolph";189;100;0
146;0;"rodolphe";146;100;0
29;0;"rodolpho";29;100;0
0;5;"rodonna";5;0;100
5;0;"rodre";5;100;0
70;0;"rodrecus";70;100;0
49;0;"rodregus";49;100;0
11;0;"rodrekus";11;100;0
0;10;"rodrianna";10;0;100
489;0;"rodric";489;100;0
0;13;"rodrica";13;0;100
5;0;"rodricas";5;100;0
8620;5;"rodrick";8625;99.9420289855072;0.0579710144927536
0;53;"rodricka";53;0;100
63;0;"rodrickus";63;100;0
60;0;"rodrico";60;100;0
279;0;"rodricus";279;100;0
22643;5;"rodrigo";22648;99.977922995408;0.022077004592017
39;0;"rodrigue";39;100;0
105;0;"rodrigues";105;100;0
944;5;"rodriguez";949;99.4731296101159;0.526870389884089
50;0;"rodrigus";50;100;0
5;0;"rodrik";5;100;0
0;6;"rodrika";6;0;100
5;0;"rodrion";5;100;0
18;0;"rodrique";18;100;0
226;0;"rodriques";226;100;0
1502;0;"rodriquez";1502;100;0
5;0;"rodson";5;100;0
339;0;"rody";339;100;0
740;107;"roe";847;87.3671782762692;12.6328217237308
0;5;"roeberta";5;0;100
0;11;"roechelle";11;0;100
56;0;"roee";56;100;0
4256;0;"roel";4256;100;0
243;0;"roemello";243;100;0
431;41;"roen";472;91.3135593220339;8.6864406779661
0;915;"roena";915;0;100
0;35;"roene";35;0;100
0;5;"roenia";5;0;100
24;0;"roert";24;100;0
0;6;"roesha";6;0;100
0;27;"roetta";27;0;100
64;0;"roey";64;100;0
1299;58;"rogan";1357;95.725865880619;4.27413411938099
5;0;"rogar";5;100;0
10;0;"rogel";10;100;0
0;25;"rogelia";25;0;100
23968;66;"rogelio";24034;99.7253890322044;0.274610967795623
79;0;"rogen";79;100;0
0;226;"rogena";226;0;100
5;806;"rogene";811;0.61652281134402;99.383477188656
0;96;"rogenia";96;0;100
437843;1689;"roger";439532;99.6157276375782;0.384272362421849
152;0;"rogerick";152;100;0
533;0;"rogerio";533;100;0
6882;21;"rogers";6903;99.6957844415471;0.304215558452847
5;0;"roget";5;100;0
10;0;"roggie";10;100;0
21;0;"rogie";21;100;0
0;187;"rogina";187;0;100
230;285;"rogue";515;44.6601941747573;55.3398058252427
0;33;"roha";33;0;100
171;0;"rohaan";171;100;0
101;0;"rohail";101;100;0
6;0;"roham";6;100;0
9271;21;"rohan";9292;99.7739991390443;0.226000860955661
0;22;"rohana";22;0;100
14;0;"rohanpreet";14;100;0
151;0;"rohen";151;100;0
86;0;"rohil";86;100;0
338;0;"rohin";338;100;0
0;301;"rohini";301;0;100
1832;0;"rohit";1832;100;0
283;0;"rohith";283;100;0
0;5;"rohma";5;0;100
5;0;"rohman";5;100;0
393;0;"rohn";393;100;0
44;0;"rohnan";44;100;0
0;54;"rohnda";54;0;100
37;0;"rohun";37;100;0
176;51;"roi";227;77.5330396475771;22.4669603524229
0;10;"roiann";10;0;100
0;5;"roianne";5;0;100
0;6;"roine";6;0;100
0;67;"roise";67;0;100
0;613;"roisin";613;0;100
0;115;"roiza";115;0;100
0;260;"roizy";260;0;100
11;0;"rojan";11;100;0
0;216;"rojean";216;0;100
2891;0;"rojelio";2891;100;0
18;0;"rokas";18;100;0
0;32;"rokaya";32;0;100
5;0;"rokeem";5;100;0
0;36;"rokeisha";36;0;100
0;17;"rokesha";17;0;100
0;16;"rokeshia";16;0;100
0;11;"rokeya";11;0;100
0;102;"rokhaya";102;0;100
0;92;"rokia";92;0;100
0;5;"rokiatou";5;0;100
0;41;"rokisha";41;0;100
0;5;"rokiya";5;0;100
10;0;"rokko";10;100;0
38;0;"roko";38;100;0
0;38;"roksana";38;0;100
0;136;"rola";136;0;100
0;10;"rolaine";10;0;100
876;0;"rolan";876;100;0
95255;362;"roland";95617;99.6214062352929;0.378593764707113
31;3385;"rolanda";3416;0.907494145199063;99.0925058548009
5;0;"rolandas";5;100;0
0;467;"rolande";467;0;100
22944;78;"rolando";23022;99.6611936408653;0.338806359134741
0;45;"rolayne";45;0;100
274;0;"roldan";274;100;0
180;0;"rolen";180;100;0
0;70;"rolena";70;0;100
0;354;"rolene";354;0;100
20;0;"roley";20;100;0
3073;0;"rolf";3073;100;0
543;0;"rolfe";543;100;0
244;0;"rolin";244;100;0
0;462;"rolinda";462;0;100
0;11;"roline";11;0;100
0;18;"rolisha";18;0;100
1026;65;"rolla";1091;94.0421631530706;5.95783684692942
223;0;"rollan";223;100;0
9420;5;"rolland";9425;99.946949602122;0.0530503978779841
0;68;"rollande";68;0;100
327;0;"rollen";327;100;0
0;32;"rollene";32;0;100
29;0;"rolley";29;100;0
3132;24;"rollie";3156;99.2395437262358;0.760456273764259
5396;0;"rollin";5396;100;0
308;14;"rollins";322;95.6521739130435;4.34782608695652
775;0;"rollo";775;100;0
6;0;"rollon";6;100;0
421;0;"rolly";421;100;0
71;0;"rollyn";71;100;0
6;0;"rolman";6;100;0
0;484;"rolonda";484;0;100
84;0;"rolondo";84;100;0
5;0;"rolph";5;100;0
5;0;"rolston";5;100;0
0;7;"rolunda";7;0;100
7;0;"roly";7;100;0
8;0;"rolyn";8;100;0
28;0;"rom";28;100;0
511;7300;"roma";7811;6.54205607476635;93.4579439252336
10;0;"romaan";10;100;0
488;5;"romain";493;98.9858012170385;1.01419878296146
945;3103;"romaine";4048;23.3448616600791;76.655138339921
0;37;"romaisa";37;0;100
10;0;"romal";10;100;0
0;10;"romalda";10;0;100
129;0;"romaldo";129;100;0
27;0;"romale";27;100;0
5;0;"romalis";5;100;0
60434;251;"roman";60685;99.5863887286809;0.413611271319107
0;1673;"romana";1673;0;100
52;0;"romance";52;100;0
0;106;"romanda";106;0;100
39;0;"romando";39;100;0
32;0;"romane";32;100;0
56;31;"romani";87;64.367816091954;35.632183908046
0;45;"romania";45;0;100
0;72;"romanita";72;0;100
308;0;"romano";308;100;0
12;0;"romanus";12;100;0
183;0;"romar";183;100;0
10;0;"romare";10;100;0
46;0;"romari";46;100;0
915;0;"romario";915;100;0
39;0;"romarion";39;100;0
37;0;"romaro";37;100;0
55;0;"romas";55;100;0
17;1118;"romayne";1135;1.49779735682819;98.5022026431718
2075;125;"rome";2200;94.3181818181818;5.68181818181818
0;11;"romee";11;0;100
0;19;"romeesa";19;0;100
0;6;"romeisha";6;0;100
0;77;"romeka";77;0;100
2139;0;"romel";2139;100;0
0;54;"romelda";54;0;100
0;1499;"romelia";1499;0;100
28;0;"romelio";28;100;0
1282;98;"romell";1380;92.8985507246377;7.10144927536232
0;10;"romella";10;0;100
144;338;"romelle";482;29.8755186721992;70.1244813278008
1705;0;"romello";1705;100;0
10;0;"romellow";10;100;0
706;0;"romelo";706;100;0
321;0;"romen";321;100;0
17630;0;"romeo";17630;100;0
50;0;"romer";50;100;0
25;0;"romere";25;100;0
1501;0;"romero";1501;100;0
0;79;"romesha";79;0;100
0;13;"romeshia";13;0;100
0;34;"rometta";34;0;100
303;106;"romey";409;74.0831295843521;25.9168704156479
36;576;"romi";612;5.88235294117647;94.1176470588235
0;5;"romia";5;0;100
0;11;"romiah";11;0;100
1637;436;"romie";2073;78.9676796912687;21.0323203087313
0;27;"romika";27;0;100
29;0;"romil";29;100;0
0;5;"romila";5;0;100
0;358;"romilda";358;0;100
0;25;"romilly";25;0;100
93;0;"romin";93;100;0
0;3007;"romina";3007;0;100
0;7;"rominna";7;0;100
40;0;"romio";40;100;0
140;0;"romir";140;100;0
5;0;"romit";5;100;0
0;6;"romita";6;0;100
0;12;"romiya";12;0;100
0;19;"romiyah";19;0;100
1341;0;"rommel";1341;100;0
51;0;"rommell";51;100;0
599;0;"rommie";599;100;0
36;9;"rommy";45;80;20
249;48;"romney";297;83.8383838383838;16.1616161616162
0;56;"romola";56;0;100
245;0;"romolo";245;100;0
356;0;"romon";356;100;0
0;5149;"romona";5149;0;100
66;0;"romond";66;100;0
0;101;"romonda";101;0;100
28;0;"romondo";28;100;0
187;0;"romone";187;100;0
0;154;"romonia";154;0;100
0;37;"romonica";37;0;100
154;0;"romuald";154;100;0
380;0;"romualdo";380;100;0
772;0;"romulo";772;100;0
291;0;"romulus";291;100;0
0;54;"romunda";54;0;100
6;0;"romus";6;100;0
177;1647;"romy";1824;9.70394736842105;90.2960526315789
0;33;"romya";33;0;100
79;0;"romyn";79;100;0
0;5;"romyna";5;0;100
36037;70;"ron";36107;99.8061317750021;0.193868224997923
0;5310;"rona";5310;0;100
0;36;"ronada";36;0;100
0;163;"ronae";163;0;100
0;15;"ronaele";15;0;100
850;6;"ronak";856;99.2990654205608;0.700934579439252
1443;0;"ronal";1443;100;0
1077045;3849;"ronald";1080894;99.6439058779122;0.356094122087827
0;277;"ronalda";277;0;100
30;0;"ronaldinho";30;100;0
11;0;"ronaldino";11;100;0
5244;0;"ronaldo";5244;100;0
0;216;"ronalee";216;0;100
0;5;"ronalie";5;0;100
0;44;"ronalyn";44;0;100
9185;90;"ronan";9275;99.0296495956873;0.970350404312669
0;97;"ronasia";97;0;100
0;39;"ronata";39;0;100
210;0;"ronav";210;100;0
0;5;"ronaya";5;0;100
359;34300;"ronda";34659;1.03580599555671;98.9641940044433
1863;0;"rondal";1863;100;0
21;0;"rondald";21;100;0
503;0;"rondale";503;100;0
751;0;"rondall";751;100;0
0;8;"rondallyn";8;0;100
0;136;"rondalyn";136;0;100
15;0;"rondarious";15;100;0
205;0;"rondarius";205;100;0
14;0;"ronde";14;100;0
0;5;"rondee";5;0;100
454;0;"rondel";454;100;0
2665;67;"rondell";2732;97.5475841874085;2.45241581259151
0;6;"rondella";6;0;100
6;13;"rondelle";19;31.5789473684211;68.4210526315789
5;0;"ronderick";5;100;0
233;0;"rondey";233;100;0
5;0;"rondez";5;100;0
7;595;"rondi";602;1.16279069767442;98.8372093023256
0;71;"rondia";71;0;100
31;5;"rondie";36;86.1111111111111;13.8888888888889
159;0;"rondle";159;100;0
65;0;"rondo";65;100;0
5;0;"rondol";5;100;0
40;0;"rondre";40;100;0
78;0;"rondrick";78;100;0
407;0;"rondy";407;100;0
15;0;"rone";15;100;0
0;20;"ronea";20;0;100
5;0;"roneal";5;100;0
0;36;"ronecia";36;0;100
0;410;"ronee";410;0;100
0;15;"roneesha";15;0;100
0;5;"roneika";5;0;100
5;0;"roneil";5;100;0
0;573;"roneisha";573;0;100
0;134;"roneka";134;0;100
0;5;"ronekia";5;0;100
459;6;"ronel";465;98.7096774193548;1.29032258064516
0;11;"ronelda";11;0;100
1548;326;"ronell";1874;82.6040554962647;17.3959445037353
0;63;"ronella";63;0;100
69;588;"ronelle";657;10.5022831050228;89.4977168949772
580;0;"ronen";580;100;0
0;773;"ronesha";773;0;100
0;257;"roneshia";257;0;100
0;15;"ronesia";15;0;100
0;7;"ronessa";7;0;100
0;703;"ronetta";703;0;100
0;951;"ronette";951;0;100
860;5;"roney";865;99.4219653179191;0.578034682080925
714;4537;"roni";5251;13.5974100171396;86.4025899828604
0;178;"ronia";178;0;100
0;21;"roniah";21;0;100
0;1280;"ronica";1280;0;100
0;41;"ronice";41;0;100
0;27;"ronicia";27;0;100
0;11;"ronicka";11;0;100
253;220;"ronie";473;53.4883720930233;46.5116279069767
0;28;"roniece";28;0;100
103;0;"roniel";103;100;0
0;178;"roniesha";178;0;100
6;0;"ronik";6;100;0
0;502;"ronika";502;0;100
5;0;"ronil";5;100;0
4271;72;"ronin";4343;98.3421597973751;1.65784020262491
0;67;"roniqua";67;0;100
10;329;"ronique";339;2.94985250737463;97.0501474926254
0;24;"ronise";24;0;100
0;1403;"ronisha";1403;0;100
0;10;"ronishia";10;0;100
0;13;"ronisue";13;0;100
471;328;"ronit";799;58.9486858573216;41.0513141426783
0;713;"ronita";713;0;100
119;0;"ronith";119;100;0
0;193;"roniya";193;0;100
0;204;"roniyah";204;0;100
0;25;"ronja";25;0;100
0;5;"ronke";5;0;100
17;0;"ronld";17;100;0
5;0;"ronmel";5;100;0
656;0;"ronn";656;100;0
0;4623;"ronna";4623;0;100
0;114;"ronnae";114;0;100
0;23;"ronnah";23;0;100
33;0;"ronnal";33;100;0
724;0;"ronnald";724;100;0
0;11;"ronnasia";11;0;100
0;5;"ronnay";5;0;100
0;6;"ronnda";6;0;100
67;68;"ronne";135;49.6296296296296;50.3703703703704
0;46;"ronnee";46;0;100
0;74;"ronneisha";74;0;100
0;22;"ronneka";22;0;100
262;0;"ronnel";262;100;0
2261;183;"ronnell";2444;92.5122749590835;7.48772504091653
0;5;"ronnella";5;0;100
7;16;"ronnelle";23;30.4347826086957;69.5652173913043
0;259;"ronnesha";259;0;100
0;28;"ronneshia";28;0;100
0;5;"ronnet";5;0;100
0;61;"ronnett";61;0;100
0;344;"ronnetta";344;0;100
0;749;"ronnette";749;0;100
1499;0;"ronney";1499;100;0
55;3279;"ronni";3334;1.6496700659868;98.3503299340132
0;19;"ronnia";19;0;100
0;134;"ronnica";134;0;100
0;8;"ronnice";8;0;100
180891;7525;"ronnie";188416;96.0061778192935;3.99382218070652
0;5;"ronniece";5;0;100
10;0;"ronniel";10;100;0
0;116;"ronniesha";116;0;100
0;135;"ronnika";135;0;100
0;364;"ronnisha";364;0;100
0;103;"ronnita";103;0;100
0;5;"ronniya";5;0;100
14152;472;"ronny";14624;96.7724288840263;3.22757111597374
10;31;"ronnye";41;24.390243902439;75.609756097561
866;0;"ronold";866;100;0
54;0;"ronon";54;100;0
11;0;"ronreaco";11;100;0
5;0;"ronreco";5;100;0
194;0;"ronrico";194;100;0
0;5;"ronshay";5;0;100
344;0;"ronson";344;100;0
12;0;"ronta";12;100;0
71;0;"rontae";71;100;0
5;0;"rontarius";5;100;0
0;5;"rontasia";5;0;100
0;5;"rontavia";5;0;100
163;0;"rontavious";163;100;0
5;0;"rontavis";5;100;0
51;0;"rontavius";51;100;0
109;0;"ronte";109;100;0
47;0;"rontez";47;100;0
181;0;"rontrell";181;100;0
1639;0;"rony";1639;100;0
0;261;"ronya";261;0;100
0;17;"ronyae";17;0;100
20;0;"ronyn";20;100;0
0;5;"ronza";5;0;100
11;0;"ronzel";11;100;0
87;0;"ronzell";87;100;0
22;0;"roody";22;100;0
0;5;"roohi";5;0;100
261;0;"rook";261;100;0
8;0;"rooke";8;100;0
5;0;"rooks";5;100;0
446;171;"rooney";617;72.2852512155592;27.7147487844408
13;0;"roony";13;100;0
0;48;"roopa";48;0;100
0;5;"roopal";5;0;100
5;0;"rooseve";5;100;0
37284;265;"roosevelt";37549;99.2942555061386;0.705744493861355
288;0;"roosvelt";288;100;0
16;0;"roozbeh";16;100;0
34;0;"rope";34;100;0
348;0;"roper";348;100;0
0;20;"roqaya";20;0;100
21;0;"roquan";21;100;0
2361;0;"roque";2361;100;0
0;68;"roquel";68;0;100
184;0;"roran";184;100;0
0;44;"roree";44;0;100
97;69;"rorey";166;58.433734939759;41.566265060241
17;1942;"rori";1959;0.867789688616641;99.1322103113834
5;0;"roric";5;100;0
11;0;"rorick";11;100;0
5;596;"rorie";601;0.831946755407654;99.1680532445923
86;0;"rorik";86;100;0
28;0;"rorke";28;100;0
0;6;"rorrie";6;0;100
21;0;"rorry";21;100;0
24975;5963;"rory";30938;80.7259680651626;19.2740319348374
1145;159141;"rosa";160286;0.714348102766305;99.2856518972337
0;10;"rosaangelica";10;0;100
0;478;"rosabel";478;0;100
0;269;"rosabell";269;0;100
0;570;"rosabella";570;0;100
0;1029;"rosabelle";1029;0;100
0;63;"rosaelena";63;0;100
0;28;"rosaelia";28;0;100
0;16;"rosaicela";16;0;100
0;17;"rosaida";17;0;100
327;10;"rosaire";337;97.0326409495549;2.9673590504451
0;444;"rosaisela";444;0;100
0;5;"rosala";5;0;100
0;344;"rosaland";344;0;100
0;2747;"rosalba";2747;0;100
0;6;"rosale";6;0;100
0;576;"rosalea";576;0;100
0;47;"rosaleah";47;0;100
0;5;"rosalean";5;0;100
0;10102;"rosalee";10102;0;100
0;949;"rosaleen";949;0;100
0;10;"rosalei";10;0;100
0;322;"rosaleigh";322;0;100
0;163;"rosalena";163;0;100
0;446;"rosalene";446;0;100
0;5;"rosaleta";5;0;100
0;21;"rosaley";21;0;100
0;136;"rosali";136;0;100
0;7106;"rosalia";7106;0;100
96;68492;"rosalie";68588;0.13996617484108;99.8600338251589
0;775;"rosalin";775;0;100
0;3268;"rosalina";3268;0;100
0;25467;"rosalind";25467;0;100
5;14746;"rosalinda";14751;0.0338960070503695;99.9661039929496
0;51;"rosalinde";51;0;100
0;3418;"rosaline";3418;0;100
10;0;"rosalino";10;100;0
1979;5;"rosalio";1984;99.7479838709677;0.252016129032258
0;267;"rosalita";267;0;100
0;6;"rosaliyah";6;0;100
0;5;"rosaliz";5;0;100
0;5;"rosalla";5;0;100
0;15;"rosalua";15;0;100
0;2110;"rosalva";2110;0;100
0;340;"rosaly";340;0;100
0;20605;"rosalyn";20605;0;100
0;6;"rosalyna";6;0;100
0;108;"rosalynd";108;0;100
0;51;"rosalynda";51;0;100
0;27;"rosalyne";27;0;100
0;2256;"rosalynn";2256;0;100
0;44;"rosalynne";44;0;100
0;112;"rosamae";112;0;100
0;1888;"rosamaria";1888;0;100
0;40;"rosamarie";40;0;100
0;195;"rosamary";195;0;100
0;5;"rosamay";5;0;100
6;3079;"rosamond";3085;0.194489465153971;99.805510534846
0;5;"rosamonde";5;0;100
0;43;"rosamund";43;0;100
0;102;"rosan";102;0;100
0;2446;"rosana";2446;0;100
0;5;"rosandra";5;0;100
0;10;"rosane";10;0;100
0;5;"rosanell";5;0;100
0;49;"rosangel";49;0;100
0;331;"rosangela";331;0;100
0;150;"rosangelica";150;0;100
0;2903;"rosann";2903;0;100
6;13599;"rosanna";13605;0.0441014332965821;99.9558985667034
5;14660;"rosanne";14665;0.0340947834981248;99.9659052165019
0;18;"rosanny";18;0;100
0;2344;"rosaria";2344;0;100
0;21;"rosarie";21;0;100
5412;10304;"rosario";15716;34.4362433189107;65.5637566810893
0;545;"rosary";545;0;100
0;2481;"rosaura";2481;0;100
0;7;"rosaysela";7;0;100
85;0;"rosbel";85;100;0
0;39;"roschell";39;0;100
0;196;"roschelle";196;0;100
1319;0;"rosco";1319;100;0
19683;5;"roscoe";19688;99.9746038195855;0.0253961804144657
1946;447005;"rose";448951;0.433454875921871;99.5665451240781
0;129;"rosea";129;0;100
0;6;"roseabella";6;0;100
0;134;"rosealee";134;0;100
0;93;"rosealie";93;0;100
0;6;"rosealina";6;0;100
0;44;"rosealyn";44;0;100
0;39;"rosealynn";39;0;100
32;5;"rosean";37;86.4864864864865;13.5135135135135
0;88;"roseana";88;0;100
0;5;"roseangela";5;0;100
0;15744;"roseann";15744;0;100
0;5512;"roseanna";5512;0;100
0;7167;"roseanne";7167;0;100
0;30;"rosebell";30;0;100
0;31;"rosebella";31;0;100
0;21;"rosebelle";21;0;100
0;708;"rosebud";708;0;100
0;5;"roseellen";5;0;100
0;11;"rosel";11;0;100
0;56;"rosela";56;0;100
0;122;"roseland";122;0;100
0;81;"roselani";81;0;100
0;45;"roselea";45;0;100
0;18;"roselean";18;0;100
0;1231;"roselee";1231;0;100
0;47;"roseleen";47;0;100
0;6;"roseleigh";6;0;100
0;39;"roselena";39;0;100
0;204;"roselene";204;0;100
0;20;"roseli";20;0;100
0;680;"roselia";680;0;100
0;665;"roselie";665;0;100
0;593;"roselin";593;0;100
0;83;"roselina";83;0;100
0;385;"roselind";385;0;100
0;202;"roselinda";202;0;100
0;1185;"roseline";1185;0;100
12;0;"roselio";12;100;0
28;152;"rosell";180;15.5555555555556;84.4444444444444
5;14619;"rosella";14624;0.0341903719912473;99.9658096280088
0;5;"rosellar";5;0;100
0;1935;"roselle";1935;0;100
0;780;"rosellen";780;0;100
0;8;"rosellie";8;0;100
0;28;"roselma";28;0;100
0;224;"rosely";224;0;100
0;11307;"roselyn";11307;0;100
0;73;"roselyne";73;0;100
0;1569;"roselynn";1569;0;100
0;50;"roselynne";50;0;100
0;101;"rosemae";101;0;100
0;16;"rosemaire";16;0;100
0;35;"rosemari";35;0;100
0;161;"rosemaria";161;0;100
33;50343;"rosemarie";50376;0.0655073844687947;99.9344926155312
0;6;"rosemarry";6;0;100
358;154942;"rosemary";155300;0.230521571152608;99.7694784288474
0;16;"rosemay";16;0;100
0;23;"rosemery";23;0;100
0;10;"rosemma";10;0;100
18;491;"rosemond";509;3.53634577603143;96.4636542239686
0;1251;"rosena";1251;0;100
0;669;"rosenda";669;0;100
5168;0;"rosendo";5168;100;0
0;263;"rosene";263;0;100
0;6;"rosenell";6;0;100
0;5;"rosenia";5;0;100
0;5;"rosenna";5;0;100
0;16;"roser";16;0;100
44;26511;"rosetta";26555;0.165693842967426;99.8343061570326
0;774;"rosette";774;0;100
0;52;"rosetter";52;0;100
0;5;"rosettia";5;0;100
5;0;"rosevell";5;100;0
3074;0;"rosevelt";3074;100;0
0;989;"rosey";989;0;100
0;6;"rosezanna";6;0;100
0;23;"rosezell";23;0;100
0;362;"rosezella";362;0;100
0;6;"rosezena";6;0;100
0;181;"rosezetta";181;0;100
0;18;"rosezina";18;0;100
5;0;"rosh";5;100;0
0;85;"rosha";85;0;100
5;0;"roshaad";5;100;0
239;0;"roshad";239;100;0
0;8;"roshae";8;0;100
1485;124;"roshan";1609;92.2933499067744;7.70665009322561
0;125;"roshana";125;0;100
0;1163;"roshanda";1163;0;100
0;34;"roshandra";34;0;100
13;0;"roshane";13;100;0
0;40;"roshani";40;0;100
0;167;"roshanna";167;0;100
0;5;"roshanta";5;0;100
127;0;"roshard";127;100;0
16;0;"roshaud";16;100;0
386;55;"roshaun";441;87.5283446712018;12.4716553287982
0;166;"roshaunda";166;0;100
881;422;"roshawn";1303;67.6132003069839;32.3867996930161
0;61;"roshawna";61;0;100
0;272;"roshawnda";272;0;100
0;5;"roshay";5;0;100
0;10;"roshea";10;0;100
0;44;"rosheda";44;0;100
6;0;"rosheen";6;100;0
0;36;"rosheena";36;0;100
0;11;"rosheka";11;0;100
12;593;"roshell";605;1.98347107438017;98.0165289256198
0;845;"roshelle";845;0;100
0;22;"roshena";22;0;100
0;15;"roshida";15;0;100
0;10;"roshika";10;0;100
0;5;"roshina";5;0;100
0;69;"roshini";69;0;100
0;965;"roshni";965;0;100
22;0;"roshod";22;100;0
166;60;"roshon";226;73.4513274336283;26.5486725663717
0;1069;"roshonda";1069;0;100
0;14;"roshondra";14;0;100
0;5;"roshonna";5;0;100
65;15;"roshun";80;81.25;18.75
0;589;"roshunda";589;0;100
0;34;"roshundra";34;0;100
0;367;"rosi";367;0;100
0;3274;"rosia";3274;0;100
0;294;"rosibel";294;0;100
0;24;"rosicela";24;0;100
469;74672;"rosie";75141;0.624159912697462;99.3758400873025
0;115;"rosielee";115;0;100
5;0;"rosier";5;100;0
0;5;"rosietta";5;0;100
0;681;"rosiland";681;0;100
0;10;"rosilda";10;0;100
0;36;"rosilee";36;0;100
0;11;"rosilind";11;0;100
0;577;"rosilyn";577;0;100
0;10;"rosilynn";10;0;100
0;4918;"rosina";4918;0;100
0;357;"rosine";357;0;100
19;2460;"rosio";2479;0.766438079870916;99.2335619201291
0;14;"rosisela";14;0;100
0;6408;"rosita";6408;0;100
0;15;"rositta";15;0;100
0;280;"rosland";280;0;100
0;11;"roslie";11;0;100
0;174;"roslin";174;0;100
0;148;"roslind";148;0;100
10;17115;"roslyn";17125;0.0583941605839416;99.9416058394161
0;1053;"roslynn";1053;0;100
0;72;"rosmarie";72;0;100
0;133;"rosmary";133;0;100
0;5;"rosmely";5;0;100
0;51;"rosmeri";51;0;100
0;266;"rosmery";266;0;100
5;0;"rosolino";5;100;0
0;12;"rosolyn";12;0;100
0;5;"rosonda";5;0;100
78777;399;"ross";79176;99.496059411943;0.503940588056987
0;5;"rossalind";5;0;100
0;32;"rossalyn";32;0;100
0;882;"rossana";882;0;100
0;60;"rossanna";60;0;100
8;0;"rossano";8;100;0
0;30;"rosse";30;0;100
0;22;"rosselin";22;0;100
0;22;"rossella";22;0;100
0;242;"rosselyn";242;0;100
148;0;"rosser";148;100;0
0;62;"rossetta";62;0;100
271;236;"rossi";507;53.4516765285996;46.5483234714004
0;17;"rossibell";17;0;100
746;1508;"rossie";2254;33.0967169476486;66.9032830523514
0;624;"rosslyn";624;0;100
0;35;"rosslynn";35;0;100
0;5;"rossmary";5;0;100
10;0;"rosston";10;100;0
7;0;"rosswell";7;100;0
0;462;"rossy";462;0;100
5;0;"rostam";5;100;0
5;0;"rostin";5;100;0
5;0;"rostislav";5;100;0
84;0;"roston";84;100;0
16;0;"rosvelt";16;100;0
1232;0;"roswell";1232;100;0
0;1696;"rosy";1696;0;100
0;5;"rosylin";5;0;100
0;55;"rosyln";55;0;100
0;15;"roszella";15;0;100
0;6;"roszetta";6;0;100
0;42;"rotasha";42;0;100
5;42;"rotem";47;10.6382978723404;89.3617021276596
220;0;"roth";220;100;0
6;148;"rotha";154;3.8961038961039;96.1038961038961
6;5;"rothana";11;54.5454545454545;45.4545454545455
5;0;"rothwell";5;100;0
5;0;"rotimi";5;100;0
0;5;"rotisha";5;0;100
0;48;"rotonda";48;0;100
0;5;"rotonia";5;0;100
0;8;"rotonya";8;0;100
0;104;"rotunda";104;0;100
0;5;"roua";5;0;100
0;5;"rouchelle";5;0;100
10;0;"roudolph";10;100;0
21;0;"roudy";21;100;0
0;5;"rougui";5;0;100
0;12;"rouguiatou";12;0;100
5;0;"roul";5;100;0
0;41;"roula";41;0;100
5;0;"rouldph";5;100;0
11;0;"rounak";11;100;0
245;0;"rourke";245;100;0
0;6;"rousey";6;0;100
12;55;"roux";67;17.910447761194;82.089552238806
0;21;"rovella";21;0;100
0;268;"rovena";268;0;100
0;60;"rovenia";60;0;100
0;6;"roverta";6;0;100
76;0;"roverto";76;100;0
0;11;"rovilla";11;0;100
6;0;"rovin";6;100;0
0;5;"rovina";5;0;100
5;0;"rovon";5;100;0
16711;10640;"rowan";27351;61.0983145040401;38.9016854959599
0;15;"rowana";15;0;100
0;10;"rowann";10;0;100
5;0;"rowden";5;100;0
5;5;"rowdie";10;50;50
3320;10;"rowdy";3330;99.6996996996997;0.3003003003003
272;16;"rowe";288;94.4444444444444;5.55555555555556
51;0;"rowell";51;100;0
2888;1099;"rowen";3987;72.435415099072;27.564584900928
0;9691;"rowena";9691;0;100
0;142;"rowene";142;0;100
0;5;"rowenna";5;0;100
96;7;"rowin";103;93.2038834951456;6.79611650485437
3952;0;"rowland";3952;100;0
30;0;"rowley";30;100;0
6;0;"rownan";6;100;0
0;7;"rowrenia";7;0;100
255;1002;"rowyn";1257;20.2863961813842;79.7136038186158
5;204;"rowynn";209;2.39234449760766;97.6076555023923
5;330;"rox";335;1.49253731343284;98.5074626865672
0;429;"roxan";429;0;100
26;11069;"roxana";11095;0.234339792699414;99.7656602073006
0;5124;"roxane";5124;0;100
0;8824;"roxann";8824;0;100
7;12731;"roxanna";12738;0.0549536818966871;99.9450463181033
55;57829;"roxanne";57884;0.0950176214497961;99.9049823785502
139;0;"roxas";139;100;0
0;16;"roxeann";16;0;100
0;10;"roxeanne";10;0;100
5;0;"roxen";5;100;0
0;100;"roxene";100;0;100
0;35;"roxette";35;0;100
0;38;"roxey";38;0;100
0;394;"roxi";394;0;100
0;27;"roxianne";27;0;100
203;15691;"roxie";15894;1.27721152636215;98.7227884736378
0;5;"roxii";5;0;100
0;238;"roxine";238;0;100
0;55;"roxsana";55;0;100
0;5;"roxsand";5;0;100
0;16;"roxsanne";16;0;100
5;0;"roxton";5;100;0
0;5;"roxxane";5;0;100
0;47;"roxxanne";47;0;100
0;11;"roxxi";11;0;100
102;3207;"roxy";3309;3.08250226654578;96.9174977334542
387444;2574;"roy";390018;99.3400304601326;0.659969539867391
0;1117;"roya";1117;0;100
5;0;"royace";5;100;0
12960;1623;"royal";14583;88.8706027566344;11.1293972433656
309;436;"royale";745;41.4765100671141;58.5234899328859
0;5;"royalene";5;0;100
43;5;"royall";48;89.5833333333333;10.4166666666667
0;17;"royalle";17;0;100
0;6;"royalte";6;0;100
0;21;"royaltee";21;0;100
0;57;"royalti";57;0;100
153;1057;"royalty";1210;12.6446280991736;87.3553719008265
10;0;"royan";10;100;0
0;120;"royann";120;0;100
0;12;"royanna";12;0;100
0;108;"royanne";108;0;100
26657;2066;"royce";28723;92.8071580266685;7.19284197333148
55;0;"royd";55;100;0
854;0;"royden";854;100;0
11;0;"roydon";11;100;0
162;43;"roye";205;79.0243902439024;20.9756097560976
34;11;"royel";45;75.5555555555556;24.4444444444444
0;60;"royelle";60;0;100
222;0;"royer";222;100;0
0;6;"royesha";6;0;100
0;153;"royetta";153;0;100
40;0;"royle";40;100;0
82;0;"roylee";82;100;0
0;365;"roylene";365;0;100
0;6;"roylynn";6;0;100
20;0;"roynell";20;100;0
0;6;"roynesha";6;0;100
26;0;"royse";26;100;0
6;0;"royster";6;100;0
206;0;"royston";206;100;0
37;0;"royzell";37;100;0
0;52;"roz";52;0;100
0;237;"roza";237;0;100
0;21;"rozalee";21;0;100
0;138;"rozalia";138;0;100
0;31;"rozalie";31;0;100
0;16;"rozalin";16;0;100
0;30;"rozalind";30;0;100
0;657;"rozalyn";657;0;100
0;231;"rozalynn";231;0;100
0;47;"rozan";47;0;100
0;36;"rozana";36;0;100
0;283;"rozann";283;0;100
0;378;"rozanna";378;0;100
0;1385;"rozanne";1385;0;100
0;10;"rozaria";10;0;100
5;0;"rozario";5;100;0
20;21;"rozay";41;48.780487804878;51.219512195122
0;13;"roze";13;0;100
5;0;"rozel";5;100;0
0;90;"rozelia";90;0;100
580;350;"rozell";930;62.3655913978495;37.6344086021505
0;2587;"rozella";2587;0;100
33;479;"rozelle";512;6.4453125;93.5546875
0;5;"rozellia";5;0;100
0;60;"rozelyn";60;0;100
5;0;"rozen";5;100;0
0;488;"rozena";488;0;100
0;42;"rozenia";42;0;100
0;5;"rozeta";5;0;100
0;574;"rozetta";574;0;100
0;5;"rozia";5;0;100
0;33;"rozie";33;0;100
16;0;"rozier";16;100;0
0;19;"rozilyn";19;0;100
0;213;"rozina";213;0;100
0;5;"rozine";5;0;100
0;23;"rozita";23;0;100
0;5;"roziya";5;0;100
0;30;"rozlin";30;0;100
0;1057;"rozlyn";1057;0;100
0;510;"rozlynn";510;0;100
0;5;"rozyn";5;0;100
0;12;"rozzie";12;0;100
0;5;"rozzlyn";5;0;100
19;0;"rpbert";19;100;0
0;5;"rreanna";5;0;100
0;6;"rreon";6;0;100
0;16;"rua";16;0;100
0;6;"ruaa";6;0;100
0;40;"ruah";40;0;100
157;0;"ruairi";157;100;0
178;0;"rual";178;100;0
28;0;"ruan";28;100;0
0;5;"ruann";5;0;100
77;112;"ruari";189;40.7407407407407;59.2592592592593
5;0;"ruaridh";5;100;0
14;0;"ruark";14;100;0
0;415;"ruba";415;0;100
0;27;"rubab";27;0;100
11;0;"ruban";11;100;0
0;15;"rubani";15;0;100
16;0;"rubben";16;100;0
0;682;"rubbie";682;0;100
0;365;"rubby";365;0;100
460;0;"rube";460;100;0
0;159;"rubee";159;0;100
151;0;"rubel";151;100;0
0;37;"rubell";37;0;100
0;11;"rubelle";11;0;100
109760;655;"ruben";110415;99.4067834986189;0.593216501381153
0;182;"rubena";182;0;100
0;16;"rubenia";16;0;100
133;0;"rubens";133;100;0
491;0;"rubert";491;100;0
0;82;"ruberta";82;0;100
5;0;"ruberto";5;100;0
0;11;"rubey";11;0;100
14;7272;"rubi";7286;0.192149327477354;99.8078506725226
0;46;"rubia";46;0;100
0;15;"rubiana";15;0;100
0;10;"rubianna";10;0;100
0;36;"rubicela";36;0;100
0;8;"rubicelia";8;0;100
46;4625;"rubie";4671;0.984799828730465;99.0152001712695
6;0;"rubiel";6;100;0
6703;16;"rubin";6719;99.7618693257925;0.238130674207471
0;559;"rubina";559;0;100
5;0;"rubio";5;100;0
0;20;"rubisela";20;0;100
0;19;"rubit";19;0;100
0;24;"rubith";24;0;100
291;65;"ruble";356;81.7415730337079;18.2584269662921
2841;333181;"ruby";336022;0.845480355452917;99.1545196445471
0;156;"rubyann";156;0;100
0;16;"rubyanne";16;0;100
0;6752;"rubye";6752;0;100
0;8;"rubyjane";8;0;100
0;123;"rubylee";123;0;100
0;12;"rubylynn";12;0;100
0;28;"rubymae";28;0;100
5;0;"rubyn";5;100;0
0;15;"rubyrose";15;0;100
0;10;"rubystine";10;0;100
0;12;"ruca";12;0;100
0;96;"rucha";96;0;100
0;199;"ruchama";199;0;100
0;254;"ruchel";254;0;100
0;6;"ruchelle";6;0;100
0;373;"ruchi";373;0;100
0;39;"ruchika";39;0;100
10;0;"ruchir";10;100;0
0;5;"ruchita";5;0;100
0;19;"ruchoma";19;0;100
0;250;"ruchy";250;0;100
107;0;"rucker";107;100;0
8;0;"ruckus";8;100;0
0;5;"rudaina";5;0;100
12;0;"rudalph";12;100;0
10;0;"rudd";10;100;0
14;0;"ruddie";14;100;0
508;5;"ruddy";513;99.0253411306043;0.974658869395711
0;107;"rudean";107;0;100
0;17;"rudee";17;0;100
0;11;"rudeen";11;0;100
394;378;"rudell";772;51.0362694300518;48.9637305699482
0;10;"rudelle";10;0;100
0;222;"rudene";222;0;100
6;0;"rudhra";6;100;0
5;0;"rudhvi";5;100;0
690;378;"rudi";1068;64.6067415730337;35.3932584269663
147;57;"rudie";204;72.0588235294118;27.9411764705882
0;307;"rudine";307;0;100
32;0;"rudis";32;100;0
10;0;"rudloph";10;100;0
2866;0;"rudolf";2866;100;0
2254;0;"rudolfo";2254;100;0
51496;197;"rudolph";51693;99.6189039134892;0.381096086510746
23;0;"rudolphe";23;100;0
384;0;"rudolpho";384;100;0
20;0;"rudolphus";20;100;0
5;0;"rudr";5;100;0
721;11;"rudra";732;98.4972677595628;1.50273224043716
6;0;"rudraksh";6;100;0
44;0;"rudransh";44;100;0
47499;1001;"rudy";48500;97.9360824742268;2.0639175257732
42;0;"rudyard";42;100;0
230;523;"rue";753;30.5444887118194;69.4555112881806
4598;0;"rueben";4598;100;0
6;0;"ruebin";6;100;0
37;0;"rueger";37;100;0
1781;5;"ruel";1786;99.7200447928331;0.279955207166853
0;7;"ruella";7;0;100
0;5;"ruenell";5;0;100
10;64;"ruey";74;13.5135135135135;86.4864864864865
25;0;"rufas";25;100;0
29;0;"rufe";29;100;0
5;0;"rufes";5;100;0
5;0;"ruff";5;100;0
549;0;"ruffin";549;100;0
649;0;"ruffus";649;100;0
0;997;"rufina";997;0;100
1569;0;"rufino";1569;100;0
12;0;"rufio";12;100;0
71;0;"ruford";71;100;0
33237;151;"rufus";33388;99.5477417036061;0.452258296393914
0;5;"rugayyah";5;0;100
0;21;"rugenia";21;0;100
1242;6;"ruger";1248;99.5192307692308;0.480769230769231
0;5;"rugiatu";5;0;100
167;0;"ruhaan";167;100;0
0;81;"ruhama";81;0;100
166;0;"ruhan";166;100;0
0;91;"ruhani";91;0;100
0;49;"ruhee";49;0;100
0;578;"ruhi";578;0;100
0;10;"ruhika";10;0;100
571;20;"rui";591;96.6159052453469;3.38409475465313
6;0;"ruichen";6;100;0
0;406;"ruie";406;0;100
0;5;"ruiqi";5;0;100
5;0;"ruiz";5;100;0
5;0;"rujul";5;100;0
0;5;"rujuta";5;0;100
0;7;"ruka";7;0;100
0;5;"rukaiya";5;0;100
0;5;"rukaiyah";5;0;100
0;57;"rukaya";57;0;100
0;11;"rukayat";11;0;100
0;12;"rukhsar";12;0;100
0;104;"rukia";104;0;100
0;282;"rukiya";282;0;100
0;12;"rukmini";12;0;100
0;148;"rula";148;0;100
1031;0;"rulon";1031;100;0
0;141;"rumaisa";141;0;100
0;55;"rumalda";55;0;100
776;0;"rumaldo";776;100;0
0;10;"ruman";10;0;100
0;10;"rumana";10;0;100
0;167;"rumaysa";167;0;100
0;12;"rumaysah";12;0;100
73;0;"rumeal";73;100;0
0;6;"rumell";6;0;100
0;46;"rumer";46;0;100
141;141;"rumi";282;50;50
0;10;"rumina";10;0;100
0;5;"rumonda";5;0;100
0;55;"rumor";55;0;100
6;0;"rumsey";6;100;0
0;125;"runa";125;0;100
28;5;"runako";33;84.8484848484848;15.1515151515152
7;0;"runar";7;100;0
0;7;"rund";7;0;100
0;10;"runda";10;0;100
5;0;"rundy";5;100;0
254;22;"rune";276;92.0289855072464;7.97101449275362
0;174;"runell";174;0;100
0;38;"runelle";38;0;100
0;117;"runette";117;0;100
12;0;"runnie";12;100;0
5;0;"ruot";5;100;0
0;16;"ruoxi";16;0;100
0;153;"rupa";153;0;100
0;201;"rupal";201;0;100
0;27;"rupali";27;0;100
5;0;"rupen";5;100;0
5103;16;"rupert";5119;99.6874389529205;0.312561047079508
0;50;"ruperta";50;0;100
1011;0;"ruperto";1011;100;0
22;0;"rupesh";22;100;0
0;37;"rupinder";37;0;100
31;0;"ruppert";31;100;0
0;11;"ruqaiya";11;0;100
0;45;"ruqaiyah";45;0;100
0;82;"ruqaya";82;0;100
0;29;"ruqayah";29;0;100
0;68;"ruqayya";68;0;100
0;339;"ruqayyah";339;0;100
0;41;"ruqiya";41;0;100
18;0;"rural";18;100;0
11;0;"rurik";11;100;0
47;0;"rury";47;100;0
11;20;"rus";31;35.4838709677419;64.5161290322581
52;0;"rusbel";52;100;0
62;0;"rusell";62;100;0
2272;0;"rush";2272;100;0
0;17;"rusha";17;0;100
49;0;"rushabh";49;100;0
5;0;"rushad";5;100;0
6;0;"rushan";6;100;0
5;0;"rushank";5;100;0
93;0;"rushawn";93;100;0
0;20;"rushda";20;0;100
0;39;"rushell";39;0;100
0;44;"rushelle";44;0;100
234;0;"rushi";234;100;0
0;22;"rushia";22;0;100
0;246;"rushie";246;0;100
0;22;"rushika";22;0;100
519;0;"rushil";519;100;0
16;0;"rushon";16;100;0
103;0;"rushton";103;100;0
5;0;"rushun";5;100;0
10;0;"ruskin";10;100;0
399;0;"ruslan";399;100;0
0;6;"ruslana";6;0;100
5983;0;"russ";5983;100;0
0;5;"russchell";5;0;100
0;24;"russchelle";24;0;100
16083;12;"russel";16095;99.9254426840634;0.0745573159366263
348290;1676;"russell";349966;99.5210963350725;0.47890366492745
0;46;"russella";46;0;100
6;0;"russelle";6;100;0
0;99;"russia";99;0;100
0;86;"russie";86;0;100
28;0;"rustam";28;100;0
11;0;"rustan";11;100;0
26;0;"rusten";26;100;0
0;350;"rusti";350;0;100
0;44;"rustie";44;0;100
2444;0;"rustin";2444;100;0
0;22;"rustina";22;0;100
636;0;"ruston";636;100;0
17476;557;"rusty";18033;96.9112183219653;3.08878167803471
129;0;"rustyn";129;100;0
0;692;"rut";692;0;100
0;305;"ruta";305;0;100
263;0;"rutger";263;100;0
2662;784166;"ruth";786828;0.33832044614579;99.6616795538542
0;2720;"rutha";2720;0;100
0;6;"ruthalee";6;0;100
0;21;"ruthan";21;0;100
0;6856;"ruthann";6856;0;100
0;725;"ruthanna";725;0;100
0;2542;"ruthanne";2542;0;100
0;1937;"ruthe";1937;0;100
0;153;"ruthel";153;0;100
0;234;"ruthell";234;0;100
0;262;"ruthella";262;0;100
0;17;"ruthelle";17;0;100
0;171;"ruthellen";171;0;100
0;36;"ruthelma";36;0;100
0;11;"ruthena";11;0;100
0;60;"ruthene";60;0;100
6;601;"ruther";607;0.988467874794069;99.0115321252059
623;0;"rutherford";623;100;0
0;83;"ruthetta";83;0;100
0;11;"ruthey";11;0;100
35;0;"ruthford";35;100;0
0;28;"ruthi";28;0;100
0;122;"ruthia";122;0;100
32;20294;"ruthie";20326;0.157433828593919;99.8425661714061
0;24;"ruthine";24;0;100
0;5;"ruthlee";5;0;100
0;5;"ruthlene";5;0;100
0;21;"ruthmae";21;0;100
0;36;"ruthmarie";36;0;100
0;214;"ruthmary";214;0;100
72;0;"ruthvik";72;100;0
0;13;"ruthvika";13;0;100
0;847;"ruthy";847;0;100
0;5;"ruthye";5;0;100
0;16;"rutila";16;0;100
77;0;"rutilio";77;100;0
213;0;"rutledge";213;100;0
0;10;"rutu";10;0;100
0;6;"rutva";6;0;100
0;16;"rutvi";16;0;100
16;0;"rutvik";16;100;0
107;0;"ruven";107;100;0
0;68;"ruvi";68;0;100
518;0;"ruvim";518;100;0
0;28;"ruwaida";28;0;100
0;115;"ruwayda";115;0;100
0;103;"ruweyda";103;0;100
102;0;"ruxin";102;100;0
11;0;"ruxton";11;100;0
24;0;"ruy";24;100;0
0;26;"ruya";26;0;100
0;5;"ruzanna";5;0;100
31;0;"ruzgar";31;100;0
0;25;"rwan";25;0;100
0;10;"rwanda";10;0;100
359;0;"ry";359;100;0
19;962;"rya";981;1.93679918450561;98.0632008154944
136;0;"ryaan";136;100;0
5;0;"ryad";5;100;0
0;786;"ryah";786;0;100
5;0;"ryahn";5;100;0
917161;22133;"ryan";939294;97.643655766991;2.35634423300905
0;301;"ryana";301;0;100
25;0;"ryananthony";25;100;0
5;0;"ryanchristian";5;100;0
45;0;"ryanchristopher";45;100;0
58;798;"ryane";856;6.77570093457944;93.2242990654206
17;0;"ryanjacob";17;100;0
54;0;"ryanjames";54;100;0
5;0;"ryanjay";5;100;0
29;0;"ryanjoseph";29;100;0
20;0;"ryanlee";20;100;0
5;0;"ryanmatthew";5;100;0
36;0;"ryanmichael";36;100;0
665;8673;"ryann";9338;7.12143928035982;92.8785607196402
0;1173;"ryanna";1173;0;100
0;35;"ryannah";35;0;100
0;2854;"ryanne";2854;0;100
5;0;"ryanpatrick";5;100;0
5;0;"ryanpaul";5;100;0
52;0;"ryant";52;100;0
0;11;"ryasia";11;0;100
5;0;"ryat";5;100;0
484;22;"ryatt";506;95.6521739130435;4.34782608695652
37;10;"ryce";47;78.7234042553192;21.2765957446809
0;37;"rychelle";37;0;100
97;0;"rydan";97;100;0
11;0;"rydar";11;100;0
10;0;"rydder";10;100;0
5;0;"rydel";5;100;0
386;0;"rydell";386;100;0
1054;38;"ryden";1092;96.5201465201465;3.47985347985348
38494;890;"ryder";39384;97.7401990656104;2.2598009343896
84;0;"rydge";84;100;0
0;12;"rydia";12;0;100
24;0;"rydin";24;100;0
6;0;"rydon";6;100;0
552;59;"rye";611;90.3436988543371;9.65630114566285
5;0;"ryean";5;100;0
0;26;"ryeisha";26;0;100
0;5;"ryeitt";5;0;100
6;0;"ryeker";6;100;0
23;6;"ryel";29;79.3103448275862;20.6896551724138
70;5;"ryelan";75;93.3333333333333;6.66666666666667
51;0;"ryeland";51;100;0
57;208;"ryelee";265;21.5094339622642;78.4905660377359
0;89;"ryeleigh";89;0;100
0;10;"ryeli";10;0;100
23;11;"ryelin";34;67.6470588235294;32.3529411764706
0;148;"ryelle";148;0;100
0;25;"ryelyn";25;0;100
0;107;"ryelynn";107;0;100
1179;854;"ryen";2033;57.9931136251845;42.0068863748155
0;191;"ryenn";191;0;100
0;214;"ryenne";214;0;100
118;0;"ryer";118;100;0
30;0;"ryerson";30;100;0
0;41;"ryesha";41;0;100
85;0;"ryett";85;100;0
22;0;"ryhan";22;100;0
0;16;"ryhana";16;0;100
0;154;"ryhanna";154;0;100
192;0;"ryheem";192;100;0
16;0;"ryheim";16;100;0
0;40;"ryia";40;0;100
0;54;"ryiah";54;0;100
51;57;"ryian";108;47.2222222222222;52.7777777777778
0;37;"ryilee";37;0;100
57;71;"ryin";128;44.53125;55.46875
6;0;"ryion";6;100;0
0;54;"ryka";54;0;100
28;0;"rykan";28;100;0
56;0;"rykar";56;100;0
17;0;"rykeem";17;100;0
501;5;"ryken";506;99.0118577075099;0.988142292490119
18831;221;"ryker";19052;98.8400167961369;1.15998320386311
0;28;"rykia";28;0;100
85;0;"rykin";85;100;0
5;0;"rykir";5;100;0
74;0;"rykker";74;100;0
0;5;"rykki";5;0;100
13;0;"ryko";13;100;0
0;304;"ryla";304;0;100
0;112;"rylah";112;0;100
25661;4111;"rylan";29772;86.1917237672981;13.8082762327019
8970;494;"ryland";9464;94.7802197802198;5.21978021978022
25;248;"rylann";273;9.15750915750916;90.8424908424908
271;35;"ryle";306;88.562091503268;11.437908496732
0;956;"rylea";956;0;100
0;84;"ryleah";84;0;100
4522;45678;"rylee";50200;9.00796812749004;90.99203187251
0;76;"ryleeann";76;0;100
0;10;"ryleeanne";10;0;100
0;5;"ryleeh";5;0;100
57;775;"rylei";832;6.85096153846154;93.1490384615385
316;21105;"ryleigh";21421;1.47518789972457;98.5248121002754
0;28;"ryleighann";28;0;100
2068;466;"rylen";2534;81.6101026045777;18.3898973954223
77;0;"rylend";77;100;0
0;6;"rylene";6;0;100
0;24;"rylenn";24;0;100
340;0;"ryler";340;100;0
3501;2789;"ryley";6290;55.6597774244833;44.3402225755167
0;550;"ryli";550;0;100
1015;16262;"rylie";17277;5.87486253400475;94.1251374659953
0;9;"rylieann";9;0;100
0;78;"ryliee";78;0;100
0;243;"ryliegh";243;0;100
0;6;"rylii";6;0;100
720;1133;"rylin";1853;38.8559093362115;61.1440906637885
17;0;"rylind";17;100;0
0;337;"rylinn";337;0;100
0;66;"ryllie";66;0;100
5;0;"rylo";5;100;0
241;0;"rylon";241;100;0
18;0;"rylund";18;100;0
5;6;"ryly";11;45.4545454545455;54.5454545454545
122;459;"rylyn";581;20.9982788296041;79.0017211703959
68;1551;"rylynn";1619;4.20012353304509;95.7998764669549
0;57;"rylynne";57;0;100
0;5;"ryma";5;0;100
60;5;"ryman";65;92.3076923076923;7.69230769230769
25;59;"ryn";84;29.7619047619048;70.2380952380952
20;60;"ryna";80;25;75
0;18;"rynda";18;0;100
4151;31;"ryne";4182;99.2587278813965;0.741272118603539
0;20;"ryneisha";20;0;100
83;0;"rynell";83;100;0
5;0;"ryner";5;100;0
0;44;"rynesha";44;0;100
0;5;"rynette";5;0;100
0;17;"ryniah";17;0;100
0;11;"rynisha";11;0;100
0;42;"rynlee";42;0;100
0;10;"rynleigh";10;0;100
10;118;"rynn";128;7.8125;92.1875
602;0;"ryo";602;100;0
0;15;"ryoko";15;0;100
75;0;"ryoma";75;100;0
1872;12;"ryon";1884;99.3630573248408;0.636942675159236
0;79;"ryonna";79;0;100
125;0;"ryosuke";125;100;0
112;0;"ryot";112;100;0
180;0;"ryota";180;100;0
37;0;"ryotaro";37;100;0
51;0;"ryott";51;100;0
5;0;"ryou";5;100;0
5;0;"ryse";5;100;0
7;0;"rysen";7;100;0
6;0;"ryshaun";6;100;0
74;0;"ryshawn";74;100;0
7;0;"ryshon";7;100;0
197;0;"ryson";197;100;0
0;11;"ryssa";11;0;100
0;33;"rystal";33;0;100
6;0;"ryston";6;100;0
33;0;"ryszard";33;100;0
5;0;"rythm";5;100;0
5;0;"ryton";5;100;0
1003;0;"ryu";1003;100;0
11;0;"ryuichi";11;100;0
12;0;"ryuji";12;100;0
5;0;"ryujin";5;100;0
5;0;"ryuki";5;100;0
181;0;"ryun";181;100;0
22;0;"ryunosuke";22;100;0
28;0;"ryusei";28;100;0
45;0;"ryuu";45;100;0
283;160;"ryver";443;63.882618510158;36.117381489842
30;0;"ryyan";30;100;0
24;0;"ryze";24;100;0
90;0;"ryzen";90;100;0
11;0;"ryzer";11;100;0
18;42;"sa";60;30;70
67;0;"saabir";67;100;0
0;354;"saachi";354;0;100
1931;0;"saad";1931;100;0
0;11;"saada";11;0;100
0;610;"saadia";610;0;100
351;0;"saadiq";351;100;0
0;66;"saadiya";66;0;100
0;5;"saadiyah";5;0;100
101;0;"saafir";101;100;0
113;0;"saagar";113;100;0
56;0;"saahas";56;100;0
316;0;"saahil";316;100;0
123;0;"saahir";123;100;0
0;23;"saahithi";23;0;100
0;9;"saahiti";9;0;100
21;0;"saaid";21;100;0
6;0;"saaim";6;100;0
62;0;"saajan";62;100;0
11;0;"saajid";11;100;0
0;5;"saajida";5;0;100
55;0;"saaketh";55;100;0
0;10;"saakshi";10;0;100
15;0;"saalih";15;100;0
0;12;"saaliha";12;0;100
0;7;"saalihah";7;0;100
11;0;"saalim";11;100;0
0;14;"saaliyah";14;0;100
40;0;"saam";40;100;0
0;12;"saamia";12;0;100
60;0;"saamir";60;100;0
0;99;"saamiya";99;0;100
0;6;"saamiyah";6;0;100
0;11;"saamya";11;0;100
0;26;"saana";26;0;100
0;14;"saanchi";14;0;100
0;20;"saani";20;0;100
0;11;"saania";11;0;100
0;17;"saanika";17;0;100
0;10;"saaniya";10;0;100
0;11;"saaniyah";11;0;100
0;5;"saanjh";5;0;100
0;2630;"saanvi";2630;0;100
0;78;"saanvika";78;0;100
0;77;"saanya";77;0;100
0;11;"saaphyri";11;0;100
0;267;"saara";267;0;100
0;214;"saarah";214;0;100
6;0;"saarang";6;100;0
22;0;"saarim";22;100;0
32;0;"saarth";32;100;0
0;6;"saasha";6;0;100
118;0;"saathvik";118;100;0
168;0;"saatvik";168;100;0
28;0;"saavan";28;100;0
0;42;"saavi";42;0;100
5;0;"saavon";5;100;0
0;86;"saaya";86;0;100
69;1346;"saba";1415;4.87632508833922;95.1236749116608
0;456;"sabah";456;0;100
75;0;"saban";75;100;0
0;5;"sabarin";5;0;100
703;0;"sabas";703;100;0
50;0;"sabastain";50;100;0
3145;0;"sabastian";3145;100;0
92;0;"sabastien";92;100;0
6;0;"sabastin";6;100;0
233;0;"sabastion";233;100;0
196;0;"sabatino";196;100;0
11;0;"sabato";11;100;0
10;0;"sabbath";10;100;0
6;0;"sabbir";6;100;0
21;0;"sabdiel";21;100;0
5;0;"sabe";5;100;0
6;0;"sabeeh";6;100;0
0;195;"sabeen";195;0;100
0;7;"sabeena";7;0;100
0;77;"sabel";77;0;100
0;27;"sabela";27;0;100
0;815;"sabella";815;0;100
0;17;"sabelle";17;0;100
102;0;"saben";102;100;0
0;88;"sabena";88;0;100
202;37;"saber";239;84.5188284518828;15.4811715481172
0;11;"saberina";11;0;100
0;5;"sabha";5;0;100
0;10;"sabia";10;0;100
820;21;"sabian";841;97.5029726516052;2.49702734839477
6;0;"sabiel";6;100;0
189;0;"sabien";189;100;0
5;0;"sabih";5;100;0
0;199;"sabiha";199;0;100
639;6;"sabin";645;99.0697674418605;0.930232558139535
0;7090;"sabina";7090;0;100
0;2618;"sabine";2618;0;100
1773;0;"sabino";1773;100;0
15;0;"sabion";15;100;0
487;0;"sabir";487;100;0
0;20;"sabira";20;0;100
0;48;"sabirah";48;0;100
0;96;"sabirin";96;0;100
5;0;"sabit";5;100;0
0;5;"sabiya";5;0;100
0;1432;"sable";1432;0;100
16;0;"saboor";16;100;0
0;4781;"sabra";4781;0;100
0;13;"sabrah";13;0;100
66;481;"sabre";547;12.0658135283364;87.9341864716636
0;142;"sabrea";142;0;100
0;6;"sabreana";6;0;100
18;269;"sabree";287;6.27177700348432;93.7282229965157
0;5;"sabreea";5;0;100
0;513;"sabreen";513;0;100
0;602;"sabreena";602;0;100
0;1971;"sabrena";1971;0;100
0;44;"sabrenia";44;0;100
0;7;"sabrenna";7;0;100
0;5;"sabreya";5;0;100
146;33;"sabri";179;81.5642458100559;18.4357541899441
0;924;"sabria";924;0;100
0;82;"sabriah";82;0;100
0;28;"sabrian";28;0;100
0;28;"sabriana";28;0;100
0;117;"sabrie";117;0;100
39;103;"sabriel";142;27.4647887323944;72.5352112676056
0;5;"sabrielle";5;0;100
0;5;"sabriena";5;0;100
0;223;"sabrin";223;0;100
348;135305;"sabrina";135653;0.256536899294524;99.7434631007055
0;39;"sabrinah";39;0;100
0;11;"sabrinamarie";11;0;100
0;326;"sabrine";326;0;100
0;197;"sabrinia";197;0;100
0;214;"sabrinna";214;0;100
0;346;"sabriya";346;0;100
0;141;"sabriyah";141;0;100
0;5;"sabriye";5;0;100
0;17;"sabriyya";17;0;100
0;5;"sabriyyah";5;0;100
0;164;"sabryn";164;0;100
0;773;"sabryna";773;0;100
0;5;"sabrynn";5;0;100
5;0;"sabu";5;100;0
5;0;"sabur";5;100;0
253;0;"saburo";253;100;0
0;32;"saby";32;0;100
0;12;"sacajawea";12;0;100
0;7;"sacaria";7;0;100
32;0;"sacario";32;100;0
436;1879;"sacha";2315;18.8336933045356;81.1663066954644
5;5;"sachary";10;50;50
0;62;"sache";62;0;100
0;105;"sacheen";105;0;100
0;5;"sachel";5;0;100
0;6;"sachelle";6;0;100
0;46;"sachet";46;0;100
0;846;"sachi";846;0;100
0;14;"sachie";14;0;100
10;0;"sachiel";10;100;0
0;11;"sachika";11;0;100
0;657;"sachiko";657;0;100
1244;0;"sachin";1244;100;0
58;0;"sachit";58;100;0
0;5;"sachiye";5;0;100
0;5;"sachiyo";5;0;100
0;11;"sacia";11;0;100
0;61;"sacora";61;0;100
0;19;"sacoria";19;0;100
0;5;"sacorya";5;0;100
0;114;"sacoya";114;0;100
0;5;"sacoyia";5;0;100
81;0;"sacramento";81;100;0
0;57;"sacred";57;0;100
0;1098;"sada";1098;0;100
0;72;"sadae";72;0;100
0;515;"sadaf";515;0;100
0;349;"sadako";349;0;100
12;0;"sadam";12;100;0
0;5;"sadame";5;0;100
25;0;"sadamu";25;100;0
0;28;"sadan";28;0;100
5;0;"sadane";5;100;0
244;0;"sadao";244;100;0
5;0;"sadaq";5;100;0
0;10;"sadara";10;0;100
0;7;"sadaria";7;0;100
5;0;"sadarian";5;100;0
5;0;"sadarion";5;100;0
158;0;"sadarius";158;100;0
87;0;"sadat";87;100;0
0;5;"sadavia";5;0;100
0;38;"sadaya";38;0;100
30;0;"saddam";30;100;0
0;776;"saddie";776;0;100
20;0;"saddiq";20;100;0
0;5;"saddiya";5;0;100
86;9245;"sade";9331;0.921658986175115;99.0783410138249
0;5;"sadea";5;0;100
0;732;"sadee";732;0;100
0;83;"sadeel";83;0;100
0;25;"sadeem";25;0;100
0;135;"sadeen";135;0;100
5;0;"sadeeq";5;100;0
0;5;"sadeigh";5;0;100
0;14;"sadeja";14;0;100
0;11;"sadell";11;0;100
0;6;"sadelle";6;0;100
0;6;"sadena";6;0;100
0;5;"saderia";5;0;100
0;311;"sadey";311;0;100
0;176;"sadhana";176;0;100
0;27;"sadhika";27;0;100
0;5;"sadhvi";5;0;100
5;588;"sadi";593;0.843170320404722;99.1568296795953
0;1132;"sadia";1132;0;100
0;43;"sadiah";43;0;100
225;105822;"sadie";106047;0.212170075532547;99.7878299244675
0;30;"sadieann";30;0;100
0;27;"sadiee";27;0;100
0;5;"sadiegrace";5;0;100
56;0;"sadiel";56;100;0
0;5;"sadielee";5;0;100
0;38;"sadielynn";38;0;100
0;39;"sadiemae";39;0;100
0;17;"sadiga";17;0;100
98;0;"sadik";98;100;0
0;6;"sadika";6;0;100
36;0;"sadiki";36;100;0
0;30;"sadina";30;0;100
0;5;"sadio";5;0;100
527;0;"sadiq";527;100;0
0;49;"sadiqa";49;0;100
0;15;"sadiqua";15;0;100
5;0;"sadique";5;100;0
5;0;"sadir";5;100;0
0;240;"sadira";240;0;100
0;272;"sadiya";272;0;100
0;277;"sadiyah";277;0;100
0;5;"sadiyya";5;0;100
0;42;"sadiyyah";42;0;100
126;6;"sadler";132;95.4545454545455;4.54545454545455
5;0;"sadman";5;100;0
0;5;"sadonia";5;0;100
0;163;"sadonna";163;0;100
6;0;"sadonte";6;100;0
0;11;"sadora";11;0;100
0;10;"sadra";10;0;100
104;0;"sadrac";104;100;0
0;215;"sady";215;0;100
0;1128;"sadye";1128;0;100
5;68;"sae";73;6.84931506849315;93.1506849315068
163;0;"saed";163;100;0
0;10;"saedee";10;0;100
0;15;"saedi";15;0;100
0;5;"saedie";5;0;100
0;7;"saee";7;0;100
1468;0;"saeed";1468;100;0
0;40;"saeeda";40;0;100
0;11;"saegan";11;0;100
0;11;"saeko";11;0;100
131;0;"sael";131;100;0
0;5;"saela";5;0;100
0;20;"saelah";20;0;100
0;11;"saelor";11;0;100
6;0;"saequan";6;100;0
0;123;"saesha";123;0;100
25;0;"saevion";25;100;0
17;0;"saevon";17;100;0
0;1571;"safa";1571;0;100
0;307;"safaa";307;0;100
0;15;"safah";15;0;100
50;0;"safal";50;100;0
0;5;"safana";5;0;100
6;0;"safaree";6;100;0
17;223;"safari";240;7.08333333333333;92.9166666666667
0;5;"safeara";5;0;100
5;0;"safee";5;100;0
30;0;"safeer";30;100;0
0;11;"safeerah";11;0;100
5;0;"safet";5;100;0
0;6;"safeya";6;0;100
0;5;"saffa";5;0;100
0;39;"saffire";39;0;100
0;23;"saffiya";23;0;100
0;40;"saffiyah";40;0;100
0;521;"saffron";521;0;100
121;14;"safi";135;89.6296296296296;10.3703703703704
0;1117;"safia";1117;0;100
0;5;"safiah";5;0;100
0;73;"safiatou";73;0;100
17;0;"safin";17;100;0
0;159;"safina";159;0;100
68;0;"safir";68;100;0
0;153;"safira";153;0;100
0;71;"safire";71;0;100
0;1656;"safiya";1656;0;100
0;489;"safiyah";489;0;100
0;16;"safiye";16;0;100
0;5;"safiyo";5;0;100
0;86;"safiyya";86;0;100
0;542;"safiyyah";542;0;100
0;6;"safoora";6;0;100
11;0;"saford";11;100;0
0;10;"safreen";10;0;100
0;10;"safronia";10;0;100
0;5;"safura";5;0;100
23;0;"safwaan";23;100;0
454;0;"safwan";454;100;0
5;0;"safwat";5;100;0
0;70;"saga";70;0;100
0;194;"sagal";194;0;100
439;307;"sagan";746;58.8471849865952;41.1528150134048
1007;0;"sagar";1007;100;0
0;17;"sagarika";17;0;100
9291;16283;"sage";25574;36.3298662704309;63.6701337295691
25;23;"sagen";48;52.0833333333333;47.9166666666667
10;0;"sager";10;100;0
0;5;"sagine";5;0;100
0;137;"sagrario";137;0;100
5;0;"sahaan";5;100;0
0;74;"sahaana";74;0;100
0;5;"sahai";5;0;100
0;12;"sahaira";12;0;100
277;0;"sahaj";277;100;0
35;0;"sahal";35;100;0
0;72;"sahalie";72;0;100
0;5;"saham";5;0;100
52;0;"sahan";52;100;0
0;1817;"sahana";1817;0;100
60;0;"sahand";60;100;0
0;5;"sahani";5;0;100
0;23;"sahanna";23;0;100
23;2006;"sahar";2029;1.13356333169049;98.8664366683095
5;3574;"sahara";3579;0.139703827884884;99.8602961721151
0;126;"saharah";126;0;100
0;43;"sahari";43;0;100
0;129;"saharra";129;0;100
0;21;"saharrah";21;0;100
286;0;"saharsh";286;100;0
157;0;"sahas";157;100;0
0;1047;"sahasra";1047;0;100
5;0;"saheb";5;100;0
147;0;"saheed";147;100;0
5;0;"saheem";5;100;0
35;0;"saheim";35;100;0
40;58;"sahej";98;40.8163265306122;59.1836734693878
37;0;"sahel";37;100;0
0;52;"saheli";52;0;100
5;0;"sahen";5;100;0
5;174;"saher";179;2.79329608938547;97.2067039106145
0;72;"sahian";72;0;100
480;15;"sahib";495;96.969696969697;3.03030303030303
0;102;"sahiba";102;0;100
8;0;"sahibdeep";8;100;0
27;0;"sahibjot";27;100;0
313;0;"sahid";313;100;0
2587;0;"sahil";2587;100;0
0;96;"sahily";96;0;100
5;0;"sahim";5;100;0
552;0;"sahir";552;100;0
0;425;"sahira";425;0;100
0;79;"sahirah";79;0;100
0;8;"sahiry";8;0;100
11;0;"sahishnu";11;100;0
18;0;"sahit";18;100;0
104;0;"sahith";104;100;0
0;207;"sahithi";207;0;100
0;98;"sahiti";98;0;100
0;10;"sahitya";10;0;100
0;5;"sahiyah";5;0;100
11;0;"sahl";11;100;0
111;0;"sahmir";111;100;0
0;10;"sahmiya";10;0;100
0;12;"sahmiyah";12;0;100
0;65;"sahmya";65;0;100
0;26;"sahni";26;0;100
0;38;"sahniya";38;0;100
0;10;"sahniyah";10;0;100
0;18;"sahnnon";18;0;100
0;5;"sahnya";5;0;100
0;37;"sahori";37;0;100
0;56;"sahory";56;0;100
37;0;"sahr";37;100;0
0;736;"sahra";736;0;100
0;5;"sahrai";5;0;100
0;6;"sahri";6;0;100
0;6;"sahrish";6;0;100
0;6;"sahriya";6;0;100
0;6;"sahriyah";6;0;100
0;5;"sahron";5;0;100
0;5;"sahrye";5;0;100
0;11;"sahvana";11;0;100
0;164;"sahvanna";164;0;100
0;73;"sahvannah";73;0;100
36;0;"sahwn";36;100;0
0;15;"sahyra";15;0;100
1064;328;"sai";1392;76.4367816091954;23.5632183908046
6;102;"saia";108;5.55555555555556;94.4444444444444
0;15;"saiah";15;0;100
5;0;"saianish";5;100;0
6;0;"saiansh";6;100;0
47;0;"saicharan";47;100;0
5;0;"saichi";5;100;0
2347;0;"said";2347;100;0
0;1040;"saida";1040;0;100
0;324;"saidah";324;0;100
0;118;"saide";118;0;100
0;247;"saidee";247;0;100
5;0;"saiden";5;100;0
0;44;"saidey";44;0;100
0;67;"saidi";67;0;100
0;45;"saidie";45;0;100
10;0;"saidou";10;100;0
0;218;"saidy";218;0;100
35;0;"saied";35;100;0
1547;0;"saif";1547;100;0
5;0;"saifaldeen";5;100;0
123;0;"saifan";123;100;0
5;0;"saifuddin";5;100;0
62;0;"saifullah";62;100;0
694;6785;"saige";7479;9.27931541649953;90.7206845835005
10;0;"saiid";10;100;0
0;29;"saija";29;0;100
0;43;"saije";43;0;100
6;0;"saikou";6;100;0
7;0;"saikrishna";7;100;0
0;39;"saila";39;0;100
0;5;"saile";5;0;100
0;29;"sailee";29;0;100
0;25;"sailer";25;0;100
20;0;"sailesh";20;100;0
319;1763;"sailor";2082;15.3218059558117;84.6781940441883
0;45;"saily";45;0;100
0;17;"sailyn";17;0;100
147;0;"saim";147;100;0
0;582;"saima";582;0;100
0;18;"saimi";18;0;100
27;0;"saimon";27;100;0
0;203;"saina";203;0;100
0;10;"sainabou";10;0;100
0;7;"saindhavi";7;0;100
918;28;"saint";946;97.0401691331924;2.95983086680761
97;0;"saintclair";97;100;0
5;0;"saintjohn";5;100;0
5;0;"saion";5;100;0
106;0;"saiquan";106;100;0
106;0;"sair";106;100;0
0;2823;"saira";2823;0;100
0;148;"sairah";148;0;100
11;0;"sairam";11;100;0
0;6;"sairi";6;0;100
0;47;"sairy";47;0;100
33;0;"saish";33;100;0
0;595;"saisha";595;0;100
11;0;"sait";11;100;0
31;0;"saith";31;100;0
19;0;"saiveon";19;100;0
77;0;"saivion";77;100;0
173;0;"saivon";173;100;0
0;264;"saiya";264;0;100
23;0;"saiyan";23;100;0
0;33;"saiyuri";33;0;100
0;667;"saja";667;0;100
5;0;"sajaad";5;100;0
88;0;"sajad";88;100;0
0;44;"sajada";44;0;100
0;17;"sajah";17;0;100
6;0;"sajal";6;100;0
248;0;"sajan";248;100;0
0;19;"sajani";19;0;100
0;13;"sajata";13;0;100
0;13;"sajda";13;0;100
0;22;"sajdah";22;0;100
38;81;"saje";119;31.9327731092437;68.0672268907563
40;0;"sajed";40;100;0
0;5;"sajeda";5;0;100
7;0;"sajen";7;100;0
5;0;"saji";5;100;0
367;0;"sajid";367;100;0
0;10;"sajidah";10;0;100
119;0;"sajjad";119;100;0
0;34;"sajni";34;0;100
58;57;"sakae";115;50.4347826086956;49.5652173913044
170;67;"sakai";237;71.7299578059072;28.2700421940928
0;5;"sakaiya";5;0;100
0;144;"sakara";144;0;100
64;399;"sakari";463;13.8228941684665;86.1771058315335
12;0;"sakaria";12;100;0
6;0;"sakariya";6;100;0
47;0;"sakariye";47;100;0
0;35;"sakaye";35;0;100
0;13;"sakayla";13;0;100
5;0;"sakeef";5;100;0
0;516;"sakeena";516;0;100
0;239;"sakeenah";239;0;100
0;6;"sakeithia";6;0;100
0;47;"sakena";47;0;100
195;0;"saket";195;100;0
401;0;"saketh";401;100;0
0;6;"saketha";6;0;100
0;5;"sakeya";5;0;100
13;10;"sakhi";23;56.5217391304348;43.4782608695652
0;28;"sakhia";28;0;100
11;282;"saki";293;3.7542662116041;96.2457337883959
0;263;"sakia";263;0;100
0;35;"sakiah";35;0;100
65;0;"sakib";65;100;0
0;6;"sakiko";6;0;100
0;23;"sakile";23;0;100
10;5;"sakima";15;66.6666666666667;33.3333333333333
0;1213;"sakina";1213;0;100
0;941;"sakinah";941;0;100
0;103;"sakira";103;0;100
0;7;"sakisha";7;0;100
0;37;"sakita";37;0;100
0;214;"sakiya";214;0;100
0;157;"sakiyah";157;0;100
0;23;"sakora";23;0;100
0;62;"sakoya";62;0;100
43;0;"saksham";43;100;0
0;200;"sakshi";200;0;100
0;10;"sakthi";10;0;100
5;0;"saku";5;100;0
0;1269;"sakura";1269;0;100
0;20;"sakurako";20;0;100
0;15;"sakya";15;0;100
0;26;"sakyra";26;0;100
3570;0;"sal";3570;100;0
0;199;"sala";199;0;100
65;0;"salaam";65;100;0
26;0;"salaar";26;100;0
164;0;"saladin";164;100;0
5;0;"saladine";5;100;0
686;69;"salah";755;90.8609271523179;9.13907284768212
5;0;"salahaldeen";5;100;0
10;0;"salahaldin";10;100;0
5;0;"salaheddine";5;100;0
110;0;"salahuddin";110;100;0
10;0;"salahudeen";10;100;0
12;0;"salahudin";12;100;0
90;218;"salam";308;29.2207792207792;70.7792207792208
0;17;"salama";17;0;100
0;17;"salamasina";17;0;100
0;5;"salamata";5;0;100
17;0;"salamon";17;100;0
0;11;"salana";11;0;100
0;5;"salanda";5;0;100
0;5;"salandra";5;0;100
107;0;"salar";107;100;0
0;12;"salara";12;0;100
0;10;"salathia";10;0;100
64;0;"salathiel";64;100;0
33;0;"salatiel";33;100;0
0;5;"salay";5;0;100
0;91;"salaya";91;0;100
0;83;"salayah";83;0;100
0;5;"salayna";5;0;100
5;0;"salazar";5;100;0
458;0;"salbador";458;100;0
0;6;"salea";6;0;100
0;172;"saleah";172;0;100
0;16;"saleana";16;0;100
1467;0;"saleem";1467;100;0
0;197;"saleema";197;0;100
0;169;"saleemah";169;0;100
0;740;"saleen";740;0;100
0;681;"saleena";681;0;100
1143;0;"saleh";1143;100;0
0;98;"saleha";98;0;100
0;5;"saleigh";5;0;100
0;24;"saleisha";24;0;100
1795;1691;"salem";3486;51.4916810097533;48.5083189902467
0;38;"salema";38;0;100
0;4957;"salena";4957;0;100
0;145;"salene";145;0;100
36;0;"salesi";36;100;0
0;10;"saleste";10;0;100
0;5;"salet";5;0;100
0;31;"saleta";31;0;100
0;8;"saleth";8;0;100
0;5;"salethia";5;0;100
0;11;"salette";11;0;100
0;5;"saleyah";5;0;100
0;7;"sali";7;0;100
0;138;"salia";138;0;100
0;77;"saliah";77;0;100
0;8;"salice";8;0;100
0;30;"salicia";30;0;100
0;5;"salida";5;0;100
61;0;"salif";61;100;0
399;0;"salih";399;100;0
0;194;"saliha";194;0;100
0;75;"salihah";75;0;100
73;0;"salik";73;100;0
78;0;"salil";78;100;0
1520;0;"salim";1520;100;0
0;458;"salima";458;0;100
0;250;"salimah";250;0;100
0;126;"salimata";126;0;100
0;88;"salimatou";88;0;100
0;6844;"salina";6844;0;100
0;207;"salinda";207;0;100
0;21;"saline";21;0;100
10;0;"salinger";10;100;0
94;0;"saliou";94;100;0
6;0;"salis";6;100;0
0;116;"salisa";116;0;100
0;11;"salise";11;0;100
0;82;"salisha";82;0;100
0;6;"salissa";6;0;100
0;55;"salita";55;0;100
9;0;"salix";9;100;0
0;5;"saliya";5;0;100
0;386;"saliyah";386;0;100
5;0;"saliym";5;100;0
0;111;"salle";111;0;100
0;321;"sallee";321;0;100
0;410;"salley";410;0;100
0;679;"salli";679;0;100
124;39334;"sallie";39458;0.314258198590907;99.6857418014091
642;200767;"sally";201409;0.31875437542513;99.6812456245749
0;1016;"sallyann";1016;0;100
0;119;"sallyanne";119;0;100
0;1031;"sallye";1031;0;100
0;36;"sallyjo";36;0;100
5;7587;"salma";7592;0.0658587987355111;99.9341412012645
189;0;"salmaan";189;100;0
0;36;"salmah";36;0;100
0;26;"salmai";26;0;100
1808;0;"salman";1808;100;0
0;7;"salmo";7;0;100
15;0;"salmon";15;100;0
0;480;"saloma";480;0;100
0;5;"salomae";5;0;100
672;3099;"salome";3771;17.8202068416866;82.1797931583134
0;10;"salomea";10;0;100
3259;0;"salomon";3259;100;0
0;5;"salonda";5;0;100
0;5;"salone";5;0;100
0;5;"salonge";5;0;100
0;394;"saloni";394;0;100
0;57;"salote";57;0;100
0;62;"salsabeel";62;0;100
0;37;"salsabil";37;0;100
5;5;"salud";10;50;50
5;0;"salvado";5;100;0
46204;183;"salvador";46387;99.6054929182745;0.394507081725483
0;5;"salvadora";5;0;100
1297;0;"salvadore";1297;100;0
919;0;"salvator";919;100;0
0;5;"salvatora";5;0;100
54975;81;"salvatore";55056;99.852877070619;0.147122929380994
0;284;"salvatrice";284;0;100
0;6;"salvina";6;0;100
27;0;"salvotore";27;100;0
0;575;"salwa";575;0;100
0;30;"saly";30;0;100
0;33;"salyna";33;0;100
113269;1382;"sam";114651;98.7946027509573;1.20539724904275
0;747;"sama";747;0;100
0;99;"samaa";99;0;100
153;0;"samaad";153;100;0
0;5;"samaah";5;0;100
0;5;"samaara";5;0;100
695;0;"samad";695;100;0
0;100;"samadhi";100;0;100
157;0;"samael";157;100;0
0;374;"samah";374;0;100
12;0;"samahj";12;100;0
0;131;"samai";131;0;100
0;81;"samaia";81;0;100
0;37;"samaiah";37;0;100
0;768;"samaira";768;0;100
0;22;"samaire";22;0;100
0;405;"samaiya";405;0;100
0;263;"samaiyah";263;0;100
263;18;"samaj";281;93.5943060498221;6.40569395017794
10;0;"samajae";10;100;0
18;0;"samajay";18;100;0
12;0;"samaje";12;100;0
0;57;"samala";57;0;100
0;5;"samalia";5;0;100
0;92;"samamtha";92;0;100
270;117;"saman";387;69.7674418604651;30.2325581395349
0;5;"samana";5;0;100
0;601;"samanatha";601;0;100
0;259;"samanda";259;0;100
5;0;"samandar";5;100;0
0;102;"samani";102;0;100
0;21;"samanntha";21;0;100
0;1690;"samanta";1690;0;100
0;45;"samantah";45;0;100
0;6;"samantaha";6;0;100
0;262;"samanth";262;0;100
1198;565973;"samantha";567171;0.211223775545647;99.7887762244544
0;13;"samanthaann";13;0;100
0;22;"samanthagrace";22;0;100
0;5;"samanthajean";5;0;100
0;287;"samanthajo";287;0;100
0;14;"samanthalee";14;0;100
0;5;"samanthalynn";5;0;100
0;68;"samanthamarie";68;0;100
0;113;"samanthan";113;0;100
0;23;"samanthanicole";23;0;100
0;24;"samanthe";24;0;100
0;5;"samanthea";5;0;100
0;492;"samanthia";492;0;100
0;213;"samanvi";213;0;100
0;11;"samanvita";11;0;100
0;55;"samanvitha";55;0;100
154;0;"samanyu";154;100;0
635;858;"samar";1493;42.5318151373074;57.4681848626926
0;13534;"samara";13534;0;100
0;1387;"samarah";1387;0;100
0;5;"samare";5;0;100
0;5;"samarea";5;0;100
0;28;"samaree";28;0;100
503;1039;"samari";1542;32.6199740596628;67.3800259403372
0;3726;"samaria";3726;0;100
0;264;"samariah";264;0;100
0;5;"samarian";5;0;100
0;127;"samarie";127;0;100
18;0;"samario";18;100;0
266;0;"samarion";266;100;0
0;28;"samaris";28;0;100
0;103;"samariya";103;0;100
0;66;"samariyah";66;0;100
5;0;"samarjit";5;100;0
5;0;"samarpreet";5;100;0
0;382;"samarra";382;0;100
0;65;"samarrah";65;0;100
0;19;"samarri";19;0;100
0;54;"samarria";54;0;100
782;0;"samarth";782;100;0
0;7;"samartha";7;0;100
0;70;"samary";70;0;100
0;38;"samarya";38;0;100
0;5;"samata";5;0;100
41;0;"samatar";41;100;0
0;4198;"samatha";4198;0;100
0;29;"samaura";29;0;100
45;58;"samauri";103;43.6893203883495;56.3106796116505
0;47;"samauria";47;0;100
236;15;"samay";251;94.0239043824701;5.97609561752988
0;2306;"samaya";2306;0;100
0;381;"samayah";381;0;100
0;15;"samayia";15;0;100
0;12;"samayiah";12;0;100
0;88;"samayra";88;0;100
113;0;"samba";113;100;0
22;0;"sambath";22;100;0
23;0;"sambhav";23;100;0
39;0;"sambo";39;100;0
6;0;"samed";6;100;0
36;0;"samee";36;100;0
6;0;"sameed";6;100;0
0;291;"sameeha";291;0;100
0;11;"sameeksha";11;0;100
5;0;"sameem";5;100;0
10;102;"sameen";112;8.92857142857143;91.0714285714286
0;65;"sameena";65;0;100
0;6;"sameenah";6;0;100
2838;0;"sameer";2838;100;0
0;660;"sameera";660;0;100
0;422;"sameerah";422;0;100
31;0;"sameh";31;100;0
0;5;"samehesha";5;0;100
0;5;"sameia";5;0;100
0;5;"sameika";5;0;100
5;0;"sameir";5;100;0
0;6;"sameisha";6;0;100
5;0;"samej";5;100;0
0;128;"sameka";128;0;100
0;5;"samekia";5;0;100
0;7;"sameko";7;0;100
69;0;"samel";69;100;0
0;711;"samella";711;0;100
0;6;"samena";6;0;100
0;62;"samentha";62;0;100
1352;5;"samer";1357;99.6315401621223;0.368459837877671
0;482;"samera";482;0;100
0;25;"samerah";25;0;100
47;0;"samere";47;100;0
0;225;"sameria";225;0;100
0;6;"sameriah";6;0;100
0;5;"samerra";5;0;100
5;0;"samet";5;100;0
0;47;"sametra";47;0;100
0;55;"sametria";55;0;100
0;10;"sametta";10;0;100
859;0;"sameul";859;100;0
0;29;"sameya";29;0;100
0;10;"sameyah";10;0;100
0;352;"samhita";352;0;100
37;0;"samhith";37;100;0
0;193;"samhitha";193;0;100
3947;1210;"sami";5157;76.536746170254;23.463253829746
0;2820;"samia";2820;0;100
0;1290;"samiah";1290;0;100
0;12;"samiaya";12;0;100
0;23;"samica";23;0;100
6;0;"samid";6;100;0
631;177;"samie";808;78.0940594059406;21.9059405940594
63;0;"samiel";63;100;0
6;0;"samien";6;100;0
101;0;"samier";101;100;0
0;5;"samiera";5;0;100
42;0;"samih";42;100;0
0;448;"samiha";448;0;100
0;16;"samihah";16;0;100
32;0;"samiir";32;100;0
0;6;"samiira";6;0;100
0;5;"samija";5;0;100
0;15;"samijah";15;0;100
0;28;"samijo";28;0;100
127;0;"samik";127;100;0
0;298;"samika";298;0;100
0;135;"samiksha";135;0;100
82;0;"samil";82;100;0
105;0;"samin";105;100;0
0;536;"samina";536;0;100
0;8;"saminah";8;0;100
7369;59;"samir";7428;99.2057081313947;0.794291868605277
0;6018;"samira";6018;0;100
0;1404;"samirah";1404;0;100
0;46;"samiria";46;0;100
0;31;"samirra";31;0;100
0;6;"samirrah";6;0;100
0;6;"samisha";6;0;100
34;0;"samisoni";34;100;0
77;0;"samit";77;100;0
0;5;"samita";5;0;100
11;0;"samith";11;100;0
27;0;"samiuela";27;100;0
37;0;"samiul";37;100;0
10;0;"samiullah";10;100;0
0;3142;"samiya";3142;0;100
0;3764;"samiyah";3764;0;100
0;13;"samiyha";13;0;100
0;148;"samiyyah";148;0;100
0;5;"samma";5;0;100
5;0;"sammael";5;100;0
0;1964;"sammantha";1964;0;100
0;27;"sammara";27;0;100
0;54;"sammatha";54;0;100
39;0;"sammer";39;100;0
5;0;"sammeul";5;100;0
33;0;"sammey";33;100;0
50;1487;"sammi";1537;3.25309043591412;96.7469095640859
20475;7330;"sammie";27805;73.6378349217767;26.3621650782233
0;6;"sammiejo";6;0;100
0;40;"sammijo";40;0;100
0;5;"sammiyah";5;0;100
59;0;"sammual";59;100;0
2466;0;"sammuel";2466;100;0
5;0;"sammul";5;100;0
42368;1568;"sammy";43936;96.4311726147123;3.56882738528769
0;5;"sammya";5;0;100
0;723;"sammye";723;0;100
0;24;"sammyjo";24;0;100
139;28;"samnang";167;83.2335329341317;16.7664670658683
0;53;"samnatha";53;0;100
0;11;"samoan";11;0;100
11;66;"samon";77;14.2857142857143;85.7142857142857
0;306;"samona";306;0;100
5;2087;"samone";2092;0.239005736137667;99.7609942638623
0;32;"samoni";32;0;100
0;5;"samonie";5;0;100
6;0;"samonte";6;100;0
0;5;"samontha";5;0;100
5;350;"samora";355;1.40845070422535;98.5915492957747
0;53;"samorah";53;0;100
0;5;"samore";5;0;100
36;0;"samori";36;100;0
0;63;"samoria";63;0;100
26;0;"samory";26;100;0
0;48;"samoya";48;0;100
5;0;"samp";5;100;0
5;0;"sampath";5;100;0
3318;0;"sampson";3318;100;0
0;414;"samra";414;0;100
13;0;"samraat";13;100;0
0;38;"samrah";38;0;100
5;0;"samraj";5;100;0
44;0;"samrat";44;100;0
30;0;"samrath";30;100;0
0;49;"samrawit";49;0;100
0;160;"samreen";160;0;100
0;26;"samreet";26;0;100
0;26;"samriddhi";26;0;100
26;0;"samridh";26;100;0
0;27;"samridhi";27;0;100
23;0;"samrudh";23;100;0
0;36;"samsam";36;0;100
0;33;"samsara";33;0;100
8203;0;"samson";8203;100;0
0;6;"samtha";6;0;100
5;0;"samuael";5;100;0
5304;0;"samual";5304;100;0
722536;2780;"samuel";725316;99.6167187818827;0.383281218117345
32;27;"samuela";59;54.2372881355932;45.7627118644068
10;0;"samueldavid";10;100;0
216;0;"samuele";216;100;0
188;0;"samuell";188;100;0
0;187;"samuella";187;0;100
39;11;"samuelle";50;78;22
11;0;"samuelu";11;100;0
5;0;"samuil";5;100;0
221;0;"samul";221;100;0
314;0;"samule";314;100;0
10;0;"samurai";10;100;0
0;25;"samus";25;0;100
120;0;"samvel";120;100;0
22;0;"samvit";22;100;0
6;0;"samwell";6;100;0
59;0;"samwise";59;100;0
652;5;"samy";657;99.2389649923896;0.76103500761035
0;2516;"samya";2516;0;100
0;642;"samyah";642;0;100
92;0;"samyak";92;100;0
18;0;"samyar";18;100;0
0;6;"samye";6;0;100
0;7;"samyha";7;0;100
0;354;"samyia";354;0;100
0;210;"samyiah";210;0;100
0;10;"samyla";10;0;100
13;0;"samyog";13;100;0
12;0;"samyr";12;100;0
0;818;"samyra";818;0;100
0;186;"samyrah";186;0;100
0;87;"samyria";87;0;100
0;12;"samyriah";12;0;100
0;94;"samyukta";94;0;100
0;164;"samyuktha";164;0;100
594;1856;"san";2450;24.2448979591837;75.7551020408163
5;3588;"sana";3593;0.139159476760367;99.8608405232396
0;5046;"sanaa";5046;0;100
0;35;"sanaah";35;0;100
0;80;"sanaai";80;0;100
0;13;"sanaaya";13;0;100
265;0;"sanad";265;100;0
0;290;"sanae";290;0;100
0;344;"sanah";344;0;100
20;2978;"sanai";2998;0.66711140760507;99.3328885923949
0;181;"sanaia";181;0;100
0;54;"sanaiah";54;0;100
0;300;"sanaii";300;0;100
0;278;"sanaiya";278;0;100
0;110;"sanaiyah";110;0;100
0;425;"sanam";425;0;100
0;26;"sanantha";26;0;100
6;0;"sanantonio";6;100;0
0;5;"sanara";5;0;100
0;118;"sanari";118;0;100
0;25;"sanaria";25;0;100
55;0;"sanat";55;100;0
26;0;"sanath";26;100;0
47;0;"sanav";47;100;0
0;19;"sanavi";19;0;100
99;24;"sanay";123;80.4878048780488;19.5121951219512
0;1180;"sanaya";1180;0;100
0;228;"sanayah";228;0;100
0;135;"sanaz";135;0;100
0;12;"sancha";12;0;100
901;17;"sanchez";918;98.1481481481482;1.85185185185185
0;12;"sanchi";12;0;100
10;0;"sanchit";10;100;0
34;0;"sancho";34;100;0
0;27;"sancia";27;0;100
0;10;"sand";10;0;100
0;604;"sanda";604;0;100
0;5;"sandal";5;0;100
0;167;"sandar";167;0;100
0;70;"sandara";70;0;100
16;258;"sande";274;5.83941605839416;94.1605839416058
0;1721;"sandee";1721;0;100
806;115;"sandeep";921;87.5135722041259;12.4864277958741
1268;79;"sander";1347;94.1351150705271;5.8648849294729
0;10;"sandera";10;0;100
2115;6;"sanders";2121;99.7171145685997;0.282885431400283
5;0;"sanderson";5;100;0
10;0;"sandesh";10;100;0
421;0;"sandford";421;100;0
0;490;"sandhya";490;0;100
21;10068;"sandi";10089;0.208147487362474;99.7918525126375
0;77;"sandia";77;0;100
0;6;"sandibel";6;0;100
5;2714;"sandie";2719;0.183891136447223;99.8161088635528
5;0;"sandino";5;100;0
82;0;"sandip";82;100;0
43;0;"sandler";43;100;0
225;0;"sandon";225;100;0
869;0;"sandor";869;100;0
0;5;"sandora";5;0;100
0;5;"sandr";5;0;100
2693;873187;"sandra";875880;0.307462209435082;99.6925377905649
0;12;"sandrah";12;0;100
0;22;"sandral";22;0;100
0;267;"sandralee";267;0;100
0;16;"sandre";16;0;100
0;673;"sandrea";673;0;100
0;5;"sandreka";5;0;100
0;7;"sandrell";7;0;100
0;654;"sandria";654;0;100
0;5;"sandricka";5;0;100
0;50;"sandrika";50;0;100
0;69;"sandrina";69;0;100
0;171;"sandrine";171;0;100
1589;0;"sandro";1589;100;0
0;5;"sandry";5;0;100
10017;68440;"sandy";78457;12.7675032183234;87.2324967816766
0;5;"sandybell";5;0;100
0;21;"sandye";21;0;100
0;7;"sanea";7;0;100
0;5;"saned";5;0;100
79;0;"sanel";79;100;0
0;77;"sanela";77;0;100
0;10;"sanetra";10;0;100
0;6;"sanetta";6;0;100
0;5;"saneya";5;0;100
14425;0;"sanford";14425;100;0
0;6;"sanfra";6;0;100
638;47;"sang";685;93.1386861313869;6.86131386861314
0;172;"sangeeta";172;0;100
0;10;"sangeetha";10;0;100
0;84;"sangita";84;0;100
0;16;"sangria";16;0;100
79;293;"sani";372;21.2365591397849;78.7634408602151
0;1668;"sania";1668;0;100
0;43;"saniaa";43;0;100
0;1411;"saniah";1411;0;100
0;24;"saniaya";24;0;100
0;5;"sanibel";5;0;100
0;20;"sanieya";20;0;100
0;5;"sanihya";5;0;100
0;205;"sanii";205;0;100
0;18;"saniia";18;0;100
0;5;"saniiya";5;0;100
0;6;"saniiyah";6;0;100
0;18;"sanija";18;0;100
0;46;"sanijah";46;0;100
0;384;"sanika";384;0;100
37;0;"sanil";37;100;0
0;17;"sanilah";17;0;100
6;0;"sanin";6;100;0
0;5;"saniqua";5;0;100
0;5;"sanira";5;0;100
0;18;"sanisha";18;0;100
0;248;"sanita";248;0;100
0;5;"sanitra";5;0;100
0;18;"saniy";18;0;100
0;5993;"saniya";5993;0;100
0;12;"saniyaa";12;0;100
0;5552;"saniyah";5552;0;100
0;5;"saniye";5;0;100
0;35;"saniyha";35;0;100
0;5;"saniyia";5;0;100
0;125;"saniyya";125;0;100
0;220;"saniyyah";220;0;100
0;122;"sanja";122;0;100
5;0;"sanjan";5;100;0
0;2056;"sanjana";2056;0;100
2375;0;"sanjay";2375;100;0
36;13;"sanjaya";49;73.469387755102;26.530612244898
11;0;"sanjeet";11;100;0
435;0;"sanjeev";435;100;0
0;38;"sanjida";38;0;100
134;0;"sanjit";134;100;0
0;19;"sanjita";19;0;100
110;0;"sanjith";110;100;0
0;10;"sanjitha";10;0;100
124;0;"sanjiv";124;100;0
0;140;"sanjna";140;0;100
139;0;"sanjuan";139;100;0
0;2282;"sanjuana";2282;0;100
0;3473;"sanjuanita";3473;0;100
94;0;"sankalp";94;100;0
5;0;"sankeerth";5;100;0
44;0;"sanket";44;100;0
5;0;"sankey";5;100;0
0;630;"sanna";630;0;100
0;10;"sannah";10;0;100
0;5;"sannai";5;0;100
0;37;"sanne";37;0;100
0;8;"sanniah";8;0;100
0;16;"sannidhi";16;0;100
0;11;"sannie";11;0;100
0;24;"sanniyah";24;0;100
0;5;"sannon";5;0;100
7;0;"sanny";7;100;0
0;93;"sanoe";93;0;100
0;325;"sanora";325;0;100
0;45;"sanovia";45;0;100
7;0;"sanquan";7;100;0
0;10;"sanquenetta";10;0;100
0;7;"sanquetta";7;0;100
0;10;"sanquita";10;0;100
0;69;"sansa";69;0;100
25;0;"sanskar";25;100;0
0;84;"sanskriti";84;0;100
0;5;"sanskruti";5;0;100
40;4255;"santa";4295;0.931315483119907;99.0686845168801
4415;4849;"santana";9264;47.6575993091537;52.3424006908463
0;5;"santanah";5;0;100
0;6;"santangela";6;0;100
6;0;"santangelo";6;100;0
0;16;"santania";16;0;100
60;804;"santanna";864;6.94444444444444;93.0555555555556
0;5;"santanya";5;0;100
0;14;"santara";14;0;100
20;0;"santario";20;100;0
0;34;"santasha";34;0;100
0;132;"santasia";132;0;100
0;5;"santavia";5;0;100
5;0;"santavious";5;100;0
106;0;"sante";106;100;0
57;0;"santee";57;100;0
0;40;"santeria";40;0;100
0;6;"santerica";6;0;100
0;6;"santerria";6;0;100
79;0;"santez";79;100;0
47;0;"santford";47;100;0
0;6;"santha";6;0;100
133;0;"santhiago";133;100;0
60;0;"santhosh";60;100;0
180;27;"santi";207;86.9565217391304;13.0434782608696
0;254;"santia";254;0;100
0;71;"santiaga";71;0;100
52554;94;"santiago";52648;99.8214557058198;0.178544294180216
0;70;"santiana";70;0;100
23;0;"santiel";23;100;0
7;0;"santigo";7;100;0
0;2927;"santina";2927;0;100
9;0;"santini";9;100;0
7343;0;"santino";7343;100;0
0;61;"santita";61;0;100
4631;0;"santo";4631;100;0
5;0;"santoi";5;100;0
11;10;"santonia";21;52.3809523809524;47.6190476190476
843;0;"santonio";843;100;0
0;113;"santoria";113;0;100
16408;2699;"santos";19107;85.8742869105563;14.1257130894437
146;0;"santosh";146;100;0
0;90;"santosha";90;0;100
0;22;"santoya";22;0;100
10;10;"santrell";20;50;50
0;64;"santresa";64;0;100
0;6;"santrese";6;0;100
5;0;"santrez";5;100;0
0;97;"santrice";97;0;100
0;10;"santricia";10;0;100
21;0;"santwan";21;100;0
17;0;"santy";17;100;0
118;0;"sanuel";118;100;0
0;10;"sanura";10;0;100
0;945;"sanvi";945;0;100
0;79;"sanvika";79;0;100
0;32;"sanvitha";32;0;100
0;1722;"sanya";1722;0;100
0;324;"sanyah";324;0;100
0;100;"sanye";100;0;100
0;57;"sanyi";57;0;100
0;244;"sanyia";244;0;100
0;144;"sanyiah";144;0;100
0;137;"sanyla";137;0;100
0;28;"sanylah";28;0;100
0;5;"sanyra";5;0;100
0;10;"sanyu";10;0;100
10;0;"sao";10;100;0
0;1350;"saoirse";1350;0;100
0;375;"saori";375;0;100
0;66;"saory";66;0;100
24;0;"sapan";24;100;0
0;12;"sapana";12;0;100
0;50;"saphera";50;0;100
0;5;"sapheria";5;0;100
0;73;"saphia";73;0;100
0;8;"saphina";8;0;100
0;1263;"saphira";1263;0;100
0;5;"saphirah";5;0;100
0;783;"saphire";783;0;100
0;53;"saphronia";53;0;100
0;83;"saphyra";83;0;100
0;117;"saphyre";117;0;100
0;69;"sapir";69;0;100
0;546;"sapna";546;0;100
0;477;"sapphira";477;0;100
0;2945;"sapphire";2945;0;100
0;46;"sapphyre";46;0;100
0;365;"saprina";365;0;100
130;0;"saqib";130;100;0
0;27;"saqqara";27;0;100
710;7;"saquan";717;99.023709902371;0.97629009762901
0;32;"saquana";32;0;100
0;5;"saquanna";5;0;100
0;35;"saquita";35;0;100
0;70;"saquoia";70;0;100
15;0;"saquon";15;100;0
0;24;"saquoya";24;0;100
1237;415851;"sara";417088;0.296580098204695;99.7034199017953
0;6;"saraa";6;0;100
0;305;"saraann";305;0;100
0;21;"saraanne";21;0;100
0;5;"sarabel";5;0;100
0;84;"sarabella";84;0;100
0;90;"sarabelle";90;0;100
0;1207;"sarabeth";1207;0;100
0;122;"sarabi";122;0;100
0;34;"sarada";34;0;100
0;358;"sarae";358;0;100
0;20;"saraelizabeth";20;0;100
0;592;"sarafina";592;0;100
15;0;"saragosa";15;100;0
0;71;"saragrace";71;0;100
3223;1037928;"sarah";1041151;0.309561245198823;99.6904387548012
0;42;"saraha";42;0;100
0;712;"sarahann";712;0;100
0;262;"sarahanne";262;0;100
0;5;"sarahbella";5;0;100
0;204;"sarahbeth";204;0;100
0;252;"sarahelizabeth";252;0;100
0;180;"sarahgrace";180;0;100
0;5910;"sarahi";5910;0;100
0;409;"sarahjane";409;0;100
0;39;"sarahjean";39;0;100
0;27;"sarahjo";27;0;100
0;10;"sarahjoy";10;0;100
0;11;"sarahkate";11;0;100
0;11;"sarahlee";11;0;100
0;17;"sarahlyn";17;0;100
0;125;"sarahlynn";125;0;100
0;34;"sarahmae";34;0;100
0;176;"sarahmarie";176;0;100
0;47;"sarahrose";47;0;100
0;819;"sarahy";819;0;100
0;5;"sarahya";5;0;100
6;16445;"sarai";16451;0.0364719469941037;99.9635280530059
0;86;"saraia";86;0;100
0;191;"saraiah";191;0;100
0;157;"saraih";157;0;100
0;32;"saraii";32;0;100
0;5;"saraina";5;0;100
0;5;"sarait";5;0;100
0;146;"saraiya";146;0;100
0;78;"saraiyah";78;0;100
0;713;"sarajane";713;0;100
0;76;"sarajean";76;0;100
0;15;"saraji";15;0;100
0;40;"sarajo";40;0;100
0;12;"sarakate";12;0;100
7;0;"saral";7;100;0
0;6;"sarala";6;0;100
0;738;"saralee";738;0;100
0;5;"saralie";5;0;100
0;17;"saralou";17;0;100
0;16;"saraly";16;0;100
0;1226;"saralyn";1226;0;100
0;384;"saralynn";384;0;100
0;19;"saramae";19;0;100
0;91;"saramarie";91;0;100
25;564;"saran";589;4.24448217317487;95.7555178268251
0;93;"saranda";93;0;100
37;36;"sarang";73;50.6849315068493;49.3150684931507
0;10;"sarani";10;0;100
0;75;"sarann";75;0;100
0;15;"saranna";15;0;100
0;80;"saranne";80;0;100
7;0;"saransh";7;100;0
0;168;"saranya";168;0;100
0;104;"saraphina";104;0;100
0;15;"saraphine";15;0;100
0;42;"sararose";42;0;100
5;0;"saras";5;100;0
0;5;"saraswati";5;0;100
46;20;"sarath";66;69.6969696969697;30.3030303030303
0;5;"saratha";5;0;100
0;1964;"saray";1964;0;100
0;1144;"saraya";1144;0;100
0;330;"sarayah";330;0;100
0;37;"saraye";37;0;100
0;426;"sarayu";426;0;100
5;0;"sarbjot";5;100;0
0;7;"sarda";7;0;100
5;0;"sardar";5;100;0
0;31;"sarde";31;0;100
6;0;"sardor";6;100;0
0;25;"sare";25;0;100
0;91;"sarea";91;0;100
0;135;"saree";135;0;100
0;169;"sareen";169;0;100
0;479;"sareena";479;0;100
0;7;"sareeta";7;0;100
13;0;"sarek";13;100;0
0;26;"sarela";26;0;100
0;17;"sareli";17;0;100
0;5;"sarell";5;0;100
0;62;"sarely";62;0;100
0;23;"sarem";23;0;100
0;135;"saren";135;0;100
0;2349;"sarena";2349;0;100
0;18;"sarene";18;0;100
0;5;"sareniti";5;0;100
0;493;"sarenity";493;0;100
0;46;"sarenna";46;0;100
0;26;"saresa";26;0;100
12;12;"sareth";24;50;50
0;33;"saretha";33;0;100
0;79;"saretta";79;0;100
0;48;"sareya";48;0;100
109;0;"sargent";109;100;0
59;0;"sargon";59;100;0
0;48;"sargun";48;0;100
0;52;"sarh";52;0;100
0;433;"sarha";433;0;100
0;6;"sarhiya";6;0;100
34;3206;"sari";3240;1.04938271604938;98.9506172839506
0;749;"saria";749;0;100
0;6931;"sariah";6931;0;100
0;5;"sariaha";5;0;100
0;55;"sariana";55;0;100
0;54;"sarianna";54;0;100
0;22;"saribel";22;0;100
0;5;"sarica";5;0;100
0;90;"sarie";90;0;100
48;0;"sariel";48;100;0
0;5;"sariha";5;0;100
0;5;"sarii";5;0;100
0;496;"sarika";496;0;100
0;7;"sarilyn";7;0;100
205;0;"sarim";205;100;0
11;123;"sarin";134;8.2089552238806;91.7910447761194
0;8591;"sarina";8591;0;100
0;61;"sarinah";61;0;100
0;46;"sarine";46;0;100
0;89;"sarinity";89;0;100
0;10;"sarinna";10;0;100
0;30;"sarisha";30;0;100
0;108;"sarissa";108;0;100
0;165;"sarit";165;0;100
0;4861;"sarita";4861;0;100
11;0;"sarith";11;100;0
0;6;"saritha";6;0;100
0;1131;"sariya";1131;0;100
0;2868;"sariyah";2868;0;100
0;5;"sariyha";5;0;100
860;0;"sarkis";860;100;0
16;0;"sarmad";16;100;0
5;0;"sarn";5;100;0
0;11;"sarne";11;0;100
16;0;"saro";16;100;0
10;0;"saroeun";10;100;0
10;5;"sarom";15;66.6666666666667;33.3333333333333
138;675;"saron";813;16.9741697416974;83.0258302583026
0;11;"saronda";11;0;100
11;0;"sarosh";11;100;0
0;5;"saroun";5;0;100
0;57;"saroya";57;0;100
59;0;"sarp";59;100;0
0;644;"sarra";644;0;100
0;1477;"sarrah";1477;0;100
0;5;"sarri";5;0;100
0;34;"sarriah";34;0;100
0;10;"sarrina";10;0;100
0;74;"sarrinah";74;0;100
0;5;"sarriyah";5;0;100
0;5;"sarsh";5;0;100
130;0;"sartaj";130;100;0
218;0;"sarthak";218;100;0
6;0;"sarva";6;100;0
202;0;"sarvesh";202;100;0
0;5;"sarvia";5;0;100
24;0;"sarvin";24;100;0
5;67;"sary";72;6.94444444444444;93.0555555555556
0;146;"sarya";146;0;100
0;406;"saryah";406;0;100
5;0;"saryan";5;100;0
0;63;"sarye";63;0;100
0;30;"saryia";30;0;100
0;121;"saryiah";121;0;100
0;221;"saryn";221;0;100
0;120;"saryna";120;0;100
0;13;"saryniti";13;0;100
0;30;"sarynity";30;0;100
0;5;"sasami";5;0;100
56;0;"sasan";56;100;0
336;1064;"sascha";1400;24;76
1360;34016;"sasha";35376;3.84441429217549;96.1555857078245
0;39;"sashae";39;0;100
0;5;"sashalee";5;0;100
36;0;"sashank";36;100;0
0;5;"sasharae";5;0;100
0;101;"sashay";101;0;100
0;19;"sashe";19;0;100
0;43;"sasheen";43;0;100
0;50;"sashenka";50;0;100
0;15;"sashi";15;0;100
0;100;"sashia";100;0;100
0;5;"sashya";5;0;100
0;6;"sasia";6;0;100
0;972;"saskia";972;0;100
0;10;"sassy";10;0;100
71;0;"sasuke";71;100;0
0;28;"satanya";28;0;100
0;314;"satara";314;0;100
0;6;"sataria";6;0;100
0;27;"satasha";27;0;100
0;6;"satavia";6;0;100
0;65;"satcha";65;0;100
520;0;"satchel";520;100;0
0;17;"sateria";17;0;100
440;0;"sathvik";440;100;0
0;83;"sathvika";83;0;100
10;0;"sathwik";10;100;0
35;6;"sathya";41;85.3658536585366;14.6341463414634
0;17;"sati";17;0;100
0;68;"satia";68;0;100
0;373;"satin";373;0;100
0;170;"satina";170;0;100
0;72;"satine";72;0;100
0;35;"satira";35;0;100
28;0;"satish";28;100;0
0;592;"sativa";592;0;100
5;0;"satnam";5;100;0
0;27;"satoko";27;0;100
0;63;"satomi";63;0;100
0;13;"satonia";13;0;100
0;89;"satonya";89;0;100
10;318;"satori";328;3.04878048780488;96.9512195121951
0;134;"satoria";134;0;100
230;0;"satoru";230;100;0
303;0;"satoshi";303;100;0
0;118;"satoya";118;0;100
0;104;"satrina";104;0;100
0;5;"satsha";5;0;100
0;102;"satsuki";102;0;100
0;5;"satsuko";5;0;100
5;0;"sattam";5;100;0
0;16;"saturn";16;0;100
0;33;"saturnina";33;0;100
590;0;"saturnino";590;100;0
366;0;"satvik";366;100;0
0;41;"satvika";41;0;100
143;310;"satya";453;31.5673289183223;68.4326710816777
21;0;"satyam";21;100;0
0;12;"satyana";12;0;100
0;5;"satyn";5;0;100
0;7;"satyra";7;0;100
0;5;"sauannah";5;0;100
354;0;"saud";354;100;0
0;22;"sauda";22;0;100
0;16;"saudah";16;0;100
0;11;"saudi";11;0;100
0;416;"saudia";416;0;100
14;0;"sauel";14;100;0
19;0;"saugat";19;100;0
38234;74;"saul";38308;99.8068288608124;0.193171139187637
15;0;"saulius";15;100;0
538;0;"saulo";538;100;0
10;0;"saumil";10;100;0
5;225;"saumya";230;2.17391304347826;97.8260869565217
10;0;"saun";10;100;0
0;5;"sauna";5;0;100
182;0;"saunders";182;100;0
11;17844;"saundra";17855;0.0616073928871465;99.9383926071129
0;53;"saundria";53;0;100
0;6;"saunti";6;0;100
0;55;"saunya";55;0;100
0;12;"saura";12;0;100
67;0;"saurabh";67;100;0
181;0;"saurav";181;100;0
12;0;"saurish";12;100;0
7;0;"saurya";7;100;0
0;150;"sausha";150;0;100
118;5;"sava";123;95.9349593495935;4.0650406504065
0;7;"savada";7;0;100
0;18;"savaeh";18;0;100
30;0;"savage";30;100;0
0;71;"savahanna";71;0;100
0;132;"savahna";132;0;100
102;0;"savalas";102;100;0
103;0;"savan";103;100;0
0;5063;"savana";5063;0;100
0;9462;"savanah";9462;0;100
0;30;"savanaha";30;0;100
0;6;"savanh";6;0;100
0;129;"savanha";129;0;100
15;29247;"savanna";29262;0.0512610211195407;99.9487389788805
198;158899;"savannah";159097;0.124452378108952;99.875547621891
0;129;"savannaha";129;0;100
0;5;"savannahgrace";5;0;100
0;5;"savannahjo";5;0;100
0;10;"savannahlynn";10;0;100
0;7;"savannahmarie";7;0;100
0;34;"savannahrose";34;0;100
0;193;"savannha";193;0;100
22;0;"savant";22;100;0
17;0;"savante";17;100;0
6;0;"savar";6;100;0
58;0;"savas";58;100;0
0;12;"savasia";12;0;100
132;5;"savaughn";137;96.3503649635037;3.64963503649635
0;86;"savaya";86;0;100
0;85;"savayah";85;0;100
0;14;"savea";14;0;100
0;98;"saveah";98;0;100
0;34;"saveena";34;0;100
21;0;"saveer";21;100;0
53;0;"saveion";53;100;0
10;0;"saveliy";10;100;0
0;5;"savena";5;0;100
194;0;"saveon";194;100;0
0;80;"savera";80;0;100
0;37;"saveria";37;0;100
1757;0;"saverio";1757;100;0
0;5;"saveya";5;0;100
5;0;"saveyon";5;100;0
0;166;"savhanna";166;0;100
0;5;"savhannah";5;0;100
0;70;"savi";70;0;100
0;10;"saviah";10;0;100
306;0;"savian";306;100;0
0;11;"saviana";11;0;100
16;0;"saviel";16;100;0
145;0;"savien";145;100;0
12;0;"savieon";12;100;0
215;0;"savier";215;100;0
0;418;"savilla";418;0;100
5;0;"savin";5;100;0
0;1082;"savina";1082;0;100
0;5;"savine";5;0;100
546;0;"savino";546;100;0
148;0;"savio";148;100;0
4113;17;"savion";4130;99.588377723971;0.411622276029056
12;0;"savione";12;100;0
267;0;"savior";267;100;0
38;0;"saviour";38;100;0
99;0;"savir";99;100;0
5;0;"savit";5;100;0
0;102;"savita";102;0;100
0;25;"savitri";25;0;100
22;0;"saviyon";22;100;0
0;5;"savoeun";5;0;100
1496;66;"savon";1562;95.7746478873239;4.22535211267606
0;22;"savona";22;0;100
22;0;"savone";22;100;0
0;6;"savonia";6;0;100
15;0;"savonn";15;100;0
0;166;"savonna";166;0;100
0;55;"savonnah";55;0;100
5;26;"savonne";31;16.1290322580645;83.8709677419355
47;0;"savonte";47;100;0
0;5;"savonya";5;0;100
171;12;"savoy";183;93.4426229508197;6.55737704918033
0;23;"savreen";23;0;100
78;0;"savva";78;100;0
71;0;"savvas";71;100;0
0;143;"savvy";143;0;100
0;36;"savy";36;0;100
5;5;"savya";10;50;50
94;0;"savyon";94;100;0
150;0;"saw";150;100;0
6;0;"sawan";6;100;0
0;10;"sawana";10;0;100
0;8;"sawanda";8;0;100
0;24;"sawda";24;0;100
0;5;"sawdah";5;0;100
0;54;"sawsan";54;0;100
36245;7066;"sawyer";43311;83.6854378795225;16.3145621204775
1166;150;"saxon";1316;88.6018237082067;11.3981762917933
481;0;"saxton";481;100;0
30;55;"say";85;35.2941176470588;64.7058823529412
0;914;"saya";914;0;100
0;10;"sayah";10;0;100
0;206;"sayaka";206;0;100
0;15;"sayali";15;0;100
149;0;"sayan";149;100;0
0;84;"sayana";84;0;100
0;22;"sayani";22;0;100
0;5;"sayanna";5;0;100
0;5;"saybree";5;0;100
26;0;"sayd";26;100;0
0;309;"sayda";309;0;100
0;615;"sayde";615;0;100
0;1256;"saydee";1256;0;100
6;0;"sayden";6;100;0
0;389;"saydi";389;0;100
0;507;"saydie";507;0;100
463;0;"sayed";463;100;0
0;5;"sayeda";5;0;100
85;0;"sayeed";85;100;0
0;12;"sayeeda";12;0;100
0;18;"sayeh";18;0;100
0;5;"sayen";5;0;100
309;5;"sayer";314;98.4076433121019;1.59235668789809
0;9;"sayesha";9;0;100
70;0;"sayf";70;100;0
70;338;"sayge";408;17.156862745098;82.843137254902
156;0;"sayid";156;100;0
0;448;"sayla";448;0;100
0;99;"saylah";99;0;100
0;6;"saylar";6;0;100
0;60;"saylee";60;0;100
0;27;"saylem";27;0;100
19;413;"sayler";432;4.39814814814815;95.6018518518518
0;15;"sayli";15;0;100
356;3984;"saylor";4340;8.20276497695852;91.7972350230415
0;18;"saynab";18;0;100
0;32;"sayoko";32;0;100
34;0;"sayon";34;100;0
0;5;"sayona";5;0;100
0;6;"sayonara";6;0;100
0;5;"sayonna";5;0;100
44;0;"sayquan";44;100;0
0;1334;"sayra";1334;0;100
87;62;"sayre";149;58.3892617449664;41.6107382550336
0;12;"sayri";12;0;100
0;135;"saysha";135;0;100
0;29;"sayumi";29;0;100
0;1026;"sayuri";1026;0;100
30;0;"sayveon";30;100;0
205;0;"sayvion";205;100;0
199;0;"sayvon";199;100;0
0;117;"sayward";117;0;100
119;0;"sayyid";119;100;0
0;5;"sbeidy";5;0;100
0;5;"sbrina";5;0;100
16;0;"scan";16;100;0
0;11328;"scarlet";11328;0;100
0;391;"scarleth";391;0;100
0;5;"scarletrose";5;0;100
13;51269;"scarlett";51282;0.0253500253500253;99.97464997465
0;3268;"scarlette";3268;0;100
0;41;"scarlettrose";41;0;100
0;21;"scarlotte";21;0;100
0;12;"scarlytt";12;0;100
28;0;"schad";28;100;0
0;101;"schae";101;0;100
40;0;"schaefer";40;100;0
18;0;"schaeffer";18;100;0
49;0;"schafer";49;100;0
5;0;"schaffer";5;100;0
0;6;"schandra";6;0;100
6;0;"schane";6;100;0
0;15;"schanel";15;0;100
0;5;"schanelle";5;0;100
0;5;"schannon";5;0;100
0;13;"schantel";13;0;100
0;166;"scharlene";166;0;100
0;48;"scharlotte";48;0;100
0;6;"scharron";6;0;100
44;0;"schaun";44;100;0
0;7;"schavon";7;0;100
66;0;"schawn";66;100;0
0;48;"scheherazade";48;0;100
0;32;"schelby";32;0;100
7;5;"schell";12;58.3333333333333;41.6666666666667
0;10;"schelle";10;0;100
0;15;"schelley";15;0;100
0;107;"schelly";107;0;100
0;15;"schenita";15;0;100
0;55;"scherri";55;0;100
0;326;"scherrie";326;0;100
0;522;"scherry";522;0;100
0;335;"scheryl";335;0;100
0;18;"schlonda";18;0;100
0;10;"schmeka";10;0;100
0;5;"schmika";5;0;100
256;0;"schneider";256;100;0
0;25;"schnell";25;0;100
281;0;"schneur";281;100;0
5;0;"scholar";5;100;0
0;5;"scholastica";5;0;100
117;0;"schon";117;100;0
0;5;"schrie";5;0;100
0;6;"schrita";6;0;100
0;25;"schronda";25;0;100
18;28;"schuylar";46;39.1304347826087;60.8695652173913
4001;1198;"schuyler";5199;76.9571071359877;23.0428928640123
0;99;"schwanda";99;0;100
0;35;"schwanna";35;0;100
111;232;"schylar";343;32.3615160349854;67.6384839650146
762;602;"schyler";1364;55.8651026392962;44.1348973607038
15;0;"scion";15;100;0
57;0;"scipio";57;100;0
22;0;"scoey";22;100;0
15;0;"scooter";15;100;0
72;0;"scorpio";72;100;0
13681;11;"scot";13692;99.9196611159801;0.0803388840198656
0;24;"scotia";24;0;100
192;234;"scotland";426;45.0704225352113;54.9295774647887
0;554;"scotlyn";554;0;100
0;199;"scotlynn";199;0;100
769651;2611;"scott";772262;99.661902307766;0.338097692233983
22;0;"scotte";22;100;0
119;448;"scotti";567;20.9876543209877;79.0123456790123
0;5;"scottia";5;0;100
10484;1663;"scottie";12147;86.3093768008562;13.6906231991438
13;0;"scottland";13;100;0
0;205;"scottlyn";205;0;100
0;105;"scottlynn";105;0;100
18494;232;"scotty";18726;98.7610808501549;1.23891914984514
1059;2403;"scout";3462;30.5892547660312;69.4107452339688
12;5;"scyler";17;70.5882352941177;29.4117647058824
6;12;"se";18;33.3333333333333;66.6666666666667
11;10;"sea";21;52.3809523809524;47.6190476190476
0;5;"seaanna";5;0;100
72;0;"seab";72;100;0
491;0;"seaborn";491;100;0
82;0;"seabron";82;100;0
5;0;"seabrook";5;100;0
22;0;"seager";22;100;0
0;440;"seaira";440;0;100
0;5;"seairah";5;0;100
0;222;"seairra";222;0;100
5;0;"seals";5;100;0
5;0;"sealtiel";5;100;0
18;0;"seam";18;100;0
5;0;"seaman";5;100;0
10;0;"seamas";10;100;0
23;0;"seamon";23;100;0
6346;0;"seamus";6346;100;0
415013;2940;"sean";417953;99.2965716240821;0.703428375917866
0;1845;"seana";1845;0;100
18;0;"seanan";18;100;0
36;0;"seananthony";36;100;0
10;0;"seanchristopher";10;100;0
0;14;"seanda";14;0;100
0;8;"seandee";8;0;100
15;0;"seandell";15;100;0
5;0;"seandouglas";5;100;0
0;59;"seandra";59;0;100
5;0;"seandre";5;100;0
0;5;"seandrea";5;0;100
0;11;"seaneen";11;0;100
0;11;"seanette";11;0;100
5;0;"seangabriel";5;100;0
0;17;"seanice";17;0;100
5;0;"seanix";5;100;0
0;7;"seaniya";7;0;100
5;0;"seanjohn";5;100;0
15;0;"seanmatthew";15;100;0
582;0;"seanmichael";582;100;0
517;5;"seann";522;99.0421455938697;0.957854406130268
0;2117;"seanna";2117;0;100
0;61;"seanne";61;0;100
245;0;"seanpatrick";245;100;0
260;0;"seanpaul";260;100;0
0;5;"seanta";5;0;100
0;13;"seantae";13;0;100
0;18;"seante";18;0;100
5;0;"seanthomas";5;100;0
5;0;"seantyler";5;100;0
0;156;"seara";156;0;100
0;5;"searah";5;0;100
226;6;"searcy";232;97.4137931034483;2.58620689655172
0;5;"searia";5;0;100
5;0;"searl";5;100;0
29;0;"searle";29;100;0
0;388;"searra";388;0;100
0;24;"searria";24;0;100
68;0;"sears";68;100;0
0;1156;"season";1156;0;100
0;5;"seasons";5;0;100
30;0;"seath";30;100;0
126;0;"seaton";126;100;0
5;96;"seattle";101;4.95049504950495;95.049504950495
129;0;"seaver";129;100;0
6;0;"seavy";6;100;0
0;89;"seba";89;0;100
41;0;"sebashtian";41;100;0
421;0;"sebastain";421;100;0
5;0;"sebastean";5;100;0
94;0;"sebasthian";94;100;0
11;0;"sebastia";11;100;0
47;0;"sebastiaan";47;100;0
134097;297;"sebastian";134394;99.7790079914282;0.220992008571811
0;282;"sebastiana";282;0;100
871;0;"sebastiano";871;100;0
3247;0;"sebastien";3247;100;0
91;0;"sebastin";91;100;0
11;0;"sebastino";11;100;0
712;0;"sebastion";712;100;0
68;0;"sebastyan";68;100;0
10;0;"sebastyen";10;100;0
25;0;"sebastyn";25;100;0
40;0;"sebatian";40;100;0
13;0;"sebaztian";13;100;0
0;12;"sebella";12;0;100
13;0;"sebern";13;100;0
11;0;"sebero";11;100;0
149;0;"sebert";149;100;0
5;0;"sebestian";5;100;0
6;0;"sebian";6;100;0
5;0;"sebie";5;100;0
0;449;"sebrena";449;0;100
0;29;"sebrenia";29;0;100
0;5;"sebria";5;0;100
0;2104;"sebrina";2104;0;100
0;5;"sebrinia";5;0;100
220;0;"sebron";220;100;0
5;0;"seburn";5;100;0
0;6;"secelia";6;0;100
0;6;"secia";6;0;100
0;301;"secilia";301;0;100
0;125;"secily";125;0;100
9;0;"secondo";9;100;0
0;30;"secora";30;0;100
0;26;"secoya";26;0;100
0;623;"secret";623;0;100
0;10;"secunda";10;0;100
0;5;"secundina";5;0;100
338;0;"secundino";338;100;0
0;166;"seda";166;0;100
108;0;"sedale";108;100;0
0;256;"sedalia";256;0;100
35;0;"sedarius";35;100;0
80;0;"seddrick";80;100;0
0;10;"sedelia";10;0;100
0;5;"sedell";5;0;100
168;0;"sederick";168;100;0
5;0;"sedgie";5;100;0
44;0;"sedgwick";44;100;0
0;38;"sedina";38;0;100
0;5;"sedney";5;0;100
0;1475;"sedona";1475;0;100
0;505;"sedonia";505;0;100
0;132;"sedra";132;0;100
1436;0;"sedric";1436;100;0
3388;0;"sedrick";3388;100;0
0;16;"sedricka";16;0;100
5;0;"sedwick";5;100;0
0;395;"see";395;0;100
0;27;"seela";27;0;100
266;97;"seeley";363;73.2782369146005;26.7217630853994
5;14;"seely";19;26.3157894736842;73.6842105263158
0;1117;"seema";1117;0;100
99;621;"seena";720;13.75;86.25
0;5;"seenaa";5;0;100
0;204;"seerat";204;0;100
0;11;"seerit";11;0;100
0;10;"seeta";10;0;100
0;6;"seeya";6;0;100
11;0;"sef";11;100;0
0;251;"seferina";251;0;100
1217;0;"seferino";1217;100;0
0;156;"sefora";156;0;100
5;0;"sefton";5;100;0
0;35;"segen";35;0;100
101;0;"seger";101;100;0
42;0;"segio";42;100;0
153;0;"segundo";153;100;0
104;102;"sehaj";206;50.4854368932039;49.5145631067961
5;10;"sehajpreet";15;33.3333333333333;66.6666666666667
6;0;"sehajveer";6;100;0
0;132;"seham";132;0;100
0;5;"sehana";5;0;100
0;161;"sehar";161;0;100
5;20;"sehej";25;20;80
0;150;"seher";150;0;100
0;31;"sehrish";31;0;100
7;0;"sei";7;100;0
0;5;"seianna";5;0;100
66;0;"seibert";66;100;0
171;0;"seichi";171;100;0
5;0;"seid";5;100;0
0;17;"seidi";17;0;100
0;5;"seidina";5;0;100
5;0;"seidon";5;100;0
0;273;"seidy";273;0;100
174;0;"seif";174;100;0
5;0;"seigo";5;100;0
40;0;"seiichi";40;100;0
0;7;"seija";7;0;100
445;0;"seiji";445;100;0
6;0;"seiki";6;100;0
28;0;"seikichi";28;100;0
24;11;"seiko";35;68.5714285714286;31.4285714285714
0;54;"seila";54;0;100
0;6;"seily";6;0;100
6;0;"sein";6;100;0
0;40;"seina";40;0;100
0;56;"seini";56;0;100
0;16;"seinna";16;0;100
0;124;"seira";124;0;100
0;885;"seirra";885;0;100
0;17;"seiry";17;0;100
125;0;"seith";125;100;0
5;0;"seitu";5;100;0
74;0;"seiya";74;100;0
0;5;"seja";5;0;100
0;770;"sejal";770;0;100
6;0;"sejin";6;100;0
0;118;"sejla";118;0;100
0;6;"seka";6;0;100
79;63;"sekai";142;55.6338028169014;44.3661971830986
10;0;"sekani";10;100;0
0;5;"sekayi";5;0;100
0;6;"sekena";6;0;100
0;5;"sekia";5;0;100
0;30;"sekina";30;0;100
887;0;"sekou";887;100;0
0;5;"sekura";5;0;100
0;1075;"sela";1075;0;100
98;7008;"selah";7106;1.37911623979735;98.6208837602026
0;165;"selam";165;0;100
0;22;"selamawit";22;0;100
0;20;"selana";20;0;100
10;0;"selasi";10;100;0
50;0;"selassie";50;100;0
0;10;"selba";10;0;100
10;0;"selbert";10;100;0
683;264;"selby";947;72.1224920802534;27.8775079197466
0;86;"selda";86;0;100
373;0;"selden";373;100;0
963;0;"seldon";963;100;0
0;24;"seleah";24;0;100
0;45;"seleana";45;0;100
0;5;"selebrity";5;0;100
0;11;"selecia";11;0;100
21;0;"seledonio";21;100;0
21;0;"seleem";21;100;0
0;74;"seleen";74;0;100
0;214;"seleena";214;0;100
0;10;"seleina";10;0;100
0;6;"selema";6;0;100
0;98;"selen";98;0;100
57;47869;"selena";47926;0.118933355589868;99.8810666444101
0;6;"selenamarie";6;0;100
5;6317;"selene";6322;0.079088895919013;99.920911104081
0;69;"seleni";69;0;100
0;457;"selenia";457;0;100
0;36;"selenna";36;0;100
0;63;"selenne";63;0;100
0;57;"seleny";57;0;100
0;29;"selest";29;0;100
0;712;"seleste";712;0;100
5;5;"selester";10;50;50
0;16;"selestina";16;0;100
0;41;"selestine";41;0;100
62;0;"selestino";62;100;0
0;131;"seleta";131;0;100
0;65;"seletha";65;0;100
0;6;"selethia";6;0;100
0;6;"seleyna";6;0;100
0;684;"selia";684;0;100
0;5;"seliah";5;0;100
0;5;"seliana";5;0;100
0;18;"selica";18;0;100
0;76;"selicia";76;0;100
154;0;"selig";154;100;0
0;8;"selihom";8;0;100
0;10;"selika";10;0;100
462;0;"selim";462;100;0
0;50;"selima";50;0;100
0;797;"selin";797;0;100
0;17256;"selina";17256;0;100
0;451;"selinda";451;0;100
0;291;"seline";291;0;100
0;11;"selinna";11;0;100
0;83;"selisa";83;0;100
0;87;"selita";87;0;100
0;5;"seliyah";5;0;100
0;21;"sella";21;0;100
22;0;"sellers";22;100;0
5;0;"sellie";5;100;0
321;23346;"selma";23667;1.35631892508556;98.6436810749144
51;0;"selman";51;100;0
684;10;"selmer";694;98.5590778097983;1.44092219020173
6;0;"selmon";6;100;0
0;5;"selphie";5;0;100
125;0;"selso";125;100;0
10;0;"selton";10;100;0
0;54;"selva";54;0;100
5;0;"selven";5;100;0
0;16;"selvia";16;0;100
1110;0;"selvin";1110;100;0
10;0;"selvyn";10;100;0
1380;10;"selwyn";1390;99.2805755395683;0.719424460431655
0;5;"selyn";5;0;100
0;126;"selyna";126;0;100
178;0;"sem";178;100;0
0;178;"sema";178;0;100
6;0;"semahj";6;100;0
0;17;"semaiah";17;0;100
5668;1724;"semaj";7392;76.6774891774892;23.3225108225108
22;152;"semaja";174;12.6436781609195;87.3563218390805
5;5;"semajae";10;50;50
0;26;"semajah";26;0;100
5;0;"semajai";5;100;0
57;0;"semajay";57;100;0
107;26;"semaje";133;80.4511278195489;19.5488721804511
0;19;"semantha";19;0;100
0;12;"semara";12;0;100
0;12;"semaria";12;0;100
5;0;"semarias";5;100;0
0;103;"semaya";103;0;100
0;5;"semayah";5;0;100
0;26;"semeka";26;0;100
0;6;"semeko";6;0;100
5;0;"semere";5;100;0
0;6;"semetria";6;0;100
0;10;"semhal";10;0;100
0;40;"semhar";40;0;100
0;47;"semia";47;0;100
0;64;"semiah";64;0;100
0;7;"semico";7;0;100
35;0;"semih";35;100;0
0;30;"semika";30;0;100
0;31;"semiko";31;0;100
5;0;"semion";5;100;0
195;0;"semir";195;100;0
0;405;"semira";405;0;100
0;15;"semirah";15;0;100
163;0;"semisi";163;100;0
0;47;"semiya";47;0;100
0;129;"semiyah";129;0;100
14;0;"semmie";14;100;0
12;5;"semon";17;70.5882352941177;29.4117647058824
0;247;"semone";247;0;100
0;6;"semora";6;0;100
0;53;"semra";53;0;100
0;143;"semya";143;0;100
0;17;"semyah";17;0;100
6;0;"semyon";6;100;0
0;6;"semyra";6;0;100
22;0;"sen";22;100;0
144;2261;"sena";2405;5.98752598752599;94.012474012474
54;0;"senaca";54;100;0
36;0;"senad";36;100;0
0;15;"senada";15;0;100
90;104;"senai";194;46.3917525773196;53.6082474226804
0;1182;"senaida";1182;0;100
8;0;"senaido";8;100;0
0;38;"senait";38;0;100
0;5;"senaiya";5;0;100
64;0;"senan";64;100;0
16;0;"senator";16;100;0
71;0;"senay";71;100;0
0;58;"senaya";58;0;100
150;0;"sencere";150;100;0
0;7;"senchal";7;0;100
0;10;"senda";10;0;100
84;0;"sender";84;100;0
0;41;"sendi";41;0;100
0;425;"sendy";425;0;100
0;6;"seneatha";6;0;100
1584;1506;"seneca";3090;51.2621359223301;48.7378640776699
27;0;"senecca";27;100;0
0;12;"seneka";12;0;100
20;0;"senen";20;100;0
0;27;"senequa";27;0;100
0;5;"seneque";5;0;100
0;78;"senetra";78;0;100
0;5;"senetria";5;0;100
0;11;"senetta";11;0;100
239;84;"seng";323;73.9938080495356;26.0061919504644
0;6;"senga";6;0;100
0;493;"senia";493;0;100
0;73;"seniah";73;0;100
72;27;"senica";99;72.7272727272727;27.2727272727273
0;5;"senida";5;0;100
0;33;"senie";33;0;100
0;28;"senika";28;0;100
0;6;"senikka";6;0;100
0;21;"seniqua";21;0;100
0;166;"senita";166;0;100
0;148;"seniya";148;0;100
0;160;"seniyah";160;0;100
0;11;"senja";11;0;100
33;473;"senna";506;6.52173913043478;93.4782608695652
11;0;"senneca";11;100;0
6;0;"sennett";6;100;0
0;187;"sennie";187;0;100
0;11;"senobia";11;0;100
75;0;"senon";75;100;0
0;6;"senona";6;0;100
0;1003;"senora";1003;0;100
0;17;"senoria";17;0;100
0;6;"senorina";6;0;100
0;6;"senorita";6;0;100
0;116;"senovia";116;0;100
29;0;"senovio";29;100;0
0;5;"sensi";5;0;100
0;314;"senta";314;0;100
33;0;"sentell";33;100;0
0;5;"senteria";5;0;100
0;66;"sentoria";66;0;100
5;0;"sentrell";5;100;0
0;114;"senya";114;0;100
0;6;"senyah";6;0;100
205;0;"seon";205;100;0
0;56;"seona";56;0;100
0;15;"seonna";15;0;100
0;5;"seoyeon";5;0;100
0;5;"seoyoon";5;0;100
38;0;"sepehr";38;100;0
13;0;"seph";13;100;0
0;35;"sephanie";35;0;100
0;10;"sephia";10;0;100
0;21;"sephina";21;0;100
0;83;"sephira";83;0;100
70;0;"sephiroth";70;100;0
0;656;"sephora";656;0;100
0;40;"sephra";40;0;100
0;5;"sepia";5;0;100
0;25;"sepideh";25;0;100
5;0;"sepp";5;100;0
0;6;"seprina";6;0;100
0;1960;"september";1960;0;100
0;42;"seqouia";42;0;100
325;0;"sequan";325;100;0
0;49;"sequana";49;0;100
0;5;"sequeena";5;0;100
0;29;"sequena";29;0;100
0;7;"sequetta";7;0;100
0;25;"sequia";25;0;100
0;8;"sequila";8;0;100
0;5;"sequina";5;0;100
0;52;"sequioa";52;0;100
0;200;"sequita";200;0;100
343;3174;"sequoia";3517;9.75263008245664;90.2473699175434
0;17;"sequoria";17;0;100
5;488;"sequoya";493;1.01419878296146;98.9858012170385
171;441;"sequoyah";612;27.9411764705882;72.0588235294118
0;5;"sequoyia";5;0;100
0;1459;"sera";1459;0;100
0;5;"serach";5;0;100
0;5;"serae";5;0;100
20;0;"serafim";20;100;0
0;13;"serafima";13;0;100
1646;0;"serafin";1646;100;0
0;2224;"serafina";2224;0;100
0;5;"serafine";5;0;100
265;0;"serafino";265;100;0
0;607;"serah";607;0;100
0;46;"serai";46;0;100
6;266;"seraiah";272;2.20588235294118;97.7941176470588
42;0;"seraj";42;100;0
0;24;"serana";24;0;100
19;6;"serani";25;76;24
15;12;"seraph";27;55.5555555555556;44.4444444444444
56;158;"seraphim";214;26.1682242990654;73.8317757009346
21;5;"seraphin";26;80.7692307692308;19.2307692307692
0;1626;"seraphina";1626;0;100
10;425;"seraphine";435;2.29885057471264;97.7011494252874
291;0;"serapio";291;100;0
0;18;"seras";18;0;100
0;10;"seray";10;0;100
0;80;"seraya";80;0;100
0;89;"serayah";89;0;100
18;0;"serbando";18;100;0
5;0;"serdar";5;100;0
0;10;"sereana";10;0;100
0;6;"sereda";6;0;100
0;326;"sereen";326;0;100
0;266;"sereena";266;0;100
0;5;"sereina";5;0;100
0;6;"serel";6;0;100
20;706;"seren";726;2.75482093663912;97.2451790633609
16;39736;"serena";39752;0.0402495471925941;99.9597504528074
0;141;"serenah";141;0;100
0;12;"serenaty";12;0;100
0;32;"serendipity";32;0;100
0;2312;"serene";2312;0;100
0;11;"serenety";11;0;100
0;46;"serenia";46;0;100
0;216;"serenidy";216;0;100
0;273;"serenitee";273;0;100
0;18;"serenitey";18;0;100
0;627;"sereniti";627;0;100
0;182;"serenitie";182;0;100
64;50156;"serenity";50220;0.127439267224213;99.8725607327758
0;6;"serenityrose";6;0;100
0;193;"serenna";193;0;100
0;5;"serennity";5;0;100
0;26;"serentiy";26;0;100
0;40;"seresa";40;0;100
0;43;"sereta";43;0;100
0;518;"seretha";518;0;100
0;38;"seretta";38;0;100
1538;0;"serge";1538;100;0
352;0;"sergei";352;100;0
408;0;"sergey";408;100;0
43;0;"sergi";43;100;0
5;0;"sergie";5;100;0
74210;356;"sergio";74566;99.5225706085884;0.477429391411635
10;0;"sergiojr";10;100;0
5;0;"serguio";5;100;0
5;0;"serhat";5;100;0
0;148;"seri";148;0;100
0;23;"seria";23;0;100
0;388;"seriah";388;0;100
0;17;"seriana";17;0;100
0;23;"serianna";23;0;100
0;10;"serica";10;0;100
0;5;"seriena";5;0;100
152;0;"serigne";152;100;0
39;0;"serigo";39;100;0
0;78;"serin";78;0;100
0;5512;"serina";5512;0;100
0;11;"serinah";11;0;100
0;57;"serine";57;0;100
0;5;"seriniti";5;0;100
0;931;"serinity";931;0;100
12;0;"serious";12;100;0
0;5;"serissa";5;0;100
0;1196;"serita";1196;0;100
0;5;"seritta";5;0;100
0;33;"seriya";33;0;100
0;190;"seriyah";190;0;100
16;0;"serj";16;100;0
984;0;"serjio";984;100;0
13;0;"serkan";13;100;0
0;5;"serly";5;0;100
0;8;"seroba";8;0;100
0;710;"serra";710;0;100
0;10;"serrah";10;0;100
0;110;"serrena";110;0;100
0;13;"serrenity";13;0;100
0;165;"serria";165;0;100
0;13;"serriah";13;0;100
0;233;"serrina";233;0;100
0;57;"serrita";57;0;100
2049;0;"servando";2049;100;0
0;18;"seryn";18;0;100
0;196;"seryna";196;0;100
0;5;"seryniti";5;0;100
0;33;"serynity";33;0;100
0;5;"sesalie";5;0;100
468;0;"sesar";468;100;0
16;0;"sesario";16;100;0
0;26;"sesen";26;0;100
0;36;"sesha";36;0;100
0;91;"sesilia";91;0;100
0;20;"sesily";20;0;100
0;23;"sesley";23;0;100
0;19;"seslie";19;0;100
0;6;"sessily";6;0;100
10;0;"set";10;100;0
0;20;"seta";20;0;100
0;5;"setara";5;0;100
0;179;"setareh";179;0;100
0;36;"setayesh";36;0;100
0;11;"seteria";11;0;100
158965;494;"seth";159459;99.6902024971936;0.309797502806364
39;0;"sethan";39;100;0
11;0;"sethaniel";11;100;0
32;0;"sethe";32;100;0
45;10;"seton";55;81.8181818181818;18.1818181818182
0;347;"setsuko";347;0;100
5;0;"setsuo";5;100;0
5;0;"settimio";5;100;0
5;0;"seumas";5;100;0
79;0;"seung";79;100;0
0;49;"seva";49;0;100
0;32;"sevaeh";32;0;100
165;0;"sevag";165;100;0
42;0;"sevak";42;100;0
242;21;"sevan";263;92.0152091254753;7.98479087452472
0;134;"sevana";134;0;100
0;21;"sevanah";21;0;100
0;173;"sevanna";173;0;100
0;82;"sevannah";82;0;100
0;6;"sevara";6;0;100
0;25;"sevasti";25;0;100
447;0;"sevastian";447;100;0
17;0;"sevaughn";17;100;0
0;12;"sevda";12;0;100
185;0;"seve";185;100;0
0;6;"seveah";6;0;100
1365;605;"seven";1970;69.2893401015228;30.7106598984772
0;5;"sevena";5;0;100
5;0;"seveon";5;100;0
5;0;"sever";5;100;0
0;456;"severa";456;0;100
5;0;"severen";5;100;0
0;5;"severia";5;0;100
745;0;"severiano";745;100;0
783;0;"severin";783;100;0
0;94;"severina";94;0;100
0;38;"severine";38;0;100
291;0;"severino";291;100;0
5;0;"severio";5;100;0
126;0;"severn";126;100;0
1363;0;"severo";1363;100;0
29;0;"severt";29;100;0
60;0;"severus";60;100;0
15;0;"severyn";15;100;0
0;18;"sevi";18;0;100
0;5;"seviah";5;0;100
0;190;"sevilla";190;0;100
50;78;"seville";128;39.0625;60.9375
275;70;"sevin";345;79.7101449275362;20.2898550724638
0;11;"sevina";11;0;100
0;6;"sevinch";6;0;100
35;0;"sevion";35;100;0
182;6;"sevon";188;96.8085106382979;3.19148936170213
25;0;"sevren";25;100;0
88;0;"sevrin";88;100;0
16;0;"sevryn";16;100;0
10;0;"sevy";10;100;0
248;359;"sevyn";607;40.8566721581549;59.1433278418451
0;15;"sevynn";15;0;100
11;0;"sewall";11;100;0
526;0;"seward";526;100;0
437;0;"sewell";437;100;0
0;5;"sewilla";5;0;100
0;5;"sewit";5;0;100
17;0;"sexton";17;100;0
0;5;"seya";5;0;100
0;29;"seychelle";29;0;100
0;36;"seydi";36;0;100
52;0;"seydina";52;100;0
89;0;"seydou";89;100;0
122;0;"seyed";122;100;0
5;0;"seyha";5;100;0
0;42;"seyla";42;0;100
0;61;"seylah";61;0;100
0;65;"seymone";65;0;100
259;0;"seymore";259;100;0
12848;10;"seymour";12858;99.9222274070618;0.0777725929382486
5;0;"seymoure";5;100;0
0;135;"seynabou";135;0;100
40;0;"seyon";40;100;0
0;6;"seyram";6;0;100
6;0;"seyvon";6;100;0
122;629;"sha";751;16.2450066577896;83.7549933422104
5;0;"shaad";5;100;0
0;224;"shaakira";224;0;100
0;11;"shaakirah";11;0;100
0;5;"shaaliyah";5;0;100
0;14;"shaam";14;0;100
1822;0;"shaan";1822;100;0
0;58;"shaana";58;0;100
0;12;"shaanvi";12;0;100
56;0;"shaarav";56;100;0
0;237;"shaaron";237;0;100
5;0;"shaarwin";5;100;0
0;116;"shaasia";116;0;100
10;0;"shaaz";10;100;0
5;0;"shaba";5;100;0
17;0;"shabab";17;100;0
28;0;"shabaka";28;100;0
22;0;"shaban";22;100;0
0;159;"shabana";159;0;100
18;0;"shabaz";18;100;0
271;0;"shabazz";271;100;0
12;0;"shabd";12;100;0
0;5;"shabina";5;0;100
0;409;"shabnam";409;0;100
16;0;"shaborn";16;100;0
0;61;"shabre";61;0;100
0;114;"shabrea";114;0;100
0;111;"shabree";111;0;100
0;70;"shabreka";70;0;100
0;10;"shabri";10;0;100
0;395;"shabria";395;0;100
0;5;"shabriana";5;0;100
0;6;"shabrie";6;0;100
0;5;"shabriel";5;0;100
0;10;"shabrika";10;0;100
0;43;"shabrina";43;0;100
0;5;"shabrittany";5;0;100
30;0;"shabsi";30;100;0
0;333;"shacara";333;0;100
0;10;"shacari";10;0;100
0;5;"shacaria";5;0;100
0;11;"shacarla";11;0;100
0;74;"shacarra";74;0;100
11;0;"shachar";11;100;0
0;5;"shachi";5;0;100
5;0;"shack";5;100;0
0;71;"shacola";71;0;100
0;39;"shacole";39;0;100
0;85;"shaconda";85;0;100
0;5;"shacondra";5;0;100
0;18;"shaconna";18;0;100
0;321;"shacora";321;0;100
11;0;"shacorey";11;100;0
0;6;"shacori";6;0;100
0;170;"shacoria";170;0;100
0;10;"shacorra";10;0;100
0;5;"shacourtney";5;0;100
0;187;"shacoya";187;0;100
0;11;"shacoyia";11;0;100
6;0;"shacquille";6;100;0
4739;0;"shad";4739;100;0
0;596;"shada";596;0;100
0;879;"shadae";879;0;100
0;283;"shadai";283;0;100
0;23;"shadaisha";23;0;100
0;35;"shadaja";35;0;100
0;7;"shadajah";7;0;100
0;10;"shadale";10;0;100
0;11;"shadan";11;0;100
0;109;"shadana";109;0;100
0;6;"shadany";6;0;100
0;61;"shadara";61;0;100
0;43;"shadaria";43;0;100
5;0;"shadarian";5;100;0
25;0;"shadarius";25;100;0
0;10;"shadarria";10;0;100
0;20;"shadasha";20;0;100
0;129;"shadasia";129;0;100
0;25;"shadava";25;0;100
0;110;"shadavia";110;0;100
0;104;"shadawn";104;0;100
0;350;"shaday";350;0;100
0;123;"shadaya";123;0;100
0;5;"shadayah";5;0;100
243;0;"shadd";243;100;0
38;136;"shaddai";174;21.8390804597701;78.1609195402299
19;0;"shaddix";19;100;0
10;0;"shaddrick";10;100;0
5;0;"shaddy";5;100;0
956;841;"shade";1797;53.1997774067891;46.8002225932109
0;52;"shadea";52;0;100
73;91;"shadee";164;44.5121951219512;55.4878048780488
181;0;"shadeed";181;100;0
0;5;"shadeen";5;0;100
0;50;"shadeja";50;0;100
0;5;"shadejah";5;0;100
0;6;"shadel";6;0;100
5;66;"shadell";71;7.04225352112676;92.9577464788732
274;203;"shaden";477;57.4423480083857;42.5576519916143
0;6;"shadena";6;0;100
0;10;"shadera";10;0;100
0;11;"shaderrica";11;0;100
0;7;"shadestiny";7;0;100
0;16;"shadey";16;0;100
660;245;"shadi";905;72.9281767955801;27.0718232044199
0;698;"shadia";698;0;100
0;26;"shadiamon";26;0;100
0;373;"shadiamond";373;0;100
16;97;"shadie";113;14.1592920353982;85.8407079646018
0;6;"shadijah";6;0;100
0;44;"shadimon";44;0;100
0;10;"shadin";10;0;100
0;6;"shadina";6;0;100
0;5;"shadiqua";5;0;100
0;5;"shadira";5;0;100
0;36;"shadiya";36;0;100
0;86;"shadiyah";86;0;100
6;0;"shadley";6;100;0
146;0;"shadman";146;100;0
187;68;"shadoe";255;73.3333333333333;26.6666666666667
33;44;"shadon";77;42.8571428571429;57.1428571428571
0;5;"shadona";5;0;100
0;638;"shadonna";638;0;100
0;26;"shadora";26;0;100
476;418;"shadow";894;53.2438478747204;46.7561521252796
0;6;"shadra";6;0;100
653;0;"shadrach";653;100;0
111;0;"shadrack";111;100;0
0;22;"shadreka";22;0;100
11;0;"shadric";11;100;0
527;0;"shadrick";527;100;0
0;16;"shadricka";16;0;100
0;11;"shadrika";11;0;100
11;0;"shadron";11;100;0
18;0;"shadwick";18;100;0
313;202;"shady";515;60.7766990291262;39.2233009708738
0;6;"shadya";6;0;100
5;12;"shadyn";17;29.4117647058824;70.5882352941177
1459;5172;"shae";6631;22.0027145226964;77.9972854773036
0;5;"shaeann";5;0;100
16;0;"shaeden";16;100;0
21;0;"shaedon";21;100;0
7;0;"shaefer";7;100;0
26;0;"shael";26;100;0
0;1066;"shaela";1066;0;100
0;28;"shaelah";28;0;100
0;24;"shaelan";24;0;100
0;5;"shaelea";5;0;100
0;439;"shaelee";439;0;100
0;166;"shaeleigh";166;0;100
0;7;"shaelen";7;0;100
0;33;"shaelene";33;0;100
0;63;"shaeley";63;0;100
0;56;"shaeli";56;0;100
0;47;"shaelie";47;0;100
0;287;"shaelin";287;0;100
0;145;"shaely";145;0;100
0;3180;"shaelyn";3180;0;100
0;1626;"shaelynn";1626;0;100
0;38;"shaelynne";38;0;100
12;0;"shaemus";12;100;0
52;0;"shaen";52;100;0
0;540;"shaena";540;0;100
0;6;"shaenna";6;0;100
8;0;"shafee";8;100;0
6;0;"shafeeq";6;100;0
0;14;"shafeqah";14;0;100
119;0;"shafer";119;100;0
43;0;"shaffer";43;100;0
52;0;"shafi";52;100;0
0;5;"shafia";5;0;100
66;0;"shafin";66;100;0
0;7;"shafina";7;0;100
80;0;"shafiq";80;100;0
0;5;"shafon";5;0;100
0;19;"shafonda";19;0;100
103;0;"shaft";103;100;0
105;0;"shafter";105;100;0
12;0;"shafton";12;100;0
0;20;"shaghayegh";20;0;100
0;54;"shaguana";54;0;100
0;6;"shaguanda";6;0;100
0;5;"shaguanna";5;0;100
0;58;"shagun";58;0;100
324;10;"shah";334;97.0059880239521;2.9940119760479
5;0;"shahaan";5;100;0
135;0;"shahab";135;100;0
5;168;"shahad";173;2.89017341040462;97.1098265895954
0;38;"shahada";38;0;100
0;43;"shahadah";43;0;100
205;0;"shahan";205;100;0
0;129;"shahana";129;0;100
0;5;"shahanna";5;0;100
0;212;"shahara";212;0;100
0;6;"shaharra";6;0;100
41;0;"shahbaz";41;100;0
0;487;"shahd";487;0;100
10;119;"shahed";129;7.75193798449612;92.2480620155039
1057;0;"shaheed";1057;100;0
0;11;"shaheeda";11;0;100
0;5;"shaheedah";5;0;100
675;0;"shaheem";675;100;0
464;142;"shaheen";606;76.5676567656766;23.4323432343234
337;0;"shaheer";337;100;0
0;24;"shaheerah";24;0;100
209;0;"shaheim";209;100;0
5;0;"shaher";5;100;0
0;18;"shahera";18;0;100
0;24;"shaherah";24;0;100
625;0;"shahid";625;100;0
0;118;"shahida";118;0;100
0;227;"shahidah";227;0;100
7;0;"shahied";7;100;0
71;0;"shahiem";71;100;0
74;0;"shahil";74;100;0
276;0;"shahin";276;100;0
0;24;"shahina";24;0;100
102;0;"shahir";102;100;0
0;72;"shahira";72;0;100
0;5;"shahirah";5;0;100
0;99;"shahla";99;0;100
72;0;"shahmeer";72;100;0
33;0;"shahmir";33;100;0
34;0;"shahn";34;100;0
0;41;"shahna";41;0;100
5;0;"shahnawaz";5;100;0
0;39;"shahnaz";39;0;100
5;0;"shahraan";5;100;0
64;0;"shahram";64;100;0
0;11;"shahrazad";11;0;100
0;5;"shahreen";5;0;100
21;0;"shahriar";21;100;0
64;0;"shahrukh";64;100;0
15;0;"shahryar";15;100;0
0;124;"shahrzad";124;0;100
87;0;"shahzad";87;100;0
173;0;"shahzaib";173;100;0
49;0;"shahzain";49;100;0
50;0;"shahzeb";50;100;0
0;16;"shahzoda";16;0;100
1042;1157;"shai";2199;47.3851750795816;52.6148249204184
0;59;"shaia";59;0;100
0;42;"shaian";42;0;100
0;16;"shaiana";16;0;100
0;331;"shaiann";331;0;100
0;45;"shaianna";45;0;100
0;439;"shaianne";439;0;100
0;6;"shaiasia";6;0;100
5;0;"shaid";5;100;0
0;67;"shaida";67;0;100
65;0;"shaiden";65;100;0
0;58;"shaiel";58;0;100
0;5;"shaienne";5;0;100
11;0;"shaiheem";11;100;0
5;0;"shaik";5;100;0
5;0;"shaikeem";5;100;0
36;0;"shaikh";36;100;0
0;5;"shaikha";5;0;100
74;0;"shail";74;100;0
0;2947;"shaila";2947;0;100
0;166;"shailah";166;0;100
0;451;"shailee";451;0;100
0;29;"shaileen";29;0;100
0;6;"shaileigh";6;0;100
70;5;"shailen";75;93.3333333333333;6.66666666666667
0;165;"shailene";165;0;100
0;375;"shailey";375;0;100
0;144;"shaili";144;0;100
0;5;"shailie";5;0;100
0;16;"shailin";16;0;100
0;161;"shaily";161;0;100
0;754;"shailyn";754;0;100
0;384;"shailynn";384;0;100
0;5;"shailynne";5;0;100
0;201;"shaima";201;0;100
0;11;"shaimaa";11;0;100
1169;26;"shain";1195;97.8242677824268;2.17573221757322
18;11375;"shaina";11393;0.157991749319758;99.8420082506803
0;24;"shainah";24;0;100
0;672;"shaindel";672;0;100
0;1579;"shaindy";1579;0;100
990;222;"shaine";1212;81.6831683168317;18.3168316831683
0;9;"shainia";9;0;100
0;137;"shainna";137;0;100
45;0;"shaiquan";45;100;0
0;358;"shaira";358;0;100
0;10;"shairon";10;0;100
0;5;"shaisha";5;0;100
0;10;"shaista";10;0;100
0;108;"shaivi";108;0;100
0;31;"shaiya";31;0;100
0;5;"shaiyan";5;0;100
56;142;"shajuan";198;28.2828282828283;71.7171717171717
0;241;"shajuana";241;0;100
0;16;"shajuanna";16;0;100
617;142;"shaka";759;81.2911725955204;18.7088274044796
69;5;"shakai";74;93.2432432432432;6.75675675675676
0;23;"shakaila";23;0;100
0;25;"shakaira";25;0;100
0;5;"shakaiya";5;0;100
0;207;"shakala";207;0;100
0;5;"shakalia";5;0;100
0;6;"shakana";6;0;100
10;0;"shakar";10;100;0
0;896;"shakara";896;0;100
12;301;"shakari";313;3.83386581469649;96.1661341853035
0;69;"shakaria";69;0;100
0;29;"shakarra";29;0;100
0;58;"shakaya";58;0;100
0;5;"shakayia";5;0;100
0;1702;"shakayla";1702;0;100
0;8;"shakaylah";8;0;100
0;138;"shakea";138;0;100
0;5;"shakeah";5;0;100
45;0;"shakeal";45;100;0
0;29;"shakeara";29;0;100
0;6;"shakeba";6;0;100
6;0;"shaked";6;100;0
0;82;"shakeda";82;0;100
0;101;"shakedra";101;0;100
6;0;"shakee";6;100;0
0;14;"shakeeka";14;0;100
212;0;"shakeel";212;100;0
0;257;"shakeela";257;0;100
0;28;"shakeelah";28;0;100
745;0;"shakeem";745;100;0
0;629;"shakeema";629;0;100
0;16;"shakeemah";16;0;100
10;0;"shakeen";10;100;0
0;508;"shakeena";508;0;100
0;10;"shakeenah";10;0;100
24;0;"shakeer";24;100;0
0;154;"shakeera";154;0;100
0;94;"shakeerah";94;0;100
0;147;"shakeeta";147;0;100
0;328;"shakeia";328;0;100
0;5;"shakeidra";5;0;100
55;0;"shakeil";55;100;0
0;181;"shakeila";181;0;100
48;0;"shakeim";48;100;0
0;23;"shakeima";23;0;100
0;328;"shakeira";328;0;100
0;197;"shakeisha";197;0;100
0;118;"shakeita";118;0;100
0;212;"shakeitha";212;0;100
0;17;"shakeithia";17;0;100
28;16;"shakel";44;63.6363636363636;36.3636363636364
0;456;"shakela";456;0;100
0;7;"shakelah";7;0;100
0;218;"shakelia";218;0;100
29;10;"shakell";39;74.3589743589744;25.6410256410256
0;7;"shakella";7;0;100
0;434;"shakema";434;0;100
0;59;"shakemia";59;0;100
0;5;"shakemmia";5;0;100
0;387;"shakena";387;0;100
0;255;"shakendra";255;0;100
0;13;"shakendria";13;0;100
0;32;"shakenia";32;0;100
0;52;"shakenna";52;0;100
0;152;"shakenya";152;0;100
32;0;"shaker";32;100;0
0;1374;"shakera";1374;0;100
0;29;"shakerah";29;0;100
0;999;"shakeria";999;0;100
0;287;"shakerra";287;0;100
0;119;"shakerria";119;0;100
0;138;"shakesha";138;0;100
0;43;"shakeshia";43;0;100
0;375;"shaketa";375;0;100
0;91;"shaketha";91;0;100
0;15;"shakethia";15;0;100
0;30;"shaketia";30;0;100
0;6;"shaketra";6;0;100
0;98;"shaketta";98;0;100
0;47;"shakeva";47;0;100
0;125;"shakevia";125;0;100
0;718;"shakeya";718;0;100
0;12;"shakeyah";12;0;100
0;5;"shakeyda";5;0;100
0;41;"shakeyia";41;0;100
0;189;"shakeyla";189;0;100
0;34;"shakeyra";34;0;100
0;10;"shakeyta";10;0;100
0;98;"shakhia";98;0;100
0;5;"shakhzoda";5;0;100
53;0;"shaki";53;100;0
0;2358;"shakia";2358;0;100
0;158;"shakiah";158;0;100
0;93;"shakiara";93;0;100
22;0;"shakib";22;100;0
0;24;"shakida";24;0;100
0;21;"shakiea";21;0;100
44;0;"shakiel";44;100;0
0;22;"shakiela";22;0;100
37;0;"shakiem";37;100;0
0;379;"shakiera";379;0;100
0;32;"shakierra";32;0;100
0;7;"shakiesha";7;0;100
0;12;"shakieta";12;0;100
172;5;"shakil";177;97.1751412429379;2.82485875706215
0;536;"shakila";536;0;100
0;30;"shakilah";30;0;100
0;52;"shakilya";52;0;100
429;0;"shakim";429;100;0
0;627;"shakima";627;0;100
0;668;"shakina";668;0;100
0;147;"shakinah";147;0;100
5;0;"shaking";5;100;0
1053;10;"shakir";1063;99.0592662276576;0.940733772342427
0;8084;"shakira";8084;0;100
0;802;"shakirah";802;0;100
0;43;"shakiria";43;0;100
0;138;"shakirra";138;0;100
0;234;"shakisha";234;0;100
0;1202;"shakita";1202;0;100
0;13;"shakitha";13;0;100
0;6;"shakitta";6;0;100
0;5;"shakiva";5;0;100
0;798;"shakiya";798;0;100
0;271;"shakiyah";271;0;100
0;398;"shakiyla";398;0;100
0;5;"shakka";5;0;100
0;23;"shakkia";23;0;100
6;0;"shakobe";6;100;0
0;32;"shakonda";32;0;100
17;0;"shakor";17;100;0
0;92;"shakora";92;0;100
0;5;"shakoria";5;0;100
0;45;"shakota";45;0;100
0;96;"shakoya";96;0;100
0;5;"shakria";5;0;100
0;59;"shakthi";59;0;100
5;96;"shakti";101;4.95049504950495;95.049504950495
12;0;"shakuan";12;100;0
1132;9;"shakur";1141;99.2112182296231;0.788781770376862
0;197;"shakura";197;0;100
0;15;"shakuria";15;0;100
5;0;"shakwan";5;100;0
10;0;"shakwon";10;100;0
0;178;"shakya";178;0;100
0;53;"shakyah";53;0;100
5;0;"shakye";5;100;0
0;108;"shakyia";108;0;100
0;5;"shakyiah";5;0;100
0;353;"shakyla";353;0;100
0;1130;"shakyra";1130;0;100
0;53;"shakyrah";53;0;100
0;16;"shakyria";16;0;100
0;2061;"shala";2061;0;100
0;126;"shalae";126;0;100
0;138;"shalah";138;0;100
0;19;"shalai";19;0;100
0;87;"shalaina";87;0;100
0;116;"shalaine";116;0;100
0;5;"shalaka";5;0;100
6;0;"shalako";6;100;0
83;234;"shalamar";317;26.1829652996845;73.8170347003155
5;112;"shalan";117;4.27350427350427;95.7264957264957
0;574;"shalana";574;0;100
0;1744;"shalanda";1744;0;100
0;241;"shalandra";241;0;100
0;105;"shalandria";105;0;100
0;429;"shalane";429;0;100
0;11;"shalani";11;0;100
0;5;"shalanna";5;0;100
0;5;"shalanta";5;0;100
0;5;"shalante";5;0;100
0;61;"shalaunda";61;0;100
0;5;"shalaundra";5;0;100
0;125;"shalawn";125;0;100
0;112;"shalay";112;0;100
0;539;"shalaya";539;0;100
0;94;"shalayah";94;0;100
0;28;"shalayla";28;0;100
0;97;"shalayna";97;0;100
0;64;"shalayne";64;0;100
56;21;"shale";77;72.7272727272727;27.2727272727273
0;389;"shalea";389;0;100
0;492;"shaleah";492;0;100
0;11;"shalean";11;0;100
0;16;"shalease";16;0;100
0;79;"shalece";79;0;100
0;26;"shalecia";26;0;100
0;1073;"shalee";1073;0;100
0;6;"shaleece";6;0;100
38;0;"shaleek";38;100;0
0;547;"shaleen";547;0;100
0;217;"shaleena";217;0;100
0;17;"shaleesa";17;0;100
0;16;"shaleese";16;0;100
0;49;"shalei";49;0;100
0;13;"shaleia";13;0;100
0;366;"shaleigh";366;0;100
0;10;"shaleigha";10;0;100
0;60;"shaleka";60;0;100
11;72;"shalen";83;13.2530120481928;86.7469879518072
0;966;"shalena";966;0;100
0;848;"shalene";848;0;100
0;9;"shalesa";9;0;100
0;209;"shalese";209;0;100
0;26;"shalesha";26;0;100
0;5;"shaleshia";5;0;100
0;107;"shaleta";107;0;100
0;189;"shaletha";189;0;100
0;12;"shalethia";12;0;100
0;60;"shaletta";60;0;100
0;16;"shalette";16;0;100
72;0;"shalev";72;100;0
0;16;"shalexis";16;0;100
0;14;"shalexus";14;0;100
0;673;"shaley";673;0;100
0;38;"shaleya";38;0;100
0;93;"shali";93;0;100
0;546;"shalia";546;0;100
0;105;"shaliah";105;0;100
0;5;"shalica";5;0;100
0;167;"shalice";167;0;100
0;104;"shalicia";104;0;100
0;148;"shalie";148;0;100
16;0;"shaliek";16;100;0
0;5;"shaliese";5;0;100
66;0;"shalik";66;100;0
0;109;"shalika";109;0;100
45;0;"shalim";45;100;0
0;5;"shalima";5;0;100
5;639;"shalimar";644;0.77639751552795;99.2236024844721
315;172;"shalin";487;64.6817248459959;35.3182751540041
0;542;"shalina";542;0;100
0;270;"shalinda";270;0;100
0;11;"shaline";11;0;100
0;766;"shalini";766;0;100
0;5;"shaliqua";5;0;100
0;863;"shalisa";863;0;100
0;411;"shalise";411;0;100
0;353;"shalisha";353;0;100
0;5;"shalisia";5;0;100
0;89;"shalissa";89;0;100
0;405;"shalita";405;0;100
0;26;"shalitha";26;0;100
0;57;"shaliya";57;0;100
0;653;"shaliyah";653;0;100
0;91;"shalla";91;0;100
18;0;"shallah";18;100;0
0;54;"shallan";54;0;100
0;57;"shallen";57;0;100
0;11;"shallin";11;0;100
0;5;"shalliyah";5;0;100
0;246;"shallon";246;0;100
0;27;"shally";27;0;100
0;85;"shallyn";85;0;100
0;18;"shalma";18;0;100
0;5;"shalo";5;0;100
1635;850;"shalom";2485;65.79476861167;34.20523138833
0;18;"shalome";18;0;100
130;1180;"shalon";1310;9.9236641221374;90.0763358778626
0;108;"shalona";108;0;100
0;4632;"shalonda";4632;0;100
0;134;"shalondra";134;0;100
0;17;"shalone";17;0;100
0;40;"shalonna";40;0;100
0;5;"shalonte";5;0;100
0;108;"shalunda";108;0;100
0;67;"shalva";67;0;100
0;27;"shalya";27;0;100
0;39;"shalyce";39;0;100
0;5;"shalymar";5;0;100
0;1973;"shalyn";1973;0;100
0;17;"shalynda";17;0;100
0;1438;"shalynn";1438;0;100
0;35;"shalynne";35;0;100
0;5;"shalyric";5;0;100
0;52;"shalyse";52;0;100
0;5;"shalyssa";5;0;100
36;84;"sham";120;30;70
0;411;"shama";411;0;100
34;0;"shamaar";34;100;0
0;5;"shamada";5;0;100
0;12;"shamae";12;0;100
0;6;"shamael";6;0;100
0;5;"shamaia";5;0;100
0;6;"shamaiah";6;0;100
0;5;"shamaila";5;0;100
0;5;"shamain";5;0;100
5;197;"shamaine";202;2.47524752475248;97.5247524752475
5;16;"shamair";21;23.8095238095238;76.1904761904762
0;58;"shamaiya";58;0;100
0;39;"shamaka";39;0;100
0;5;"shamakia";5;0;100
172;0;"shamal";172;100;0
0;11;"shamala";11;0;100
71;0;"shaman";71;100;0
0;79;"shamanda";79;0;100
0;23;"shamane";23;0;100
0;52;"shamani";52;0;100
0;5;"shamanique";5;0;100
5566;249;"shamar";5815;95.7179707652623;4.28202923473775
0;1620;"shamara";1620;0;100
0;28;"shamarah";28;0;100
70;0;"shamarcus";70;100;0
18;0;"shamare";18;100;0
5;29;"shamaree";34;14.7058823529412;85.2941176470588
736;984;"shamari";1720;42.7906976744186;57.2093023255814
0;525;"shamaria";525;0;100
0;79;"shamariah";79;0;100
11;128;"shamarie";139;7.9136690647482;92.0863309352518
11;0;"shamario";11;100;0
276;5;"shamarion";281;98.220640569395;1.77935943060498
0;12;"shamariona";12;0;100
0;11;"shamariya";11;0;100
294;5;"shamarr";299;98.3277591973244;1.67224080267559
0;101;"shamarra";101;0;100
0;23;"shamarria";23;0;100
11;19;"shamauri";30;36.6666666666667;63.3333333333333
0;6;"shamauria";6;0;100
0;5;"shamay";5;0;100
0;773;"shamaya";773;0;100
0;16;"shamayah";16;0;100
0;10;"shamayia";10;0;100
0;6;"shamber";6;0;100
0;50;"shambhavi";50;0;100
0;34;"shambra";34;0;100
0;24;"shambre";24;0;100
0;5;"shambrea";5;0;100
0;16;"shambreka";16;0;100
0;165;"shambria";165;0;100
0;28;"shambrica";28;0;100
0;6;"shambrika";6;0;100
0;31;"shamea";31;0;100
0;7;"shameah";7;0;100
0;48;"shameaka";48;0;100
0;296;"shameca";296;0;100
0;245;"shamecca";245;0;100
0;16;"shamecia";16;0;100
0;114;"shamecka";114;0;100
229;5;"shameek";234;97.8632478632479;2.13675213675214
0;936;"shameeka";936;0;100
0;6;"shameekia";6;0;100
0;13;"shameen";13;0;100
98;0;"shameer";98;100;0
0;6;"shameera";6;0;100
0;10;"shameerah";10;0;100
0;36;"shameia";36;0;100
5;0;"shameik";5;100;0
0;837;"shameika";837;0;100
5;0;"shameir";5;100;0
5;0;"shamek";5;100;0
0;6191;"shameka";6191;0;100
0;5;"shameki";5;0;100
0;947;"shamekia";947;0;100
0;41;"shamekka";41;0;100
0;6;"shameko";6;0;100
992;155;"shamel";1147;86.4864864864865;13.5135135135135
0;105;"shamela";105;0;100
0;45;"shamelia";45;0;100
128;65;"shamell";193;66.3212435233161;33.6787564766839
0;20;"shamella";20;0;100
0;23;"shamelle";23;0;100
0;7;"shamena";7;0;100
0;24;"shamequa";24;0;100
0;307;"shamera";307;0;100
95;188;"shamere";283;33.5689045936396;66.4310954063604
0;208;"shameria";208;0;100
0;15;"shamese";15;0;100
0;30;"shamesha";30;0;100
0;6;"shameta";6;0;100
0;102;"shametra";102;0;100
0;44;"shametria";44;0;100
0;5;"shametrice";5;0;100
0;21;"shameya";21;0;100
0;17;"shami";17;0;100
0;1434;"shamia";1434;0;100
0;562;"shamiah";562;0;100
0;606;"shamica";606;0;100
10;5;"shamichael";15;66.6666666666667;33.3333333333333
0;172;"shamicka";172;0;100
5;0;"shamiek";5;100;0
0;227;"shamieka";227;0;100
35;0;"shamier";35;100;0
51;5;"shamik";56;91.0714285714286;8.92857142857143
6;5054;"shamika";5060;0.118577075098814;99.8814229249012
0;59;"shamikia";59;0;100
0;17;"shamikka";17;0;100
0;11;"shamiko";11;0;100
38;15;"shamil";53;71.6981132075472;28.3018867924528
0;133;"shamila";133;0;100
0;5;"shamill";5;0;100
0;11;"shamilla";11;0;100
0;25;"shamille";25;0;100
0;5;"shamillia";5;0;100
0;13;"shamim";13;0;100
0;139;"shamina";139;0;100
0;39;"shamiqua";39;0;100
1226;213;"shamir";1439;85.1980542043085;14.8019457956915
0;1444;"shamira";1444;0;100
0;99;"shamiracle";99;0;100
0;213;"shamirah";213;0;100
10;12;"shamire";22;45.4545454545455;54.5454545454545
0;23;"shamirra";23;0;100
0;5;"shamise";5;0;100
0;7;"shamisha";7;0;100
0;12;"shamita";12;0;100
0;1237;"shamiya";1237;0;100
0;605;"shamiyah";605;0;100
0;6;"shamkia";6;0;100
0;5;"shamma";5;0;100
39;6;"shammah";45;86.6666666666667;13.3333333333333
0;56;"shammara";56;0;100
0;5;"shammie";5;0;100
67;0;"shammond";67;100;0
7;0;"shamod";7;100;0
619;140;"shamon";759;81.5546772068511;18.4453227931489
0;220;"shamona";220;0;100
172;0;"shamond";172;100;0
0;31;"shamonda";31;0;100
22;213;"shamone";235;9.36170212765957;90.6382978723404
0;30;"shamoni";30;0;100
0;5;"shamonia";5;0;100
0;297;"shamonica";297;0;100
0;98;"shamonique";98;0;100
21;0;"shamont";21;100;0
17;22;"shamonte";39;43.5897435897436;56.4102564102564
8;0;"shamor";8;100;0
0;55;"shamora";55;0;100
6;0;"shamore";6;100;0
5;0;"shamori";5;100;0
0;12;"shamoria";12;0;100
0;6;"shamorrow";6;0;100
0;5;"shampagne";5;0;100
0;19;"shampayne";19;0;100
0;202;"shamra";202;0;100
48;96;"shams";144;33.3333333333333;66.6666666666667
0;25;"shamsa";25;0;100
0;5;"shamso";5;0;100
10;0;"shamsuddin";10;100;0
5;0;"shamuel";5;100;0
1699;0;"shamus";1699;100;0
0;2080;"shamya";2080;0;100
0;255;"shamyah";255;0;100
0;350;"shamyia";350;0;100
0;53;"shamyiah";53;0;100
0;32;"shamyla";32;0;100
0;768;"shamyra";768;0;100
0;12;"shamyria";12;0;100
2145;864;"shan";3009;71.2861415752742;28.7138584247258
113;29385;"shana";29498;0.383076818767374;99.6169231812326
0;21;"shanada";21;0;100
0;26;"shanade";26;0;100
0;3430;"shanae";3430;0;100
0;295;"shanah";295;0;100
0;387;"shanai";387;0;100
0;77;"shanaia";77;0;100
0;5;"shanaih";5;0;100
0;5;"shanail";5;0;100
0;11;"shanaira";11;0;100
0;5;"shanaisha";5;0;100
0;90;"shanaiya";90;0;100
0;6;"shanaja";6;0;100
0;16;"shanaka";16;0;100
0;31;"shanalee";31;0;100
123;745;"shanan";868;14.1705069124424;85.8294930875576
0;12;"shanana";12;0;100
0;34;"shanann";34;0;100
0;241;"shanara";241;0;100
133;0;"shanard";133;100;0
0;17;"shanari";17;0;100
0;39;"shanaria";39;0;100
0;5;"shanarra";5;0;100
0;5;"shanasha";5;0;100
0;179;"shanasia";179;0;100
0;6;"shanata";6;0;100
0;86;"shanautica";86;0;100
0;220;"shanavia";220;0;100
0;1415;"shanay";1415;0;100
0;1898;"shanaya";1898;0;100
0;56;"shanayah";56;0;100
0;122;"shanaye";122;0;100
0;37;"shanaz";37;0;100
0;10;"shanbria";10;0;100
10;0;"shance";10;100;0
5;0;"shanchez";5;100;0
0;7997;"shanda";7997;0;100
0;10;"shandal";10;0;100
5;109;"shandale";114;4.3859649122807;95.6140350877193
0;49;"shandalyn";49;0;100
0;5;"shandara";5;0;100
12;7;"shande";19;63.1578947368421;36.8421052631579
0;165;"shandee";165;0;100
10;365;"shandel";375;2.66666666666667;97.3333333333333
68;526;"shandell";594;11.4478114478114;88.5521885521886
0;5;"shandella";5;0;100
0;92;"shandelle";92;0;100
39;0;"shanden";39;100;0
0;7;"shander";7;0;100
0;5;"shandera";5;0;100
0;1744;"shandi";1744;0;100
0;27;"shandia";27;0;100
0;12;"shandice";12;0;100
0;92;"shandie";92;0;100
0;143;"shandiin";143;0;100
0;40;"shandolyn";40;0;100
730;184;"shandon";914;79.8687089715536;20.1312910284464
0;66;"shandora";66;0;100
0;3018;"shandra";3018;0;100
0;459;"shandrea";459;0;100
0;5;"shandreika";5;0;100
0;233;"shandreka";233;0;100
0;86;"shandrell";86;0;100
0;303;"shandria";303;0;100
0;32;"shandrica";32;0;100
0;77;"shandricka";77;0;100
0;303;"shandrika";303;0;100
115;728;"shandy";843;13.6417556346382;86.3582443653618
186814;3472;"shane";190286;98.1753781150479;1.82462188495212
0;1131;"shanea";1131;0;100
0;16;"shaneah";16;0;100
0;11;"shaneaka";11;0;100
0;62;"shaneal";62;0;100
0;26;"shanean";26;0;100
0;77;"shaneca";77;0;100
0;352;"shanece";352;0;100
0;92;"shanecia";92;0;100
0;5;"shanecka";5;0;100
0;15;"shanecqua";15;0;100
0;16;"shaneda";16;0;100
0;59;"shanedra";59;0;100
0;1503;"shanee";1503;0;100
0;98;"shaneece";98;0;100
0;16;"shaneek";16;0;100
0;433;"shaneeka";433;0;100
0;321;"shaneen";321;0;100
0;170;"shaneequa";170;0;100
0;5;"shaneesa";5;0;100
0;90;"shaneese";90;0;100
0;12;"shanegua";12;0;100
0;6;"shanei";6;0;100
0;25;"shaneia";25;0;100
0;485;"shaneice";485;0;100
0;549;"shaneika";549;0;100
0;176;"shaneil";176;0;100
0;50;"shaneiqua";50;0;100
0;15;"shaneise";15;0;100
0;98;"shaneisha";98;0;100
0;2686;"shaneka";2686;0;100
0;283;"shanekia";283;0;100
0;5;"shanekqa";5;0;100
0;125;"shanekqua";125;0;100
0;23;"shanekwa";23;0;100
0;2387;"shanel";2387;0;100
0;73;"shanele";73;0;100
12;4553;"shanell";4565;0.262869660460022;99.73713033954
0;33;"shanella";33;0;100
0;4349;"shanelle";4349;0;100
0;31;"shanelly";31;0;100
0;5;"shanely";5;0;100
48;131;"shanen";179;26.8156424581006;73.1843575418994
0;79;"shanena";79;0;100
0;16;"shanene";16;0;100
0;10;"shaneqa";10;0;100
0;1874;"shanequa";1874;0;100
0;8;"shanequah";8;0;100
0;120;"shaneque";120;0;100
0;5;"shanequea";5;0;100
0;162;"shanequia";162;0;100
0;22;"shaneqwa";22;0;100
0;119;"shanera";119;0;100
0;35;"shaneria";35;0;100
0;18;"shanerica";18;0;100
0;5;"shanesa";5;0;100
0;753;"shanese";753;0;100
0;218;"shanesha";218;0;100
0;5;"shaneshia";5;0;100
0;14;"shanesia";14;0;100
0;131;"shanessa";131;0;100
0;5;"shanesse";5;0;100
0;31;"shanet";31;0;100
0;80;"shaneta";80;0;100
0;113;"shanetha";113;0;100
0;24;"shanethia";24;0;100
0;177;"shanetra";177;0;100
0;40;"shanetria";40;0;100
0;6;"shanett";6;0;100
0;913;"shanetta";913;0;100
0;826;"shanette";826;0;100
0;18;"shaneva";18;0;100
0;409;"shaney";409;0;100
0;60;"shaneya";60;0;100
0;5;"shanez";5;0;100
25;0;"shang";25;100;0
36;5;"shanga";41;87.8048780487805;12.1951219512195
0;5;"shangaleza";5;0;100
28;0;"shango";28;100;0
17;4392;"shani";4409;0.38557496030846;99.6144250396915
0;14950;"shania";14950;0;100
0;1798;"shaniah";1798;0;100
0;11;"shaniaya";11;0;100
0;6;"shaniayah";6;0;100
0;409;"shanica";409;0;100
5;9460;"shanice";9465;0.0528262017960909;99.9471737982039
0;25;"shanicia";25;0;100
0;217;"shanicka";217;0;100
0;75;"shanicqua";75;0;100
0;17;"shanida";17;0;100
0;488;"shanie";488;0;100
0;5;"shanieca";5;0;100
0;1973;"shaniece";1973;0;100
0;220;"shanieka";220;0;100
0;40;"shaniel";40;0;100
0;59;"shanielle";59;0;100
0;25;"shaniequa";25;0;100
0;33;"shaniese";33;0;100
0;22;"shaniesha";22;0;100
0;59;"shanigua";59;0;100
0;5;"shanii";5;0;100
0;38;"shanija";38;0;100
0;18;"shanijah";18;0;100
0;206;"shanik";206;0;100
11;5590;"shanika";5601;0.196393501160507;99.8036064988395
0;17;"shanike";17;0;100
0;5;"shaniki";5;0;100
0;87;"shanikia";87;0;100
0;146;"shanikka";146;0;100
0;189;"shanikqua";189;0;100
0;8;"shanikque";8;0;100
0;85;"shanikwa";85;0;100
0;6;"shanil";6;0;100
0;25;"shanila";25;0;100
0;15;"shanille";15;0;100
0;317;"shanin";317;0;100
0;216;"shanina";216;0;100
0;54;"shanine";54;0;100
0;25;"shaniqa";25;0;100
0;5117;"shaniqua";5117;0;100
0;47;"shaniquah";47;0;100
0;1689;"shanique";1689;0;100
0;27;"shaniquea";27;0;100
0;139;"shaniquia";139;0;100
0;5;"shaniquwa";5;0;100
0;64;"shaniqwa";64;0;100
0;140;"shanira";140;0;100
0;24;"shanisa";24;0;100
0;1466;"shanise";1466;0;100
0;354;"shanisha";354;0;100
0;12;"shanissa";12;0;100
0;3449;"shanita";3449;0;100
0;63;"shanitha";63;0;100
0;273;"shanitra";273;0;100
0;37;"shanitta";37;0;100
0;6141;"shaniya";6141;0;100
0;2699;"shaniyah";2699;0;100
0;10;"shaniyha";10;0;100
0;5;"shaniyia";5;0;100
0;15;"shaniyla";15;0;100
0;10;"shanka";10;0;100
68;0;"shankar";68;100;0
0;8;"shankeria";8;0;100
0;59;"shankia";59;0;100
0;34;"shanlee";34;0;100
0;30;"shanleigh";30;0;100
0;456;"shanley";456;0;100
0;5;"shanli";5;0;100
5;0;"shanmukh";5;100;0
280;214;"shann";494;56.6801619433198;43.3198380566802
88;28179;"shanna";28267;0.311317083524958;99.688682916475
0;51;"shannae";51;0;100
0;1379;"shannah";1379;0;100
0;5;"shannalee";5;0;100
317;5161;"shannan";5478;5.78678349762687;94.2132165023731
0;49;"shannara";49;0;100
0;16;"shannay";16;0;100
0;13;"shannda";13;0;100
0;11;"shanndolyn";11;0;100
37;43;"shanne";80;46.25;53.75
0;5;"shannee";5;0;100
0;5;"shanneka";5;0;100
0;1245;"shannel";1245;0;100
0;488;"shannell";488;0;100
0;190;"shannelle";190;0;100
150;1916;"shannen";2066;7.26040658276863;92.7395934172314
0;6;"shannequa";6;0;100
0;51;"shannetta";51;0;100
0;180;"shannette";180;0;100
0;28;"shanni";28;0;100
0;105;"shannia";105;0;100
0;48;"shannice";48;0;100
0;91;"shannie";91;0;100
0;6;"shanniece";6;0;100
0;42;"shannika";42;0;100
0;21;"shannikia";21;0;100
0;240;"shannin";240;0;100
0;5;"shanniya";5;0;100
51836;294707;"shannon";346543;14.9580282966327;85.0419717033673
0;11;"shannondoah";11;0;100
0;25;"shannone";25;0;100
0;24;"shanny";24;0;100
0;5;"shannya";5;0;100
0;526;"shannyn";526;0;100
0;38;"shanoa";38;0;100
0;103;"shanoah";103;0;100
0;5;"shanobia";5;0;100
1726;4813;"shanon";6539;26.3954733139624;73.6045266860376
0;5;"shanona";5;0;100
0;5;"shanonn";5;0;100
0;99;"shanora";99;0;100
0;36;"shanovia";36;0;100
0;5;"shanqua";5;0;100
0;5;"shanqual";5;0;100
5;0;"shanquan";5;100;0
0;11;"shanque";11;0;100
0;10;"shanquel";10;0;100
0;7;"shanquell";7;0;100
0;11;"shanquella";11;0;100
0;34;"shanquetta";34;0;100
0;21;"shanquia";21;0;100
0;5;"shanquil";5;0;100
0;23;"shanquilla";23;0;100
9;0;"shanquille";9;100;0
0;105;"shanquita";105;0;100
0;17;"shanreka";17;0;100
0;5;"shanrica";5;0;100
0;10;"shanrika";10;0;100
766;0;"shant";766;100;0
142;5111;"shanta";5253;2.70321720921378;97.2967827907862
6;1578;"shantae";1584;0.378787878787879;99.6212121212121
0;160;"shantai";160;0;100
0;10;"shantail";10;0;100
0;10;"shantaja";10;0;100
0;1510;"shantal";1510;0;100
0;5;"shantala";5;0;100
0;125;"shantale";125;0;100
0;43;"shantall";43;0;100
0;12;"shantalle";12;0;100
0;157;"shantana";157;0;100
0;5;"shantanae";5;0;100
0;10;"shantania";10;0;100
0;61;"shantanique";61;0;100
69;0;"shantanu";69;100;0
0;146;"shantara";146;0;100
0;22;"shantaria";22;0;100
0;13;"shantasha";13;0;100
0;278;"shantasia";278;0;100
0;679;"shantavia";679;0;100
0;35;"shantavious";35;0;100
0;1270;"shantay";1270;0;100
0;140;"shantaya";140;0;100
0;46;"shantaye";46;0;100
0;14;"shantazia";14;0;100
216;5795;"shante";6011;3.59341207785726;96.4065879221427
0;215;"shantea";215;0;100
0;8;"shanteal";8;0;100
0;489;"shantee";489;0;100
0;36;"shanteka";36;0;100
59;10139;"shantel";10198;0.578544812708374;99.4214551872916
0;5;"shantela";5;0;100
0;238;"shantele";238;0;100
26;5051;"shantell";5077;0.512113452826472;99.4878865471735
0;197;"shantella";197;0;100
0;2661;"shantelle";2661;0;100
0;84;"shantera";84;0;100
0;703;"shanteria";703;0;100
0;76;"shanterica";76;0;100
0;5;"shanterika";5;0;100
0;36;"shanterra";36;0;100
0;5;"shanterri";5;0;100
0;251;"shanterria";251;0;100
0;45;"shanterrica";45;0;100
0;59;"shantese";59;0;100
0;5;"shantesha";5;0;100
0;37;"shantey";37;0;100
0;5;"shanteya";5;0;100
48;29;"shantez";77;62.3376623376623;37.6623376623377
0;7;"shantha";7;0;100
0;44;"shanthi";44;0;100
140;1745;"shanti";1885;7.42705570291777;92.5729442970822
0;1088;"shantia";1088;0;100
0;16;"shantiana";16;0;100
0;125;"shantice";125;0;100
0;5;"shantie";5;0;100
0;5;"shantiece";5;0;100
0;5;"shantiel";5;0;100
0;7;"shantierra";7;0;100
0;5;"shantih";5;0;100
0;106;"shantika";106;0;100
0;111;"shantil";111;0;100
0;366;"shantina";366;0;100
0;91;"shantinique";91;0;100
0;41;"shantiqua";41;0;100
0;55;"shantique";55;0;100
0;26;"shantise";26;0;100
0;34;"shantisha";34;0;100
0;10;"shantivia";10;0;100
0;5;"shantle";5;0;100
43;15;"shanton";58;74.1379310344828;25.8620689655172
0;7;"shantonia";7;0;100
0;7;"shantora";7;0;100
0;351;"shantoria";351;0;100
0;79;"shantoya";79;0;100
0;14;"shantra";14;0;100
0;5;"shantrail";5;0;100
0;12;"shantrece";12;0;100
0;42;"shantrel";42;0;100
10;620;"shantrell";630;1.58730158730159;98.4126984126984
0;38;"shantrelle";38;0;100
0;11;"shantrese";11;0;100
0;473;"shantrice";473;0;100
0;5;"shantwana";5;0;100
0;178;"shanty";178;0;100
0;5;"shantya";5;0;100
0;119;"shanvi";119;0;100
0;16;"shanvika";16;0;100
0;5;"shanvitha";5;0;100
0;68;"shany";68;0;100
0;2067;"shanya";2067;0;100
0;435;"shanyah";435;0;100
0;267;"shanyce";267;0;100
0;5;"shanye";5;0;100
0;5;"shanyel";5;0;100
0;27;"shanygne";27;0;100
0;487;"shanyia";487;0;100
0;91;"shanyiah";91;0;100
0;6;"shanyk";6;0;100
0;6;"shanyka";6;0;100
0;290;"shanyla";290;0;100
0;38;"shanylah";38;0;100
0;262;"shanyn";262;0;100
0;34;"shanyra";34;0;100
0;5;"shanyse";5;0;100
0;12;"shanythia";12;0;100
0;25;"shanza";25;0;100
0;150;"shanzay";150;0;100
0;10;"shanze";10;0;100
7;0;"shao";7;100;0
5;62;"shaolin";67;7.46268656716418;92.5373134328358
12;0;"shaon";12;100;0
0;10;"shaonna";10;0;100
0;25;"shaparis";25;0;100
53;0;"shaphan";53;100;0
0;10;"shapree";10;0;100
0;5;"shapria";5;0;100
5;0;"shaqil";5;100;0
16;0;"shaqille";16;100;0
0;7;"shaqita";7;0;100
0;28;"shaqua";28;0;100
0;25;"shaquail";25;0;100
0;5;"shaquaila";5;0;100
0;355;"shaquala";355;0;100
0;5;"shaquale";5;0;100
0;16;"shaqualia";16;0;100
0;41;"shaqualla";41;0;100
2011;536;"shaquan";2547;78.955634079309;21.044365920691
0;2286;"shaquana";2286;0;100
0;13;"shaquanah";13;0;100
0;691;"shaquanda";691;0;100
0;169;"shaquandra";169;0;100
0;6;"shaquandria";6;0;100
5;5;"shaquane";10;50;50
0;21;"shaquania";21;0;100
13;0;"shaquann";13;100;0
0;873;"shaquanna";873;0;100
0;135;"shaquanta";135;0;100
0;12;"shaquara";12;0;100
0;5;"shaquarius";5;0;100
0;78;"shaquasha";78;0;100
0;11;"shaquashia";11;0;100
0;208;"shaquasia";208;0;100
0;95;"shaquavia";95;0;100
17;0;"shaquawn";17;100;0
0;55;"shaquay";55;0;100
0;96;"shaquaya";96;0;100
0;114;"shaquayla";114;0;100
0;12;"shaque";12;0;100
0;10;"shaquea";10;0;100
44;0;"shaqueal";44;100;0
0;5;"shaqueda";5;0;100
5;0;"shaqueel";5;100;0
0;26;"shaqueen";26;0;100
0;197;"shaqueena";197;0;100
0;5;"shaqueeta";5;0;100
7;0;"shaqueil";7;100;0
73;78;"shaquel";151;48.3443708609272;51.6556291390728
0;108;"shaquela";108;0;100
0;5;"shaquelia";5;0;100
40;49;"shaquell";89;44.9438202247191;55.0561797752809
0;107;"shaquella";107;0;100
73;45;"shaquelle";118;61.864406779661;38.135593220339
0;11;"shaquena";11;0;100
0;13;"shaquenta";13;0;100
0;119;"shaquera";119;0;100
0;33;"shaqueria";33;0;100
0;5;"shaquerra";5;0;100
0;57;"shaquesha";57;0;100
0;145;"shaqueta";145;0;100
0;457;"shaquetta";457;0;100
0;15;"shaquette";15;0;100
28;5;"shaquez";33;84.8484848484848;15.1515151515152
0;165;"shaquia";165;0;100
0;34;"shaquida";34;0;100
51;5;"shaquiel";56;91.0714285714286;8.92857142857143
38;0;"shaquielle";38;100;0
206;7;"shaquil";213;96.7136150234742;3.28638497652582
0;405;"shaquila";405;0;100
120;7;"shaquile";127;94.488188976378;5.51181102362205
155;17;"shaquill";172;90.1162790697674;9.88372093023256
36;520;"shaquilla";556;6.47482014388489;93.5251798561151
5391;387;"shaquille";5778;93.3021806853583;6.69781931464174
5;0;"shaquillie";5;100;0
0;5;"shaquin";5;0;100
0;123;"shaquina";123;0;100
0;6;"shaquinda";6;0;100
0;5;"shaquinn";5;0;100
0;6;"shaquinna";6;0;100
0;149;"shaquinta";149;0;100
0;246;"shaquira";246;0;100
0;5;"shaquirra";5;0;100
0;21;"shaquise";21;0;100
0;108;"shaquisha";108;0;100
5;2391;"shaquita";2396;0.208681135225376;99.7913188647746
0;238;"shaquitta";238;0;100
0;6;"shaqula";6;0;100
0;10;"shaqulia";10;0;100
6;0;"shaqulle";6;100;0
0;57;"shaquna";57;0;100
0;30;"shaqunda";30;0;100
0;26;"shaqunna";26;0;100
0;72;"shaquoia";72;0;100
124;13;"shaquon";137;90.5109489051095;9.48905109489051
0;47;"shaquona";47;0;100
0;21;"shaquonda";21;0;100
5;0;"shaquone";5;100;0
0;28;"shaquonna";28;0;100
5;0;"shaquor";5;100;0
0;95;"shaquoya";95;0;100
13;0;"shaqur";13;100;0
0;11;"shaqura";11;0;100
0;10;"shaquria";10;0;100
21;0;"shaqville";21;100;0
24;0;"shaqwan";24;100;0
0;47;"shaqwana";47;0;100
0;5;"shaqwanna";5;0;100
0;212;"shar";212;0;100
5;4887;"shara";4892;0.102207686017989;99.897792313982
105;0;"sharad";105;100;0
0;56;"sharada";56;0;100
0;1289;"sharae";1289;0;100
0;6;"sharaea";6;0;100
0;231;"sharah";231;0;100
0;460;"sharai";460;0;100
0;5;"sharail";5;0;100
0;53;"sharain";53;0;100
0;64;"sharaine";64;0;100
0;16;"sharal";16;0;100
0;8;"sharale";8;0;100
0;101;"sharalee";101;0;100
0;386;"sharalyn";386;0;100
0;5;"sharalynn";5;0;100
53;1190;"sharan";1243;4.26387771520515;95.7361222847949
0;6;"sharana";6;0;100
0;431;"sharanda";431;0;100
0;54;"sharane";54;0;100
0;11;"sharann";11;0;100
0;294;"sharanya";294;0;100
0;10;"sharareh";10;0;100
5;0;"sharat";5;100;0
11;0;"sharath";11;100;0
6;0;"sharav";6;100;0
0;5;"sharaven";5;0;100
5;739;"sharay";744;0.672043010752688;99.3279569892473
0;424;"sharaya";424;0;100
0;592;"sharayah";592;0;100
0;19;"sharaye";19;0;100
0;24;"sharayne";24;0;100
0;5;"sharayu";5;0;100
81;0;"sharbel";81;100;0
0;613;"sharda";613;0;100
0;1404;"shardae";1404;0;100
0;293;"shardai";293;0;100
0;7;"shardasha";7;0;100
0;23;"shardasia";23;0;100
0;796;"sharday";796;0;100
0;17;"shardaye";17;0;100
0;978;"sharde";978;0;100
0;49;"shardea";49;0;100
0;51;"shardee";51;0;100
0;30;"shardell";30;0;100
0;32;"shardey";32;0;100
0;16;"shardi";16;0;100
0;7;"shardia";7;0;100
0;5;"shardonay";5;0;100
0;26;"shardonnay";26;0;100
5;0;"shardul";5;100;0
0;22;"share";22;0;100
0;203;"sharea";203;0;100
0;12;"sharease";12;0;100
0;10;"shareca";10;0;100
0;217;"sharece";217;0;100
0;42;"shareda";42;0;100
0;3871;"sharee";3871;0;100
0;144;"shareece";144;0;100
0;10;"shareeda";10;0;100
1075;0;"shareef";1075;100;0
0;43;"shareefah";43;0;100
5;0;"shareek";5;100;0
0;84;"shareeka";84;0;100
5;0;"shareem";5;100;0
0;22;"shareema";22;0;100
0;980;"shareen";980;0;100
0;201;"shareena";201;0;100
0;5;"sharees";5;0;100
0;507;"shareese";507;0;100
0;50;"shareeta";50;0;100
5;0;"shareif";5;100;0
0;37;"shareika";37;0;100
0;795;"shareka";795;0;100
0;48;"sharekia";48;0;100
0;337;"sharel";337;0;100
16;1366;"sharell";1382;1.15774240231548;98.8422575976845
0;10;"sharella";10;0;100
0;775;"sharelle";775;0;100
0;12;"sharema";12;0;100
0;3782;"sharen";3782;0;100
0;523;"sharena";523;0;100
0;25;"sharenda";25;0;100
0;551;"sharene";551;0;100
0;6;"sharenna";6;0;100
0;5;"shareny";5;0;100
0;115;"sharesa";115;0;100
0;887;"sharese";887;0;100
0;6;"sharessa";6;0;100
0;24;"sharesse";24;0;100
0;71;"shareta";71;0;100
0;157;"sharetha";157;0;100
0;263;"sharetta";263;0;100
0;22;"sharette";22;0;100
0;5;"shareva";5;0;100
0;10;"sharey";10;0;100
0;1333;"sharhonda";1333;0;100
46;40858;"shari";40904;0.112458439272443;99.8875415607276
0;648;"sharia";648;0;100
0;870;"shariah";870;0;100
0;73;"sharian";73;0;100
0;6;"shariana";6;0;100
0;31;"shariann";31;0;100
0;8;"sharianne";8;0;100
0;249;"sharica";249;0;100
0;1459;"sharice";1459;0;100
0;159;"sharicka";159;0;100
0;30;"sharida";30;0;100
0;11;"sharidan";11;0;100
0;5;"shariden";5;0;100
0;1975;"sharie";1975;0;100
0;70;"shariece";70;0;100
187;0;"sharief";187;100;0
33;0;"sharieff";33;100;0
0;44;"sharieka";44;0;100
0;5;"sharielle";5;0;100
2528;5;"sharif";2533;99.8026056060008;0.19739439399921
0;526;"sharifa";526;0;100
0;145;"sharifah";145;0;100
572;0;"shariff";572;100;0
0;15;"sharik";15;0;100
0;1295;"sharika";1295;0;100
0;5;"sharikka";5;0;100
0;41;"sharil";41;0;100
0;43;"sharilee";43;0;100
0;1785;"sharilyn";1785;0;100
0;106;"sharilynn";106;0;100
0;28;"sharima";28;0;100
0;5;"sharimar";5;0;100
0;398;"sharin";398;0;100
0;1048;"sharina";1048;0;100
0;5;"sharinda";5;0;100
0;110;"sharine";110;0;100
0;5;"sharini";5;0;100
0;5;"sharinna";5;0;100
0;796;"sharion";796;0;100
90;0;"shariq";90;100;0
0;191;"sharis";191;0;100
0;103;"sharisa";103;0;100
0;645;"sharise";645;0;100
0;502;"sharissa";502;0;100
0;621;"sharisse";621;0;100
0;2637;"sharita";2637;0;100
0;12;"sharitha";12;0;100
0;54;"sharitta";54;0;100
0;38;"sharity";38;0;100
0;6;"sharitza";6;0;100
0;315;"shariya";315;0;100
0;387;"shariyah";387;0;100
20;0;"shariyf";20;100;0
0;5;"shariyka";5;0;100
0;10;"sharkia";10;0;100
0;52;"sharl";52;0;100
0;6380;"sharla";6380;0;100
0;5;"sharlan";5;0;100
0;5;"sharlanda";5;0;100
0;16;"sharlane";16;0;100
0;6;"sharlayne";6;0;100
0;48;"sharlean";48;0;100
0;635;"sharlee";635;0;100
0;2606;"sharleen";2606;0;100
0;5;"sharleene";5;0;100
0;11;"sharleez";11;0;100
0;5;"sharlen";5;0;100
0;143;"sharlena";143;0;100
0;12055;"sharlene";12055;0;100
0;612;"sharlet";612;0;100
0;5;"sharletha";5;0;100
0;110;"sharlett";110;0;100
0;37;"sharletta";37;0;100
0;311;"sharlette";311;0;100
0;156;"sharley";156;0;100
0;26;"sharli";26;0;100
0;342;"sharlie";342;0;100
0;49;"sharlin";49;0;100
0;6;"sharlinda";6;0;100
0;415;"sharline";415;0;100
0;71;"sharlisa";71;0;100
0;22;"sharlita";22;0;100
0;94;"sharlize";94;0;100
0;87;"sharlon";87;0;100
0;45;"sharlonda";45;0;100
0;66;"sharlot";66;0;100
0;880;"sharlotte";880;0;100
0;5;"sharly";5;0;100
0;1459;"sharlyn";1459;0;100
0;80;"sharlyne";80;0;100
0;162;"sharlynn";162;0;100
0;434;"sharma";434;0;100
0;5;"sharmae";5;0;100
0;177;"sharmain";177;0;100
5;1668;"sharmaine";1673;0.298864315600717;99.7011356843993
10;0;"sharmake";10;100;0
28;1014;"sharman";1042;2.68714011516315;97.3128598848369
0;335;"sharmane";335;0;100
7;0;"sharmar";7;100;0
75;0;"sharmarke";75;100;0
0;246;"sharmayne";246;0;100
0;58;"sharmeen";58;0;100
0;91;"sharmeka";91;0;100
0;117;"sharmel";117;0;100
0;32;"sharmell";32;0;100
0;35;"sharmen";35;0;100
0;6;"sharmeta";6;0;100
0;5;"sharmia";5;0;100
0;40;"sharmika";40;0;100
0;180;"sharmila";180;0;100
0;5;"sharmilla";5;0;100
0;363;"sharmin";363;0;100
0;11;"sharmine";11;0;100
7;458;"sharmon";465;1.50537634408602;98.494623655914
0;17;"sharmonique";17;0;100
0;12;"sharmyn";12;0;100
26;23;"sharn";49;53.0612244897959;46.9387755102041
0;413;"sharna";413;0;100
0;373;"sharnae";373;0;100
0;129;"sharnay";129;0;100
0;7;"sharnaye";7;0;100
0;94;"sharne";94;0;100
0;12;"sharnea";12;0;100
0;17;"sharnece";17;0;100
0;102;"sharnee";102;0;100
0;56;"sharneice";56;0;100
0;13;"sharneka";13;0;100
0;31;"sharnel";31;0;100
0;5;"sharnele";5;0;100
0;599;"sharnell";599;0;100
0;80;"sharnelle";80;0;100
0;6;"sharnequa";6;0;100
0;82;"sharnese";82;0;100
0;5;"sharnet";5;0;100
0;11;"sharnett";11;0;100
0;121;"sharnetta";121;0;100
0;192;"sharnette";192;0;100
0;5;"sharney";5;0;100
0;6;"sharnia";6;0;100
0;424;"sharnice";424;0;100
0;144;"sharniece";144;0;100
0;69;"sharnika";69;0;100
0;12;"sharniqua";12;0;100
0;13;"sharnique";13;0;100
0;119;"sharnise";119;0;100
0;5;"sharnisha";5;0;100
0;186;"sharnita";186;0;100
0;6;"sharnyce";6;0;100
0;11;"sharo";11;0;100
0;5;"sharocka";5;0;100
1239;0;"sharod";1239;100;0
0;994;"sharol";994;0;100
0;11;"sharold";11;0;100
0;5;"sharoll";5;0;100
0;1367;"sharolyn";1367;0;100
0;5;"sharolynn";5;0;100
5;0;"sharome";5;100;0
3102;721165;"sharon";724267;0.428295090070375;99.5717049099296
0;695;"sharona";695;0;100
0;73;"sharonann";73;0;100
0;5839;"sharonda";5839;0;100
150;584;"sharone";734;20.4359673024523;79.5640326975477
0;5;"sharonette";5;0;100
0;246;"sharonica";246;0;100
0;109;"sharonlee";109;0;100
0;43;"sharonn";43;0;100
0;154;"sharonna";154;0;100
0;211;"sharonne";211;0;100
0;12;"sharoya";12;0;100
0;41;"sharquita";41;0;100
0;457;"sharra";457;0;100
0;5;"sharrae";5;0;100
0;21;"sharrah";21;0;100
0;86;"sharran";86;0;100
0;5;"sharray";5;0;100
0;5;"sharre";5;0;100
0;23;"sharree";23;0;100
0;48;"sharrel";48;0;100
0;422;"sharrell";422;0;100
0;202;"sharren";202;0;100
0;1299;"sharri";1299;0;100
0;751;"sharrie";751;0;100
10;0;"sharrief";10;100;0
75;0;"sharrieff";75;100;0
0;5;"sharrika";5;0;100
0;22;"sharrion";22;0;100
0;5;"sharrita";5;0;100
553;0;"sharrod";553;100;0
0;6;"sharrol";6;0;100
370;16848;"sharron";17218;2.1489139272854;97.8510860727146
0;6;"sharrona";6;0;100
0;148;"sharronda";148;0;100
0;31;"sharrone";31;0;100
0;953;"sharry";953;0;100
0;52;"sharryl";52;0;100
0;47;"sharryn";47;0;100
0;21;"shartavia";21;0;100
0;59;"sharunda";59;0;100
11;0;"sharva";11;100;0
0;9;"sharvae";9;0;100
0;6;"sharvani";6;0;100
7;0;"sharvesh";7;100;0
0;76;"sharvi";76;0;100
60;0;"sharvil";60;100;0
0;26;"sharvon";26;0;100
5;0;"sharwin";5;100;0
0;362;"shary";362;0;100
0;53;"sharya";53;0;100
0;61;"sharyah";61;0;100
0;5;"sharyan";5;0;100
0;17;"sharyce";17;0;100
0;5;"sharyia";5;0;100
0;2631;"sharyl";2631;0;100
0;38;"sharyle";38;0;100
0;7238;"sharyn";7238;0;100
0;49;"sharyne";49;0;100
0;12;"sharynn";12;0;100
0;5;"sharynne";5;0;100
0;99;"sharyon";99;0;100
0;5;"shasa";5;0;100
0;209;"shasha";209;0;100
0;99;"shashana";99;0;100
326;0;"shashank";326;100;0
0;25;"shashanna";25;0;100
5;0;"shashanth";5;100;0
0;5;"shashawn";5;0;100
0;30;"shashawna";30;0;100
5;0;"shashi";5;100;0
0;25;"shashona";25;0;100
6;0;"shashvat";6;100;0
78;0;"shashwat";78;100;0
0;10;"shaska";10;0;100
0;25;"shasmeen";25;0;100
15;4234;"shasta";4249;0.353024240997882;99.6469757590021
0;5;"shastelin";5;0;100
0;35;"shastelyn";35;0;100
0;90;"shastina";90;0;100
0;7;"shastity";7;0;100
0;26;"shata";26;0;100
0;7;"shatae";7;0;100
0;5;"shataka";5;0;100
0;90;"shatana";90;0;100
0;16;"shatanna";16;0;100
0;44;"shatanya";44;0;100
0;1479;"shatara";1479;0;100
0;5;"shatarah";5;0;100
0;31;"shatari";31;0;100
0;78;"shataria";78;0;100
0;114;"shatarra";114;0;100
0;174;"shatasha";174;0;100
0;71;"shatasia";71;0;100
0;5;"shataura";5;0;100
0;739;"shatavia";739;0;100
0;5;"shatay";5;0;100
0;195;"shataya";195;0;100
0;30;"shateara";30;0;100
33;0;"shateek";33;100;0
0;15;"shateema";15;0;100
0;6;"shateia";6;0;100
0;95;"shateka";95;0;100
0;5;"shatel";5;0;100
0;5;"shatell";5;0;100
0;34;"shatema";34;0;100
0;300;"shatera";300;0;100
0;243;"shateria";243;0;100
0;174;"shaterica";174;0;100
0;52;"shaterika";52;0;100
0;291;"shaterra";291;0;100
0;145;"shaterria";145;0;100
0;157;"shaterrica";157;0;100
0;10;"shaterrika";10;0;100
0;11;"shatesha";11;0;100
0;5;"shateya";5;0;100
0;129;"shatha";129;0;100
0;635;"shatia";635;0;100
0;5;"shatiah";5;0;100
0;11;"shatiana";11;0;100
0;11;"shatica";11;0;100
0;11;"shatice";11;0;100
5;0;"shatiek";5;100;0
0;26;"shatiera";26;0;100
0;5;"shatierra";5;0;100
0;8;"shatifah";8;0;100
0;273;"shatika";273;0;100
0;10;"shatila";10;0;100
0;172;"shatima";172;0;100
0;401;"shatina";401;0;100
0;75;"shatiqua";75;0;100
12;0;"shatique";12;100;0
0;115;"shatira";115;0;100
0;163;"shatisha";163;0;100
0;50;"shatiya";50;0;100
10;101;"shaton";111;9.00900900900901;90.990990990991
0;88;"shatona";88;0;100
0;11;"shatondra";11;0;100
0;21;"shatonga";21;0;100
0;5;"shatoni";5;0;100
0;117;"shatonia";117;0;100
0;29;"shatonna";29;0;100
0;220;"shatonya";220;0;100
0;119;"shatora";119;0;100
0;88;"shatori";88;0;100
0;510;"shatoria";510;0;100
0;22;"shatorria";22;0;100
0;5;"shatory";5;0;100
0;5;"shatorya";5;0;100
0;840;"shatoya";840;0;100
0;13;"shatoyia";13;0;100
0;33;"shatrice";33;0;100
0;204;"shatyra";204;0;100
0;6;"shaude";6;0;100
387;5;"shaughn";392;98.7244897959184;1.27551020408163
5;91;"shaughnessy";96;5.20833333333333;94.7916666666667
490;0;"shaul";490;100;0
0;56;"shaula";56;0;100
69057;3101;"shaun";72158;95.7024862108152;4.29751378918484
55;27928;"shauna";27983;0.196547904084623;99.8034520959154
0;5;"shaunacy";5;0;100
0;71;"shaunae";71;0;100
0;14;"shaunah";14;0;100
252;0;"shaunak";252;100;0
0;5;"shaunay";5;0;100
0;1623;"shaunda";1623;0;100
5;0;"shaundale";5;100;0
0;5;"shaundel";5;0;100
42;5;"shaundell";47;89.3617021276596;10.6382978723404
0;978;"shaundra";978;0;100
0;145;"shaundrea";145;0;100
0;5;"shaundreka";5;0;100
0;34;"shaundria";34;0;100
0;5;"shaundrika";5;0;100
444;335;"shaune";779;56.9961489088575;43.0038510911425
0;6;"shaunea";6;0;100
0;11;"shaunece";11;0;100
0;128;"shaunee";128;0;100
0;15;"shauneen";15;0;100
0;5;"shauneille";5;0;100
0;5;"shaunel";5;0;100
0;42;"shaunell";42;0;100
0;31;"shaunelle";31;0;100
0;17;"shaunese";17;0;100
5;69;"shaunessy";74;6.75675675675676;93.2432432432432
0;25;"shaunetta";25;0;100
0;154;"shaunette";154;0;100
0;6;"shauney";6;0;100
0;265;"shauni";265;0;100
0;7;"shaunia";7;0;100
0;609;"shaunice";609;0;100
0;78;"shaunie";78;0;100
0;70;"shauniece";70;0;100
0;5;"shaunielle";5;0;100
0;54;"shaunika";54;0;100
0;19;"shauniqua";19;0;100
0;10;"shaunique";10;0;100
0;41;"shaunise";41;0;100
0;135;"shaunita";135;0;100
0;5;"shauniya";5;0;100
10;0;"shaunmichael";10;100;0
76;0;"shaunn";76;100;0
0;2936;"shaunna";2936;0;100
40;0;"shaunt";40;100;0
37;1193;"shaunta";1230;3.00813008130081;96.9918699186992
5;689;"shauntae";694;0.720461095100865;99.2795389048991
0;31;"shauntai";31;0;100
0;15;"shauntal";15;0;100
0;12;"shauntasia";12;0;100
0;148;"shauntavia";148;0;100
5;0;"shauntavious";5;100;0
6;439;"shauntay";445;1.34831460674157;98.6516853932584
0;5;"shauntaya";5;0;100
0;5;"shauntaye";5;0;100
88;1699;"shaunte";1787;4.92445439283716;95.0755456071629
0;48;"shauntea";48;0;100
0;152;"shauntee";152;0;100
10;913;"shauntel";923;1.08342361863489;98.9165763813651
0;5;"shauntele";5;0;100
0;266;"shauntell";266;0;100
0;195;"shauntelle";195;0;100
0;8;"shaunteria";8;0;100
30;0;"shauntez";30;100;0
0;50;"shaunti";50;0;100
0;273;"shauntia";273;0;100
0;5;"shauntiana";5;0;100
0;26;"shauntice";26;0;100
0;36;"shauntina";36;0;100
0;5;"shauntoria";5;0;100
0;29;"shauntrell";29;0;100
0;53;"shauntrice";53;0;100
0;40;"shaunya";40;0;100
0;6;"shaunyce";6;0;100
0;48;"shauri";48;0;100
0;42;"shaurice";42;0;100
813;0;"shaurya";813;100;0
6;0;"shauwn";6;100;0
0;5;"shavada";5;0;100
0;10;"shavae";10;0;100
0;5;"shavan";5;0;100
0;57;"shavana";57;0;100
0;24;"shavanda";24;0;100
0;157;"shavanna";157;0;100
0;43;"shavannah";43;0;100
0;32;"shavante";32;0;100
361;0;"shavar";361;100;0
0;5;"shavaria";5;0;100
11;174;"shavaughn";185;5.94594594594595;94.0540540540541
0;92;"shavaun";92;0;100
0;55;"shavawn";55;0;100
6;113;"shavell";119;5.04201680672269;94.9579831932773
0;20;"shavella";20;0;100
0;122;"shavelle";122;0;100
0;5;"shavera";5;0;100
0;30;"shavetta";30;0;100
0;101;"shavette";101;0;100
39;0;"shavez";39;100;0
0;10;"shavia";10;0;100
0;11;"shavina";11;0;100
0;5;"shavion";5;0;100
0;18;"shavita";18;0;100
0;32;"shavna";32;0;100
362;3875;"shavon";4237;8.54378097710644;91.4562190228936
0;271;"shavona";271;0;100
0;1117;"shavonda";1117;0;100
0;53;"shavondra";53;0;100
0;473;"shavone";473;0;100
0;25;"shavonia";25;0;100
0;174;"shavonn";174;0;100
0;799;"shavonna";799;0;100
0;2940;"shavonne";2940;0;100
10;141;"shavonta";151;6.62251655629139;93.3774834437086
5;94;"shavontae";99;5.05050505050505;94.9494949494949
48;233;"shavonte";281;17.0818505338078;82.9181494661922
0;12;"shavonya";12;0;100
0;55;"shavy";55;0;100
1073;41;"shaw";1114;96.3195691202873;3.68043087971275
7;0;"shawaiz";7;100;0
59;236;"shawan";295;20;80
0;1881;"shawana";1881;0;100
0;2853;"shawanda";2853;0;100
0;6;"shawandra";6;0;100
0;17;"shawann";17;0;100
0;1404;"shawanna";1404;0;100
0;11;"shawauna";11;0;100
0;24;"shawda";24;0;100
0;23;"shawdae";23;0;100
0;10;"shawday";10;0;100
11;0;"shawen";11;100;0
5;0;"shawhin";5;100;0
6;0;"shawkat";6;100;0
5;0;"shawki";5;100;0
301056;32946;"shawn";334002;90.1359872096574;9.86401279034257
105;45327;"shawna";45432;0.231114632857898;99.7688853671421
0;5;"shawnacy";5;0;100
0;351;"shawnae";351;0;100
0;39;"shawnah";39;0;100
0;29;"shawnalee";29;0;100
0;64;"shawnay";64;0;100
0;2538;"shawnda";2538;0;100
158;28;"shawndale";186;84.9462365591398;15.0537634408602
0;37;"shawndee";37;0;100
51;46;"shawndel";97;52.5773195876289;47.4226804123711
258;146;"shawndell";404;63.8613861386139;36.1386138613861
0;5;"shawndelle";5;0;100
0;5;"shawndi";5;0;100
0;677;"shawndra";677;0;100
22;0;"shawndre";22;100;0
0;133;"shawndrea";133;0;100
0;19;"shawndreka";19;0;100
0;6;"shawndria";6;0;100
0;22;"shawndrika";22;0;100
429;808;"shawne";1237;34.6806790622474;65.3193209377526
0;52;"shawnea";52;0;100
0;18;"shawnece";18;0;100
120;3845;"shawnee";3965;3.02648171500631;96.9735182849937
0;6;"shawneece";6;0;100
0;123;"shawneen";123;0;100
0;90;"shawneequa";90;0;100
0;5;"shawneeque";5;0;100
0;19;"shawneice";19;0;100
0;5;"shawneka";5;0;100
21;248;"shawnell";269;7.80669144981413;92.1933085501859
0;117;"shawnelle";117;0;100
0;24;"shawnequa";24;0;100
0;173;"shawnese";173;0;100
0;5;"shawnesha";5;0;100
0;23;"shawnessy";23;0;100
0;11;"shawnett";11;0;100
0;255;"shawnetta";255;0;100
0;750;"shawnette";750;0;100
0;35;"shawney";35;0;100
0;230;"shawni";230;0;100
0;168;"shawnia";168;0;100
0;16;"shawnic";16;0;100
0;435;"shawnice";435;0;100
0;559;"shawnie";559;0;100
0;175;"shawniece";175;0;100
0;158;"shawnika";158;0;100
0;50;"shawniqua";50;0;100
0;106;"shawnique";106;0;100
0;92;"shawnise";92;0;100
0;21;"shawnisha";21;0;100
0;258;"shawnita";258;0;100
156;0;"shawnmichael";156;100;0
107;44;"shawnn";151;70.8609271523179;29.1390728476821
0;2854;"shawnna";2854;0;100
0;11;"shawnnessy";11;0;100
0;5;"shawnon";5;0;100
118;1812;"shawnta";1930;6.1139896373057;93.8860103626943
15;854;"shawntae";869;1.72612197928654;98.2738780207135
0;16;"shawntai";16;0;100
0;33;"shawntal";33;0;100
0;5;"shawntale";5;0;100
0;5;"shawntane";5;0;100
0;13;"shawntasia";13;0;100
0;190;"shawntavia";190;0;100
35;694;"shawntay";729;4.80109739368999;95.19890260631
0;24;"shawntaya";24;0;100
0;12;"shawntaye";12;0;100
102;1383;"shawnte";1485;6.86868686868687;93.1313131313131
0;29;"shawntea";29;0;100
0;207;"shawntee";207;0;100
17;1135;"shawntel";1152;1.47569444444444;98.5243055555556
0;495;"shawntell";495;0;100
0;10;"shawntella";10;0;100
0;211;"shawntelle";211;0;100
0;7;"shawnteria";7;0;100
0;5;"shawntey";5;0;100
119;0;"shawntez";119;100;0
0;11;"shawnti";11;0;100
0;305;"shawntia";305;0;100
0;10;"shawntice";10;0;100
0;5;"shawntika";5;0;100
0;101;"shawntina";101;0;100
8;51;"shawntrell";59;13.5593220338983;86.4406779661017
0;70;"shawntrice";70;0;100
0;87;"shawny";87;0;100
0;141;"shawnya";141;0;100
165;40;"shawon";205;80.4878048780488;19.5121951219512
0;43;"shawona";43;0;100
0;123;"shawonda";123;0;100
0;29;"shawonna";29;0;100
0;42;"shawta";42;0;100
5;0;"shawun";5;100;0
0;5;"shawyn";5;0;100
4222;6142;"shay";10364;40.7371671169433;59.2628328830567
877;767;"shaya";1644;53.345498783455;46.654501216545
566;0;"shayaan";566;100;0
0;6;"shayah";6;0;100
0;10;"shayal";10;0;100
1605;58;"shayan";1663;96.5123271196633;3.48767288033674
0;239;"shayana";239;0;100
0;6;"shayane";6;0;100
0;157;"shayann";157;0;100
0;281;"shayanna";281;0;100
0;331;"shayanne";331;0;100
26;0;"shayd";26;100;0
0;307;"shayda";307;0;100
83;55;"shayde";138;60.1449275362319;39.8550724637681
0;24;"shaydee";24;0;100
779;262;"shayden";1041;74.8318924111431;25.1681075888569
0;13;"shaydie";13;0;100
5;0;"shaydin";5;100;0
133;0;"shaydon";133;100;0
581;2074;"shaye";2655;21.8832391713748;78.1167608286252
0;12;"shayeeda";12;0;100
0;19;"shayenne";19;0;100
0;37;"shayera";37;0;100
17;29398;"shayla";29415;0.0577936426993031;99.9422063573007
0;877;"shaylah";877;0;100
60;323;"shaylan";383;15.6657963446475;84.3342036553525
0;159;"shayle";159;0;100
0;311;"shaylea";311;0;100
0;5;"shayleah";5;0;100
0;6308;"shaylee";6308;0;100
0;494;"shayleen";494;0;100
0;37;"shaylei";37;0;100
0;662;"shayleigh";662;0;100
32;538;"shaylen";570;5.6140350877193;94.3859649122807
0;950;"shaylene";950;0;100
0;239;"shayley";239;0;100
0;333;"shayli";333;0;100
0;31;"shaylia";31;0;100
0;592;"shaylie";592;0;100
10;1746;"shaylin";1756;0.569476082004556;99.4305239179954
0;68;"shaylinn";68;0;100
0;5;"shaylla";5;0;100
0;16;"shayln";16;0;100
87;166;"shaylon";253;34.3873517786561;65.6126482213439
0;5;"shaylonda";5;0;100
10;0;"shaylor";10;100;0
0;1997;"shaylyn";1997;0;100
0;2063;"shaylynn";2063;0;100
0;67;"shaylynne";67;0;100
0;151;"shayma";151;0;100
0;18;"shaymaa";18;0;100
75;0;"shaymus";75;100;0
444;0;"shayn";444;100;0
5;15528;"shayna";15533;0.0321895319642052;99.9678104680358
0;113;"shaynah";113;0;100
0;5;"shayndel";5;0;100
10388;2783;"shayne";13171;78.8702452357452;21.1297547642548
0;58;"shaynee";58;0;100
0;6;"shaynell";6;0;100
0;5;"shaynelle";5;0;100
0;10;"shayni";10;0;100
0;22;"shaynia";22;0;100
0;10;"shaynie";10;0;100
0;233;"shaynna";233;0;100
0;6;"shaynne";6;0;100
102;7;"shayon";109;93.5779816513761;6.42201834862385
0;82;"shayona";82;0;100
0;216;"shayonna";216;0;100
53;0;"shayquan";53;100;0
0;148;"shayra";148;0;100
5;11;"shayron";16;31.25;68.75
5;28;"shayvon";33;15.1515151515152;84.8484848484848
0;25;"shayvonne";25;0;100
6;0;"shaz";6;100;0
0;46;"shaza";46;0;100
16;0;"shazad";16;100;0
6;0;"shazain";6;100;0
0;10;"shazaria";10;0;100
6;0;"shazeb";6;100;0
0;471;"shazia";471;0;100
30;0;"shazil";30;100;0
0;12;"shdiamond";12;0;100
0;5;"she";5;0;100
7417;10628;"shea";18045;41.1027985591577;58.8972014408423
45;0;"sheadon";45;100;0
0;5;"sheaira";5;0;100
0;278;"sheala";278;0;100
0;5;"shealan";5;0;100
0;227;"shealee";227;0;100
0;11;"shealeen";11;0;100
0;129;"shealeigh";129;0;100
0;32;"shealene";32;0;100
0;10;"shealey";10;0;100
0;5;"sheali";5;0;100
0;27;"shealin";27;0;100
0;34;"shealy";34;0;100
0;1212;"shealyn";1212;0;100
0;735;"shealynn";735;0;100
407;0;"sheamus";407;100;0
414;6;"shean";420;98.5714285714286;1.42857142857143
0;623;"sheana";623;0;100
0;5;"sheandra";5;0;100
0;198;"sheanna";198;0;100
0;10;"sheara";10;0;100
10;10;"shearl";20;50;50
0;216;"shearon";216;0;100
0;5;"sheary";5;0;100
0;1147;"sheba";1147;0;100
0;63;"shebra";63;0;100
0;5;"shebria";5;0;100
0;376;"sheccid";376;0;100
0;21;"shecid";21;0;100
72;0;"shed";72;100;0
181;0;"sheddrick";181;100;0
6;0;"shederick";6;100;0
0;5;"shedonna";5;0;100
78;0;"shedric";78;100;0
5;0;"shedrich";5;100;0
2607;0;"shedrick";2607;100;0
0;5;"shedricka";5;0;100
0;38;"sheeba";38;0;100
69;5;"sheehan";74;93.2432432432432;6.75675675675676
25;0;"sheel";25;100;0
0;679;"sheela";679;0;100
0;7;"sheelagh";7;0;100
0;89;"sheelah";89;0;100
0;35;"sheema";35;0;100
15;11;"sheen";26;57.6923076923077;42.3076923076923
67;22236;"sheena";22303;0.300408016858719;99.6995919831413
0;86;"sheenah";86;0;100
0;26;"sheenamarie";26;0;100
0;13;"sheene";13;0;100
0;5;"sheeneeka";5;0;100
0;21;"sheenia";21;0;100
0;6;"sheenika";6;0;100
0;12;"sheenna";12;0;100
0;133;"sheera";133;0;100
0;9;"sheere";9;0;100
0;11;"sheereen";11;0;100
0;6;"sheery";6;0;100
0;251;"sheetal";251;0;100
0;40;"sheeva";40;0;100
0;296;"shefali";296;0;100
71;0;"sheffield";71;100;0
44;0;"shehab";44;100;0
5;0;"sheharyar";5;100;0
0;5;"shehrbano";5;0;100
5;0;"shehroz";5;100;0
10;0;"shehryar";10;100;0
39;0;"shehzad";39;100;0
0;6;"shehzeen";6;0;100
0;15;"sheida";15;0;100
39;0;"sheik";39;100;0
0;76;"sheika";76;0;100
287;10;"sheikh";297;96.6329966329966;3.36700336700337
0;11;"sheikha";11;0;100
0;5;"sheil";5;0;100
648;237812;"sheila";238460;0.271743688668959;99.728256311331
0;56;"sheilagh";56;0;100
0;2284;"sheilah";2284;0;100
0;10;"sheilamarie";10;0;100
0;49;"sheilda";49;0;100
0;5;"sheili";5;0;100
0;384;"sheilia";384;0;100
0;444;"sheilla";444;0;100
0;17;"sheilly";17;0;100
0;421;"sheily";421;0;100
0;81;"sheilyn";81;0;100
0;407;"sheina";407;0;100
0;38;"sheindel";38;0;100
0;39;"sheindy";39;0;100
0;12;"sheira";12;0;100
0;5;"sheiva";5;0;100
0;37;"sheka";37;0;100
0;6;"shekayla";6;0;100
0;7;"shekeena";7;0;100
0;5;"shekeia";5;0;100
0;5;"shekeila";5;0;100
0;6;"shekeita";6;0;100
0;10;"shekeitha";10;0;100
0;82;"shekela";82;0;100
0;55;"shekelia";55;0;100
0;30;"shekema";30;0;100
0;36;"shekena";36;0;100
0;77;"shekera";77;0;100
0;38;"shekeria";38;0;100
0;7;"shekerra";7;0;100
0;84;"sheketa";84;0;100
0;11;"sheketha";11;0;100
0;6;"shekevia";6;0;100
0;6;"shekeya";6;0;100
0;5;"shekhinah";5;0;100
0;313;"shekia";313;0;100
0;44;"shekila";44;0;100
0;34;"shekima";34;0;100
0;176;"shekina";176;0;100
0;1915;"shekinah";1915;0;100
0;159;"shekira";159;0;100
0;300;"shekita";300;0;100
0;5;"shekitha";5;0;100
10;0;"sheku";10;100;0
0;1398;"shela";1398;0;100
0;509;"shelagh";509;0;100
0;510;"shelah";510;0;100
0;101;"shelaine";101;0;100
0;5;"shelan";5;0;100
0;29;"shelana";29;0;100
0;125;"shelanda";125;0;100
0;23;"shelane";23;0;100
0;5;"shelaya";5;0;100
0;5;"shelayne";5;0;100
5;2136;"shelba";2141;0.233535730966838;99.7664642690332
0;336;"shelbe";336;0;100
0;54;"shelbea";54;0;100
0;587;"shelbee";587;0;100
5;0;"shelbert";5;100;0
0;896;"shelbey";896;0;100
0;5401;"shelbi";5401;0;100
0;147;"shelbia";147;0;100
0;5433;"shelbie";5433;0;100
0;5;"shelbra";5;0;100
15827;143557;"shelby";159384;9.93010590774482;90.0698940922552
0;12;"shelbyann";12;0;100
0;39;"shelbye";39;0;100
0;6;"shelbyjean";6;0;100
0;5;"shelbyjo";5;0;100
0;21;"shelbylyn";21;0;100
0;139;"shelbylynn";139;0;100
0;19;"shelcy";19;0;100
0;569;"shelda";569;0;100
22;0;"sheldan";22;100;0
269;5;"shelden";274;98.1751824817518;1.82481751824817
0;5;"sheldia";5;0;100
35819;496;"sheldon";36315;98.6341732066639;1.36582679333609
36;0;"sheldrick";36;100;0
11;12;"sheldyn";23;47.8260869565217;52.1739130434783
0;5;"shele";5;0;100
0;32;"shelea";32;0;100
0;12;"sheleah";12;0;100
0;25;"shelee";25;0;100
0;78;"sheleen";78;0;100
0;5;"sheleena";5;0;100
0;404;"shelena";404;0;100
0;326;"shelene";326;0;100
0;15;"shelese";15;0;100
0;42;"sheleta";42;0;100
0;128;"sheletha";128;0;100
0;18;"sheletta";18;0;100
0;5;"shelette";5;0;100
0;32;"sheley";32;0;100
0;647;"sheli";647;0;100
111;47722;"shelia";47833;0.232057366253423;99.7679426337466
0;434;"sheliah";434;0;100
0;5;"shelica";5;0;100
0;11;"shelice";11;0;100
0;22;"shelicia";22;0;100
0;119;"shelie";119;0;100
0;20;"shelika";20;0;100
0;425;"shelina";425;0;100
0;47;"shelinda";47;0;100
0;391;"shelisa";391;0;100
0;137;"shelise";137;0;100
0;66;"shelisha";66;0;100
0;7;"shelissa";7;0;100
0;966;"shelita";966;0;100
0;86;"shelitha";86;0;100
0;5;"sheliya";5;0;100
0;10;"sheliyah";10;0;100
0;5;"sheliza";5;0;100
114;198;"shell";312;36.5384615384615;63.4615384615385
0;1123;"shella";1123;0;100
0;5;"shellaine";5;0;100
0;28;"shellane";28;0;100
0;5;"shellbe";5;0;100
0;57;"shellbie";57;0;100
0;496;"shellby";496;0;100
0;577;"shelle";577;0;100
0;10;"shellea";10;0;100
0;859;"shellee";859;0;100
0;37;"shelleen";37;0;100
0;52;"shellena";52;0;100
0;290;"shellene";290;0;100
1713;72468;"shelley";74181;2.30921664577183;97.6907833542282
0;6981;"shelli";6981;0;100
0;397;"shellia";397;0;100
859;9869;"shellie";10728;8.00708426547353;91.9929157345265
0;32;"shellina";32;0;100
0;11;"shelline";11;0;100
0;5;"shellisa";5;0;100
0;12;"shellise";12;0;100
0;127;"shellsea";127;0;100
2116;84170;"shelly";86286;2.45230976056371;97.5476902394363
0;76;"shellyann";76;0;100
0;174;"shellye";174;0;100
0;77;"shelma";77;0;100
0;20;"shelon";20;0;100
0;279;"shelonda";279;0;100
0;620;"shelsea";620;0;100
0;224;"shelsey";224;0;100
0;88;"shelsie";88;0;100
0;374;"shelsy";374;0;100
11600;172;"shelton";11772;98.5389058783554;1.46109412164458
14;1117;"shelva";1131;1.23784261715296;98.762157382847
0;46;"shelvey";46;0;100
0;400;"shelvia";400;0;100
6;293;"shelvie";299;2.0066889632107;97.9933110367893
59;0;"shelvin";59;100;0
64;332;"shelvy";396;16.1616161616162;83.8383838383838
0;31;"shely";31;0;100
0;11;"shelyn";11;0;100
622;5;"shem";627;99.2025518341308;0.797448165869218
0;35;"shema";35;0;100
12;258;"shemaiah";270;4.44444444444444;95.5555555555556
0;5;"shemaine";5;0;100
0;5;"shemaka";5;0;100
2177;6;"shemar";2183;99.7251488776913;0.274851122308749
0;5;"shemara";5;0;100
11;5;"shemari";16;68.75;31.25
0;27;"shemariah";27;0;100
6;0;"shemarion";6;100;0
11;0;"shemarr";11;100;0
0;91;"shemeca";91;0;100
0;8;"shemecka";8;0;100
0;59;"shemeeka";59;0;100
0;186;"shemeika";186;0;100
0;1563;"shemeka";1563;0;100
0;333;"shemekia";333;0;100
0;5;"shemera";5;0;100
0;142;"shemia";142;0;100
0;160;"shemiah";160;0;100
0;201;"shemica";201;0;100
0;74;"shemicka";74;0;100
0;6;"shemieka";6;0;100
0;1454;"shemika";1454;0;100
0;18;"shemira";18;0;100
0;5;"shemita";5;0;100
83;0;"shemuel";83;100;0
0;33;"shemya";33;0;100
48;0;"shen";48;100;0
0;2350;"shena";2350;0;100
0;6;"shenade";6;0;100
0;333;"shenae";333;0;100
0;19;"shenai";19;0;100
25;27;"shenan";52;48.0769230769231;51.9230769230769
112;319;"shenandoah";431;25.9860788863109;74.0139211136891
10;0;"shenard";10;100;0
0;162;"shenay";162;0;100
0;54;"shenaya";54;0;100
0;10;"shenaye";10;0;100
0;10;"shenda";10;0;100
0;92;"shene";92;0;100
0;147;"shenea";147;0;100
0;5;"sheneaka";5;0;100
0;5;"sheneda";5;0;100
0;264;"shenee";264;0;100
0;37;"sheneeka";37;0;100
0;28;"sheneice";28;0;100
0;78;"sheneika";78;0;100
0;5;"sheneil";5;0;100
0;822;"sheneka";822;0;100
0;60;"shenekia";60;0;100
0;42;"shenel";42;0;100
0;624;"shenell";624;0;100
0;430;"shenelle";430;0;100
0;506;"shenequa";506;0;100
0;16;"sheneque";16;0;100
0;18;"shenequia";18;0;100
0;48;"shenese";48;0;100
0;5;"sheneshia";5;0;100
0;21;"sheneta";21;0;100
0;54;"shenetha";54;0;100
0;30;"shenetra";30;0;100
0;230;"shenetta";230;0;100
0;43;"shenette";43;0;100
16;370;"sheng";386;4.14507772020725;95.8549222797927
0;5;"shengyeng";5;0;100
0;359;"shenia";359;0;100
0;71;"sheniah";71;0;100
0;132;"shenica";132;0;100
0;261;"shenice";261;0;100
0;56;"shenicka";56;0;100
0;76;"sheniece";76;0;100
0;1839;"shenika";1839;0;100
0;5;"shenikia";5;0;100
0;10;"shenikwa";10;0;100
0;7;"shenille";7;0;100
0;5;"shenina";5;0;100
0;703;"sheniqua";703;0;100
0;266;"shenique";266;0;100
0;467;"shenise";467;0;100
0;11;"shenisha";11;0;100
0;1550;"shenita";1550;0;100
0;42;"shenitha";42;0;100
0;25;"shenitra";25;0;100
0;9;"shenitta";9;0;100
0;100;"sheniya";100;0;100
0;22;"sheniyah";22;0;100
0;10;"shenkia";10;0;100
0;1328;"shenna";1328;0;100
0;5;"shennan";5;0;100
0;5;"shennel";5;0;100
0;10;"shennon";10;0;100
0;62;"shenoa";62;0;100
0;13;"shenoah";13;0;100
68;0;"shenouda";68;100;0
0;8;"shentel";8;0;100
0;6;"shentell";6;0;100
0;21;"sheny";21;0;100
0;5;"shenya";5;0;100
0;5;"shenyah";5;0;100
5;5;"sheon";10;50;50
0;28;"sheona";28;0;100
0;12;"sheonna";12;0;100
0;6;"sheonta";6;0;100
50;0;"shep";50;100;0
1587;5;"shepard";1592;99.6859296482412;0.314070351758794
11;0;"sheperd";11;100;0
0;64;"shephanie";64;0;100
17;0;"shephard";17;100;0
23;0;"shephen";23;100;0
1758;5;"shepherd";1763;99.7163925127623;0.283607487237663
434;0;"sheppard";434;100;0
17;0;"shequan";17;100;0
0;31;"shequana";31;0;100
0;5;"shequanda";5;0;100
0;5;"shequanna";5;0;100
0;17;"shequetta";17;0;100
0;154;"shequila";154;0;100
0;64;"shequilla";64;0;100
30;0;"shequille";30;100;0
0;5;"shequira";5;0;100
0;602;"shequita";602;0;100
0;15;"shequitta";15;0;100
122;124;"sher";246;49.5934959349593;50.4065040650407
0;1507;"shera";1507;0;100
0;18;"sheradyn";18;0;100
0;273;"sherae";273;0;100
0;193;"sherah";193;0;100
0;16;"sheraine";16;0;100
0;423;"sheral";423;0;100
40;110;"sherald";150;26.6666666666667;73.3333333333333
0;5;"sheraldine";5;0;100
0;102;"sheralee";102;0;100
0;5;"sherall";5;0;100
0;580;"sheralyn";580;0;100
0;567;"sheran";567;0;100
0;73;"sheranda";73;0;100
537;0;"sherard";537;100;0
5;0;"sheraton";5;100;0
0;151;"sheray";151;0;100
0;20;"sheraya";20;0;100
0;6;"sherayne";6;0;100
44;0;"sheraz";44;100;0
5;0;"sherburne";5;100;0
0;93;"sherby";93;0;100
0;15;"sherdina";15;0;100
0;253;"shere";253;0;100
0;231;"sherea";231;0;100
0;28;"sherease";28;0;100
0;10;"shereca";10;0;100
0;260;"sherece";260;0;100
0;67;"shereda";67;0;100
0;13546;"sheree";13546;0;100
0;92;"shereece";92;0;100
6;0;"shereef";6;100;0
0;1574;"shereen";1574;0;100
0;58;"shereena";58;0;100
0;238;"shereese";238;0;100
0;16;"shereeta";16;0;100
0;5;"shereika";5;0;100
0;501;"shereka";501;0;100
0;139;"sherel";139;0;100
0;5;"sherelene";5;0;100
5;1475;"sherell";1480;0.337837837837838;99.6621621621622
0;1020;"sherelle";1020;0;100
0;56;"sherelyn";56;0;100
0;21;"sheren";21;0;100
0;446;"sherena";446;0;100
0;746;"sherene";746;0;100
0;312;"sheresa";312;0;100
0;940;"sherese";940;0;100
0;11;"sheresse";11;0;100
0;64;"shereta";64;0;100
0;74;"sheretha";74;0;100
0;355;"sheretta";355;0;100
0;24;"sherette";24;0;100
0;5;"sherezade";5;0;100
0;145;"sherhonda";145;0;100
114;60393;"sheri";60507;0.18840795279885;99.8115920472011
0;654;"sheria";654;0;100
0;53;"sheriah";53;0;100
0;93;"sherial";93;0;100
0;849;"sherian";849;0;100
0;156;"sheriann";156;0;100
0;39;"sherianne";39;0;100
0;648;"sherica";648;0;100
0;1505;"sherice";1505;0;100
6;0;"sherick";6;100;0
0;324;"shericka";324;0;100
0;998;"sherida";998;0;100
2676;5416;"sheridan";8092;33.0696984676223;66.9303015323777
0;64;"sheriden";64;0;100
0;6;"sheridon";6;0;100
0;87;"sheridyn";87;0;100
0;5010;"sherie";5010;0;100
0;47;"sheriece";47;0;100
0;6;"sheriee";6;0;100
11;0;"sherief";11;100;0
0;5;"sheriel";5;0;100
377;0;"sherif";377;100;0
0;5;"sherifat";5;0;100
85;0;"sheriff";85;100;0
0;1966;"sherika";1966;0;100
5;704;"sheril";709;0.705218617771509;99.2947813822285
0;5;"sherile";5;0;100
0;129;"sherilee";129;0;100
61;1019;"sherill";1080;5.64814814814815;94.3518518518518
0;11;"sherille";11;0;100
0;3881;"sherilyn";3881;0;100
0;319;"sherilynn";319;0;100
0;404;"sherin";404;0;100
0;797;"sherina";797;0;100
0;5;"sherinda";5;0;100
0;430;"sherine";430;0;100
0;159;"sherion";159;0;100
0;68;"sherisa";68;0;100
0;975;"sherise";975;0;100
0;92;"sherissa";92;0;100
0;193;"sherisse";193;0;100
0;4018;"sherita";4018;0;100
0;124;"sheritha";124;0;100
0;205;"sheritta";205;0;100
0;22;"sheriyah";22;0;100
0;7;"sherkia";7;0;100
0;5;"sherkita";5;0;100
5;349;"sherl";354;1.41242937853107;98.5875706214689
0;19;"sherla";19;0;100
0;16;"sherlanda";16;0;100
0;69;"sherle";69;0;100
0;26;"sherlean";26;0;100
0;24;"sherlee";24;0;100
0;174;"sherleen";174;0;100
0;6;"sherlena";6;0;100
0;1071;"sherlene";1071;0;100
264;1218;"sherley";1482;17.8137651821862;82.1862348178138
0;10;"sherli";10;0;100
0;219;"sherlie";219;0;100
0;716;"sherlin";716;0;100
0;356;"sherline";356;0;100
0;25;"sherlita";25;0;100
0;5;"sherlly";5;0;100
55;0;"sherlock";55;100;0
0;99;"sherlon";99;0;100
0;156;"sherlonda";156;0;100
0;908;"sherly";908;0;100
8;7704;"sherlyn";7712;0.103734439834025;99.896265560166
0;108;"sherlyne";108;0;100
0;274;"sherlynn";274;0;100
0;319;"sherma";319;0;100
5;5;"shermain";10;50;50
173;508;"shermaine";681;25.4038179148311;74.5961820851689
37532;203;"sherman";37735;99.4620378958527;0.537962104147343
0;32;"shermane";32;0;100
93;0;"shermar";93;100;0
0;139;"shermeka";139;0;100
0;16;"shermia";16;0;100
0;24;"shermica";24;0;100
0;151;"shermika";151;0;100
370;0;"shermon";370;100;0
0;5;"shermona";5;0;100
0;31;"shermya";31;0;100
0;21;"sherna";21;0;100
12;0;"shernard";12;100;0
0;5;"sherneice";5;0;100
0;62;"shernell";62;0;100
0;5;"shernette";5;0;100
0;22;"shernice";22;0;100
0;48;"shernika";48;0;100
0;136;"shernita";136;0;100
565;0;"sherod";565;100;0
0;5;"sherokee";5;0;100
0;72;"sherol";72;0;100
0;192;"sherolyn";192;0;100
5;0;"sherome";5;100;0
384;3378;"sheron";3762;10.207336523126;89.792663476874
0;22;"sherona";22;0;100
0;1300;"sheronda";1300;0;100
10;40;"sherone";50;20;80
0;157;"sheronica";157;0;100
0;19;"sheronne";19;0;100
0;5;"sherquita";5;0;100
0;5;"sherr";5;0;100
0;897;"sherra";897;0;100
0;44;"sherrae";44;0;100
0;6;"sherraine";6;0;100
0;183;"sherral";183;0;100
0;5;"sherralyn";5;0;100
0;281;"sherran";281;0;100
47;0;"sherrard";47;100;0
0;36;"sherray";36;0;100
0;857;"sherre";857;0;100
0;5;"sherrea";5;0;100
0;1555;"sherree";1555;0;100
0;5;"sherreka";5;0;100
112;768;"sherrel";880;12.7272727272727;87.2727272727273
439;2775;"sherrell";3214;13.658991910392;86.341008089608
0;236;"sherrelle";236;0;100
0;32;"sherren";32;0;100
0;10;"sherrena";10;0;100
0;5;"sherrene";5;0;100
0;18;"sherrese";18;0;100
0;5;"sherretta";5;0;100
0;67;"sherrey";67;0;100
176;83563;"sherri";83739;0.210176859050144;99.7898231409498
0;419;"sherria";419;0;100
0;251;"sherrian";251;0;100
0;130;"sherriann";130;0;100
0;39;"sherrianne";39;0;100
0;176;"sherrica";176;0;100
0;412;"sherrice";412;0;100
166;5;"sherrick";171;97.0760233918129;2.92397660818713
0;57;"sherricka";57;0;100
0;17;"sherridan";17;0;100
11;35107;"sherrie";35118;0.0313229682783758;99.9686770317216
0;20;"sherriel";20;0;100
0;176;"sherrika";176;0;100
153;1622;"sherril";1775;8.61971830985915;91.3802816901408
0;44;"sherrilee";44;0;100
1914;6932;"sherrill";8846;21.6368980330093;78.3631019669907
0;5;"sherrille";5;0;100
0;690;"sherrilyn";690;0;100
0;210;"sherrilynn";210;0;100
0;310;"sherrin";310;0;100
0;63;"sherrina";63;0;100
0;74;"sherrine";74;0;100
0;33;"sherrion";33;0;100
0;5;"sherris";5;0;100
0;64;"sherrise";64;0;100
0;566;"sherrita";566;0;100
0;18;"sherritta";18;0;100
0;17;"sherrl";17;0;100
0;51;"sherrlyn";51;0;100
1912;5;"sherrod";1917;99.7391757955138;0.260824204486176
0;61;"sherrol";61;0;100
511;2946;"sherron";3457;14.7816025455597;85.2183974544403
0;195;"sherronda";195;0;100
0;6;"sherrone";6;0;100
976;229606;"sherry";230582;0.423276751871352;99.5767232481286
0;153;"sherryann";153;0;100
0;674;"sherrye";674;0;100
5;4103;"sherryl";4108;0.121713729308666;99.8782862706913
0;29;"sherryle";29;0;100
0;19;"sherrylee";19;0;100
0;109;"sherryll";109;0;100
0;19;"sherrylyn";19;0;100
0;38;"sherrylynn";38;0;100
0;68;"sherryn";68;0;100
0;5;"shertia";5;0;100
0;5;"sherunda";5;0;100
198;0;"shervin";198;100;0
0;97;"shervon";97;0;100
0;5;"shervonda";5;0;100
0;17;"shervonne";17;0;100
0;58;"sherwanda";58;0;100
3666;15;"sherwin";3681;99.5925020374898;0.407497962510187
5585;11;"sherwood";5596;99.8034310221587;0.196568977841315
6;0;"sherwyn";6;100;0
0;391;"shery";391;0;100
0;32;"sheryal";32;0;100
0;19;"sheryce";19;0;100
0;42;"sherye";42;0;100
0;16;"sheryel";16;0;100
200;78654;"sheryl";78854;0.253633296979227;99.7463667030208
0;72;"sherylann";72;0;100
0;1214;"sheryle";1214;0;100
0;1558;"sheryll";1558;0;100
0;11;"sheryln";11;0;100
0;26;"sherylyn";26;0;100
0;341;"sheryn";341;0;100
0;5;"sheshe";5;0;100
0;5;"shesia";5;0;100
0;6;"shetal";6;0;100
0;112;"shetara";112;0;100
0;5;"shetarra";5;0;100
0;7;"sheteka";7;0;100
0;7;"shetera";7;0;100
0;5;"sheterica";5;0;100
0;5;"sheterrica";5;0;100
0;11;"shetia";11;0;100
0;12;"shetika";12;0;100
0;278;"sheva";278;0;100
0;105;"shevaun";105;0;100
0;128;"shevawn";128;0;100
0;6;"shevell";6;0;100
0;5;"shevella";5;0;100
0;151;"shevelle";151;0;100
0;5;"shevetta";5;0;100
0;62;"shevette";62;0;100
0;5;"shevi";5;0;100
13;0;"shevin";13;100;0
15;419;"shevon";434;3.45622119815668;96.5437788018433
0;54;"shevonda";54;0;100
0;13;"shevone";13;0;100
0;307;"shevonne";307;0;100
16;205;"shevy";221;7.23981900452489;92.7601809954751
0;19;"shewana";19;0;100
0;121;"shewanda";121;0;100
0;32;"shewanna";32;0;100
139;135;"shey";274;50.7299270072993;49.2700729927007
15;0;"sheya";15;100;0
0;120;"sheyann";120;0;100
0;55;"sheyanna";55;0;100
0;733;"sheyanne";733;0;100
0;23;"sheyda";23;0;100
0;1415;"sheyenne";1415;0;100
0;3488;"sheyla";3488;0;100
0;111;"sheyli";111;0;100
0;101;"sheylin";101;0;100
0;6;"sheylla";6;0;100
0;38;"sheyly";38;0;100
0;5;"sheylyn";5;0;100
0;5;"sheylynn";5;0;100
0;196;"sheyna";196;0;100
0;149;"sheza";149;0;100
80;314;"shi";394;20.3045685279188;79.6954314720812
1101;702;"shia";1803;61.0648918469218;38.9351081530782
42;80;"shiah";122;34.4262295081967;65.5737704918033
0;5;"shiala";5;0;100
6;419;"shian";425;1.41176470588235;98.5882352941176
0;369;"shiana";369;0;100
0;434;"shiane";434;0;100
0;1965;"shiann";1965;0;100
0;910;"shianna";910;0;100
0;3742;"shianne";3742;0;100
0;68;"shiara";68;0;100
0;93;"shiasia";93;0;100
0;15;"shibani";15;0;100
0;6;"shida";6;0;100
6;5;"shie";11;54.5454545454545;45.4545454545455
0;14;"shieda";14;0;100
0;13;"shieka";13;0;100
0;4408;"shiela";4408;0;100
0;5;"shielah";5;0;100
0;14;"shielda";14;0;100
88;0;"shields";88;100;0
0;10;"shiena";10;0;100
0;5;"shiera";5;0;100
0;5;"shierra";5;0;100
0;62;"shiesha";62;0;100
0;224;"shifa";224;0;100
0;18;"shiffon";18;0;100
0;25;"shiffy";25;0;100
0;1269;"shifra";1269;0;100
6;0;"shig";6;100;0
5;0;"shige";5;100;0
22;0;"shigeki";22;100;0
0;325;"shigeko";325;0;100
6;0;"shigemi";6;100;0
0;13;"shigeno";13;0;100
6;0;"shigenobu";6;100;0
427;0;"shigeo";427;100;0
590;0;"shigeru";590;100;0
53;0;"shigeto";53;100;0
5;0;"shigetoshi";5;100;0
5;0;"shigeyuki";5;100;0
79;0;"shihab";79;100;0
75;0;"shiheem";75;100;0
10;0;"shiheim";10;100;0
0;10;"shiho";10;0;100
0;68;"shikara";68;0;100
0;6;"shikari";6;0;100
24;0;"shikeem";24;100;0
0;14;"shikela";14;0;100
0;5;"shikema";5;0;100
0;51;"shikera";51;0;100
0;5;"shikeria";5;0;100
0;5;"shiketa";5;0;100
0;5;"shikeyla";5;0;100
0;261;"shikha";261;0;100
15;0;"shikhar";15;100;0
0;42;"shikia";42;0;100
0;18;"shikina";18;0;100
0;143;"shikira";143;0;100
0;94;"shikita";94;0;100
0;1055;"shila";1055;0;100
0;795;"shilah";795;0;100
0;6;"shilat";6;0;100
0;60;"shilee";60;0;100
0;43;"shiley";43;0;100
0;10;"shilla";10;0;100
0;5;"shillae";5;0;100
796;1662;"shilo";2458;32.3840520748576;67.6159479251424
0;18;"shiloah";18;0;100
0;29;"shiloe";29;0;100
3762;7511;"shiloh";11273;33.3717732635501;66.6282267364499
0;37;"shilonda";37;0;100
0;15;"shilow";15;0;100
0;573;"shilpa";573;0;100
0;58;"shilyn";58;0;100
0;161;"shilynn";161;0;100
0;109;"shima";109;0;100
0;6;"shimara";6;0;100
0;7;"shimaya";7;0;100
5;0;"shimeek";5;100;0
0;5;"shimeeka";5;0;100
0;261;"shimeka";261;0;100
0;5;"shimekia";5;0;100
0;43;"shimere";43;0;100
0;174;"shimika";174;0;100
0;16;"shimira";16;0;100
3604;0;"shimon";3604;100;0
271;0;"shimshon";271;100;0
0;19;"shimya";19;0;100
81;12;"shin";93;87.0967741935484;12.9032258064516
0;426;"shina";426;0;100
0;42;"shinae";42;0;100
0;11;"shinaya";11;0;100
0;5;"shinda";5;0;100
0;17;"shindana";17;0;100
71;123;"shine";194;36.5979381443299;63.4020618556701
0;17;"shinea";17;0;100
0;19;"shinead";19;0;100
0;7;"shinece";7;0;100
0;5;"shinee";5;0;100
0;150;"shineka";150;0;100
0;17;"shinell";17;0;100
0;12;"shinelle";12;0;100
0;27;"shinequa";27;0;100
0;9;"shinese";9;0;100
0;5;"shinesha";5;0;100
0;6;"shinetta";6;0;100
5;5;"shing";10;50;50
31;0;"shingo";31;100;0
0;18;"shinia";18;0;100
0;5;"shiniah";5;0;100
0;32;"shinice";32;0;100
89;0;"shinichi";89;100;0
0;11;"shiniece";11;0;100
0;167;"shinika";167;0;100
0;95;"shiniqua";95;0;100
0;24;"shinique";24;0;100
0;10;"shinise";10;0;100
0;160;"shinita";160;0;100
0;10;"shiniya";10;0;100
28;0;"shinji";28;100;0
0;6;"shinna";6;0;100
7;0;"shinnosuke";7;100;0
5;0;"shinobi";5;100;0
5;5;"shinobu";10;50;50
26;0;"shintaro";26;100;0
0;23;"shiny";23;0;100
22;16;"shinya";38;57.8947368421053;42.1052631578947
0;5;"shioban";5;0;100
0;11;"shiobhan";11;0;100
0;19;"shiomara";19;0;100
98;38;"shion";136;72.0588235294118;27.9411764705882
0;24;"shiona";24;0;100
0;11;"shionna";11;0;100
0;201;"shiori";201;0;100
0;15;"shiphrah";15;0;100
0;6;"shiqi";6;0;100
120;0;"shiquan";120;100;0
0;11;"shiquana";11;0;100
0;456;"shiquita";456;0;100
0;177;"shir";177;0;100
0;5166;"shira";5166;0;100
0;5;"shirae";5;0;100
0;285;"shirah";285;0;100
0;46;"shiran";46;0;100
119;57;"shiraz";176;67.6136363636364;32.3863636363636
0;16;"shire";16;0;100
0;631;"shiree";631;0;100
0;1284;"shireen";1284;0;100
0;43;"shireka";43;0;100
0;251;"shirel";251;0;100
0;324;"shirell";324;0;100
0;705;"shirelle";705;0;100
0;231;"shirely";231;0;100
0;11;"shirena";11;0;100
0;36;"shirene";36;0;100
0;5;"shiretta";5;0;100
0;7;"shirey";7;0;100
0;211;"shiri";211;0;100
0;17;"shirika";17;0;100
0;696;"shirin";696;0;100
0;41;"shirita";41;0;100
448;1323;"shirl";1771;25.296442687747;74.703557312253
0;159;"shirla";159;0;100
0;5;"shirlane";5;0;100
0;11;"shirlann";11;0;100
0;104;"shirle";104;0;100
0;336;"shirlean";336;0;100
5;5703;"shirlee";5708;0.0875963559915907;99.9124036440084
0;1791;"shirleen";1791;0;100
0;5;"shirleeta";5;0;100
0;105;"shirlena";105;0;100
0;4856;"shirlene";4856;0;100
0;5;"shirletha";5;0;100
0;24;"shirletta";24;0;100
0;68;"shirlette";68;0;100
9254;684318;"shirley";693572;1.33425224778394;98.6657477522161
0;32;"shirleyan";32;0;100
0;576;"shirleyann";576;0;100
0;6;"shirleye";6;0;100
0;71;"shirleymae";71;0;100
0;22;"shirli";22;0;100
0;1288;"shirlie";1288;0;100
0;5;"shirlina";5;0;100
0;181;"shirline";181;0;100
0;20;"shirlon";20;0;100
27;1041;"shirly";1068;2.52808988764045;97.4719101123596
0;11;"shirlye";11;0;100
0;389;"shirlyn";389;0;100
0;48;"shirlynn";48;0;100
192;0;"shiro";192;100;0
32;88;"shiron";120;26.6666666666667;73.3333333333333
0;83;"shironda";83;0;100
17;10;"shirrel";27;62.962962962963;37.037037037037
31;68;"shirrell";99;31.3131313131313;68.6868686868687
0;5;"shirret";5;0;100
0;5;"shirron";5;0;100
0;72;"shiryl";72;0;100
66;0;"shishir";66;100;0
0;135;"shital";135;0;100
1477;0;"shiv";1477;100;0
384;249;"shiva";633;60.6635071090047;39.3364928909953
72;0;"shivaan";72;100;0
18;0;"shivaansh";18;100;0
13;0;"shivaay";13;100;0
0;203;"shivali";203;0;100
1303;0;"shivam";1303;100;0
130;0;"shivan";130;100;0
0;10;"shivana";10;0;100
41;0;"shivang";41;100;0
0;149;"shivangi";149;0;100
0;2604;"shivani";2604;0;100
63;0;"shivank";63;100;0
233;0;"shivansh";233;100;0
0;17;"shivanshi";17;0;100
0;5;"shivany";5;0;100
0;13;"shivanya";13;0;100
0;60;"shivaun";60;0;100
6;0;"shivay";6;100;0
348;0;"shiven";348;100;0
21;0;"shivesh";21;100;0
0;5;"shivi";5;0;100
0;24;"shivika";24;0;100
15;0;"shivin";15;100;0
0;131;"shivon";131;0;100
0;117;"shivonne";117;0;100
0;6;"shivonni";6;0;100
15;0;"shivraj";15;100;0
0;6;"shivya";6;0;100
0;6;"shiwana";6;0;100
0;12;"shiwanda";12;0;100
36;176;"shiya";212;16.9811320754717;83.0188679245283
0;10;"shiyah";10;0;100
0;30;"shiyan";30;0;100
0;10;"shiyana";10;0;100
0;5;"shiyann";5;0;100
0;5;"shiyanna";5;0;100
0;19;"shiyanne";19;0;100
10;0;"shiye";10;100;0
0;123;"shiza";123;0;100
0;28;"shizu";28;0;100
0;608;"shizue";608;0;100
0;35;"shizuka";35;0;100
0;620;"shizuko";620;0;100
135;0;"shizuo";135;100;0
0;84;"shizuye";84;0;100
0;16;"shizuyo";16;0;100
74;0;"shjon";74;100;0
0;22;"shlanda";22;0;100
0;127;"shley";127;0;100
28;0;"shloak";28;100;0
56;0;"shloima";56;100;0
414;0;"shloime";414;100;0
231;0;"shloimy";231;100;0
591;0;"shlok";591;100;0
0;173;"shloka";173;0;100
6;0;"shloke";6;100;0
308;0;"shloma";308;100;0
487;0;"shlome";487;100;0
107;0;"shlomie";107;100;0
0;5;"shlomit";5;0;100
3847;0;"shlomo";3847;100;0
25;0;"shlomy";25;100;0
0;118;"shlonda";118;0;100
26;0;"shmar";26;100;0
42;0;"shmaya";42;100;0
10;0;"shmeil";10;100;0
0;32;"shmeka";32;0;100
552;0;"shmiel";552;100;0
3932;0;"shmuel";3932;100;0
0;40;"shmya";40;0;100
0;5;"shnea";5;0;100
5;0;"shneor";5;100;0
0;6;"shnequa";6;0;100
414;0;"shneur";414;100;0
0;7;"shnika";7;0;100
0;5;"shnita";5;0;100
0;29;"shniya";29;0;100
0;5;"shniyah";5;0;100
0;16;"shnya";16;0;100
383;0;"sho";383;100;0
134;0;"shoaib";134;100;0
9;0;"shoan";9;100;0
94;0;"shogo";94;100;0
43;0;"shohei";43;100;0
12;0;"shohjahon";12;100;0
11;0;"shohn";11;100;0
131;0;"shoichi";131;100;0
129;0;"shoji";129;100;0
0;30;"shoko";30;0;100
5;27;"shola";32;15.625;84.375
0;309;"sholanda";309;0;100
44;0;"sholem";44;100;0
1094;0;"sholom";1094;100;0
0;118;"sholonda";118;0;100
11;0;"shoma";11;100;0
1064;71;"shomari";1135;93.7444933920705;6.25550660792952
5019;354;"shon";5373;93.4115019542155;6.58849804578448
0;2403;"shona";2403;0;100
0;10;"shonae";10;0;100
0;7444;"shonda";7444;0;100
0;12;"shondala";12;0;100
77;14;"shondale";91;84.6153846153846;15.3846153846154
0;5;"shondalyn";5;0;100
24;24;"shondel";48;50;50
262;237;"shondell";499;52.5050100200401;47.4949899799599
0;6;"shondelle";6;0;100
0;22;"shondi";22;0;100
0;21;"shondia";21;0;100
0;5;"shondolyn";5;0;100
0;1228;"shondra";1228;0;100
5;0;"shondre";5;100;0
0;147;"shondrea";147;0;100
0;34;"shondreka";34;0;100
0;58;"shondria";58;0;100
5;0;"shondrick";5;100;0
0;88;"shondrika";88;0;100
335;51;"shone";386;86.7875647668394;13.2124352331606
0;7;"shonee";7;0;100
0;12;"shoneen";12;0;100
0;5;"shoneka";5;0;100
0;50;"shonell";50;0;100
0;22;"shonelle";22;0;100
0;5;"shonett";5;0;100
0;39;"shonetta";39;0;100
0;160;"shonette";160;0;100
5;11;"shoney";16;31.25;68.75
5;0;"shong";5;100;0
0;144;"shoni";144;0;100
0;144;"shonia";144;0;100
0;72;"shonica";72;0;100
0;91;"shonice";91;0;100
0;29;"shonie";29;0;100
0;7;"shoniece";7;0;100
0;112;"shonika";112;0;100
0;41;"shoniqua";41;0;100
0;77;"shonique";77;0;100
0;122;"shonita";122;0;100
242;5;"shonn";247;97.9757085020243;2.02429149797571
0;3089;"shonna";3089;0;100
0;10;"shonnell";10;0;100
0;5;"shonnetta";5;0;100
0;39;"shonnette";39;0;100
0;5;"shonni";5;0;100
0;244;"shonnie";244;0;100
0;5;"shonnita";5;0;100
23;31;"shonnon";54;42.5925925925926;57.4074074074074
5;0;"shonski";5;100;0
74;1604;"shonta";1678;4.41001191895113;95.5899880810489
10;842;"shontae";852;1.17370892018779;98.8262910798122
0;17;"shontai";17;0;100
0;22;"shontal";22;0;100
0;13;"shontasia";13;0;100
0;261;"shontavia";261;0;100
5;0;"shontavius";5;100;0
10;567;"shontay";577;1.73310225303293;98.2668977469671
0;6;"shontaya";6;0;100
0;35;"shontaye";35;0;100
80;1008;"shonte";1088;7.35294117647059;92.6470588235294
0;17;"shontea";17;0;100
0;41;"shontee";41;0;100
19;771;"shontel";790;2.40506329113924;97.5949367088608
6;652;"shontell";658;0.911854103343465;99.0881458966565
0;17;"shontella";17;0;100
0;257;"shontelle";257;0;100
0;71;"shonteria";71;0;100
0;25;"shonterria";25;0;100
55;0;"shontez";55;100;0
0;330;"shontia";330;0;100
0;11;"shontice";11;0;100
0;47;"shontina";47;0;100
0;5;"shontisha";5;0;100
0;12;"shontoria";12;0;100
0;6;"shontoya";6;0;100
0;51;"shontrell";51;0;100
0;22;"shontrice";22;0;100
0;117;"shonya";117;0;100
230;0;"shooter";230;100;0
0;16;"shoran";16;0;100
5;0;"shorn";5;100;0
0;11;"shoronda";11;0;100
30;0;"shorty";30;100;0
0;4502;"shoshana";4502;0;100
0;188;"shoshanah";188;0;100
0;729;"shoshanna";729;0;100
0;217;"shoshannah";217;0;100
0;18;"shoshawna";18;0;100
0;5;"shoshona";5;0;100
0;11;"shoshone";11;0;100
7;0;"shoso";7;100;0
281;0;"shota";281;100;0
23;0;"shotaro";23;100;0
10;0;"shou";10;100;0
83;282;"shoua";365;22.7397260273973;77.2602739726027
0;12;"shouana";12;0;100
6;0;"shoumik";6;100;0
6;0;"shoun";6;100;0
0;16;"shounda";16;0;100
233;0;"shourya";233;100;0
0;6;"shovan";6;0;100
0;5;"shovon";5;0;100
0;10;"shovonne";10;0;100
0;15;"showanda";15;0;100
75;6;"shown";81;92.5925925925926;7.40740740740741
19;0;"shozo";19;100;0
0;16;"shpresa";16;0;100
0;11;"shqipe";11;0;100
0;203;"shraddha";203;0;100
0;44;"shradha";44;0;100
462;0;"shraga";462;100;0
271;0;"shravan";271;100;0
0;27;"shravani";27;0;100
0;217;"shravya";217;0;100
104;0;"shray";104;100;0
0;5;"shrea";5;0;100
13;830;"shree";843;1.54211150652432;98.4578884934757
10;0;"shreehan";10;100;0
0;15;"shreeja";15;0;100
0;11;"shreen";11;0;100
0;75;"shreena";75;0;100
0;6;"shreenidhi";6;0;100
0;14;"shreenika";14;0;100
0;10;"shreeta";10;0;100
0;488;"shreeya";488;0;100
0;13;"shrena";13;0;100
14;0;"shrenik";14;100;0
5;0;"shresht";5;100;0
0;61;"shreshta";61;0;100
0;79;"shresta";79;0;100
536;0;"shrey";536;100;0
0;4211;"shreya";4211;0;100
24;0;"shreyaan";24;100;0
287;0;"shreyan";287;100;0
11;0;"shreyank";11;100;0
6;0;"shreyans";6;100;0
134;0;"shreyansh";134;100;0
1115;0;"shreyas";1115;100;0
35;0;"shreyash";35;100;0
0;5;"shreyasi";5;0;100
17;0;"shreyes";17;100;0
0;5;"shrhonda";5;0;100
0;34;"shria";34;0;100
40;0;"shrihaan";40;100;0
224;0;"shrihan";224;100;0
0;124;"shrika";124;0;100
14;0;"shrikar";14;100;0
0;104;"shriley";104;0;100
0;55;"shrina";55;0;100
0;32;"shrinidhi";32;0;100
0;33;"shrinika";33;0;100
28;0;"shriram";28;100;0
29;0;"shrish";29;100;0
0;5;"shrishti";5;0;100
0;90;"shristi";90;0;100
6;0;"shristopher";6;100;0
0;58;"shrita";58;0;100
29;0;"shritan";29;100;0
0;58;"shritha";58;0;100
5;0;"shrivas";5;100;0
0;1474;"shriya";1474;0;100
10;0;"shriyaan";10;100;0
175;0;"shriyan";175;100;0
89;0;"shriyans";89;100;0
26;0;"shriyansh";26;100;0
0;97;"shron";97;0;100
0;497;"shronda";497;0;100
0;471;"shruthi";471;0;100
0;50;"shruthika";50;0;100
0;1037;"shruti";1037;0;100
0;54;"shryl";54;0;100
0;226;"shterna";226;0;100
52;18;"shu";70;74.2857142857143;25.7142857142857
0;11;"shua";11;0;100
212;0;"shuaib";212;100;0
176;0;"shuan";176;100;0
0;42;"shuana";42;0;100
70;0;"shuayb";70;100;0
29;0;"shuban";29;100;0
255;0;"shubh";255;100;0
0;5;"shubha";5;0;100
261;0;"shubham";261;100;0
16;0;"shubhan";16;100;0
0;11;"shubhi";11;0;100
0;5;"shuchi";5;0;100
12;0;"shue";12;100;0
39;0;"shuford";39;100;0
29;0;"shuhei";29;100;0
24;0;"shuichi";24;100;0
6;0;"shuji";6;100;0
15;181;"shukri";196;7.6530612244898;92.3469387755102
0;12;"shukriyyah";12;0;100
0;21;"shukura";21;0;100
0;114;"shulamis";114;0;100
0;86;"shulamit";86;0;100
0;5;"shulamite";5;0;100
0;20;"shulamith";20;0;100
0;21;"shulanda";21;0;100
968;0;"shulem";968;100;0
0;25;"shulonda";25;0;100
0;20;"shumeka";20;0;100
5;0;"shumel";5;100;0
853;30;"shun";883;96.6024915062288;3.39750849377123
0;108;"shuna";108;0;100
0;5;"shunashi";5;0;100
0;538;"shunda";538;0;100
10;0;"shundarius";10;100;0
6;0;"shundell";6;100;0
0;376;"shundra";376;0;100
0;18;"shundrea";18;0;100
0;17;"shundreka";17;0;100
0;10;"shundria";10;0;100
0;19;"shundrika";19;0;100
0;5;"shunell";5;0;100
0;6;"shunette";6;0;100
0;41;"shunika";41;0;100
0;28;"shunita";28;0;100
0;6;"shuniya";6;0;100
16;0;"shunn";16;100;0
0;76;"shunna";76;0;100
75;0;"shunsuke";75;100;0
29;732;"shunta";761;3.8107752956636;96.1892247043364
0;144;"shuntae";144;0;100
0;5;"shuntana";5;0;100
0;61;"shuntavia";61;0;100
0;114;"shuntay";114;0;100
0;142;"shunte";142;0;100
0;140;"shuntel";140;0;100
0;64;"shuntell";64;0;100
0;22;"shunteria";22;0;100
0;5;"shunterria";5;0;100
0;61;"shuntia";61;0;100
0;5;"shuntina";5;0;100
0;5;"shunya";5;0;100
5;0;"shuraim";5;100;0
0;151;"shuree";151;0;100
0;23;"shureka";23;0;100
0;5;"shurhonda";5;0;100
0;5;"shuri";5;0;100
0;5;"shurie";5;0;100
0;17;"shurla";17;0;100
0;5;"shurlene";5;0;100
16;0;"shurley";16;100;0
22;0;"shurman";22;100;0
47;40;"shuron";87;54.0229885057471;45.9770114942529
0;87;"shuronda";87;0;100
0;5;"shushan";5;0;100
0;6;"shuvon";6;0;100
0;5;"shuvonne";5;0;100
0;26;"shuwanda";26;0;100
0;5;"shuwanna";5;0;100
0;50;"shvonne";50;0;100
0;21;"shwana";21;0;100
0;133;"shwanda";133;0;100
0;20;"shwanna";20;0;100
0;197;"shweta";197;0;100
0;29;"shwetha";29;0;100
26;381;"shy";407;6.38820638820639;93.6117936117936
0;280;"shya";280;0;100
5;122;"shyah";127;3.93700787401575;96.0629921259843
0;10;"shyaira";10;0;100
679;0;"shyam";679;100;0
35;813;"shyan";848;4.12735849056604;95.872641509434
0;264;"shyana";264;0;100
0;316;"shyane";316;0;100
0;6038;"shyann";6038;0;100
0;1647;"shyanna";1647;0;100
0;27;"shyannah";27;0;100
0;8898;"shyanne";8898;0;100
0;232;"shyasia";232;0;100
0;5;"shyauna";5;0;100
0;5;"shyda";5;0;100
0;20;"shydae";20;0;100
0;5;"shydia";5;0;100
5;72;"shye";77;6.49350649350649;93.5064935064935
0;6;"shyeeda";6;0;100
0;587;"shyenne";587;0;100
0;21;"shyera";21;0;100
0;21;"shyesha";21;0;100
17;0;"shyheed";17;100;0
298;0;"shyheem";298;100;0
882;0;"shyheim";882;100;0
5;0;"shyhem";5;100;0
158;0;"shyhiem";158;100;0
0;63;"shyia";63;0;100
13;0;"shyiem";13;100;0
86;0;"shykeem";86;100;0
30;0;"shykeim";30;100;0
0;27;"shykela";27;0;100
0;14;"shykemmia";14;0;100
0;80;"shykeria";80;0;100
0;5;"shykerria";5;0;100
0;6;"shykeyla";6;0;100
0;21;"shykia";21;0;100
0;18;"shykila";18;0;100
13;0;"shykim";13;100;0
0;56;"shykira";56;0;100
0;6944;"shyla";6944;0;100
0;1477;"shylah";1477;0;100
5;29;"shylan";34;14.7058823529412;85.2941176470588
0;38;"shylar";38;0;100
0;7;"shylea";7;0;100
0;5;"shyleah";5;0;100
0;687;"shylee";687;0;100
0;30;"shyleen";30;0;100
0;5;"shylei";5;0;100
0;77;"shyleigh";77;0;100
0;35;"shylene";35;0;100
102;163;"shyler";265;38.4905660377359;61.5094339622641
0;25;"shyli";25;0;100
0;52;"shylia";52;0;100
0;64;"shylie";64;0;100
0;115;"shylin";115;0;100
0;5;"shylla";5;0;100
106;573;"shylo";679;15.6111929307806;84.3888070692194
0;10;"shyloe";10;0;100
88;392;"shyloh";480;18.3333333333333;81.6666666666667
5;0;"shylon";5;100;0
0;5;"shylow";5;0;100
0;60;"shylyn";60;0;100
0;354;"shylynn";354;0;100
0;5;"shyma";5;0;100
6;0;"shymeek";6;100;0
0;16;"shymeka";16;0;100
5;0;"shymel";5;100;0
16;0;"shymere";16;100;0
0;15;"shymia";15;0;100
53;0;"shymir";53;100;0
0;118;"shyna";118;0;100
238;73;"shyne";311;76.5273311897106;23.4726688102894
0;11;"shynece";11;0;100
0;10;"shyneice";10;0;100
0;5;"shyneka";5;0;100
0;10;"shynell";10;0;100
0;6;"shynequa";6;0;100
0;12;"shynese";12;0;100
0;5;"shynesha";5;0;100
0;139;"shynia";139;0;100
0;61;"shynice";61;0;100
0;95;"shyniece";95;0;100
0;12;"shynika";12;0;100
0;11;"shyniqua";11;0;100
0;6;"shynise";6;0;100
0;6;"shynisha";6;0;100
0;5;"shynita";5;0;100
46;0;"shyon";46;100;0
0;5;"shyona";5;0;100
0;63;"shyonna";63;0;100
144;0;"shyquan";144;100;0
0;776;"shyra";776;0;100
0;25;"shyrah";25;0;100
0;55;"shyree";55;0;100
0;8;"shyreeta";8;0;100
0;21;"shyrel";21;0;100
0;12;"shyrell";12;0;100
0;5;"shyrene";5;0;100
0;181;"shyrl";181;0;100
0;12;"shyrle";12;0;100
0;15;"shyrlee";15;0;100
55;0;"shyron";55;100;0
37;0;"shyrone";37;100;0
0;15;"shytavia";15;0;100
0;66;"shyteria";66;0;100
0;53;"shyvonne";53;0;100
159;19;"si";178;89.3258426966292;10.6741573033708
5;1215;"sia";1220;0.409836065573771;99.5901639344262
115;119;"siah";234;49.1452991452991;50.8547008547009
0;20;"siahna";20;0;100
16;0;"siaka";16;100;0
10;0;"siaki";10;100;0
11;0;"siale";11;100;0
52;0;"siam";52;100;0
64;766;"sian";830;7.71084337349398;92.289156626506
0;849;"siana";849;0;100
0;6;"sianah";6;0;100
0;23;"siane";23;0;100
0;971;"siani";971;0;100
0;52;"siann";52;0;100
0;1339;"sianna";1339;0;100
0;25;"siannah";25;0;100
0;95;"sianne";95;0;100
0;217;"sianni";217;0;100
0;44;"siany";44;0;100
237;0;"siaosi";237;100;0
0;1597;"siara";1597;0;100
0;266;"siarah";266;0;100
0;6;"siari";6;0;100
0;711;"siarra";711;0;100
0;40;"siarrah";40;0;100
5;0;"sias";5;100;0
11;0;"siavash";11;100;0
0;12;"siba";12;0;100
0;104;"sibbie";104;0;100
0;211;"sibel";211;0;100
0;31;"sibella";31;0;100
0;5;"sibelle";5;0;100
5;0;"sibi";5;100;0
0;5;"sibil";5;0;100
0;5;"sibilla";5;0;100
0;110;"sible";110;0;100
18;73;"sibley";91;19.7802197802198;80.2197802197802
0;80;"siboney";80;0;100
0;6;"sibora";6;0;100
0;5;"sibrina";5;0;100
0;4096;"sibyl";4096;0;100
0;49;"sibyle";49;0;100
0;41;"sibylla";41;0;100
0;13;"sicely";13;0;100
0;6;"sicilee";6;0;100
0;192;"sicilia";192;0;100
0;1105;"sicily";1105;0;100
0;60;"siclali";60;0;100
0;22;"siclaly";22;0;100
2651;5;"sid";2656;99.8117469879518;0.188253012048193
5;0;"sidahmed";5;100;0
25;0;"sidak";25;100;0
0;19;"sidalee";19;0;100
22;0;"sidarth";22;100;0
0;90;"sidda";90;0;100
0;144;"siddalee";144;0;100
16;0;"siddanth";16;100;0
372;0;"siddarth";372;100;0
0;6;"siddeegah";6;0;100
10;0;"siddeeq";10;100;0
0;18;"siddeeqah";18;0;100
83;0;"siddh";83;100;0
21;0;"siddhan";21;100;0
451;0;"siddhant";451;100;0
126;0;"siddhanth";126;100;0
2554;0;"siddharth";2554;100;0
413;0;"siddhartha";413;100;0
5;0;"siddhesh";5;100;0
0;273;"siddhi";273;0;100
0;5;"siddhiksha";5;0;100
0;35;"siddie";35;0;100
132;0;"siddiq";132;100;0
0;13;"sidea";13;0;100
28;0;"sidh";28;100;0
94;0;"sidhant";94;100;0
35;0;"sidhanth";35;100;0
563;0;"sidharth";563;100;0
5;0;"sidhartha";5;100;0
93;0;"sidi";93;100;0
7;0;"sidiki";7;100;0
0;10;"sidna";10;0;100
0;42;"sidne";42;0;100
0;627;"sidnee";627;0;100
0;24;"sidnei";24;0;100
79648;23053;"sidney";102701;77.5532857518427;22.4467142481573
0;236;"sidni";236;0;100
0;307;"sidnie";307;0;100
0;57;"sidny";57;0;100
5;0;"sidon";5;100;0
0;11;"sidona";11;0;100
0;332;"sidonia";332;0;100
0;152;"sidonie";152;0;100
0;5;"sidora";5;0;100
0;1013;"sidra";1013;0;100
0;230;"sidrah";230;0;100
0;11;"sidratul";11;0;100
23;0;"sidy";23;100;0
99;0;"sie";99;100;0
0;10;"sieana";10;0;100
0;270;"sieanna";270;0;100
0;140;"sieara";140;0;100
0;251;"siearra";251;0;100
5;0;"siebert";5;100;0
0;20;"sieda";20;0;100
0;271;"siedah";271;0;100
674;0;"siegfried";674;100;0
0;16;"sieglinde";16;0;100
5;0;"siem";5;100;0
0;6893;"siena";6893;0;100
0;6;"siene";6;0;100
10;22743;"sienna";22753;0.043950248318903;99.9560497516811
0;74;"siennah";74;0;100
0;5;"sienne";5;0;100
11;0;"sier";11;100;0
0;2495;"siera";2495;0;100
0;203;"sierah";203;0;100
0;5;"sieria";5;0;100
269;95225;"sierra";95494;0.281693090665382;99.7183069093346
0;1119;"sierrah";1119;0;100
0;5;"sierraleone";5;0;100
0;5;"sierralynn";5;0;100
0;5;"sierramarie";5;0;100
0;36;"sierre";36;0;100
0;5;"sierrea";5;0;100
0;225;"sierria";225;0;100
0;8;"siersha";8;0;100
0;5;"siesta";5;0;100
5;0;"sievert";5;100;0
0;15;"sifa";15;0;100
0;16;"sifan";16;0;100
5;0;"sifat";5;100;0
43;0;"sig";43;100;0
0;31;"sigal";31;0;100
11;0;"sigel";11;100;0
21;0;"sigfred";21;100;0
251;0;"sigfredo";251;100;0
5;0;"sigfrid";5;100;0
5;0;"sigfrido";5;100;0
520;0;"sigifredo";520;100;0
138;0;"sigismund";138;100;0
10;0;"sigle";10;100;0
137;0;"sigmond";137;100;0
2742;0;"sigmund";2742;100;0
5;0;"sigmunt";5;100;0
0;328;"signa";328;0;100
0;2575;"signe";2575;0;100
0;90;"signora";90;0;100
0;345;"sigourney";345;0;100
0;2586;"sigrid";2586;0;100
0;5;"sigrun";5;0;100
703;0;"sigurd";703;100;0
5;0;"sigvard";5;100;0
0;55;"sihaam";55;0;100
0;496;"siham";496;0;100
0;10;"sihara";10;0;100
0;38;"siiri";38;0;100
5;0;"sikander";5;100;0
0;217;"sila";217;0;100
0;29;"silah";29;0;100
39065;57;"silas";39122;99.8543019273043;0.14569807269567
22;0;"silberio";22;100;0
10;0;"silbestre";10;100;0
0;45;"silbia";45;0;100
0;145;"silena";145;0;100
0;9;"silence";9;0;100
123;0;"siler";123;100;0
0;18;"silia";18;0;100
0;8;"silina";8;0;100
25;0;"silis";25;100;0
0;11;"silja";11;0;100
0;41;"silje";41;0;100
0;8;"silk";8;0;100
0;52;"silka";52;0;100
0;42;"silke";42;0;100
0;12;"silken";12;0;100
0;43;"siller";43;0;100
0;24;"silpa";24;0;100
6;0;"silton";6;100;0
139;0;"silus";139;100;0
0;885;"silva";885;0;100
43;0;"silvan";43;100;0
0;1969;"silvana";1969;0;100
0;68;"silvanna";68;0;100
916;0;"silvano";916;100;0
10;0;"silvanus";10;100;0
5;0;"silven";5;100;0
362;1341;"silver";1703;21.2566059894304;78.7433940105696
0;91;"silveria";91;0;100
1700;0;"silverio";1700;100;0
10;0;"silverius";10;100;0
1282;0;"silvester";1282;100;0
0;31;"silvestra";31;0;100
2289;0;"silvestre";2289;100;0
10;0;"silvestro";10;100;0
0;5;"silvi";5;0;100
51;19632;"silvia";19683;0.259106843468983;99.740893156531
0;11;"silviana";11;0;100
256;0;"silviano";256;100;0
0;84;"silvie";84;0;100
12;0;"silvin";12;100;0
0;159;"silvina";159;0;100
323;0;"silvino";323;100;0
2726;0;"silvio";2726;100;0
5;0;"silvo";5;100;0
0;10;"silvya";10;0;100
1593;0;"sim";1593;100;0
0;1609;"sima";1609;0;100
24;0;"simao";24;100;0
51;172;"simar";223;22.8699551569507;77.1300448430493
0;129;"simara";129;0;100
0;15;"simarpreet";15;0;100
0;161;"simaya";161;0;100
0;7;"simayah";7;0;100
36;0;"simba";36;100;0
5;0;"simbarashe";5;100;0
0;5;"simbo";5;0;100
1344;193;"simcha";1537;87.4430709173715;12.5569290826285
5;0;"sime";5;100;0
0;7;"simeko";7;0;100
7508;25;"simeon";7533;99.6681269082703;0.331873091729723
6;330;"simi";336;1.78571428571429;98.2142857142857
0;5;"simia";5;0;100
0;11;"similoluwa";11;0;100
0;5;"simin";5;0;100
31;0;"simion";31;100;0
5;0;"simione";5;100;0
0;63;"simisola";63;0;100
5;0;"simitrio";5;100;0
0;42;"simiya";42;0;100
0;58;"simiyah";58;0;100
12;0;"simmeon";12;100;0
1139;153;"simmie";1292;88.1578947368421;11.8421052631579
26;0;"simmon";26;100;0
0;184;"simmone";184;0;100
17;0;"simmons";17;100;0
5;0;"simms";5;100;0
55719;155;"simon";55874;99.7225901134696;0.277409886530408
0;3549;"simona";3549;0;100
500;24649;"simone";25149;1.98815062229114;98.0118493777089
0;18;"simonetta";18;0;100
0;5;"simoni";5;0;100
0;848;"simonne";848;0;100
0;65;"simora";65;0;100
5;0;"simote";5;100;0
10;0;"simplicio";10;100;0
638;0;"simpson";638;100;0
0;302;"simra";302;0;100
0;215;"simrah";215;0;100
133;2525;"simran";2658;5.00376222723852;94.9962377727615
0;5;"simrandeep";5;0;100
14;70;"simranjit";84;16.6666666666667;83.3333333333333
0;29;"simranpreet";29;0;100
0;124;"simrat";124;0;100
0;5;"simreet";5;0;100
0;69;"simren";69;0;100
0;104;"simrin";104;0;100
0;55;"simrit";55;0;100
0;5;"simron";5;0;100
0;29;"simrun";29;0;100
0;21;"simryn";21;0;100
300;0;"sims";300;100;0
360;0;"simuel";360;100;0
0;10;"simy";10;0;100
0;218;"simya";218;0;100
0;23;"simyah";23;0;100
437;1367;"sina";1804;24.2239467849224;75.7760532150776
0;31;"sinae";31;0;100
0;88;"sinahi";88;0;100
163;1638;"sinai";1801;9.05052748473071;90.9494725152693
0;5;"sinaiya";5;0;100
266;5;"sinan";271;98.1549815498155;1.8450184501845
0;5;"sinath";5;0;100
18;0;"sinatra";18;100;0
0;55;"sinay";55;0;100
0;114;"sinaya";114;0;100
46;0;"sincear";46;100;0
15;11;"sinceer";26;57.6923076923077;42.3076923076923
48;0;"sincer";48;100;0
5817;1079;"sincere";6896;84.3532482598608;15.6467517401392
0;6;"sincerely";6;0;100
0;68;"sincerity";68;0;100
0;5;"sinchana";5;0;100
1355;313;"sinclair";1668;81.2350119904077;18.7649880095923
0;180;"sinclaire";180;0;100
0;278;"sinda";278;0;100
0;66;"sindee";66;0;100
0;34;"sindel";34;0;100
5;0;"sindey";5;100;0
0;189;"sindhu";189;0;100
0;29;"sindhuja";29;0;100
0;11;"sindhura";11;0;100
0;618;"sindi";618;0;100
0;192;"sindia";192;0;100
0;10;"sindie";10;0;100
0;2668;"sindy";2668;0;100
0;21;"sinea";21;0;100
0;1245;"sinead";1245;0;100
0;17;"sinem";17;0;100
0;6;"sinforosa";6;0;100
27;5;"sing";32;84.375;15.625
72;0;"singleton";72;100;0
11;0;"sinh";11;100;0
0;95;"sinia";95;0;100
0;39;"siniah";39;0;100
0;8;"sinit";8;0;100
0;111;"siniya";111;0;100
0;117;"siniyah";117;0;100
371;0;"sinjin";371;100;0
5;0;"sinjon";5;100;0
0;5;"sinnamon";5;0;100
0;28;"sinnie";28;0;100
0;246;"sinthia";246;0;100
0;449;"sintia";449;0;100
10;0;"sinue";10;100;0
10;0;"sinuhe";10;100;0
0;17;"sinya";17;0;100
0;77;"siobahn";77;0;100
0;36;"sioban";36;0;100
0;22;"siobhain";22;0;100
0;6730;"siobhan";6730;0;100
0;5;"siobhon";5;0;100
5;0;"sioeli";5;100;0
0;5;"siohban";5;0;100
0;658;"siomara";658;0;100
491;67;"sion";558;87.9928315412186;12.0071684587814
0;265;"siona";265;0;100
1180;6;"sione";1186;99.4940978077572;0.505902192242833
0;45;"sionna";45;0;100
10;0;"siosaia";10;100;0
7;0;"siosiua";7;100;0
0;29;"sioux";29;0;100
0;5;"siovhan";5;0;100
117;0;"sipriano";117;100;0
0;5;"siqi";5;0;100
1333;0;"sir";1333;100;0
0;166;"sira";166;0;100
5;0;"siraaj";5;100;0
6;0;"sirach";6;100;0
0;21;"sirah";21;0;100
380;0;"siraj";380;100;0
6;0;"siran";6;100;0
37;0;"siranthony";37;100;0
0;28;"sirat";28;0;100
0;11;"siraya";11;0;100
0;5;"sirayah";5;0;100
95;0;"sircharles";95;100;0
5;0;"sirchristopher";5;100;0
7;0;"sirdarius";7;100;0
559;0;"sire";559;100;0
0;166;"sireen";166;0;100
0;17;"sireena";17;0;100
0;49;"siren";49;0;100
0;2773;"sirena";2773;0;100
0;99;"sirenia";99;0;100
0;271;"sirenity";271;0;100
0;15;"sirenna";15;0;100
5;0;"sirgio";5;100;0
0;2235;"siri";2235;0;100
0;301;"siria";301;0;100
0;66;"siriah";66;0;100
0;6;"siriana";6;0;100
8;0;"sirica";8;100;0
0;16;"sirin";16;0;100
0;33;"sirina";33;0;100
0;22;"sirine";22;0;100
0;58;"sirinity";58;0;100
75;0;"siris";75;100;0
0;27;"sirita";27;0;100
308;5;"sirius";313;98.4025559105431;1.59744408945687
0;5;"siriya";5;0;100
0;49;"siriyah";49;0;100
15;0;"sirjames";15;100;0
6;0;"sirking";6;100;0
0;6;"sirkka";6;0;100
0;35;"sirley";35;0;100
34;0;"sirmichael";34;100;0
201;0;"sirr";201;100;0
0;5;"sirrah";5;0;100
191;0;"sirron";191;100;0
198;0;"sirus";198;100;0
5;0;"sirvon";5;100;0
35;0;"sirwilliam";35;100;0
0;6;"siryah";6;0;100
6;0;"sisco";6;100;0
0;25;"sisi";25;0;100
0;40;"sisilia";40;0;100
0;43;"sisira";43;0;100
0;12;"sisley";12;0;100
0;17;"sismai";17;0;100
9;0;"sisqo";9;100;0
0;74;"sissi";74;0;100
0;27;"sissie";27;0;100
0;711;"sissy";711;0;100
0;31;"sista";31;0;100
0;428;"sister";428;0;100
0;15;"sistine";15;0;100
406;0;"sisto";406;100;0
0;401;"sita";401;0;100
0;333;"sitara";333;0;100
0;5;"sitey";5;0;100
5;8;"sitha";13;38.4615384615385;61.5384615384615
0;11;"siti";11;0;100
7;0;"sitiveni";7;100;0
5;0;"sitka";5;100;0
0;139;"sitlali";139;0;100
0;121;"sitlaly";121;0;100
0;6;"sitora";6;0;100
5;13;"siu";18;27.7777777777778;72.2222222222222
37;0;"siva";37;100;0
18;0;"sivad";18;100;0
58;509;"sivan";567;10.2292768959436;89.7707231040564
0;21;"sivana";21;0;100
0;48;"sivani";48;0;100
11;0;"sivert";11;100;0
0;47;"sivi";47;0;100
0;5;"siwar";5;0;100
11;0;"siwoo";11;100;0
0;17;"sixta";17;0;100
5;0;"sixten";5;100;0
1661;0;"sixto";1661;100;0
0;1319;"siya";1319;0;100
0;5;"siyaa";5;0;100
13;111;"siyah";124;10.4838709677419;89.5161290322581
7;5;"siyam";12;58.3333333333333;41.6666666666667
0;7;"siyan";7;0;100
0;109;"siyana";109;0;100
0;44;"siyanna";44;0;100
48;0;"siyon";48;100;0
0;275;"siyona";275;0;100
14;0;"siyuan";14;100;0
0;5;"siyuri";5;0;100
11;0;"sj";11;100;0
0;5;"sjana";5;0;100
37;0;"sjon";37;100;0
22;410;"skai";432;5.09259259259259;94.9074074074074
0;8;"skaii";8;0;100
0;18;"skailar";18;0;100
79;0;"skanda";79;100;0
0;255;"skarlet";255;0;100
0;120;"skarleth";120;0;100
0;513;"skarlett";513;0;100
0;176;"skarlette";176;0;100
29;0;"skeet";29;100;0
125;13;"skeeter";138;90.5797101449275;9.42028985507246
5;103;"ski";108;4.62962962962963;95.3703703703704
0;275;"skie";275;0;100
0;5;"skieler";5;0;100
0;5;"skielynn";5;0;100
0;79;"skii";79;0;100
0;6;"skiilar";6;0;100
0;76;"skila";76;0;100
0;13;"skilah";13;0;100
50;302;"skilar";352;14.2045454545455;85.7954545454545
0;5;"skilee";5;0;100
163;158;"skiler";321;50.7788161993769;49.2211838006231
0;7;"skiley";7;0;100
0;52;"skilyn";52;0;100
0;154;"skilynn";154;0;100
2026;0;"skip";2026;100;0
6;0;"skipp";6;100;0
824;0;"skipper";824;100;0
219;0;"skippy";219;100;0
0;45;"skky";45;0;100
27;5;"sklyer";32;84.375;15.625
3312;6621;"sky";9933;33.3434007852613;66.6565992147387
0;86;"skya";86;0;100
0;54;"skyah";54;0;100
0;5;"skyana";5;0;100
0;156;"skyann";156;0;100
0;43;"skyanna";43;0;100
0;101;"skyanne";101;0;100
0;5;"skyasia";5;0;100
26;0;"skyden";26;100;0
2362;17916;"skye";20278;11.6480915277641;88.3519084722359
0;16;"skyee";16;0;100
0;25;"skyela";25;0;100
161;584;"skyelar";745;21.6107382550336;78.3892617449664
0;5;"skyelee";5;0;100
115;116;"skyeler";231;49.7835497835498;50.2164502164502
0;18;"skyelin";18;0;100
0;75;"skyelyn";75;0;100
0;215;"skyelynn";215;0;100
0;50;"skyi";50;0;100
0;5;"skyia";5;0;100
0;10430;"skyla";10430;0;100
0;11;"skylaa";11;0;100
0;16;"skylaar";16;0;100
0;1808;"skylah";1808;0;100
0;10;"skylair";10;0;100
178;292;"skylan";470;37.8723404255319;62.1276595744681
23;11;"skyland";34;67.6470588235294;32.3529411764706
0;5;"skylann";5;0;100
16665;57664;"skylar";74329;22.4205895410943;77.5794104589057
0;11;"skylarmarie";11;0;100
0;78;"skylarr";78;0;100
0;5;"skylarrae";5;0;100
0;6;"skylarrose";6;0;100
0;5;"skyle";5;0;100
0;23;"skylea";23;0;100
0;1855;"skylee";1855;0;100
0;83;"skyleen";83;0;100
0;35;"skylei";35;0;100
0;477;"skyleigh";477;0;100
84;133;"skylen";217;38.7096774193548;61.2903225806452
0;85;"skylene";85;0;100
37641;22208;"skyler";59849;62.8932814249194;37.1067185750806
0;22;"skylette";22;0;100
0;81;"skyley";81;0;100
0;52;"skyli";52;0;100
0;23;"skylia";23;0;100
0;523;"skylie";523;0;100
62;48;"skylier";110;56.3636363636364;43.6363636363636
41;596;"skylin";637;6.43642072213501;93.563579277865
0;96;"skylinn";96;0;100
0;16;"skylir";16;0;100
0;5;"skylit";5;0;100
0;27;"skylla";27;0;100
0;171;"skyllar";171;0;100
23;9;"skyller";32;71.875;28.125
34;0;"skylon";34;100;0
1003;382;"skylor";1385;72.4187725631769;27.5812274368231
11;16;"skylr";27;40.7407407407407;59.2592592592593
76;58;"skylur";134;56.7164179104478;43.2835820895522
0;792;"skylyn";792;0;100
0;1969;"skylynn";1969;0;100
0;102;"skylynne";102;0;100
0;37;"skylyr";37;0;100
0;70;"skyra";70;0;100
0;74;"skyrah";74;0;100
5;0;"skyshun";5;100;0
114;1452;"skyy";1566;7.27969348659004;92.72030651341
0;59;"skyye";59;0;100
5;53;"skyylar";58;8.62068965517241;91.3793103448276
5;0;"skyyler";5;100;0
4351;0;"slade";4351;100;0
136;0;"sladen";136;100;0
50;0;"slader";50;100;0
451;0;"slate";451;100;0
22;0;"slaten";22;100;0
1436;0;"slater";1436;100;0
107;0;"slaton";107;100;0
0;5;"slavica";5;0;100
5;0;"slavko";5;100;0
226;0;"slayde";226;100;0
185;0;"slayden";185;100;0
11;0;"slayder";11;100;0
73;0;"slayter";73;100;0
321;0;"slayton";321;100;0
78;0;"slevin";78;100;0
12;0;"slim";12;100;0
2155;4333;"sloan";6488;33.2151664611591;66.7848335388409
268;8596;"sloane";8864;3.02346570397112;96.9765342960289
0;142;"sloka";142;0;100
33;7;"slone";40;82.5;17.5
72;0;"sly";72;100;0
152;0;"slyvester";152;100;0
0;342;"slyvia";342;0;100
0;26;"smanatha";26;0;100
0;325;"smantha";325;0;100
115;0;"smaran";115;100;0
52;0;"smauel";52;100;0
0;23;"smaya";23;0;100
42;0;"smayan";42;100;0
5;0;"smead";5;100;0
0;75;"smera";75;0;100
357;0;"smiley";357;100;0
41;0;"smit";41;100;0
0;134;"smita";134;0;100
3992;101;"smith";4093;97.5323723430247;2.46762765697532
0;51;"smitha";51;0;100
0;54;"smithie";54;0;100
11;0;"smithy";11;100;0
90;0;"smitty";90;100;0
0;5;"smiya";5;0;100
125;0;"smokey";125;100;0
0;104;"smrithi";104;0;100
0;204;"smriti";204;0;100
0;45;"smya";45;0;100
34;0;"smyan";34;100;0
0;5;"smyrna";5;0;100
5;0;"snaider";5;100;0
24;0;"snapper";24;100;0
27;0;"snayder";27;100;0
5;0;"sneed";5;100;0
31;5;"sneh";36;86.1111111111111;13.8888888888889
0;1369;"sneha";1369;0;100
49;6;"snehal";55;89.0909090909091;10.9090909090909
107;0;"sneijder";107;100;0
28;0;"sneyder";28;100;0
0;40;"snezana";40;0;100
0;15;"snezhana";15;0;100
0;222;"snigdha";222;0;100
18;0;"snithik";18;100;0
0;18;"sniya";18;0;100
0;58;"sniyah";58;0;100
0;5;"snoda";5;0;100
20;597;"snow";617;3.24149108589951;96.7585089141005
47;0;"snowden";47;100;0
0;10;"snowy";10;0;100
0;13;"snya";13;0;100
128;0;"snyder";128;100;0
0;47;"so";47;0;100
0;5;"soana";5;0;100
25;0;"soane";25;100;0
0;14;"sobeida";14;0;100
0;61;"sobia";61;0;100
0;7;"sobra";7;0;100
0;12;"sobrina";12;0;100
7;0;"socheat";7;100;0
0;12;"socheata";12;0;100
0;10;"sochi";10;0;100
0;7;"sochikaima";7;0;100
0;18;"sochil";18;0;100
0;5;"socoro";5;0;100
0;26;"socorra";26;0;100
549;6836;"socorro";7385;7.43398781313473;92.5660121868653
683;0;"socrates";683;100;0
33;0;"soctt";33;100;0
0;5;"soda";5;0;100
5;0;"sodbileg";5;100;0
15;13;"soe";28;53.5714285714286;46.4285714285714
0;28;"sofee";28;0;100
0;104;"soffia";104;0;100
0;5;"soffie";5;0;100
0;69;"sofhia";69;0;100
0;449;"sofi";449;0;100
114;117882;"sofia";117996;0.0966134445235432;99.9033865554765
0;28;"sofiagrace";28;0;100
0;190;"sofiah";190;0;100
0;15;"sofiamarie";15;0;100
57;0;"sofian";57;100;0
0;27;"sofiana";27;0;100
0;13;"sofiarose";13;0;100
0;3617;"sofie";3617;0;100
0;232;"sofija";232;0;100
0;29;"sofina";29;0;100
0;668;"sofiya";668;0;100
0;22;"sofiyah";22;0;100
0;200;"sofya";200;0;100
0;611;"soha";611;0;100
12;0;"sohaan";12;100;0
244;0;"sohaib";244;100;0
365;0;"sohail";365;100;0
0;10;"sohaila";10;0;100
851;0;"soham";851;100;0
731;0;"sohan";731;100;0
0;86;"sohana";86;0;100
0;11;"sohani";11;0;100
0;14;"sohanny";14;0;100
0;5;"sohany";5;0;100
6;0;"soheil";6;100;0
0;10;"soheila";10;0;100
0;5;"sohela";5;0;100
115;0;"sohil";115;100;0
0;46;"sohini";46;0;100
16;0;"sohn";16;100;0
0;5;"sohna";5;0;100
0;15;"sohni";15;0;100
6;0;"sohom";6;100;0
0;11;"sohpia";11;0;100
68;0;"sohrab";68;100;0
15;0;"sohrob";15;100;0
428;0;"sohum";428;100;0
10;0;"soichi";10;100;0
0;826;"soila";826;0;100
0;144;"sojourner";144;0;100
28;8;"sok";36;77.7777777777778;22.2222222222222
27;55;"sokha";82;32.9268292682927;67.0731707317073
0;185;"sokhna";185;0;100
13;12;"sokhom";25;52;48
5;0;"sokol";5;100;0
0;5;"sokoya";5;0;100
6768;1923;"sol";8691;77.873662409389;22.126337590611
5;121;"sola";126;3.96825396825397;96.031746031746
60;114;"solace";174;34.4827586206897;65.5172413793103
0;5;"solach";5;0;100
0;112;"solae";112;0;100
0;6;"solage";6;0;100
0;34;"solai";34;0;100
0;5;"solaine";5;0;100
136;0;"solan";136;100;0
0;1342;"solana";1342;0;100
0;28;"solanch";28;0;100
0;1471;"solange";1471;0;100
0;105;"solangel";105;0;100
0;24;"solangie";24;0;100
0;391;"solara";391;0;100
0;5;"solarah";5;0;100
5;65;"solaris";70;7.14285714285714;92.8571428571429
0;64;"solash";64;0;100
0;39;"solay";39;0;100
0;15;"solaya";15;0;100
0;425;"sole";425;0;100
0;41;"solea";41;0;100
5;3938;"soledad";3943;0.126806999746386;99.8731930002536
0;6;"solee";6;0;100
0;393;"solei";393;0;100
0;38;"soleia";38;0;100
0;5;"soleigh";5;0;100
0;2951;"soleil";2951;0;100
12;0;"solen";12;100;0
0;46;"solena";46;0;100
0;83;"solene";83;0;100
0;5;"solenn";5;0;100
0;74;"solenne";74;0;100
0;106;"soley";106;0;100
0;5;"soleya";5;0;100
0;40;"soli";40;0;100
0;48;"solia";48;0;100
0;359;"soliana";359;0;100
0;11;"solida";11;0;100
0;12;"solidad";12;0;100
0;28;"solie";28;0;100
0;59;"soliel";59;0;100
0;5;"soliha";5;0;100
36;0;"soliman";36;100;0
0;354;"solimar";354;0;100
0;117;"solina";117;0;100
0;6;"soline";6;0;100
0;112;"solita";112;0;100
0;11;"solitaire";11;0;100
0;92;"soliyana";92;0;100
264;0;"sollie";264;100;0
137;0;"solly";137;100;0
0;15;"solmaira";15;0;100
0;12;"solmari";12;0;100
0;26;"solmarie";26;0;100
0;5;"solmary";5;0;100
0;34;"solmayra";34;0;100
114;0;"solmon";114;100;0
19;0;"solo";19;100;0
1453;0;"soloman";1453;100;0
0;118;"solomia";118;0;100
0;62;"solomiya";62;0;100
30192;11;"solomon";30203;99.9635797768434;0.0364202231566401
5;0;"solomona";5;100;0
22;0;"solomone";22;100;0
1205;0;"solon";1205;100;0
0;42;"solstice";42;0;100
0;842;"solveig";842;0;100
0;5;"solveigh";5;0;100
0;88;"solyana";88;0;100
0;179;"solymar";179;0;100
13;0;"som";13;100;0
57;52;"soma";109;52.2935779816514;47.7064220183486
0;20;"somaiya";20;0;100
0;114;"somalia";114;0;100
0;75;"somaly";75;0;100
0;90;"somara";90;0;100
0;5;"somarah";5;0;100
0;11;"somaria";11;0;100
0;759;"somaya";759;0;100
0;12;"somayah";12;0;100
0;7;"someeka";7;0;100
0;2197;"somer";2197;0;100
5;0;"somers";5;100;0
0;11;"somi";11;0;100
0;21;"somia";21;0;100
0;5;"somiah";5;0;100
5;0;"somil";5;100;0
0;47;"somiya";47;0;100
0;19;"somiyah";19;0;100
0;32;"sommar";32;0;100
0;5782;"sommer";5782;0;100
0;7;"sommers";7;0;100
62;0;"somnang";62;100;0
0;5;"somona";5;0;100
0;54;"somone";54;0;100
84;26;"somtochukwu";110;76.3636363636364;23.6363636363636
0;163;"somya";163;0;100
925;5;"son";930;99.4623655913979;0.537634408602151
0;1164;"sona";1164;0;100
0;17;"sonai";17;0;100
0;71;"sonakshi";71;0;100
0;592;"sonal";592;0;100
0;1144;"sonali";1144;0;100
65;381;"sonam";446;14.5739910313901;85.4260089686099
0;47;"sonata";47;0;100
0;39;"sonaya";39;0;100
0;5;"sonceria";5;0;100
0;717;"sonda";717;0;100
0;98;"sondi";98;0;100
0;70;"sondos";70;0;100
0;27044;"sondra";27044;0;100
0;27;"sondrea";27;0;100
0;20;"sondria";20;0;100
0;5;"sone";5;0;100
0;5;"sonequa";5;0;100
71;201;"song";272;26.1029411764706;73.8970588235294
0;55;"songa";55;0;100
0;300;"soni";300;0;100
283;64826;"sonia";65109;0.434655731158519;99.5653442688415
0;33;"soniah";33;0;100
5;0;"sonic";5;100;0
0;5;"sonica";5;0;100
0;56;"sonie";56;0;100
0;130;"sonika";130;0;100
0;5;"soniqua";5;0;100
0;24;"sonique";24;0;100
0;191;"sonita";191;0;100
0;278;"soniya";278;0;100
0;83;"soniyah";83;0;100
44;38933;"sonja";38977;0.112887087256587;99.8871129127434
5;0;"sonjay";5;100;0
0;7;"sonje";7;0;100
0;904;"sonji";904;0;100
0;1113;"sonjia";1113;0;100
0;5;"sonjie";5;0;100
0;398;"sonna";398;0;100
0;269;"sonnet";269;0;100
0;5;"sonnett";5;0;100
0;10;"sonnette";10;0;100
20;440;"sonni";460;4.34782608695652;95.6521739130435
0;110;"sonnia";110;0;100
754;599;"sonnie";1353;55.7280118255728;44.2719881744272
16235;596;"sonny";16831;96.4589150971422;3.54108490285782
0;16;"sonnya";16;0;100
0;183;"sonoma";183;0;100
0;951;"sonora";951;0;100
0;5;"sonovia";5;0;100
0;38;"sonrisa";38;0;100
0;12;"sonseeahray";12;0;100
0;15;"sonta";15;0;100
0;10;"sonte";10;0;100
0;70;"sontee";70;0;100
0;5;"sonum";5;0;100
274;39;"sony";313;87.5399361022364;12.4600638977636
182;64780;"sonya";64962;0.280163788060712;99.7198362119393
0;11;"sonye";11;0;100
0;194;"sonyia";194;0;100
0;5;"sonza";5;0;100
18;193;"soo";211;8.53080568720379;91.4691943127962
0;5;"soobin";5;0;100
0;28;"soojin";28;0;100
0;6;"sook";6;0;100
0;50;"sookie";50;0;100
0;5;"soomin";5;0;100
5;43;"soon";48;10.4166666666667;89.5833333333333
0;10;"sooner";10;0;100
11;0;"soorya";11;100;0
5;0;"sopath";5;100;0
5;0;"sopaul";5;100;0
0;5;"sopha";5;0;100
37;0;"sophal";37;100;0
8;0;"sophan";8;100;0
14;5;"sophana";19;73.6842105263158;26.3157894736842
7;10;"sophanna";17;41.1764705882353;58.8235294117647
0;11;"sophany";11;0;100
22;0;"sophat";22;100;0
5;301;"sophea";306;1.63398692810458;98.3660130718954
38;0;"sopheak";38;100;0
46;80;"sopheap";126;36.5079365079365;63.4920634920635
10;8;"sophear";18;55.5555555555556;44.4444444444444
0;321;"sophee";321;0;100
0;6;"sopheia";6;0;100
0;40;"sophelia";40;0;100
0;36;"sophey";36;0;100
0;19;"sopheya";19;0;100
0;445;"sophi";445;0;100
404;316681;"sophia";317085;0.127410631218758;99.8725893687812
0;17;"sophiaann";17;0;100
0;7;"sophiaanne";7;0;100
0;115;"sophiagrace";115;0;100
0;181;"sophiah";181;0;100
0;5;"sophiaisabella";5;0;100
0;11;"sophiaisabelle";11;0;100
0;5;"sophialauren";5;0;100
0;21;"sophialynn";21;0;100
0;10;"sophiamae";10;0;100
0;5;"sophiamaria";5;0;100
0;173;"sophiamarie";173;0;100
0;61;"sophiana";61;0;100
0;46;"sophianna";46;0;100
0;115;"sophiarose";115;0;100
111;104462;"sophie";104573;0.106145945894256;99.8938540541057
0;90;"sophiea";90;0;100
0;21;"sophieann";21;0;100
0;14;"sophieanne";14;0;100
0;12;"sophiee";12;0;100
0;5;"sophiemarie";5;0;100
0;5;"sophilia";5;0;100
0;220;"sophina";220;0;100
0;74;"sophira";74;0;100
0;203;"sophiya";203;0;100
0;20;"sophiyah";20;0;100
0;143;"sophonie";143;0;100
0;11;"sophorn";11;0;100
0;11;"sophrona";11;0;100
0;1159;"sophronia";1159;0;100
0;432;"sophy";432;0;100
0;497;"sophya";497;0;100
0;6;"sophyia";6;0;100
0;5;"sopia";5;0;100
203;1009;"sora";1212;16.7491749174918;83.2508250825083
0;165;"sorah";165;0;100
0;9;"soraia";9;0;100
0;542;"soraida";542;0;100
0;5;"soraide";5;0;100
0;72;"soraiya";72;0;100
5;0;"soran";5;100;0
0;34;"sorangel";34;0;100
0;4707;"soraya";4707;0;100
0;132;"sorayah";132;0;100
0;12;"sorayda";12;0;100
0;214;"sorcha";214;0;100
0;11;"sorella";11;0;100
0;50;"sorelle";50;0;100
6072;364;"soren";6436;94.3443132380361;5.65568676196395
0;20;"sorena";20;0;100
0;5;"soreya";5;0;100
0;5;"soria";5;0;100
0;274;"soriah";274;0;100
179;5;"sorin";184;97.2826086956522;2.71739130434783
0;136;"sorina";136;0;100
5;253;"soriya";258;1.93798449612403;98.062015503876
0;98;"soriyah";98;0;100
6;0;"soroosh";6;100;0
18;0;"soroush";18;100;0
0;5;"soroya";5;0;100
0;5;"sorraya";5;0;100
0;70;"sorrel";70;0;100
36;0;"sorrell";36;100;0
44;0;"sorren";44;100;0
0;45;"sorsha";45;0;100
5;0;"sory";5;100;0
17;17;"soryn";34;50;50
11;0;"sosa";11;100;0
77;0;"sosaia";77;100;0
0;40;"sosefina";40;0;100
0;150;"sosha";150;0;100
0;89;"sosie";89;0;100
0;12;"sossity";12;0;100
122;0;"sostenes";122;100;0
25;0;"sosuke";25;100;0
125;0;"sota";125;100;0
5;0;"sotaro";5;100;0
0;17;"sotera";17;0;100
0;58;"soteria";58;0;100
5;0;"soterios";5;100;0
776;0;"sotero";776;100;0
18;8;"sothea";26;69.2307692307692;30.7692307692308
0;20;"sotheary";20;0;100
0;41;"sotiria";41;0;100
253;0;"sotirios";253;100;0
5;0;"sotiris";5;100;0
113;0;"sou";113;100;0
56;105;"soua";161;34.7826086956522;65.2173913043478
0;21;"souad";21;0;100
5;0;"soufiane";5;100;0
0;5;"soukaina";5;0;100
106;40;"soul";146;72.6027397260274;27.3972602739726
0;5;"soula";5;0;100
289;0;"souleymane";289;100;0
0;45;"soumaya";45;0;100
59;0;"soumil";59;100;0
0;256;"soumya";256;0;100
0;153;"soundra";153;0;100
5;0;"souren";5;100;0
6;0;"sourik";6;100;0
62;0;"sourish";62;100;0
6;0;"souriya";6;100;0
16;0;"sourya";16;100;0
5;0;"souta";5;100;0
5;0;"south";5;100;0
11;32;"southern";43;25.5813953488372;74.4186046511628
35;0;"sovann";35;100;0
6;17;"sovanna";23;26.0869565217391;73.9130434782609
0;18;"sovanny";18;0;100
0;10;"soveida";10;0;100
36;23;"sovereign";59;61.0169491525424;38.9830508474576
0;5;"sovilla";5;0;100
0;80;"sowmya";80;0;100
0;5;"sowsan";5;0;100
12;0;"soyer";12;100;0
0;59;"soyini";59;0;100
0;204;"soyla";204;0;100
0;57;"soyna";57;0;100
0;7;"soyoung";7;0;100
5;0;"spandan";5;100;0
0;18;"spandana";18;0;100
6;0;"spanky";6;100;0
0;6;"sparkel";6;0;100
0;1583;"sparkle";1583;0;100
0;73;"sparkles";73;0;100
5;0;"sparks";5;100;0
11;0;"sparky";11;100;0
60;451;"sparrow";511;11.7416829745597;88.2583170254403
133;0;"sparsh";133;100;0
7;0;"spartaco";7;100;0
36;0;"spartacus";36;100;0
5;0;"spartan";5;100;0
5;0;"spaulding";5;100;0
0;338;"special";338;0;100
14;0;"speed";14;100;0
5;0;"speedy";5;100;0
1067;0;"spence";1067;100;0
5;0;"spencel";5;100;0
114141;3530;"spencer";117671;97.0001104775178;2.99988952248217
2918;355;"spenser";3273;89.1536816376413;10.8463183623587
316;0;"spero";316;100;0
11;0;"speros";11;100;0
5;0;"sperry";5;100;0
5;0;"spessard";5;100;0
0;5;"spicie";5;0;100
0;5;"spicy";5;0;100
111;0;"spike";111;100;0
15;0;"spiridon";15;100;0
0;10;"spiridoula";10;0;100
5;593;"spirit";598;0.836120401337793;99.1638795986622
0;28;"spiritual";28;0;100
974;0;"spiro";974;100;0
604;0;"spiros";604;100;0
5;0;"spivey";5;100;0
0;5;"splendora";5;0;100
0;6;"spontaneous";6;0;100
0;34;"spoorthi";34;0;100
5;0;"sprague";5;100;0
0;13;"spriha";13;0;100
0;3325;"spring";3325;0;100
0;38;"spruha";38;0;100
1302;0;"spurgeon";1302;100;0
89;0;"spyridon";89;100;0
102;0;"spyros";102;100;0
78;0;"square";78;100;0
381;0;"squire";381;100;0
0;27;"sra";27;0;100
0;5;"sraavya";5;0;100
0;5;"sragvi";5;0;100
0;84;"srah";84;0;100
7;0;"sravan";7;100;0
0;23;"sravani";23;0;100
0;228;"sravya";228;0;100
0;13;"sree";13;0;100
11;0;"sreehan";11;100;0
0;122;"sreeja";122;0;100
90;0;"sreekar";90;100;0
0;81;"sreenidhi";81;0;100
0;15;"sreenika";15;0;100
22;0;"sreeram";22;100;0
0;26;"sreeya";26;0;100
0;113;"sreshta";113;0;100
0;238;"sreya";238;0;100
22;0;"sreyas";22;100;0
5;84;"sri";89;5.61797752808989;94.3820224719101
0;5;"sriaadya";5;0;100
53;0;"sriansh";53;100;0
71;0;"sricharan";71;100;0
0;7;"sridevi";7;0;100
0;5;"sridha";5;0;100
13;0;"sridhar";13;100;0
27;0;"srihaan";27;100;0
44;0;"srihaas";44;100;0
218;0;"srihan";218;100;0
95;0;"srihari";95;100;0
48;0;"sriharsha";48;100;0
0;21;"srihita";21;0;100
62;0;"srihith";62;100;0
0;122;"srihitha";122;0;100
0;142;"srija";142;0;100
129;0;"srijan";129;100;0
0;5;"srika";5;0;100
13;0;"srikanth";13;100;0
477;0;"srikar";477;100;0
0;6;"srikari";6;0;100
43;0;"srikrishna";43;100;0
0;5;"srikrithi";5;0;100
0;5;"srikruthi";5;0;100
0;5;"srilaasya";5;0;100
0;6;"srilakshmi";6;0;100
77;0;"sriman";77;100;0
0;5;"srimayi";5;0;100
0;5;"srimedha";5;0;100
32;0;"srinath";32;100;0
6;0;"srinav";6;100;0
0;365;"srinidhi";365;0;100
0;5;"srinija";5;0;100
0;215;"srinika";215;0;100
10;0;"sriniketh";10;100;0
0;23;"srinithi";23;0;100
0;5;"srinithya";5;0;100
0;8;"srinitya";8;0;100
74;0;"srinivas";74;100;0
490;0;"sriram";490;100;0
5;0;"srisai";5;100;0
0;38;"srisha";38;0;100
0;262;"srishti";262;0;100
0;32;"sristi";32;0;100
5;0;"sritan";5;100;0
0;79;"sritha";79;0;100
45;0;"srithan";45;100;0
34;0;"srithik";34;100;0
0;5;"srivaishnavi";5;0;100
10;0;"srivanth";10;100;0
5;0;"srivar";5;100;0
32;0;"srivatsa";32;100;0
10;0;"srivatsan";10;100;0
0;6;"srividya";6;0;100
0;481;"sriya";481;0;100
6;0;"sriyaan";6;100;0
0;18;"sriyah";18;0;100
125;0;"sriyan";125;100;0
26;0;"sriyansh";26;100;0
32;0;"srujan";32;100;0
47;0;"sruly";47;100;0
0;19;"srushti";19;0;100
0;381;"sruthi";381;0;100
0;110;"sruti";110;0;100
0;5;"ssirley";5;0;100
0;5;"sstephanie";5;0;100
24;0;"st";24;100;0
16;0;"staccato";16;100;0
0;6;"stacci";6;0;100
184;33;"stace";217;84.7926267281106;15.2073732718894
0;1633;"stacee";1633;0;100
13864;147163;"stacey";161027;8.60973625541058;91.3902637445894
0;70;"staceyann";70;0;100
0;38;"stacha";38;0;100
0;134;"stachia";134;0;100
60;25438;"staci";25498;0.235312573535179;99.7646874264648
0;8947;"stacia";8947;0;100
0;5;"staciann";5;0;100
194;38974;"stacie";39168;0.495302287581699;99.5046977124183
22051;162547;"stacy";184598;11.9454165267229;88.0545834732771
0;90;"stacyann";90;0;100
0;521;"stacye";521;0;100
5;0;"stafan";5;100;0
0;37;"stafanie";37;0;100
33;0;"staffon";33;100;0
2689;0;"stafford";2689;100;0
5;0;"stafon";5;100;0
0;82;"staisha";82;0;100
0;6;"stajah";6;0;100
230;94;"staley";324;70.9876543209877;29.0123456790123
96;0;"stalin";96;100;0
12;0;"stallone";12;100;0
10;0;"stalyn";10;100;0
0;97;"stamatia";97;0;100
0;5;"stamatina";5;0;100
23;0;"stamatios";23;100;0
25;0;"stamatis";25;100;0
8404;0;"stan";8404;100;0
0;147;"stana";147;0;100
5;0;"stance";5;100;0
10;0;"stancel";10;100;0
90;0;"stancil";90;100;0
0;5;"stancy";5;0;100
10;0;"standard";10;100;0
25;0;"standford";25;100;0
5;0;"standish";5;100;0
382;0;"standley";382;100;0
21;0;"standly";21;100;0
228;0;"stanely";228;100;0
0;10;"stanesha";10;0;100
0;10;"stanette";10;0;100
5;0;"staney";5;100;0
7565;0;"stanford";7565;100;0
0;78;"stanisha";78;0;100
771;0;"stanislaus";771;100;0
244;0;"stanislav";244;100;0
0;16;"stanislava";16;0;100
432;0;"stanislaw";432;100;0
0;159;"stanislawa";159;0;100
0;6;"stanja";6;0;100
67;20;"stanlee";87;77.0114942528736;22.9885057471264
5;0;"stanleigh";5;100;0
295173;1438;"stanley";296611;99.5151899288968;0.484810071103229
957;0;"stanly";957;100;0
5;0;"stann";5;100;0
0;22;"stanna";22;0;100
5;0;"stanson";5;100;0
6399;0;"stanton";6399;100;0
51;0;"stanwood";51;100;0
0;16;"stanya";16;0;100
0;206;"staphanie";206;0;100
0;178;"staphany";178;0;100
7;0;"staphon";7;100;0
120;7269;"star";7389;1.62403572878603;98.375964271214
0;5;"stara";5;0;100
0;308;"starasia";308;0;100
11;0;"starbuck";11;100;0
0;5;"starcia";5;0;100
0;5;"stardust";5;0;100
0;62;"staria";62;0;100
0;11;"starisha";11;0;100
116;0;"stark";116;100;0
0;74;"starkeisha";74;0;100
0;35;"starkesha";35;0;100
5;0;"starkey";5;100;0
0;94;"starkisha";94;0;100
0;7835;"starla";7835;0;100
0;5;"starlah";5;0;100
0;11;"starleana";11;0;100
0;77;"starlee";77;0;100
0;85;"starleen";85;0;100
0;23;"starleigh";23;0;100
0;146;"starlena";146;0;100
0;1278;"starlene";1278;0;100
0;987;"starlet";987;0;100
0;665;"starlett";665;0;100
0;112;"starletta";112;0;100
0;636;"starlette";636;0;100
10;22;"starley";32;31.25;68.75
0;22;"starlight";22;0;100
179;41;"starlin";220;81.3636363636364;18.6363636363636
0;57;"starlina";57;0;100
895;134;"starling";1029;86.977648202138;13.022351797862
0;5;"starlisa";5;0;100
0;23;"starlisha";23;0;100
0;88;"starlit";88;0;100
0;5;"starlita";5;0;100
0;34;"starlite";34;0;100
6;663;"starlyn";669;0.896860986547085;99.1031390134529
0;381;"starlynn";381;0;100
0;58;"starnisha";58;0;100
0;14;"starquasia";14;0;100
324;9087;"starr";9411;3.44277972585273;96.5572202741473
0;5;"starri";5;0;100
0;44;"starrla";44;0;100
0;10;"starrlynn";10;0;100
0;260;"starsha";260;0;100
0;12;"starshema";12;0;100
0;5;"starshemah";5;0;100
134;0;"starsky";134;100;0
0;5;"startasia";5;0;100
19;0;"stas";19;100;0
5;0;"stash";5;100;0
0;764;"stasha";764;0;100
0;81;"stashia";81;0;100
0;46;"stasi";46;0;100
0;2153;"stasia";2153;0;100
0;6;"stassa";6;0;100
0;99;"stassi";99;0;100
18;0;"staten";18;100;0
43;0;"statham";43;100;0
5;0;"stathan";5;100;0
0;167;"statia";167;0;100
21;0;"statler";21;100;0
84;0;"staton";84;100;0
5;0;"statton";5;100;0
19;21;"stav";40;47.5;52.5
29;0;"stavon";29;100;0
28;0;"stavro";28;100;0
860;0;"stavros";860;100;0
0;432;"stavroula";432;0;100
5;0;"stavya";5;100;0
0;172;"stayce";172;0;100
0;92;"staysha";92;0;100
10;0;"stayton";10;100;0
0;5;"stazia";5;0;100
241;0;"stclair";241;100;0
0;5;"stcy";5;0;100
72;0;"steadman";72;100;0
5;0;"stearl";5;100;0
6;0;"stearns";6;100;0
24;0;"steave";24;100;0
244;0;"steaven";244;100;0
22;0;"steban";22;100;0
362;0;"stedman";362;100;0
6;0;"stedmen";6;100;0
31;0;"stedmon";31;100;0
12;0;"stedmond";12;100;0
62;0;"steed";62;100;0
459;0;"steel";459;100;0
1876;39;"steele";1915;97.9634464751958;2.03655352480418
11;0;"steeler";11;100;0
0;10;"steelie";10;0;100
5;35;"steely";40;12.5;87.5
151;0;"steen";151;100;0
10;0;"steeve";10;100;0
25;0;"steeven";25;100;0
0;10;"steevie";10;0;100
0;12;"stefaine";12;0;100
18925;42;"stefan";18967;99.778562766911;0.221437233089049
0;67;"stefana";67;0;100
0;32;"stefane";32;0;100
0;203;"stefanee";203;0;100
0;19;"stefaney";19;0;100
0;6879;"stefani";6879;0;100
0;2256;"stefania";2256;0;100
43;36892;"stefanie";36935;0.116420739136321;99.8835792608637
0;5;"stefanni";5;0;100
0;69;"stefannie";69;0;100
0;217;"stefanny";217;0;100
2635;0;"stefano";2635;100;0
396;0;"stefanos";396;100;0
0;3856;"stefany";3856;0;100
7;0;"stefaun";7;100;0
784;0;"stefen";784;100;0
0;10;"stefeni";10;0;100
0;40;"stefenie";40;0;100
1347;0;"steffan";1347;100;0
0;6;"steffane";6;0;100
0;997;"steffani";997;0;100
0;2538;"steffanie";2538;0;100
20;0;"steffano";20;100;0
0;1766;"steffany";1766;0;100
1432;0;"steffen";1432;100;0
0;11;"steffenie";11;0;100
0;523;"steffi";523;0;100
0;495;"steffie";495;0;100
29;0;"steffin";29;100;0
814;0;"steffon";814;100;0
0;12;"steffy";12;0;100
0;133;"stefhanie";133;0;100
0;16;"stefhany";16;0;100
5;0;"stefhon";5;100;0
0;15;"stefie";15;0;100
11;0;"stefin";11;100;0
0;6;"stefnie";6;0;100
1552;0;"stefon";1552;100;0
53;0;"stefone";53;100;0
0;9;"stefoni";9;0;100
5;0;"stefphon";5;100;0
0;207;"stehanie";207;0;100
29;0;"stehen";29;100;0
0;10;"stehpanie";10;0;100
5;0;"stehpen";5;100;0
0;5;"steicy";5;0;100
100;0;"stein";100;100;0
0;12;"steisy";12;0;100
0;120;"stela";120;0;100
159;0;"stelios";159;100;0
0;11;"stell";11;0;100
346;148527;"stella";148873;0.232412861969598;99.7675871380304
0;86;"stellah";86;0;100
0;13;"stellaluna";13;0;100
0;13;"stellamae";13;0;100
0;17;"stellamarie";17;0;100
574;0;"stellan";574;100;0
17;143;"stellar";160;10.625;89.375
0;60;"stellarose";60;0;100
0;49;"stelle";49;0;100
0;36;"stellina";36;0;100
35;0;"stelmo";35;100;0
163;0;"sten";163;100;0
0;5;"stena";5;0;100
16;0;"stennis";16;100;0
0;6;"steohanie";6;0;100
0;6;"stepahanie";6;0;100
0;397;"stepahnie";397;0;100
200;0;"stepan";200;100;0
0;676;"stepanie";676;0;100
26;0;"stepehen";26;100;0
63;0;"stepehn";63;100;0
56;0;"stepen";56;100;0
21;0;"stepfan";21;100;0
0;182;"stepfanie";182;0;100
158;0;"stepfon";158;100;0
0;66;"steph";66;0;100
0;136;"stephaie";136;0;100
0;4160;"stephaine";4160;0;100
26486;229;"stephan";26715;99.1428036683511;0.857196331648886
0;239;"stephana";239;0;100
674;1128;"stephane";1802;37.4028856825749;62.5971143174251
0;515;"stephanee";515;0;100
0;422;"stephaney";422;0;100
0;5257;"stephani";5257;0;100
0;3136;"stephania";3136;0;100
0;5;"stephanic";5;0;100
2638;738056;"stephanie";740694;0.35615247322106;99.6438475267789
0;95;"stephanieann";95;0;100
0;10;"stephanieanne";10;0;100
0;59;"stephaniemarie";59;0;100
0;143;"stephanine";143;0;100
0;92;"stephanne";92;0;100
0;5;"stephanni";5;0;100
0;1461;"stephannie";1461;0;100
0;194;"stephanny";194;0;100
443;0;"stephano";443;100;0
100;0;"stephanos";100;100;0
5;14583;"stephany";14588;0.0342747463668769;99.9657252536331
0;180;"stephanye";180;0;100
132;0;"stephaun";132;100;0
16;0;"stephe";16;100;0
851985;2932;"stephen";854917;99.6570427304639;0.342957269536107
0;281;"stephene";281;0;100
0;6;"stephenee";6;0;100
0;151;"stepheni";151;0;100
0;252;"stephenia";252;0;100
0;5730;"stephenie";5730;0;100
6;0;"stephenmichael";6;100;0
0;5;"stephennie";5;0;100
6;0;"stepheno";6;100;0
393;0;"stephens";393;100;0
217;0;"stephenson";217;100;0
0;400;"stepheny";400;0;100
5;0;"stepheon";5;100;0
5;0;"stephfan";5;100;0
66;0;"stephfon";66;100;0
0;21;"stephiane";21;0;100
0;249;"stephie";249;0;100
6;0;"stephin";6;100;0
0;45;"stephina";45;0;100
0;1685;"stephine";1685;0;100
0;80;"stephinie";80;0;100
10;0;"stephn";10;100;0
0;11;"stephne";11;0;100
0;38;"stephney";38;0;100
0;530;"stephnie";530;0;100
8156;14;"stephon";8170;99.828641370869;0.171358629130967
706;0;"stephone";706;100;0
0;155;"stephonie";155;0;100
5;0;"stephun";5;100;0
5;0;"stephvon";5;100;0
0;39;"stephy";39;0;100
0;5;"stepphanie";5;0;100
13;0;"sterl";13;100;0
666;0;"sterlin";666;100;0
0;5;"sterline";5;0;100
29765;2261;"sterling";32026;92.9401111596828;7.05988884031724
28;0;"sterlyn";28;100;0
0;132;"stesha";132;0;100
32;0;"stetsen";32;100;0
4267;0;"stetson";4267;100;0
6;0;"steuart";6;100;0
0;34;"steva";34;0;100
4021;0;"stevan";4021;100;0
0;69;"stevana";69;0;100
0;5;"stevani";5;0;100
0;26;"stevanie";26;0;100
0;27;"stevanna";27;0;100
238661;906;"steve";239567;99.6218176960934;0.378182303906632
11;353;"stevee";364;3.02197802197802;96.978021978022
21;0;"steveland";21;100;0
1277941;4465;"steven";1282406;99.6518263326903;0.348173667309729
0;5;"stevena";5;0;100
23;0;"stevenmichael";23;100;0
6;0;"stevenn";6;100;0
16;0;"stevenray";16;100;0
1287;0;"stevens";1287;100;0
1470;0;"stevenson";1470;100;0
11;0;"stevephen";11;100;0
23;0;"steveson";23;100;0
0;26;"stevette";26;0;100
23;124;"stevey";147;15.6462585034014;84.3537414965986
0;1405;"stevi";1405;0;100
12114;8968;"stevie";21082;57.461341428707;42.538658571293
0;10;"stevierae";10;0;100
20;0;"stevieray";20;100;0
0;6;"stevii";6;0;100
432;0;"stevin";432;100;0
5;0;"stevion";5;100;0
16;0;"stevn";16;100;0
707;0;"stevon";707;100;0
0;11;"stevona";11;0;100
0;12;"stevonna";12;0;100
10;0;"stevonte";10;100;0
21;0;"stevphen";21;100;0
5;33;"stevy";38;13.1578947368421;86.8421052631579
16;0;"stevyn";16;100;0
1196;0;"steward";1196;100;0
30428;85;"stewart";30513;99.7214302100744;0.278569789925605
0;5;"steysi";5;0;100
0;5;"sthefani";5;0;100
0;48;"sthefany";48;0;100
0;5;"sthepanie";5;0;100
0;17;"sthephanie";17;0;100
19;0;"stian";19;100;0
17;0;"stig";17;100;0
52;0;"stihl";52;100;0
380;0;"stiles";380;100;0
276;0;"stillman";276;100;0
0;96;"stina";96;0;100
5;0;"stiney";5;100;0
46;0;"stinson";46;100;0
693;41;"stirling";734;94.4141689373297;5.5858310626703
157;0;"stiven";157;100;0
5;0;"stjulian";5;100;0
956;0;"stockton";956;100;0
24;0;"stoddard";24;100;0
6;0;"stoic";6;100;0
31;0;"stokely";31;100;0
143;0;"stokes";143;100;0
13;0;"stokley";13;100;0
4767;32;"stone";4799;99.3331944155032;0.66680558449677
629;0;"stonewall";629;100;0
2838;37;"stoney";2875;98.7130434782609;1.28695652173913
25;10;"stonie";35;71.4285714285714;28.5714285714286
275;0;"stony";275;100;0
0;34;"storee";34;0;100
0;184;"storey";184;0;100
0;525;"stori";525;0;100
0;272;"storie";272;0;100
0;6;"storii";6;0;100
2810;1665;"storm";4475;62.7932960893855;37.2067039106145
34;49;"storme";83;40.9638554216867;59.0361445783133
0;233;"stormee";233;0;100
7;215;"stormey";222;3.15315315315315;96.8468468468468
0;1957;"stormi";1957;0;100
0;3185;"stormie";3185;0;100
803;6652;"stormy";7455;10.7712944332663;89.2287055667337
60;997;"story";1057;5.67644276253548;94.3235572374645
22;0;"stosh";22;100;0
5;0;"stover";5;100;0
10;0;"stowe";10;100;0
89;0;"stoy";89;100;0
0;109;"stpehanie";109;0;100
49;0;"stpehen";49;100;0
0;40;"stphanie";40;0;100
25;0;"stphen";25;100;0
0;11;"stracy";11;0;100
138;0;"stran";138;100;0
0;17;"strange";17;0;100
0;6;"stranje";6;0;100
5;0;"stratford";5;100;0
42;0;"straton";42;100;0
5;0;"stratos";5;100;0
7;0;"stratten";7;100;0
1027;11;"stratton";1038;98.9402697495183;1.0597302504817
5;0;"strauss";5;100;0
0;10;"strawberry";10;0;100
5;0;"streeter";5;100;0
0;11;"strella";11;0;100
12;0;"strickland";12;100;0
230;0;"strider";230;100;0
31;0;"striker";31;100;0
71;0;"strother";71;100;0
67;0;"strummer";67;100;0
501;0;"stryder";501;100;0
937;0;"stryker";937;100;0
55;0;"stu";55;100;0
18;0;"stuard";18;100;0
68053;314;"stuart";68367;99.5407140872058;0.459285912794184
0;5;"stuthi";5;0;100
0;224;"stuti";224;0;100
5;0;"stven";5;100;0
5;0;"styler";5;100;0
437;0;"styles";437;100;0
35;0;"stylez";35;100;0
51;0;"stylianos";51;100;0
7;0;"stylz";7;100;0
33;655;"su";688;4.79651162790698;95.203488372093
0;124;"sua";124;0;100
5;221;"suad";226;2.21238938053097;97.787610619469
0;15;"suada";15;0;100
0;27;"suah";27;0;100
33;106;"suan";139;23.7410071942446;76.2589928057554
0;751;"suann";751;0;100
0;22;"suanna";22;0;100
0;1402;"suanne";1402;0;100
0;37;"suany";37;0;100
45;0;"suave";45;100;0
0;7;"suban";7;0;100
5;0;"subaru";5;100;0
42;0;"subhaan";42;100;0
415;0;"subhan";415;100;0
0;20;"subhana";20;0;100
15;0;"subhi";15;100;0
10;6;"subin";16;62.5;37.5
0;6;"subira";6;0;100
0;191;"subrena";191;0;100
0;18;"subrenia";18;0;100
0;5;"subria";5;0;100
0;871;"subrina";871;0;100
41;29;"success";70;58.5714285714286;41.4285714285714
0;5;"sucdi";5;0;100
0;31;"sucely";31;0;100
0;15;"suchi";15;0;100
55;0;"suchir";55;100;0
10;0;"suchit";10;100;0
0;18;"suchita";18;0;100
0;108;"suda";108;0;100
172;0;"sudais";172;100;0
10;0;"sudan";10;100;0
41;0;"sudarshan";41;100;0
11;0;"sudays";11;100;0
0;49;"suddie";49;0;100
0;45;"sude";45;0;100
0;5;"sudeeksha";5;0;100
58;0;"sudeep";58;100;0
24;0;"sudeys";24;100;0
0;15;"sudha";15;0;100
5;0;"sudhanva";5;100;0
12;0;"sudhir";12;100;0
0;3149;"sudie";3149;0;100
0;100;"sudiksha";100;0;100
5;0;"sudip";5;100;0
519;142210;"sue";142729;0.363626172676891;99.6363738273231
0;6;"suean";6;0;100
0;2138;"sueann";2138;0;100
0;44;"sueanna";44;0;100
0;467;"sueanne";467;0;100
73;0;"suede";73;100;0
0;5;"suedell";5;0;100
0;462;"sueellen";462;0;100
0;11;"suehay";11;0;100
0;5;"suejin";5;0;100
0;271;"sueko";271;0;100
0;17;"sueling";17;0;100
0;405;"suella";405;0;100
0;3335;"suellen";3335;0;100
0;291;"suellyn";291;0;100
0;5;"suelyn";5;0;100
0;50;"suelynn";50;0;100
5;0;"suen";5;100;0
0;17;"sueno";17;0;100
80;0;"sueo";80;100;0
0;61;"suesan";61;0;100
0;137;"suetta";137;0;100
0;14;"suezanne";14;0;100
0;76;"suezette";76;0;100
0;5;"sufi";5;0;100
0;41;"sufia";41;0;100
95;0;"sufian";95;100;0
42;0;"sufiyan";42;100;0
102;0;"sufyaan";102;100;0
341;0;"sufyan";341;100;0
46;130;"sugar";176;26.1363636363636;73.8636363636364
0;6;"sugei";6;0;100
0;5;"sugeily";5;0;100
0;5;"sugeiri";5;0;100
0;380;"sugey";380;0;100
0;453;"suha";453;0;100
127;0;"suhaan";127;100;0
0;23;"suhaani";23;0;100
90;0;"suhaas";90;100;0
0;8;"suhad";8;0;100
340;0;"suhaib";340;100;0
276;25;"suhail";301;91.6943521594684;8.30564784053156
0;142;"suhaila";142;0;100
0;97;"suhailah";97;0;100
0;5;"suhailey";5;0;100
0;15;"suhaill";15;0;100
0;5;"suhaily";5;0;100
0;5;"suhaira";5;0;100
65;0;"suhan";65;100;0
0;363;"suhana";363;0;100
0;5;"suhanee";5;0;100
0;770;"suhani";770;0;100
6;0;"suhanth";6;100;0
328;0;"suhas";328;100;0
0;34;"suhavi";34;0;100
214;0;"suhayb";214;100;0
0;208;"suhayla";208;0;100
0;201;"suhaylah";201;0;100
35;0;"suheb";35;100;0
5;0;"suheib";5;100;0
0;14;"suheidy";14;0;100
0;62;"suheily";62;0;100
0;207;"suhey";207;0;100
47;0;"suheyb";47;100;0
0;53;"suheyla";53;0;100
5;0;"suhrit";5;100;0
0;5;"suhur";5;0;100
0;52;"sui";52;0;100
0;11;"suja";11;0;100
44;0;"sujal";44;100;0
24;0;"sujan";24;100;0
0;123;"sujata";123;0;100
0;5;"sujatha";5;0;100
251;0;"sujay";251;100;0
0;23;"sujei";23;0;100
0;31;"sujeily";31;0;100
0;12;"sujeiry";12;0;100
0;627;"sujey";627;0;100
0;32;"sujin";32;0;100
22;0;"sujit";22;100;0
0;5;"sujood";5;0;100
0;88;"sukaina";88;0;100
0;75;"sukanya";75;0;100
0;91;"sukari";91;0;100
0;34;"sukayna";34;0;100
37;10;"sukhdeep";47;78.7234042553192;21.2765957446809
11;10;"sukhjit";21;52.3809523809524;47.6190476190476
11;0;"sukhjot";11;100;0
0;9;"sukhleen";9;0;100
76;63;"sukhman";139;54.6762589928058;45.3237410071942
0;188;"sukhmani";188;0;100
6;33;"sukhpreet";39;15.3846153846154;84.6153846153846
77;0;"sukhraj";77;100;0
0;320;"suki";320;0;100
0;12;"sukie";12;0;100
0;10;"sukina";10;0;100
0;1064;"sula";1064;0;100
0;24;"sulaf";24;0;100
0;5;"sulai";5;0;100
984;0;"sulaiman";984;100;0
0;179;"sulamita";179;0;100
0;16;"sular";16;0;100
0;65;"sulay";65;0;100
5;0;"sulaymaan";5;100;0
405;0;"sulayman";405;100;0
0;5;"sule";5;0;100
0;8;"suleica";8;0;100
0;137;"suleika";137;0;100
0;286;"suleima";286;0;100
405;0;"suleiman";405;100;0
0;5;"sulekha";5;0;100
0;1955;"sulema";1955;0;100
146;0;"suleman";146;100;0
0;32;"suley";32;0;100
0;47;"suleyka";47;0;100
0;329;"suleyma";329;0;100
150;0;"suleyman";150;100;0
0;5;"suleymi";5;0;100
0;33;"suli";33;0;100
0;5;"sulia";5;0;100
0;34;"suliana";34;0;100
0;10;"sulie";10;0;100
16;0;"sulieman";16;100;0
168;0;"suliman";168;100;0
0;5;"sulin";5;0;100
0;15;"sulinda";15;0;100
0;6;"sullie";6;0;100
7567;688;"sullivan";8255;91.6656571774682;8.3343428225318
450;299;"sully";749;60.0801068090788;39.9198931909212
0;403;"sulma";403;0;100
0;7;"sulmy";7;0;100
220;0;"sulo";220;100;0
1274;0;"sultan";1274;100;0
0;217;"sultana";217;0;100
11;0;"sulton";11;100;0
0;73;"suly";73;0;100
0;11;"sulyn";11;0;100
0;5;"sulynn";5;0;100
0;53;"suma";53;0;100
0;22;"sumaia";22;0;100
5;0;"sumair";5;100;0
0;37;"sumaira";37;0;100
0;446;"sumaiya";446;0;100
0;285;"sumaiyah";285;0;100
0;5;"sumaiyya";5;0;100
0;34;"sumako";34;0;100
0;5;"sumalee";5;0;100
10;63;"suman";73;13.6986301369863;86.3013698630137
0;36;"sumana";36;0;100
30;0;"sumanth";30;100;0
0;53;"sumar";53;0;100
0;36;"sumara";36;0;100
0;1469;"sumaya";1469;0;100
0;426;"sumayah";426;0;100
0;49;"sumayo";49;0;100
0;209;"sumayya";209;0;100
0;615;"sumayyah";615;0;100
104;0;"sumedh";104;100;0
0;162;"sumedha";162;0;100
231;10;"sumeet";241;95.850622406639;4.149377593361
0;10;"sumehra";10;0;100
0;15;"sumeja";15;0;100
0;14;"sumeka";14;0;100
0;7;"sumeko";7;0;100
0;1502;"sumer";1502;0;100
0;22;"sumera";22;0;100
0;10;"sumerlyn";10;0;100
0;189;"sumeya";189;0;100
0;7;"sumeyye";7;0;100
0;171;"sumi";171;0;100
0;5;"sumia";5;0;100
0;10;"sumiah";10;0;100
0;223;"sumie";223;0;100
0;11;"sumika";11;0;100
0;618;"sumiko";618;0;100
0;16;"sumin";16;0;100
17;0;"sumio";17;100;0
5;0;"sumir";5;100;0
0;62;"sumire";62;0;100
250;0;"sumit";250;100;0
0;23;"sumita";23;0;100
0;11;"sumitra";11;0;100
0;58;"sumiya";58;0;100
0;46;"sumiyah";46;0;100
0;88;"sumiye";88;0;100
0;5;"summa";5;0;100
0;316;"summar";316;0;100
0;7;"summaya";7;0;100
0;5;"summayah";5;0;100
234;74935;"summer";75169;0.311298540621799;99.6887014593782
0;13;"summerlee";13;0;100
0;33;"summerlin";33;0;100
0;192;"summerlyn";192;0;100
0;87;"summerlynn";87;0;100
0;11;"summerrain";11;0;100
0;34;"summerrose";34;0;100
11;65;"summers";76;14.4736842105263;85.5263157894737
21;0;"summie";21;100;0
310;37;"summit";347;89.3371757925072;10.6628242074928
0;5;"summitt";5;0;100
2206;190;"sumner";2396;92.0701168614357;7.92988313856427
39;0;"sumpter";39;100;0
0;5;"sumra";5;0;100
29;0;"sumter";29;100;0
18;0;"sumukh";18;100;0
0;30;"sumya";30;0;100
0;8;"sumyah";8;0;100
381;464;"sun";845;45.0887573964497;54.9112426035503
0;20;"suna";20;0;100
0;110;"sunaina";110;0;100
39;0;"sunao";39;100;0
0;5;"sunasia";5;0;100
28;0;"sunay";28;100;0
0;6;"sunbeam";6;0;100
0;40;"sunda";40;0;100
0;357;"sundae";357;0;100
0;65;"sundai";65;0;100
65;5;"sundance";70;92.8571428571429;7.14285714285714
0;11;"sundara";11;0;100
0;31;"sundari";31;0;100
0;31;"sundas";31;0;100
53;2047;"sunday";2100;2.52380952380952;97.4761904761905
0;5;"sunde";5;0;100
0;282;"sundee";282;0;100
248;5;"sundeep";253;98.0237154150198;1.97628458498024
0;182;"sundi";182;0;100
109;0;"sundiata";109;100;0
0;36;"sundie";36;0;100
0;5;"sundos";5;0;100
6;12;"sundown";18;33.3333333333333;66.6666666666667
0;649;"sundra";649;0;100
0;446;"sundus";446;0;100
0;100;"sundy";100;0;100
0;51;"sunee";51;0;100
10;0;"suneel";10;100;0
0;6;"sunehri";6;0;100
14;0;"sunel";14;100;0
0;17;"sunem";17;0;100
0;13;"sunflower";13;0;100
444;69;"sung";513;86.5497076023392;13.4502923976608
0;320;"suni";320;0;100
0;12;"sunia";12;0;100
0;11;"sunidhi";11;0;100
0;10;"sunie";10;0;100
983;0;"sunil";983;100;0
0;602;"sunita";602;0;100
0;5;"sunitha";5;0;100
0;43;"suniya";43;0;100
0;42;"suniyah";42;0;100
0;11;"sunja";11;0;100
0;64;"sunjai";64;0;100
49;0;"sunjay";49;100;0
0;29;"sunna";29;0;100
0;5;"sunnee";5;0;100
11;1884;"sunni";1895;0.580474934036939;99.4195250659631
21;1616;"sunnie";1637;1.28283445326817;98.7171655467318
0;40;"sunniva";40;0;100
3233;8429;"sunny";11662;27.72251757846;72.27748242154
0;29;"sunnye";29;0;100
0;7;"sunrise";7;0;100
0;56;"sunset";56;0;100
37;5116;"sunshine";5153;0.718028333009897;99.2819716669901
0;89;"sunshyne";89;0;100
0;111;"sunya";111;0;100
0;5;"suoma";5;0;100
0;31;"suong";31;0;100
0;5;"suparna";5;0;100
0;5;"supraja";5;0;100
0;35;"supreet";35;0;100
232;0;"supreme";232;100;0
0;114;"suprena";114;0;100
0;5;"suprenia";5;0;100
0;111;"suprina";111;0;100
0;333;"supriya";333;0;100
0;262;"sura";262;0;100
0;167;"surabhi";167;0;100
67;0;"surafel";67;100;0
0;88;"surah";88;0;100
0;50;"surai";50;0;100
0;142;"suraiya";142;0;100
0;5;"suraiyah";5;0;100
985;0;"suraj";985;100;0
0;486;"suraya";486;0;100
0;16;"surayah";16;0;100
0;5;"surayya";5;0;100
0;15;"surayyah";15;0;100
0;22;"surbhi";22;0;100
0;5;"suree";5;0;100
0;10;"sureena";10;0;100
0;10;"surely";10;0;100
116;0;"suren";116;100;0
0;95;"surena";95;0;100
0;36;"surenity";36;0;100
140;0;"suresh";140;100;0
0;22;"sureya";22;0;100
0;2345;"suri";2345;0;100
0;55;"suria";55;0;100
0;117;"suriah";117;0;100
0;20;"suriana";20;0;100
0;5;"surianna";5;0;100
0;158;"surie";158;0;100
57;0;"suriel";57;100;0
0;428;"surina";428;0;100
10;177;"suriya";187;5.3475935828877;94.6524064171123
0;140;"suriyah";140;0;100
0;10;"surraya";10;0;100
0;10;"surrey";10;0;100
0;29;"surveen";29;0;100
0;744;"sury";744;0;100
812;249;"surya";1061;76.5315739868049;23.4684260131951
31;0;"suryansh";31;100;0
0;211;"susa";211;0;100
0;10;"susaa";10;0;100
2534;1114305;"susan";1116839;0.226890357517959;99.773109642482
52;20090;"susana";20142;0.258167014199186;99.7418329858008
0;34;"susanah";34;0;100
0;151;"susane";151;0;100
0;3089;"susann";3089;0;100
0;17759;"susanna";17759;0;100
0;7135;"susannah";7135;0;100
0;25874;"susanne";25874;0;100
62;0;"susano";62;100;0
0;6;"susaye";6;0;100
0;16;"susej";16;0;100
0;6;"susel";6;0;100
0;195;"susen";195;0;100
0;19;"suset";19;0;100
0;1042;"susette";1042;0;100
40;0;"sushant";40;100;0
30;0;"sushanth";30;100;0
25;0;"sushil";25;100;0
0;5;"sushma";5;0;100
0;19;"sushmita";19;0;100
0;386;"susi";386;0;100
0;10;"susia";10;0;100
0;7;"susian";7;0;100
260;73548;"susie";73808;0.35226533709083;99.6477346629092
0;5;"susin";5;0;100
0;71;"sussan";71;0;100
0;394;"sussie";394;0;100
0;38;"sussy";38;0;100
351;0;"susumu";351;100;0
0;1159;"susy";1159;0;100
0;5;"susyn";5;0;100
0;42;"suszanne";42;0;100
0;17;"sutten";17;0;100
259;19;"sutter";278;93.1654676258993;6.83453237410072
2339;2526;"sutton";4865;48.0781089414183;51.9218910585817
0;66;"suttyn";66;0;100
0;7;"suvali";7;0;100
115;0;"suvan";115;100;0
0;11;"suvanna";11;0;100
11;0;"suveer";11;100;0
0;83;"suvi";83;0;100
0;5;"suvilla";5;0;100
49;0;"suvir";49;100;0
0;5;"suyai";5;0;100
0;24;"suyapa";24;0;100
70;0;"suyash";70;100;0
0;5;"suyeko";5;0;100
20;0;"suyog";20;100;0
0;18;"suz";18;0;100
0;9006;"suzan";9006;0;100
0;1126;"suzana";1126;0;100
0;314;"suzane";314;0;100
0;4035;"suzann";4035;0;100
0;9132;"suzanna";9132;0;100
0;1694;"suzannah";1694;0;100
492;218584;"suzanne";219076;0.224579597947744;99.7754204020522
0;11;"suze";11;0;100
0;20;"suzelle";20;0;100
0;44;"suzen";44;0;100
0;23;"suzet";23;0;100
0;46;"suzeth";46;0;100
0;51;"suzett";51;0;100
0;204;"suzetta";204;0;100
5;16633;"suzette";16638;0.0300516889049165;99.9699483110951
0;1381;"suzi";1381;0;100
0;3711;"suzie";3711;0;100
0;48;"suzon";48;0;100
0;40;"suzonne";40;0;100
0;12;"suzu";12;0;100
0;25;"suzuko";25;0;100
0;4102;"suzy";4102;0;100
0;146;"suzzane";146;0;100
0;20;"suzzanna";20;0;100
0;724;"suzzanne";724;0;100
0;631;"suzzette";631;0;100
0;5;"suzzie";5;0;100
0;26;"svana";26;0;100
27;0;"svanik";27;100;0
0;12;"svannah";12;0;100
0;69;"svara";69;0;100
0;609;"svea";609;0;100
2083;0;"sven";2083;100;0
32;0;"svend";32;100;0
12;0;"sverre";12;100;0
0;717;"svetlana";717;0;100
0;5;"sveva";5;0;100
79;0;"swade";79;100;0
0;5;"swadha";5;0;100
71;0;"swain";71;100;0
119;73;"swan";192;61.9791666666667;38.0208333333333
0;5;"swanda";5;0;100
0;5;"swanee";5;0;100
0;5;"swanie";5;0;100
0;160;"swannie";160;0;100
121;0;"swanson";121;100;0
0;34;"swanzetta";34;0;100
0;24;"swapna";24;0;100
6;0;"swapnil";6;100;0
0;426;"swara";426;0;100
11;0;"swaraj";11;100;0
23;0;"swarit";23;100;0
0;6;"swarna";6;0;100
0;11;"swasti";11;0;100
7;0;"swastik";7;100;0
0;227;"swathi";227;0;100
0;403;"swati";403;0;100
40;173;"sway";213;18.7793427230047;81.2206572769953
36;0;"swayam";36;100;0
6;0;"swayde";6;100;0
11;0;"swayne";11;100;0
86;315;"swayze";401;21.4463840399002;78.5536159600997
0;116;"swayzee";116;0;100
0;7;"swayzi";7;0;100
0;116;"swayzie";116;0;100
0;10;"swecha";10;0;100
0;43;"sweden";43;0;100
0;65;"sweet";65;0;100
0;322;"sweetie";322;0;100
56;0;"swen";56;100;0
0;6;"swendy";6;0;100
0;217;"sweta";217;0;100
0;311;"swetha";311;0;100
10;0;"swift";10;100;0
6;0;"swindell";6;100;0
5;0;"swinton";5;100;0
0;12;"swiyyah";12;0;100
874;0;"sy";874;100;0
0;79;"sya";79;0;100
0;46;"syah";46;0;100
87;0;"syair";87;100;0
0;5;"syaira";5;0;100
133;6;"syaire";139;95.6834532374101;4.31654676258993
27;103;"syan";130;20.7692307692308;79.2307692307692
0;60;"syana";60;0;100
0;10;"syani";10;0;100
0;231;"syann";231;0;100
0;205;"syanna";205;0;100
0;224;"syanne";224;0;100
0;41;"syara";41;0;100
0;47;"syasia";47;0;100
0;10;"sybal";10;0;100
15;0;"sybastian";15;100;0
0;123;"sybel";123;0;100
0;149;"sybella";149;0;100
5;18835;"sybil";18840;0.0265392781316348;99.9734607218684
0;51;"sybile";51;0;100
0;7;"sybill";7;0;100
0;134;"sybilla";134;0;100
0;10;"sybille";10;0;100
0;5514;"syble";5514;0;100
0;101;"sybol";101;0;100
0;5;"sybrena";5;0;100
0;98;"sybrina";98;0;100
124;80;"syd";204;60.7843137254902;39.2156862745098
0;5;"sydalee";5;0;100
0;6;"sydea";6;0;100
0;37;"sydel";37;0;100
0;593;"sydell";593;0;100
0;734;"sydelle";734;0;100
7;0;"syden";7;100;0
0;12;"sydeny";12;0;100
0;10;"sydia";10;0;100
0;168;"sydna";168;0;100
0;875;"sydne";875;0;100
0;12;"sydnea";12;0;100
0;7912;"sydnee";7912;0;100
0;601;"sydnei";601;0;100
8804;166254;"sydney";175058;5.02919032549212;94.9708096745079
0;5162;"sydni";5162;0;100
0;5005;"sydnie";5005;0;100
0;6;"sydnii";6;0;100
7;0;"sydnor";7;100;0
0;270;"sydny";270;0;100
0;59;"sydnye";59;0;100
0;5;"sydonia";5;0;100
0;7;"sydonna";7;0;100
0;5;"sydra";5;0;100
96;0;"sye";96;100;0
4803;11;"syed";4814;99.7714997922725;0.228500207727462
0;1342;"syeda";1342;0;100
0;5;"syedah";5;0;100
6;0;"syedmuhammad";6;100;0
55;0;"syeed";55;100;0
0;26;"syeeda";26;0;100
0;29;"syeira";29;0;100
0;5;"syeisha";5;0;100
0;140;"syenna";140;0;100
15;0;"syer";15;100;0
0;43;"syera";43;0;100
11;0;"syere";11;100;0
0;6;"syeria";6;0;100
0;409;"syerra";409;0;100
0;64;"syesha";64;0;100
5;0;"syheem";5;100;0
17;0;"syhir";17;100;0
0;12;"syia";12;0;100
0;6;"syiah";6;0;100
5;0;"syid";5;100;0
19;0;"syier";19;100;0
6;0;"syiere";6;100;0
16;0;"syion";16;100;0
13;0;"syir";13;100;0
21;0;"syire";21;100;0
0;5;"sykeria";5;0;100
0;6;"sykora";6;0;100
5;0;"syl";5;100;0
0;67;"syla";67;0;100
0;28;"sylah";28;0;100
642;36;"sylar";678;94.6902654867257;5.30973451327434
3952;10;"sylas";3962;99.7476022211005;0.252397778899546
0;5;"sylbia";5;0;100
0;10;"sylee";10;0;100
0;112;"syleena";112;0;100
0;340;"sylena";340;0;100
603;18;"syler";621;97.1014492753623;2.89855072463768
0;12;"syleste";12;0;100
18;0;"sylester";18;100;0
0;13;"sylia";13;0;100
13;0;"sylias";13;100;0
0;174;"sylina";174;0;100
0;40;"sylinda";40;0;100
649;0;"sylis";649;100;0
5;0;"syliss";5;100;0
0;491;"syliva";491;0;100
0;35;"sylivia";35;0;100
754;0;"sylus";754;100;0
18;796;"sylva";814;2.21130221130221;97.7886977886978
77;0;"sylvain";77;100;0
3069;56;"sylvan";3125;98.208;1.792
0;710;"sylvana";710;0;100
0;7;"sylvanas";7;0;100
5;487;"sylvania";492;1.01626016260163;98.9837398373984
0;255;"sylvanna";255;0;100
0;5;"sylvannah";5;0;100
389;0;"sylvanus";389;100;0
0;15;"sylvene";15;0;100
5;119;"sylver";124;4.03225806451613;95.9677419354839
26;45;"sylvesta";71;36.6197183098592;63.3802816901408
40853;604;"sylvester";41457;98.5430687218081;1.45693127819186
91;0;"sylvestre";91;100;0
0;36;"sylvette";36;0;100
0;79;"sylvi";79;0;100
908;234335;"sylvia";235243;0.385983854992497;99.6140161450075
12;0;"sylvian";12;100;0
0;19;"sylviana";19;0;100
0;3276;"sylvie";3276;0;100
51;0;"sylvin";51;100;0
0;52;"sylvina";52;0;100
463;0;"sylvio";463;100;0
0;5;"sylvonia";5;0;100
0;119;"sylwia";119;0;100
16;0;"sylys";16;100;0
0;10;"syma";10;0;100
0;602;"symantha";602;0;100
0;12;"symanthia";12;0;100
0;47;"symara";47;0;100
0;5;"symarah";5;0;100
0;11;"symari";11;0;100
0;40;"symaria";40;0;100
0;5;"symaya";5;0;100
0;35;"symba";35;0;100
5;0;"symeir";5;100;0
163;0;"symeon";163;100;0
33;0;"symere";33;100;0
0;160;"symia";160;0;100
0;155;"symiah";155;0;100
212;0;"symir";212;100;0
0;58;"symira";58;0;100
0;13;"symirah";13;0;100
0;22;"symmone";22;0;100
382;10;"symon";392;97.4489795918367;2.55102040816327
0;5;"symona";5;0;100
0;3939;"symone";3939;0;100
0;49;"symonne";49;0;100
0;25;"symora";25;0;100
0;51;"symphani";51;0;100
0;87;"symphanie";87;0;100
0;198;"symphany";198;0;100
0;85;"symphoni";85;0;100
0;101;"symphonie";101;0;100
0;1895;"symphony";1895;0;100
0;40;"symya";40;0;100
0;84;"syna";84;0;100
0;28;"synae";28;0;100
0;205;"synai";205;0;100
0;5;"synaia";5;0;100
0;6;"synaya";6;0;100
13;0;"synceer";13;100;0
5;0;"synceir";5;100;0
1519;428;"syncere";1947;78.0174627632255;21.9825372367745
0;12;"synclair";12;0;100
0;29;"synclaire";29;0;100
0;61;"synda";61;0;100
0;12;"syndal";12;0;100
0;57;"syndee";57;0;100
0;7;"syndel";7;0;100
0;318;"syndey";318;0;100
0;255;"syndi";255;0;100
0;5;"syndia";5;0;100
0;15;"syndie";15;0;100
0;24;"syndney";24;0;100
0;11;"syndy";11;0;100
0;123;"synethia";123;0;100
0;7;"synetra";7;0;100
0;48;"synetta";48;0;100
0;390;"synia";390;0;100
0;480;"syniah";480;0;100
0;5;"synithia";5;0;100
0;40;"syniya";40;0;100
0;73;"syniyah";73;0;100
0;5;"synneva";5;0;100
0;11;"synnove";11;0;100
0;32;"synovia";32;0;100
0;26;"synquis";26;0;100
0;10;"synthea";10;0;100
0;2341;"synthia";2341;0;100
0;10;"syntia";10;0;100
0;6;"syntyche";6;0;100
231;0;"syon";231;100;0
0;71;"syona";71;0;100
0;6;"syonna";6;0;100
5;0;"syr";5;100;0
0;262;"syra";262;0;100
0;22;"syrae";22;0;100
0;142;"syrah";142;0;100
0;260;"syrai";260;0;100
162;0;"syre";162;100;0
6;5;"syree";11;54.5454545454545;45.4545454545455
0;5;"syreen";5;0;100
0;13;"syreena";13;0;100
0;1960;"syreeta";1960;0;100
6;45;"syren";51;11.7647058823529;88.2352941176471
0;569;"syrena";569;0;100
0;5;"syrene";5;0;100
0;13;"syreniti";13;0;100
0;194;"syrenity";194;0;100
0;5;"syrenna";5;0;100
0;32;"syreta";32;0;100
0;6;"syretha";6;0;100
0;392;"syretta";392;0;100
0;5;"syrette";5;0;100
0;26;"syri";26;0;100
0;525;"syria";525;0;100
0;538;"syriah";538;0;100
0;312;"syriana";312;0;100
0;79;"syrianna";79;0;100
0;10;"syrie";10;0;100
0;18;"syril";18;0;100
0;175;"syrina";175;0;100
0;11;"syrinity";11;0;100
209;0;"syris";209;100;0
0;112;"syrita";112;0;100
0;5;"syritta";5;0;100
5;0;"syrius";5;100;0
5;0;"syron";5;100;0
1201;0;"syrus";1201;100;0
0;5;"sytha";5;0;100
0;11;"syuri";11;0;100
0;87;"syvanna";87;0;100
0;46;"syvannah";46;0;100
0;6;"syvella";6;0;100
5;0;"syvester";5;100;0
0;5;"syvia";5;0;100
0;112;"syvilla";112;0;100
5;0;"szander";5;100;0
0;5;"szofia";5;0;100
376;0;"szymon";376;100;0
30;207;"ta";237;12.6582278481013;87.3417721518987
0;7;"taaffe";7;0;100
15;0;"taaha";15;100;0
50;0;"taahir";50;100;0
0;54;"taahira";54;0;100
0;18;"taahirah";18;0;100
74;5;"taaj";79;93.6708860759494;6.32911392405063
0;5;"taalia";5;0;100
0;24;"taaliah";24;0;100
16;0;"taalib";16;100;0
0;10;"taaliba";10;0;100
0;214;"taaliyah";214;0;100
0;5;"taalor";5;0;100
0;16;"taana";16;0;100
0;36;"taara";36;0;100
5;0;"taaraz";5;100;0
268;0;"taariq";268;100;0
0;5;"taarna";5;0;100
10;0;"taaron";10;100;0
0;13;"taasia";13;0;100
97;0;"taavi";97;100;0
17;0;"taavon";17;100;0
1111;0;"tab";1111;100;0
0;5;"taba";5;0;100
0;27;"tabaitha";27;0;100
415;0;"tabari";415;100;0
0;11;"tabassum";11;0;100
0;6;"tabata";6;0;100
0;19307;"tabatha";19307;0;100
0;5;"tabathe";5;0;100
0;183;"tabathia";183;0;100
61;0;"tabb";61;100;0
0;748;"tabbatha";748;0;100
0;214;"tabbetha";214;0;100
0;26;"tabbie";26;0;100
0;699;"tabbitha";699;0;100
5;162;"tabby";167;2.9940119760479;97.0059880239521
0;5;"tabbytha";5;0;100
0;10;"tabea";10;0;100
412;28;"taber";440;93.6363636363636;6.36363636363636
0;3912;"tabetha";3912;0;100
0;28;"tabethia";28;0;100
0;171;"tabia";171;0;100
370;0;"tabias";370;100;0
0;23;"tabiatha";23;0;100
10;0;"tabious";10;100;0
16;0;"tabish";16;100;0
0;240;"tabita";240;0;100
146;57428;"tabitha";57574;0.253586688435752;99.7464133115643
0;165;"tabithia";165;0;100
55;0;"tabius";55;100;0
610;87;"tabor";697;87.5179340028694;12.4820659971306
0;5;"taborah";5;0;100
5;0;"tabori";5;100;0
31;0;"taboris";31;100;0
0;17;"tabrea";17;0;100
0;27;"tabresha";27;0;100
0;255;"tabria";255;0;100
0;91;"tabrina";91;0;100
0;10;"tabrisha";10;0;100
0;5;"tabriya";5;0;100
5;0;"tabu";5;100;0
0;491;"tabytha";491;0;100
0;546;"tacara";546;0;100
101;17;"tacari";118;85.5932203389831;14.4067796610169
0;343;"tacarra";343;0;100
0;129;"taccara";129;0;100
0;14;"taccarra";14;0;100
5;0;"tace";5;100;0
0;300;"tacey";300;0;100
0;63;"tacha";63;0;100
0;8;"tachaka";8;0;100
0;5;"tachara";5;0;100
0;70;"tache";70;0;100
0;50;"tachelle";50;0;100
0;5;"tachiana";5;0;100
0;5;"tachic";5;0;100
0;65;"tachina";65;0;100
0;146;"taci";146;0;100
0;103;"tacia";103;0;100
0;5;"taciana";5;0;100
0;126;"tacie";126;0;100
0;16;"tacita";16;0;100
176;42;"tacoma";218;80.7339449541284;19.2660550458716
0;173;"tacora";173;0;100
29;0;"tacorey";29;100;0
36;64;"tacori";100;36;64
0;24;"tacoria";24;0;100
11;0;"tacorian";11;100;0
0;7;"tacorra";7;0;100
5;0;"tacory";5;100;0
0;71;"tacoya";71;0;100
87;0;"tacuma";87;100;0
0;770;"tacy";770;0;100
6815;0;"tad";6815;100;0
0;5;"tadajah";5;0;100
114;0;"tadan";114;100;0
294;0;"tadao";294;100;0
5;0;"tadarian";5;100;0
10;0;"tadarious";10;100;0
381;0;"tadarius";381;100;0
69;0;"tadarrius";69;100;0
585;0;"tadashi";585;100;0
0;12;"tadasia";12;0;100
12;0;"tadayoshi";12;100;0
1456;0;"tadd";1456;100;0
10;0;"taddeo";10;100;0
33;0;"tade";33;100;0
6;0;"tadeas";6;100;0
21;0;"tadeh";21;100;0
0;5;"tadeja";5;0;100
303;0;"taden";303;100;0
1405;0;"tadeo";1405;100;0
0;5;"tadesha";5;0;100
34;0;"tadeus";34;100;0
369;0;"tadeusz";369;100;0
310;0;"tadhg";310;100;0
6;0;"tadrian";6;100;0
6;0;"tadyn";6;100;0
0;17;"tadzia";17;0;100
382;102;"tae";484;78.9256198347107;21.0743801652893
0;52;"taea";52;0;100
95;0;"taeden";95;100;0
8;0;"taedon";8;100;0
50;5;"taedyn";55;90.9090909090909;9.09090909090909
324;917;"taegan";1241;26.1079774375504;73.8920225624496
73;149;"taegen";222;32.8828828828829;67.1171171171171
0;10;"taeghan";10;0;100
0;5;"taegyn";5;0;100
0;5;"taeh";5;0;100
5;0;"taehyun";5;100;0
0;25;"taeisha";25;0;100
0;127;"taeja";127;0;100
0;102;"taejah";102;0;100
7;0;"taejohn";7;100;0
178;0;"taejon";178;100;0
5;0;"taejuan";5;100;0
9;0;"taejzon";9;100;0
0;74;"taeko";74;0;100
39;0;"taekwon";39;100;0
0;125;"taela";125;0;100
5;0;"taelan";5;100;0
0;63;"taelar";63;0;100
0;10;"taelee";10;0;100
13;0;"taelen";13;100;0
5;341;"taeler";346;1.44508670520231;98.5549132947977
49;25;"taelin";74;66.2162162162162;33.7837837837838
79;0;"taelon";79;100;0
179;2123;"taelor";2302;7.7758470894874;92.2241529105126
0;5;"taelour";5;0;100
97;1460;"taelyn";1557;6.22992935131663;93.7700706486834
0;902;"taelynn";902;0;100
0;7;"taelynne";7;0;100
0;87;"taelyr";87;0;100
10;0;"taemon";10;100;0
18;0;"taeo";18;100;0
12;0;"taeon";12;100;0
135;0;"taequan";135;100;0
20;0;"taeron";20;100;0
0;5;"taeryn";5;0;100
113;0;"taesean";113;100;0
0;198;"taesha";198;0;100
205;0;"taeshaun";205;100;0
295;0;"taeshawn";295;100;0
0;5;"taeshia";5;0;100
54;0;"taeshon";54;100;0
11;0;"taeson";11;100;0
15;100;"taetum";115;13.0434782608696;86.9565217391304
0;5;"taetym";5;0;100
16;0;"taeven";16;100;0
176;0;"taeveon";176;100;0
21;0;"taevian";21;100;0
107;0;"taevin";107;100;0
409;0;"taevion";409;100;0
605;0;"taevon";605;100;0
68;0;"taevyn";68;100;0
0;343;"taeya";343;0;100
0;5;"taeyah";5;0;100
5;0;"taeyang";5;100;0
0;21;"taeylor";21;0;100
11;0;"taeyon";11;100;0
691;6;"tafari";697;99.1391678622669;0.860832137733142
28;0;"taff";28;100;0
0;10;"taffani";10;0;100
0;219;"taffany";219;0;100
0;5;"taffeta";5;0;100
0;43;"taffi";43;0;100
0;118;"taffie";118;0;100
0;10;"taffney";10;0;100
0;875;"taffy";875;0;100
1429;0;"taft";1429;100;0
129;0;"tag";129;100;0
54;63;"tagan";117;46.1538461538462;53.8461538461538
422;0;"tage";422;100;0
161;99;"tagen";260;61.9230769230769;38.0769230769231
6;0;"tagert";6;100;0
81;0;"tagg";81;100;0
575;0;"taggart";575;100;0
138;0;"taggert";138;100;0
1684;0;"taha";1684;100;0
34;0;"tahaj";34;100;0
12;0;"tahan";12;100;0
0;314;"tahani";314;0;100
0;10;"tahany";10;0;100
0;289;"tahara";289;0;100
52;86;"tahari";138;37.6811594202899;62.3188405797101
10;0;"taheed";10;100;0
224;0;"taheem";224;100;0
0;91;"taheera";91;0;100
0;157;"taheerah";157;0;100
39;0;"taheim";39;100;0
0;10;"tahel";10;0;100
183;0;"taher";183;100;0
0;18;"tahera";18;0;100
0;165;"tahesha";165;0;100
0;5;"tahesia";5;0;100
5;0;"tahi";5;100;0
0;49;"tahia";49;0;100
18;0;"tahiem";18;100;0
0;53;"tahina";53;0;100
1385;0;"tahir";1385;100;0
0;1091;"tahira";1091;0;100
0;873;"tahirah";873;0;100
0;70;"tahiri";70;0;100
0;89;"tahirih";89;0;100
0;355;"tahiry";355;0;100
0;14;"tahis";14;0;100
0;6;"tahisa";6;0;100
0;373;"tahisha";373;0;100
0;5;"tahitha";5;0;100
0;44;"tahitia";44;0;100
5;0;"tahitoa";5;100;0
0;31;"tahiya";31;0;100
0;5;"tahiyah";5;0;100
2654;85;"tahj";2739;96.8966776195692;3.10332238043081
15;233;"tahja";248;6.04838709677419;93.9516129032258
104;122;"tahjae";226;46.0176991150442;53.9823008849557
70;28;"tahjai";98;71.4285714285714;28.5714285714286
0;78;"tahjanae";78;0;100
0;6;"tahjanay";6;0;100
0;5;"tahjanee";5;0;100
76;0;"tahjay";76;100;0
77;43;"tahje";120;64.1666666666667;35.8333333333333
32;0;"tahjee";32;100;0
146;0;"tahji";146;100;0
0;6;"tahjia";6;0;100
57;0;"tahjir";57;100;0
11;0;"tahjmir";11;100;0
0;5;"tahlaya";5;0;100
0;10;"tahlea";10;0;100
0;17;"tahleah";17;0;100
6;0;"tahlee";6;100;0
5;0;"tahleek";5;100;0
0;10;"tahler";10;0;100
0;2410;"tahlia";2410;0;100
0;19;"tahliah";19;0;100
5;0;"tahlib";5;100;0
14;0;"tahlik";14;100;0
17;0;"tahlil";17;100;0
0;18;"tahliya";18;0;100
0;62;"tahliyah";62;0;100
0;80;"tahlor";80;0;100
0;16;"tahlya";16;0;100
14;0;"tahmeed";14;100;0
6;0;"tahmel";6;100;0
0;5;"tahmia";5;0;100
249;0;"tahmid";249;100;0
0;53;"tahmina";53;0;100
172;0;"tahmir";172;100;0
0;11;"tahmya";11;0;100
0;5;"tahna";5;0;100
0;919;"tahnee";919;0;100
0;5;"tahnesha";5;0;100
0;45;"tahni";45;0;100
0;41;"tahnia";41;0;100
0;5;"tahnisha";5;0;100
0;35;"tahniya";35;0;100
0;48;"tahnya";48;0;100
0;147;"tahra";147;0;100
0;21;"tahreem";21;0;100
5;0;"tahriq";5;100;0
17;0;"tahron";17;100;0
6;0;"tahseen";6;100;0
0;10;"tahsha";10;0;100
5;0;"tahshawn";5;100;0
83;19;"tahsin";102;81.3725490196078;18.6274509803922
0;110;"tahtiana";110;0;100
0;10;"tahtianna";10;0;100
0;10;"tahtyana";10;0;100
0;53;"tahya";53;0;100
2636;1693;"tai";4329;60.8916608916609;39.1083391083391
0;525;"taia";525;0;100
0;34;"taiah";34;0;100
0;67;"taiana";67;0;100
0;23;"taianna";23;0;100
0;28;"taiasha";28;0;100
0;28;"taiba";28;0;100
106;0;"taichi";106;100;0
0;25;"taide";25;0;100
356;0;"taiden";356;100;0
26;0;"taidyn";26;100;0
0;251;"taiesha";251;0;100
0;25;"taifa";25;0;100
5;0;"taig";5;100;0
234;0;"taiga";234;100;0
5;56;"taigan";61;8.19672131147541;91.8032786885246
86;35;"taige";121;71.0743801652893;28.9256198347107
26;36;"taigen";62;41.9354838709677;58.0645161290323
0;5;"taighlor";5;0;100
5;0;"taigon";5;100;0
0;5;"taihlor";5;0;100
6;0;"taij";6;100;0
0;800;"taija";800;0;100
11;18;"taijae";29;37.9310344827586;62.0689655172414
0;385;"taijah";385;0;100
0;6;"taijanae";6;0;100
0;5;"taijarae";5;0;100
6;0;"taijay";6;100;0
0;19;"taijha";19;0;100
149;0;"taijon";149;100;0
64;0;"taijuan";64;100;0
207;0;"taiki";207;100;0
0;247;"taila";247;0;100
0;33;"tailah";33;0;100
0;20;"tailar";20;0;100
0;34;"tailee";34;0;100
5;0;"tailen";5;100;0
10;193;"tailer";203;4.92610837438424;95.0738916256158
0;46;"tailey";46;0;100
10;0;"tailon";10;100;0
161;924;"tailor";1085;14.8387096774194;85.1612903225806
0;7;"tailore";7;0;100
0;10;"taily";10;0;100
10;515;"tailyn";525;1.9047619047619;98.0952380952381
0;568;"tailynn";568;0;100
0;15;"tailyr";15;0;100
187;0;"taim";187;100;0
0;95;"taima";95;0;100
19;0;"taimak";19;100;0
0;126;"taimane";126;0;100
0;5;"taimani";5;0;100
0;11;"taime";11;0;100
0;172;"taimi";172;0;100
5;0;"taimoor";5;100;0
46;0;"taimur";46;100;0
0;2545;"taina";2545;0;100
93;0;"taino";93;100;0
28;0;"taio";28;100;0
18;0;"taion";18;100;0
0;27;"taionna";27;0;100
116;0;"taiquan";116;100;0
0;1013;"taira";1013;0;100
0;8;"taire";8;0;100
0;5;"tairen";5;0;100
5;0;"tairik";5;100;0
6;0;"tairiq";6;100;0
17;0;"tairon";17;100;0
0;46;"tairra";46;0;100
0;6;"tairy";6;0;100
0;17;"tairyn";17;0;100
0;409;"tais";409;0;100
0;146;"taisa";146;0;100
43;0;"taisean";43;100;0
127;0;"taisei";127;100;0
6;0;"taisen";6;100;0
0;2729;"taisha";2729;0;100
10;0;"taishan";10;100;0
88;0;"taishaun";88;100;0
113;0;"taishawn";113;100;0
54;0;"taishi";54;100;0
0;11;"taishia";11;0;100
0;8;"taishima";8;0;100
11;0;"taishon";11;100;0
0;71;"taisia";71;0;100
0;51;"taisiya";51;0;100
0;5;"taislee";5;0;100
0;82;"taisley";82;0;100
156;0;"taison";156;100;0
0;15;"taissa";15;0;100
26;0;"taisto";26;100;0
1123;16;"tait";1139;98.595258999122;1.40474100087796
129;110;"taite";239;53.9748953974895;46.0251046025105
103;0;"taiten";103;100;0
0;27;"taitiana";27;0;100
0;5;"taitianna";5;0;100
0;39;"taitlyn";39;0;100
42;0;"taiton";42;100;0
62;352;"taitum";414;14.975845410628;85.024154589372
0;5;"taityana";5;0;100
0;5;"taityanna";5;0;100
0;44;"taitym";44;0;100
113;0;"taiven";113;100;0
49;0;"taiveon";49;100;0
50;0;"taivion";50;100;0
243;0;"taivon";243;100;0
798;71;"taiwan";869;91.8296892980437;8.17031070195627
0;111;"taiwana";111;0;100
0;6;"taiwanda";6;0;100
0;22;"taiwanna";22;0;100
140;57;"taiwo";197;71.0659898477157;28.9340101522843
5;0;"taiwon";5;100;0
0;625;"taiya";625;0;100
0;37;"taiyah";37;0;100
0;112;"taiyana";112;0;100
0;15;"taiyanna";15;0;100
0;24;"taiyari";24;0;100
0;5;"taiyler";5;0;100
0;272;"taiylor";272;0;100
211;0;"taiyo";211;100;0
11;0;"taiyon";11;100;0
0;98;"taiz";98;0;100
0;5;"taizha";5;0;100
0;12;"taizlee";12;0;100
0;10;"taizley";10;0;100
10;0;"taizo";10;100;0
4398;390;"taj";4788;91.8546365914787;8.1453634085213
28;1832;"taja";1860;1.50537634408602;98.494623655914
180;256;"tajae";436;41.2844036697248;58.7155963302752
76;845;"tajah";921;8.25190010857763;91.7480998914224
5;0;"tajahn";5;100;0
0;41;"tajahnae";41;0;100
0;5;"tajahne";5;0;100
165;147;"tajai";312;52.8846153846154;47.1153846153846
0;91;"tajana";91;0;100
0;468;"tajanae";468;0;100
0;6;"tajanai";6;0;100
0;109;"tajanay";109;0;100
0;29;"tajane";29;0;100
0;18;"tajanea";18;0;100
0;59;"tajanee";59;0;100
0;59;"tajanique";59;0;100
22;0;"tajaun";22;100;0
0;18;"tajauna";18;0;100
64;10;"tajay";74;86.4864864864865;13.5135135135135
125;99;"taje";224;55.8035714285714;44.1964285714286
0;16;"tajea";16;0;100
80;34;"tajee";114;70.1754385964912;29.8245614035088
655;0;"tajh";655;100;0
0;75;"tajha";75;0;100
0;5;"tajhanae";5;0;100
422;125;"taji";547;77.1480804387569;22.8519195612431
0;204;"tajia";204;0;100
0;6;"tajiah";6;0;100
0;44;"tajiana";44;0;100
0;5;"tajianna";5;0;100
25;0;"tajiddin";25;100;0
0;5;"tajinae";5;0;100
6;0;"tajion";6;100;0
39;0;"tajir";39;100;0
26;0;"tajiri";26;100;0
0;53;"tajma";53;0;100
0;11;"tajmah";11;0;100
5;0;"tajmalik";5;100;0
5;0;"tajmere";5;100;0
21;0;"tajmir";21;100;0
29;0;"tajohn";29;100;0
308;0;"tajon";308;100;0
0;6;"tajsa";6;0;100
647;7;"tajuan";654;98.9296636085627;1.07033639143731
0;1090;"tajuana";1090;0;100
0;6;"tajuanda";6;0;100
0;63;"tajuanna";63;0;100
5;0;"tajudeen";5;100;0
5;0;"tajveer";5;100;0
5;0;"tajwar";5;100;0
0;46;"taka";46;0;100
104;0;"takahiro";104;100;0
267;48;"takai";315;84.7619047619048;15.2380952380952
0;11;"takaia";11;0;100
0;10;"takaila";10;0;100
0;57;"takaiya";57;0;100
0;6;"takaiyah";6;0;100
0;148;"takako";148;0;100
0;60;"takala";60;0;100
6;0;"takanori";6;100;0
146;0;"takao";146;100;0
0;1398;"takara";1398;0;100
0;8;"takarah";8;0;100
171;66;"takari";237;72.1518987341772;27.8481012658228
0;24;"takaria";24;0;100
0;47;"takarra";47;0;100
0;58;"takasha";58;0;100
815;0;"takashi";815;100;0
0;5;"takashia";5;0;100
5;78;"takaya";83;6.02409638554217;93.9759036144578
0;1007;"takayla";1007;0;100
0;16;"takaylah";16;0;100
49;0;"takayuki";49;100;0
0;40;"takea";40;0;100
0;5;"takeara";5;0;100
0;5;"takeasha";5;0;100
0;19;"takecia";19;0;100
0;5;"takedra";5;0;100
0;47;"takeela";47;0;100
57;0;"takeem";57;100;0
0;51;"takeema";51;0;100
0;27;"takeena";27;0;100
0;137;"takeesha";137;0;100
0;5;"takeeta";5;0;100
0;277;"takeia";277;0;100
5;0;"takeichi";5;100;0
0;5;"takeidra";5;0;100
0;63;"takeila";63;0;100
0;107;"takeira";107;0;100
0;1048;"takeisha";1048;0;100
0;11;"takeita";11;0;100
0;6;"takeiya";6;0;100
0;43;"takeko";43;0;100
0;269;"takela";269;0;100
0;163;"takelia";163;0;100
0;5;"takella";5;0;100
0;52;"takema";52;0;100
0;5;"takemia";5;0;100
0;11;"takena";11;0;100
0;23;"takendra";23;0;100
0;286;"takenya";286;0;100
685;0;"takeo";685;100;0
0;286;"takera";286;0;100
0;312;"takeria";312;0;100
0;61;"takerra";61;0;100
0;23;"takerria";23;0;100
84;0;"takeru";84;100;0
0;10;"takesa";10;0;100
0;977;"takesha";977;0;100
678;5;"takeshi";683;99.2679355783309;0.732064421669107
0;418;"takeshia";418;0;100
0;11;"takesia";11;0;100
0;43;"taketa";43;0;100
0;16;"takevia";16;0;100
0;640;"takeya";640;0;100
0;189;"takeyah";189;0;100
0;35;"takeyia";35;0;100
0;106;"takeyla";106;0;100
0;10;"takeyra";10;0;100
0;123;"takeysha";123;0;100
0;6;"takeyshia";6;0;100
22;0;"takhi";22;100;0
0;107;"takhia";107;0;100
0;12;"takhiya";12;0;100
50;5;"taki";55;90.9090909090909;9.09090909090909
0;1957;"takia";1957;0;100
0;107;"takiah";107;0;100
0;20;"takiara";20;0;100
0;11;"takiea";11;0;100
0;123;"takiera";123;0;100
0;18;"takierra";18;0;100
0;182;"takiesha";182;0;100
0;5;"takijah";5;0;100
0;203;"takila";203;0;100
8;0;"takim";8;100;0
0;95;"takima";95;0;100
0;89;"takina";89;0;100
0;6;"takindra";6;0;100
0;944;"takira";944;0;100
0;75;"takirah";75;0;100
0;7;"takirra";7;0;100
0;5;"takisa";5;0;100
0;2057;"takisha";2057;0;100
0;26;"takishia";26;0;100
0;300;"takita";300;0;100
0;1016;"takiya";1016;0;100
0;1871;"takiyah";1871;0;100
0;5;"takiyla";5;0;100
0;6;"taknisha";6;0;100
6;0;"takobe";6;100;0
1296;107;"takoda";1403;92.3734853884533;7.62651461154668
21;0;"takoma";21;100;0
5;0;"takori";5;100;0
339;33;"takota";372;91.1290322580645;8.87096774193548
0;105;"takoya";105;0;100
41;0;"taksh";41;100;0
36;0;"taku";36;100;0
142;0;"takuma";142;100;0
417;0;"takumi";417;100;0
53;0;"takuto";53;100;0
145;0;"takuya";145;100;0
11;0;"takwon";11;100;0
0;200;"takya";200;0;100
0;103;"takyah";103;0;100
5;0;"takye";5;100;0
0;85;"takyia";85;0;100
0;11;"takyiah";11;0;100
0;282;"takyla";282;0;100
0;32;"takylah";32;0;100
0;5;"takylia";5;0;100
0;560;"takyra";560;0;100
0;27;"takyrah";27;0;100
1171;514;"tal";1685;69.4955489614243;30.5044510385757
0;2102;"tala";2102;0;100
0;5;"talae";5;0;100
0;99;"talah";99;0;100
0;10;"talaia";10;0;100
0;6;"talaiah";6;0;100
0;5;"talaija";5;0;100
0;23;"talaijah";23;0;100
0;10;"talaina";10;0;100
0;8;"talaisha";8;0;100
0;31;"talaiya";31;0;100
0;24;"talaiyah";24;0;100
0;9;"talaja";9;0;100
0;73;"talajah";73;0;100
0;5;"talajha";5;0;100
0;5;"talajiah";5;0;100
566;0;"talal";566;100;0
3574;51;"talan";3625;98.5931034482759;1.40689655172414
0;369;"talana";369;0;100
0;53;"talanda";53;0;100
0;6;"talandra";6;0;100
0;66;"talani";66;0;100
0;212;"talar";212;0;100
0;16;"talara";16;0;100
0;17;"talarisha";17;0;100
0;11;"talasha";11;0;100
0;227;"talasia";227;0;100
5;0;"talat";5;100;0
0;1247;"talaya";1247;0;100
0;607;"talayah";607;0;100
0;5;"talayasia";5;0;100
0;73;"talayeh";73;0;100
0;105;"talayia";105;0;100
0;11;"talayiah";11;0;100
0;10;"talayja";10;0;100
0;13;"talayjah";13;0;100
0;67;"talayla";67;0;100
0;33;"talayna";33;0;100
0;67;"talaysha";67;0;100
0;26;"talayshia";26;0;100
0;328;"talaysia";328;0;100
0;15;"talazia";15;0;100
821;0;"talbert";821;100;0
444;11;"talbot";455;97.5824175824176;2.41758241758242
6;0;"talbott";6;100;0
0;778;"talea";778;0;100
0;2180;"taleah";2180;0;100
0;37;"taleaha";37;0;100
0;15;"taleasha";15;0;100
35;0;"taleb";35;100;0
0;85;"talecia";85;0;100
0;10;"talee";10;0;100
0;45;"taleea";45;0;100
0;41;"taleeah";41;0;100
12;0;"taleek";12;100;0
0;608;"taleen";608;0;100
0;39;"taleena";39;0;100
0;22;"taleesa";22;0;100
0;34;"taleesha";34;0;100
0;92;"taleeya";92;0;100
0;69;"taleeyah";69;0;100
0;22;"talei";22;0;100
0;166;"taleia";166;0;100
0;36;"taleiah";36;0;100
0;79;"taleigh";79;0;100
0;287;"taleigha";287;0;100
0;5;"taleisa";5;0;100
0;207;"taleisha";207;0;100
0;6;"taleiya";6;0;100
0;46;"taleiyah";46;0;100
0;6;"taleka";6;0;100
1665;44;"talen";1709;97.4253949678174;2.57460503218256
0;905;"talena";905;0;100
0;72;"talene";72;0;100
14;0;"talent";14;100;0
5;68;"taler";73;6.84931506849315;93.1506849315068
0;37;"talesa";37;0;100
0;15;"talese";15;0;100
0;622;"talesha";622;0;100
0;157;"taleshia";157;0;100
0;23;"talesia";23;0;100
0;242;"taletha";242;0;100
0;18;"talethia";18;0;100
0;6;"talexis";6;0;100
0;11;"taley";11;0;100
0;250;"taleya";250;0;100
0;274;"taleyah";274;0;100
12;0;"talford";12;100;0
695;0;"talha";695;100;0
22;0;"talhah";22;100;0
0;18;"talhia";18;0;100
60;1012;"tali";1072;5.59701492537313;94.4029850746269
5;24567;"talia";24572;0.0203483639915351;99.9796516360085
0;2529;"taliah";2529;0;100
0;178;"taliana";178;0;100
0;26;"talianna";26;0;100
0;12;"taliayah";12;0;100
766;0;"talib";766;100;0
0;5;"taliba";5;0;100
0;123;"talibah";123;0;100
0;542;"talicia";542;0;100
0;11;"talie";11;0;100
0;6;"taliea";6;0;100
44;0;"taliek";44;100;0
0;10;"taliesha";10;0;100
128;0;"taliesin";128;100;0
0;5;"taliha";5;0;100
0;45;"talijah";45;0;100
252;0;"talik";252;100;0
0;50;"talika";50;0;100
0;6;"talim";6;0;100
563;308;"talin";871;64.638346727899;35.361653272101
0;975;"talina";975;0;100
0;274;"taline";274;0;100
17;0;"talion";17;100;0
44;0;"taliq";44;100;0
17;0;"talique";17;100;0
75;11;"talis";86;87.2093023255814;12.7906976744186
0;2032;"talisa";2032;0;100
0;301;"talise";301;0;100
0;2886;"talisha";2886;0;100
0;104;"talishia";104;0;100
0;22;"talisia";22;0;100
0;401;"talissa";401;0;100
0;5;"talissia";5;0;100
0;210;"talita";210;0;100
0;3020;"talitha";3020;0;100
0;39;"talithia";39;0;100
0;819;"taliya";819;0;100
0;6733;"taliyah";6733;0;100
0;34;"taliyha";34;0;100
0;11;"talla";11;0;100
151;0;"tallan";151;100;0
463;0;"tallen";463;100;0
81;303;"talley";384;21.09375;78.90625
0;139;"talli";139;0;100
0;165;"tallia";165;0;100
112;461;"tallie";573;19.5462478184991;80.4537521815009
79;0;"tallin";79;100;0
72;47;"tallis";119;60.5042016806723;39.4957983193277
0;39;"talliyah";39;0;100
916;0;"tallon";916;100;0
0;99;"tallula";99;0;100
0;1851;"tallulah";1851;0;100
137;485;"tally";622;22.0257234726688;77.9742765273312
48;61;"tallyn";109;44.0366972477064;55.9633027522936
12;204;"talma";216;5.55555555555556;94.4444444444444
5506;36;"talmadge";5542;99.3504150126308;0.649584987369181
2088;0;"talmage";2088;100;0
5;0;"talmer";5;100;0
17;0;"talmon";17;100;0
10021;436;"talon";10457;95.8305441331166;4.16945586688343
0;25;"talona";25;0;100
0;158;"talonda";158;0;100
196;551;"talor";747;26.2382864792503;73.7617135207497
0;38;"talore";38;0;100
0;16;"taloria";16;0;100
0;5;"talsha";5;0;100
192;0;"talton";192;100;0
0;231;"talula";231;0;100
0;226;"talulah";226;0;100
0;28;"talulla";28;0;100
0;49;"talullah";49;0;100
37;0;"talus";37;100;0
113;0;"talvin";113;100;0
0;5;"taly";5;0;100
0;2467;"talya";2467;0;100
0;375;"talyah";375;0;100
0;77;"talyia";77;0;100
0;60;"talyiah";60;0;100
742;792;"talyn";1534;48.3702737940026;51.6297262059974
10;524;"talynn";534;1.87265917602996;98.12734082397
0;5;"talyor";5;0;100
0;6;"talyr";6;0;100
0;20;"talysa";20;0;100
0;25;"talysha";25;0;100
0;90;"talyssa";90;0;100
932;850;"tam";1782;52.300785634119;47.699214365881
6;1433;"tama";1439;0.416956219596942;99.5830437804031
0;15;"tamae";15;0;100
0;53;"tamah";53;0;100
0;16;"tamai";16;0;100
0;35;"tamaia";35;0;100
0;5;"tamaiah";5;0;100
0;11;"tamaica";11;0;100
0;19;"tamaika";19;0;100
6;0;"tamaine";6;100;0
0;278;"tamaira";278;0;100
0;82;"tamaiya";82;0;100
86;0;"tamaj";86;100;0
0;5;"tamajah";5;0;100
0;182;"tamaka";182;0;100
0;35;"tamaki";35;0;100
0;92;"tamakia";92;0;100
16;0;"tamal";16;100;0
0;2873;"tamala";2873;0;100
0;5;"tamalia";5;0;100
0;144;"tamalyn";144;0;100
0;86;"tamana";86;0;100
0;127;"tamani";127;0;100
0;69;"tamanika";69;0;100
0;172;"tamanna";172;0;100
0;143;"tamantha";143;0;100
853;5516;"tamar";6369;13.3929973308212;86.6070026691788
417;130201;"tamara";130618;0.319251557978227;99.6807484420218
0;5;"tamarae";5;0;100
0;1309;"tamarah";1309;0;100
0;6;"tamaran";6;0;100
536;0;"tamarcus";536;100;0
12;10;"tamare";22;54.5454545454545;45.4545454545455
0;10;"tamarea";10;0;100
0;7;"tamaree";7;0;100
256;502;"tamari";758;33.7730870712401;66.2269129287599
0;814;"tamaria";814;0;100
0;21;"tamariah";21;0;100
17;0;"tamarian";17;100;0
0;6;"tamariana";6;0;100
63;0;"tamarick";63;100;0
0;52;"tamarie";52;0;100
5;0;"tamarik";5;100;0
0;20;"tamarin";20;0;100
0;10;"tamarind";10;0;100
93;0;"tamario";93;100;0
561;0;"tamarion";561;100;0
18;0;"tamarious";18;100;0
26;32;"tamaris";58;44.8275862068966;55.1724137931034
0;14;"tamarisk";14;0;100
188;0;"tamarius";188;100;0
7;0;"tamarkus";7;100;0
0;5;"tamaro";5;0;100
0;5;"tamaron";5;0;100
12;5;"tamarr";17;70.5882352941177;29.4117647058824
0;1220;"tamarra";1220;0;100
0;5;"tamarrah";5;0;100
0;16;"tamarria";16;0;100
16;0;"tamarrion";16;100;0
0;6;"tamarsha";6;0;100
0;11;"tamarya";11;0;100
96;0;"tamas";96;100;0
0;108;"tamasha";108;0;100
0;5;"tamasine";5;0;100
0;2811;"tamatha";2811;0;100
0;10;"tamathia";10;0;100
0;15;"tamathy";15;0;100
27;0;"tamatoa";27;100;0
29;10;"tamauri";39;74.3589743589744;25.6410256410256
5;0;"tamaurice";5;100;0
0;1047;"tamaya";1047;0;100
0;16;"tamayah";16;0;100
0;10;"tamaye";10;0;100
0;5;"tamayia";5;0;100
14;0;"tamaz";14;100;0
11;12;"tamba";23;47.8260869565217;52.1739130434783
0;215;"tamber";215;0;100
0;230;"tamberly";230;0;100
0;61;"tamberlyn";61;0;100
0;177;"tambi";177;0;100
0;18;"tamblyn";18;0;100
12;5;"tamboura";17;70.5882352941177;29.4117647058824
0;1817;"tambra";1817;0;100
0;23;"tambre";23;0;100
0;5;"tambresha";5;0;100
0;32;"tambrey";32;0;100
0;236;"tambria";236;0;100
0;5;"tambry";5;0;100
0;297;"tamea";297;0;100
0;64;"tameah";64;0;100
0;159;"tameaka";159;0;100
0;697;"tameca";697;0;100
0;67;"tamecca";67;0;100
0;10;"tamecha";10;0;100
0;264;"tamecia";264;0;100
0;127;"tamecka";127;0;100
0;16;"tameco";16;0;100
0;127;"tamee";127;0;100
0;938;"tameeka";938;0;100
268;0;"tameem";268;100;0
18;0;"tameer";18;100;0
0;5;"tameera";5;0;100
0;23;"tameesha";23;0;100
0;153;"tameia";153;0;100
0;32;"tameica";32;0;100
0;1535;"tameika";1535;0;100
0;13;"tameiko";13;0;100
0;5;"tameira";5;0;100
0;391;"tameisha";391;0;100
41;12727;"tameka";12768;0.321115288220551;99.6788847117794
0;5;"tameke";5;0;100
0;5;"tamekea";5;0;100
0;59;"tameki";59;0;100
0;1883;"tamekia";1883;0;100
0;10;"tamekio";10;0;100
0;60;"tamekka";60;0;100
0;270;"tameko";270;0;100
83;0;"tamel";83;100;0
0;7181;"tamela";7181;0;100
0;165;"tamelia";165;0;100
5;0;"tamell";5;100;0
0;94;"tamella";94;0;100
12;0;"tamem";12;100;0
750;33;"tamer";783;95.7854406130268;4.21455938697318
0;14061;"tamera";14061;0;100
0;36;"tamerah";36;0;100
11;0;"tamere";11;100;0
0;685;"tameria";685;0;100
6;0;"tamerick";6;100;0
117;53;"tameron";170;68.8235294117647;31.1764705882353
0;138;"tamerra";138;0;100
0;24;"tamesa";24;0;100
0;1883;"tamesha";1883;0;100
0;541;"tameshia";541;0;100
0;55;"tamesia";55;0;100
0;85;"tametha";85;0;100
0;84;"tametra";84;0;100
0;63;"tametria";63;0;100
0;150;"tamey";150;0;100
0;190;"tameya";190;0;100
0;76;"tameyah";76;0;100
0;5;"tameyka";5;0;100
0;5;"tamhra";5;0;100
91;37883;"tami";37974;0.239637646810976;99.760362353189
0;11757;"tamia";11757;0;100
0;710;"tamiah";710;0;100
0;5;"tamiaya";5;0;100
0;2138;"tamica";2138;0;100
0;16;"tamicha";16;0;100
16;0;"tamichael";16;100;0
0;45;"tamicia";45;0;100
0;420;"tamicka";420;0;100
0;5;"tamicko";5;0;100
0;85;"tamico";85;0;100
0;3237;"tamie";3237;0;100
0;643;"tamieka";643;0;100
0;5;"tamieko";5;0;100
0;48;"tamiera";48;0;100
0;17;"tamiesha";17;0;100
0;30;"tamiia";30;0;100
0;5;"tamiika";5;0;100
14;26;"tamija";40;35;65
0;18;"tamijah";18;0;100
0;10;"tamijo";10;0;100
90;22700;"tamika";22790;0.394910048266784;99.6050899517332
0;20;"tamikah";20;0;100
0;5;"tamikca";5;0;100
0;43;"tamike";43;0;100
0;61;"tamiki";61;0;100
0;367;"tamikia";367;0;100
0;163;"tamikka";163;0;100
42;2997;"tamiko";3039;1.38203356367226;98.6179664363277
0;556;"tamila";556;0;100
0;28;"tamilia";28;0;100
0;17;"tamilla";17;0;100
0;15;"tamille";15;0;100
0;5;"tamillia";5;0;100
5;21;"tamilore";26;19.2307692307692;80.7692307692308
0;101;"tamilyn";101;0;100
286;0;"tamim";286;100;0
0;209;"tamina";209;0;100
0;11;"taminka";11;0;100
13;0;"tamio";13;100;0
0;22;"tamiqua";22;0;100
1563;53;"tamir";1616;96.720297029703;3.27970297029703
0;2049;"tamira";2049;0;100
0;20;"tamiracle";20;0;100
0;204;"tamirah";204;0;100
0;17;"tamiria";17;0;100
0;125;"tamirra";125;0;100
0;10;"tamisa";10;0;100
0;2188;"tamisha";2188;0;100
0;29;"tamishia";29;0;100
0;13;"tamita";13;0;100
0;454;"tamitha";454;0;100
0;37;"tamitra";37;0;100
0;1656;"tamiya";1656;0;100
0;1037;"tamiyah";1037;0;100
0;9;"tamka";9;0;100
0;130;"tamkia";130;0;100
0;12;"tamkio";12;0;100
0;358;"tamla";358;0;100
0;149;"tamlyn";149;0;100
0;215;"tamma";215;0;100
0;88;"tammala";88;0;100
0;6;"tammany";6;0;100
0;2507;"tammara";2507;0;100
0;16;"tammarra";16;0;100
0;153;"tammatha";153;0;100
0;267;"tamme";267;0;100
0;92;"tammee";92;0;100
0;11;"tammeka";11;0;100
0;82;"tammela";82;0;100
22;0;"tammer";22;100;0
0;1338;"tammera";1338;0;100
0;10;"tammeria";10;0;100
0;5;"tammetha";5;0;100
0;778;"tammey";778;0;100
0;13883;"tammi";13883;0;100
0;29;"tammia";29;0;100
0;25;"tammica";25;0;100
134;35363;"tammie";35497;0.377496689861115;99.6225033101389
0;50;"tammika";50;0;100
0;5;"tammila";5;0;100
0;6;"tammis";6;0;100
0;17;"tammitha";17;0;100
0;5;"tammmy";5;0;100
0;5;"tammora";5;0;100
0;583;"tammra";583;0;100
1392;331673;"tammy";333065;0.417936438833261;99.5820635611667
0;6;"tammyann";6;0;100
0;666;"tammye";666;0;100
0;38;"tammyjo";38;0;100
0;5;"tammylee";5;0;100
0;29;"tammylynn";29;0;100
0;5;"tammyra";5;0;100
190;0;"tamon";190;100;0
0;8;"tamona";8;0;100
0;10;"tamoni";10;0;100
0;39;"tamonica";39;0;100
0;656;"tamora";656;0;100
0;80;"tamorah";80;0;100
5;0;"tamorion";5;100;0
199;0;"tamotsu";199;100;0
0;10;"tamoya";10;0;100
0;15;"tampa";15;0;100
0;27;"tampatha";27;0;100
5;13698;"tamra";13703;0.036488360213092;99.9635116397869
0;145;"tamrah";145;0;100
0;90;"tamre";90;0;100
0;5;"tamriel";5;0;100
18;5;"tamron";23;78.2608695652174;21.7391304347826
10;330;"tamryn";340;2.94117647058824;97.0588235294118
0;409;"tamsen";409;0;100
0;285;"tamsin";285;0;100
0;15;"tamson";15;0;100
0;119;"tamsyn";119;0;100
5;285;"tamu";290;1.72413793103448;98.2758620689655
0;196;"tamula";196;0;100
0;193;"tamura";193;0;100
0;623;"tamy";623;0;100
0;2642;"tamya";2642;0;100
0;361;"tamyah";361;0;100
0;42;"tamye";42;0;100
0;314;"tamyia";314;0;100
0;54;"tamyiah";54;0;100
0;136;"tamyka";136;0;100
0;12;"tamyko";12;0;100
0;28;"tamyla";28;0;100
0;2227;"tamyra";2227;0;100
0;62;"tamyrah";62;0;100
0;5;"tamyria";5;0;100
0;12;"tamzen";12;0;100
0;38;"tamzin";38;0;100
0;25;"tamzyn";25;0;100
571;11;"tan";582;98.1099656357388;1.89003436426117
6;9173;"tana";9179;0.0653665976685913;99.9346334023314
0;5;"tanaa";5;0;100
0;659;"tanae";659;0;100
0;15;"tanaeja";15;0;100
0;18;"tanaejah";18;0;100
0;23;"tanah";23;0;100
0;134;"tanai";134;0;100
0;80;"tanaia";80;0;100
0;59;"tanaija";59;0;100
0;41;"tanaijah";41;0;100
0;203;"tanairi";203;0;100
0;110;"tanairy";110;0;100
0;26;"tanaisa";26;0;100
0;235;"tanaisha";235;0;100
0;167;"tanaiya";167;0;100
0;22;"tanaiyah";22;0;100
0;276;"tanaja";276;0;100
0;295;"tanajah";295;0;100
0;16;"tanajha";16;0;100
0;23;"tanajia";23;0;100
10;129;"tanaka";139;7.19424460431655;92.8057553956834
11;0;"tanar";11;100;0
0;214;"tanara";214;0;100
5;0;"tanard";5;100;0
0;11;"tanari";11;0;100
0;17;"tanaria";17;0;100
0;606;"tanasha";606;0;100
0;201;"tanashia";201;0;100
0;1211;"tanasia";1211;0;100
0;14;"tanautica";14;0;100
128;0;"tanav";128;100;0
0;10;"tanavia";10;0;100
432;330;"tanay";762;56.6929133858268;43.3070866141732
0;2007;"tanaya";2007;0;100
0;179;"tanayah";179;0;100
0;80;"tanayia";80;0;100
0;10;"tanayja";10;0;100
0;10;"tanayjah";10;0;100
0;142;"tanaysha";142;0;100
0;5;"tanayshia";5;0;100
0;148;"tanaysia";148;0;100
0;5;"tanayzia";5;0;100
0;111;"tanazia";111;0;100
0;40;"tancy";40;0;100
0;462;"tanda";462;0;100
0;7;"tandeka";7;0;100
12;0;"tanden";12;100;0
0;602;"tandi";602;0;100
0;5;"tandice";5;0;100
0;12;"tandie";12;0;100
0;5;"tandis";5;0;100
34;0;"tandon";34;100;0
0;1389;"tandra";1389;0;100
135;0;"tandre";135;100;0
0;148;"tandrea";148;0;100
0;39;"tandria";39;0;100
693;1164;"tandy";1857;37.3182552504039;62.6817447495961
17;159;"tane";176;9.65909090909091;90.3409090909091
0;739;"tanea";739;0;100
0;68;"taneah";68;0;100
0;127;"taneal";127;0;100
0;88;"taneasha";88;0;100
0;12;"taneca";12;0;100
0;6;"tanechia";6;0;100
0;287;"tanecia";287;0;100
0;5;"tanedra";5;0;100
0;115;"tanee";115;0;100
0;194;"taneeka";194;0;100
10;0;"taneesh";10;100;0
0;525;"taneesha";525;0;100
0;42;"taneha";42;0;100
0;126;"taneia";126;0;100
0;5;"taneice";5;0;100
0;5;"taneicia";5;0;100
0;242;"taneika";242;0;100
0;133;"taneil";133;0;100
0;5;"taneille";5;0;100
0;5;"taneiqua";5;0;100
0;2038;"taneisha";2038;0;100
0;12;"taneishia";12;0;100
0;5;"taneiya";5;0;100
0;52;"taneja";52;0;100
0;8;"tanejah";8;0;100
5;0;"tanek";5;100;0
0;1519;"taneka";1519;0;100
0;123;"tanekia";123;0;100
0;5;"tanekqua";5;0;100
0;52;"tanell";52;0;100
0;58;"tanelle";58;0;100
0;171;"tanequa";171;0;100
552;0;"taner";552;100;0
0;23;"tanera";23;0;100
0;15;"taneria";15;0;100
0;60;"tanesa";60;0;100
0;5306;"tanesha";5306;0;100
0;1309;"taneshia";1309;0;100
0;285;"tanesia";285;0;100
0;382;"tanessa";382;0;100
0;81;"tanetta";81;0;100
0;60;"tanette";60;0;100
0;367;"taneya";367;0;100
0;50;"taneyah";50;0;100
0;5;"taneysha";5;0;100
0;47;"tang";47;0;100
0;404;"tanga";404;0;100
0;97;"tangala";97;0;100
0;61;"tanganika";61;0;100
0;113;"tanganyika";113;0;100
0;59;"tange";59;0;100
0;358;"tangee";358;0;100
0;3784;"tangela";3784;0;100
0;284;"tangelia";284;0;100
0;22;"tangella";22;0;100
5;0;"tangelo";5;100;0
0;5;"tangenika";5;0;100
0;20;"tanger";20;0;100
0;39;"tangerine";39;0;100
0;11;"tangerla";11;0;100
0;338;"tangi";338;0;100
0;74;"tangia";74;0;100
0;1149;"tangie";1149;0;100
0;15;"tangier";15;0;100
0;22;"tangila";22;0;100
0;44;"tangina";44;0;100
0;36;"tangla";36;0;100
0;8;"tangle";8;0;100
0;5;"tanglia";5;0;100
0;33;"tango";33;0;100
0;55;"tangula";55;0;100
0;5;"tangular";5;0;100
0;263;"tangy";263;0;100
10;976;"tani";986;1.01419878296146;98.9858012170385
60;27710;"tania";27770;0.216060496939143;99.7839395030609
0;856;"taniah";856;0;100
0;72;"taniaya";72;0;100
0;5;"taniayah";5;0;100
0;253;"tanica";253;0;100
0;66;"tanice";66;0;100
0;5;"tanicha";5;0;100
0;144;"tanicia";144;0;100
0;115;"tanicka";115;0;100
0;5;"tanida";5;0;100
0;17;"taniece";17;0;100
0;146;"tanieka";146;0;100
0;18;"taniel";18;0;100
103;0;"taniela";103;100;0
0;134;"tanielle";134;0;100
11;0;"tanielu";11;100;0
0;775;"taniesha";775;0;100
0;6;"taniha";6;0;100
0;11;"tanihya";11;0;100
0;315;"tanija";315;0;100
0;442;"tanijah";442;0;100
0;27;"tanijha";27;0;100
0;4515;"tanika";4515;0;100
0;59;"tanikia";59;0;100
0;124;"tanikka";124;0;100
0;33;"taniko";33;0;100
0;18;"tanikqua";18;0;100
0;8;"tanila";8;0;100
0;14;"tanilah";14;0;100
0;46;"tanille";46;0;100
5;0;"tanin";5;100;0
0;130;"tanina";130;0;100
0;605;"taniqua";605;0;100
0;125;"tanique";125;0;100
0;24;"tanira";24;0;100
501;982;"tanis";1483;33.7828725556305;66.2171274443695
0;76;"tanisa";76;0;100
0;79;"tanise";79;0;100
430;66;"tanish";496;86.6935483870968;13.3064516129032
21;19097;"tanisha";19118;0.109844125954598;99.8901558740454
0;6;"tanishea";6;0;100
0;75;"tanishi";75;0;100
0;563;"tanishia";563;0;100
0;244;"tanishka";244;0;100
42;0;"tanishq";42;100;0
0;43;"tanisi";43;0;100
0;68;"tanisia";68;0;100
0;607;"tanita";607;0;100
0;122;"tanith";122;0;100
0;6;"tanitha";6;0;100
0;35;"tanitra";35;0;100
0;4793;"taniya";4793;0;100
0;3628;"taniyah";3628;0;100
0;44;"taniyha";44;0;100
0;8;"taniyia";8;0;100
0;28;"taniyla";28;0;100
0;13;"taniylah";13;0;100
0;2571;"tanja";2571;0;100
0;25;"tanjala";25;0;100
0;5;"tanjanae";5;0;100
0;35;"tanjanika";35;0;100
0;7;"tanjanique";7;0;100
0;147;"tanji";147;0;100
0;5;"tanjie";5;0;100
114;0;"tank";114;100;0
0;7;"tankia";7;0;100
0;41;"tanley";41;0;100
148;0;"tanmay";148;100;0
0;32;"tanmayi";32;0;100
0;3186;"tanna";3186;0;100
0;259;"tannah";259;0;100
141;10;"tannar";151;93.3774834437086;6.62251655629139
0;36;"tannaz";36;0;100
150;0;"tannen";150;100;0
89331;2107;"tanner";91438;97.6957063802795;2.30429361972047
0;7;"tannesha";7;0;100
0;5;"tanneshia";5;0;100
0;6;"tannetta";6;0;100
0;23;"tannette";23;0;100
0;6;"tanni";6;0;100
0;392;"tannia";392;0;100
11;111;"tannie";122;9.01639344262295;90.983606557377
0;21;"tannika";21;0;100
0;8;"tannille";8;0;100
5;0;"tannim";5;100;0
11;0;"tannin";11;100;0
5;321;"tannis";326;1.53374233128834;98.4662576687116
0;66;"tannisha";66;0;100
203;0;"tannon";203;100;0
356;0;"tannor";356;100;0
10;177;"tanny";187;5.3475935828877;94.6524064171123
0;253;"tannya";253;0;100
5;0;"tannyr";5;100;0
15;0;"tano";15;100;0
0;11;"tanoa";11;0;100
61;0;"tanor";61;100;0
0;21;"tansey";21;0;100
0;12;"tansha";12;0;100
0;5;"tansi";5;0;100
0;316;"tansy";316;0;100
0;8;"tantanea";8;0;100
0;47;"tantania";47;0;100
0;11;"tante";11;0;100
0;5;"tantra";5;0;100
70;0;"tanuj";70;100;0
0;5;"tanuja";5;0;100
324;0;"tanush";324;100;0
0;5;"tanusha";5;0;100
0;5;"tanushka";5;0;100
0;16;"tanushri";16;0;100
0;25;"tanvee";25;0;100
136;37;"tanveer";173;78.6127167630058;21.3872832369942
0;1799;"tanvi";1799;0;100
0;20;"tanvika";20;0;100
248;7;"tanvir";255;97.2549019607843;2.74509803921569
0;28;"tany";28;0;100
405;116308;"tanya";116713;0.34700504656722;99.6529949534328
0;303;"tanyah";303;0;100
0;49;"tanyanika";49;0;100
0;6;"tanyea";6;0;100
0;26;"tanyeka";26;0;100
0;17;"tanyel";17;0;100
0;48;"tanyell";48;0;100
0;10;"tanyelle";10;0;100
0;40;"tanyetta";40;0;100
0;11;"tanyette";11;0;100
0;5;"tanyha";5;0;100
0;525;"tanyia";525;0;100
0;120;"tanyiah";120;0;100
0;70;"tanyika";70;0;100
0;6;"tanyja";6;0;100
0;26;"tanyjah";26;0;100
0;29;"tanyka";29;0;100
0;260;"tanyla";260;0;100
0;82;"tanylah";82;0;100
151;0;"tanyon";151;100;0
0;21;"tanyra";21;0;100
0;228;"tanysha";228;0;100
0;168;"tanza";168;0;100
0;666;"tanzania";666;0;100
0;10;"tanzi";10;0;100
0;20;"tanzia";20;0;100
0;68;"tanzie";68;0;100
0;23;"tanzila";23;0;100
12;0;"tanzim";12;100;0
0;55;"tanzy";55;0;100
313;10;"tao";323;96.9040247678019;3.09597523219814
0;5;"taonna";5;0;100
59;0;"taos";59;100;0
0;8;"tapainga";8;0;100
11;0;"tapan";11;100;0
0;531;"tapanga";531;0;100
0;5;"tapasya";5;0;100
0;6;"tapatha";6;0;100
10;0;"taqee";10;100;0
15;0;"taqi";15;100;0
0;11;"taqiyya";11;0;100
0;5;"taqiyyah";5;0;100
1184;0;"taquan";1184;100;0
0;310;"taquana";310;0;100
0;37;"taquanda";37;0;100
0;63;"taquanna";63;0;100
0;5;"taquanta";5;0;100
17;0;"taquarius";17;100;0
0;45;"taquasha";45;0;100
0;44;"taquasia";44;0;100
0;6;"taqueena";6;0;100
0;5;"taquella";5;0;100
0;18;"taqueria";18;0;100
0;53;"taquesha";53;0;100
0;11;"taquetta";11;0;100
5;0;"taquez";5;100;0
0;29;"taquia";29;0;100
6;0;"taquil";6;100;0
0;214;"taquila";214;0;100
0;219;"taquilla";219;0;100
0;38;"taquira";38;0;100
0;5;"taquisa";5;0;100
0;307;"taquisha";307;0;100
0;270;"taquita";270;0;100
0;10;"taquoia";10;0;100
21;0;"taquon";21;100;0
0;5;"taquoya";5;0;100
0;71;"taqwa";71;0;100
5;0;"taqwan";5;100;0
0;5;"tar";5;0;100
543;173579;"tara";174122;0.311850311850312;99.6881496881497
0;54;"taraann";54;0;100
10;104;"tarae";114;8.7719298245614;91.2280701754386
0;16;"taraf";16;0;100
0;4651;"tarah";4651;0;100
7;94;"tarahji";101;6.93069306930693;93.0693069306931
35;0;"taraj";35;100;0
0;34;"taraja";34;0;100
0;25;"tarajah";25;0;100
0;7;"tarajai";7;0;100
0;18;"tarajee";18;0;100
0;6;"tarajhi";6;0;100
50;2254;"taraji";2304;2.17013888888889;97.8298611111111
0;36;"tarajii";36;0;100
28;0;"tarak";28;100;0
0;207;"taralee";207;0;100
0;681;"taralyn";681;0;100
0;418;"taralynn";418;0;100
0;36;"taramarie";36;0;100
1777;560;"taran";2337;76.0376551133932;23.9623448866068
0;31;"tarana";31;0;100
219;0;"tarance";219;100;0
0;11;"taranda";11;0;100
0;110;"taraneh";110;0;100
0;6;"taraneka";6;0;100
0;21;"taranika";21;0;100
0;5;"taranique";5;0;100
0;6;"taranisha";6;0;100
0;40;"taraoluwa";40;0;100
627;0;"taras";627;100;0
0;28;"tarasa";28;0;100
0;52;"tarasha";52;0;100
17;0;"taraus";17;100;0
92;0;"taray";92;100;0
0;122;"taraya";122;0;100
0;17;"tarcha";17;0;100
0;5;"tarcia";5;0;100
0;79;"tarea";79;0;100
5;16;"taree";21;23.8095238095238;76.1904761904762
85;0;"tareek";85;100;0
0;6;"tareena";6;0;100
0;5;"tareia";5;0;100
1963;0;"tarek";1963;100;0
0;74;"tareka";74;0;100
18;0;"tarel";18;100;0
831;0;"tarell";831;100;0
23;0;"tarelle";23;100;0
454;1162;"taren";1616;28.0940594059406;71.9059405940594
0;153;"tarena";153;0;100
537;0;"tarence";537;100;0
316;0;"tareq";316;100;0
0;432;"taresa";432;0;100
0;32;"taresha";32;0;100
0;362;"taressa";362;0;100
0;85;"tareva";85;0;100
0;5;"tareyn";5;0;100
100;0;"tarez";100;100;0
0;5;"tarha";5;0;100
0;94;"tarhonda";94;0;100
46;2244;"tari";2290;2.00873362445415;97.9912663755458
26;679;"taria";705;3.68794326241135;96.3120567375886
0;559;"tariah";559;0;100
26;0;"tarian";26;100;0
0;165;"tariana";165;0;100
0;50;"tarianna";50;0;100
5;0;"taric";5;100;0
0;99;"tarica";99;0;100
147;0;"tarick";147;100;0
0;20;"tarie";20;0;100
17;0;"tariek";17;100;0
23;0;"tarif";23;100;0
115;0;"tarig";115;100;0
0;8;"tarijah";8;0;100
3807;11;"tarik";3818;99.7118910424306;0.288108957569408
0;380;"tarika";380;0;100
315;881;"tarin";1196;26.3377926421405;73.6622073578595
0;803;"tarina";803;0;100
0;109;"tarini";109;0;100
7;0;"tario";7;100;0
43;0;"tarion";43;100;0
5670;7;"tariq";5677;99.8766954377312;0.123304562268804
324;0;"tarique";324;100;0
122;41;"taris";163;74.8466257668712;25.1533742331288
0;90;"tarisa";90;0;100
0;237;"tarisha";237;0;100
0;247;"tarissa";247;0;100
0;363;"tarita";363;0;100
0;5;"taritha";5;0;100
226;0;"tarius";226;100;0
0;136;"tariya";136;0;100
0;454;"tariyah";454;0;100
0;11;"tarja";11;0;100
0;46;"tarji";46;0;100
11;0;"tarkan";11;100;0
0;7;"tarkesha";7;0;100
0;5;"tarkeshia";5;0;100
0;5;"tarkisha";5;0;100
166;0;"tarl";166;100;0
0;56;"tarla";56;0;100
0;11;"tarlisha";11;0;100
10;0;"tarlton";10;100;0
0;31;"tarmara";31;0;100
0;29;"tarna";29;0;100
0;5;"tarneisha";5;0;100
6;0;"tarnell";6;100;0
0;112;"tarnesha";112;0;100
0;21;"tarneshia";21;0;100
0;397;"tarnisha";397;0;100
0;5;"tarnya";5;0;100
342;0;"taro";342;100;0
0;16;"tarolyn";16;0;100
2345;90;"taron";2435;96.3039014373717;3.69609856262834
0;175;"taronda";175;0;100
46;0;"tarone";46;100;0
0;6;"taronica";6;0;100
0;5;"taronza";5;0;100
66;0;"tarquin";66;100;0
0;2288;"tarra";2288;0;100
0;1074;"tarrah";1074;0;100
0;5;"tarralyn";5;0;100
37;39;"tarran";76;48.6842105263158;51.3157894736842
881;0;"tarrance";881;100;0
44;0;"tarrant";44;100;0
49;0;"tarrel";49;100;0
759;11;"tarrell";770;98.5714285714286;1.42857142857143
423;230;"tarren";653;64.7779479326187;35.2220520673813
780;0;"tarrence";780;100;0
0;280;"tarri";280;0;100
0;16;"tarria";16;0;100
36;0;"tarrick";36;100;0
5;104;"tarrie";109;4.58715596330275;95.4128440366973
6;0;"tarrik";6;100;0
113;97;"tarrin";210;53.8095238095238;46.1904761904762
92;0;"tarris";92;100;0
5;0;"tarrius";5;100;0
5;0;"tarrod";5;100;0
402;20;"tarron";422;95.260663507109;4.739336492891
12;0;"tarrus";12;100;0
430;189;"tarry";619;69.4668820678514;30.5331179321486
10;0;"tarryl";10;100;0
10;737;"tarryn";747;1.33868808567604;98.661311914324
0;2375;"tarsha";2375;0;100
0;5;"tarsheka";5;0;100
0;123;"tarshia";123;0;100
0;5;"tarteel";5;0;100
777;0;"tarun";777;100;0
534;0;"tarus";534;100;0
66;0;"tarvares";66;100;0
107;0;"tarvaris";107;100;0
20;0;"tarvarus";20;100;0
10;0;"tarver";10;100;0
5;0;"tarvin";5;100;0
401;0;"tarvis";401;100;0
57;30;"tary";87;65.5172413793103;34.4827586206897
0;43;"tarya";43;0;100
0;52;"taryah";52;0;100
0;30;"taryiah";30;0;100
5;0;"taryl";5;100;0
60;0;"taryll";60;100;0
661;24700;"taryn";25361;2.60636410236189;97.3936358976381
0;133;"taryne";133;0;100
0;512;"tarynn";512;0;100
5;0;"tarzan";5;100;0
0;42;"tasa";42;0;100
0;48;"tasanee";48;0;100
0;5;"tasani";5;0;100
0;205;"tascha";205;0;100
241;5;"tasean";246;97.9674796747967;2.03252032520325
133;0;"taseen";133;100;0
0;131;"tasfia";131;0;100
15;15;"tash";30;50;50
106;35374;"tasha";35480;0.298759864712514;99.7012401352875
16;0;"tashad";16;100;0
0;345;"tashae";345;0;100
0;71;"tashai";71;0;100
0;77;"tashala";77;0;100
0;5;"tashalee";5;0;100
123;10;"tashan";133;92.4812030075188;7.5187969924812
0;846;"tashana";846;0;100
0;13;"tashanae";13;0;100
0;209;"tashanda";209;0;100
0;16;"tashani";16;0;100
0;5;"tashanika";5;0;100
0;28;"tashanique";28;0;100
0;438;"tashanna";438;0;100
0;5;"tashante";5;0;100
0;115;"tashanti";115;0;100
0;1147;"tashara";1147;0;100
6;0;"tashard";6;100;0
0;78;"tashari";78;0;100
0;34;"tasharia";34;0;100
0;78;"tasharra";78;0;100
643;36;"tashaun";679;94.6980854197349;5.3019145802651
0;563;"tashauna";563;0;100
0;19;"tashaunda";19;0;100
0;5;"tashaunti";5;0;100
1422;273;"tashawn";1695;83.8938053097345;16.1061946902655
0;899;"tashawna";899;0;100
0;57;"tashawnda";57;0;100
0;15;"tashawnna";15;0;100
0;536;"tashay";536;0;100
0;84;"tashaya";84;0;100
0;11;"tashaye";11;0;100
0;432;"tashayla";432;0;100
0;98;"tashe";98;0;100
0;266;"tashea";266;0;100
0;50;"tasheana";50;0;100
0;25;"tasheanna";25;0;100
0;184;"tasheba";184;0;100
0;30;"tashee";30;0;100
0;5;"tasheeka";5;0;100
119;0;"tasheem";119;100;0
0;126;"tasheema";126;0;100
0;45;"tasheen";45;0;100
0;838;"tasheena";838;0;100
0;21;"tasheia";21;0;100
0;151;"tasheika";151;0;100
0;408;"tasheka";408;0;100
0;22;"tashekia";22;0;100
0;5;"tashel";5;0;100
0;55;"tashell";55;0;100
0;43;"tashelle";43;0;100
0;255;"tashema";255;0;100
0;332;"tashena";332;0;100
0;27;"tashenna";27;0;100
0;6;"tasheona";6;0;100
0;121;"tashera";121;0;100
0;6;"tasheria";6;0;100
0;7;"tasherra";7;0;100
0;5;"tasheyana";5;0;100
0;5;"tashfia";5;0;100
73;421;"tashi";494;14.7773279352227;85.2226720647773
0;2359;"tashia";2359;0;100
0;479;"tashiana";479;0;100
0;171;"tashianna";171;0;100
0;138;"tashiba";138;0;100
0;101;"tashica";101;0;100
0;16;"tashie";16;0;100
0;35;"tashieka";35;0;100
6;0;"tashiem";6;100;0
0;569;"tashika";569;0;100
0;347;"tashima";347;0;100
0;1758;"tashina";1758;0;100
0;5;"tashiona";5;0;100
0;5;"tashionna";5;0;100
0;366;"tashira";366;0;100
0;99;"tashiya";99;0;100
0;23;"tashiyah";23;0;100
0;5;"tashiyana";5;0;100
0;6;"tashma";6;0;100
320;15;"tashon";335;95.5223880597015;4.47761194029851
0;188;"tashona";188;0;100
0;386;"tashonda";386;0;100
0;153;"tashonna";153;0;100
0;47;"tashua";47;0;100
57;0;"tashun";57;100;0
0;25;"tashuna";25;0;100
0;58;"tashunda";58;0;100
0;48;"tashvi";48;0;100
0;85;"tashya";85;0;100
0;8;"tashyah";8;0;100
0;10;"tashyana";10;0;100
0;30;"tashyia";30;0;100
0;10;"tashyla";10;0;100
0;163;"tashyra";163;0;100
16;41;"tasi";57;28.0701754385965;71.9298245614035
0;4054;"tasia";4054;0;100
0;19;"tasiah";19;0;100
0;38;"tasiana";38;0;100
0;5;"tasina";5;0;100
7;0;"tasir";7;100;0
0;8;"tasiya";8;0;100
0;22;"tasiyah";22;0;100
0;39;"tasja";39;0;100
0;24;"taska";24;0;100
20;0;"tasker";20;100;0
6;0;"taskin";6;100;0
0;5;"taslin";5;0;100
0;5;"tasma";5;0;100
38;0;"tasman";38;100;0
0;73;"tasmia";73;0;100
0;52;"tasmin";52;0;100
0;69;"tasmine";69;0;100
0;1067;"tasneem";1067;0;100
0;187;"tasnia";187;0;100
10;544;"tasnim";554;1.80505415162455;98.1949458483755
40;0;"tason";40;100;0
6;0;"tasos";6;100;0
0;6;"tassa";6;0;100
0;15;"tassia";15;0;100
0;375;"tassie";375;0;100
0;27;"tassy";27;0;100
0;54;"tasya";54;0;100
0;138;"tata";138;0;100
0;7;"tatania";7;0;100
0;586;"tatanisha";586;0;100
0;5;"tatanishia";5;0;100
0;25;"tatanya";25;0;100
0;24;"tatasha";24;0;100
0;210;"tatayana";210;0;100
0;23;"tatayanna";23;0;100
16521;964;"tate";17485;94.4867028881899;5.51329711181012
0;39;"tateana";39;0;100
0;74;"tateanna";74;0;100
0;76;"tatelyn";76;0;100
0;15;"tatelynn";15;0;100
210;293;"tatem";503;41.7495029821074;58.2504970178926
477;0;"taten";477;100;0
27;25;"tateum";52;51.9230769230769;48.0769230769231
0;6;"tatevik";6;0;100
0;59;"tateyana";59;0;100
6;0;"tathan";6;100;0
0;26;"tathiana";26;0;100
0;628;"tatia";628;0;100
35;32762;"tatiana";32797;0.106717077781504;99.8932829222185
0;41;"tatianah";41;0;100
0;17;"tatiania";17;0;100
0;5369;"tatianna";5369;0;100
0;11;"tatiannah";11;0;100
0;32;"tatianya";32;0;100
0;10;"tatiara";10;0;100
0;18;"tatiauna";18;0;100
0;5;"tatiayana";5;0;100
0;68;"tatijana";68;0;100
0;21;"tatina";21;0;100
0;157;"tationa";157;0;100
0;152;"tationna";152;0;100
0;61;"tatisha";61;0;100
0;2102;"tatiyana";2102;0;100
0;11;"tatiyanah";11;0;100
0;495;"tatiyanna";495;0;100
0;11;"tatiyona";11;0;100
0;5;"tatiyonna";5;0;100
0;418;"tatjana";418;0;100
0;5;"tatom";5;0;100
15;0;"taton";15;100;0
0;5;"tatrina";5;0;100
0;5;"tatsiana";5;0;100
5;0;"tatsu";5;100;0
0;14;"tatsue";14;0;100
6;0;"tatsuki";6;100;0
0;39;"tatsuko";39;0;100
39;0;"tatsumi";39;100;0
222;0;"tatsuo";222;100;0
5;0;"tatsuro";5;100;0
104;0;"tatsuya";104;100;0
0;176;"tattiana";176;0;100
0;83;"tattianna";83;0;100
5;0;"tatton";5;100;0
0;6;"tattyana";6;0;100
4057;18599;"tatum";22656;17.9069562146893;82.0930437853107
5;299;"tatumn";304;1.64473684210526;98.3552631578947
0;10061;"tatyana";10061;0;100
0;51;"tatyanah";51;0;100
0;37;"tatyania";37;0;100
0;1944;"tatyanna";1944;0;100
0;47;"tatyiana";47;0;100
5;220;"tatym";225;2.22222222222222;97.7777777777778
0;36;"tatyona";36;0;100
0;20;"tatyonna";20;0;100
23;0;"tau";23;100;0
80;0;"tauheed";80;100;0
0;160;"tauheedah";160;0;100
5;0;"tauhid";5;100;0
0;6;"tauja";6;0;100
0;5;"taumi";5;0;100
0;647;"tauna";647;0;100
0;6;"taunda";6;0;100
0;37;"taundra";37;0;100
0;296;"tauni";296;0;100
0;264;"taunia";264;0;100
0;5;"taunie";5;0;100
0;90;"taunja";90;0;100
160;0;"tauno";160;100;0
0;1484;"taunya";1484;0;100
0;433;"taura";433;0;100
5;0;"taurance";5;100;0
10;0;"tauras";10;100;0
0;5;"taurasi";5;0;100
2137;45;"taurean";2182;97.9376718606783;2.06232813932172
68;8;"tauren";76;89.4736842105263;10.5263157894737
27;0;"taurence";27;100;0
10;0;"taureon";10;100;0
0;71;"tauri";71;0;100
55;0;"taurian";55;100;0
39;0;"taurice";39;100;0
0;33;"taurie";33;0;100
0;90;"tauriel";90;0;100
29;0;"taurin";29;100;0
21;0;"taurino";21;100;0
25;0;"tauris";25;100;0
5;0;"taurius";5;100;0
1880;84;"taurus";1964;95.7230142566191;4.27698574338086
0;12;"tauryn";12;0;100
0;1369;"tausha";1369;0;100
0;5;"taushia";5;0;100
16;0;"tausif";16;100;0
0;7;"tautiana";7;0;100
0;442;"tava";442;0;100
5;0;"tavain";5;100;0
5;0;"tavalas";5;100;0
32;0;"tavan";32;100;0
0;14;"tavania";14;0;100
0;5;"tavanna";5;0;100
30;0;"tavante";30;100;0
29;0;"tavar";29;100;0
0;39;"tavara";39;0;100
132;0;"tavaras";132;100;0
38;0;"tavare";38;100;0
2823;23;"tavares";2846;99.1918482080113;0.808151791988756
22;0;"tavarez";22;100;0
68;0;"tavari";68;100;0
0;113;"tavaria";113;0;100
5;0;"tavarian";5;100;0
5;0;"tavario";5;100;0
107;0;"tavarion";107;100;0
175;0;"tavarious";175;100;0
2357;6;"tavaris";2363;99.7460854845535;0.253914515446466
670;0;"tavarius";670;100;0
28;0;"tavarous";28;100;0
8;0;"tavarres";8;100;0
16;0;"tavarris";16;100;0
950;0;"tavarus";950;100;0
109;0;"tavaughn";109;100;0
0;8;"tavaya";8;0;100
0;12;"taveah";12;0;100
5;0;"tavean";5;100;0
54;0;"taveion";54;100;0
1425;47;"taven";1472;96.8070652173913;3.1929347826087
662;0;"taveon";662;100;0
0;5;"tavera";5;0;100
10;0;"taveres";10;100;0
5;0;"tavern";5;100;0
0;12;"tavery";12;0;100
6;0;"taves";6;100;0
0;5;"tavette";5;0;100
0;5;"tavey";5;0;100
10;0;"taveyon";10;100;0
63;122;"tavi";185;34.0540540540541;65.945945945946
0;2365;"tavia";2365;0;100
0;14;"taviah";14;0;100
1837;0;"tavian";1837;100;0
0;113;"taviana";113;0;100
0;58;"tavianna";58;0;100
7;0;"tavias";7;100;0
0;61;"tavie";61;0;100
377;0;"tavien";377;100;0
48;0;"tavier";48;100;0
0;5;"tavifa";5;0;100
1663;23;"tavin";1686;98.6358244365362;1.36417556346382
133;0;"tavio";133;100;0
2667;13;"tavion";2680;99.5149253731343;0.485074626865672
0;22;"taviona";22;0;100
23;0;"tavione";23;100;0
0;78;"tavionna";78;0;100
148;0;"tavious";148;100;0
2125;6;"tavis";2131;99.7184420459878;0.281557954012201
593;5;"tavish";598;99.1638795986622;0.836120401337793
0;18;"tavishi";18;0;100
26;0;"tavist";26;100;0
127;34;"tavita";161;78.8819875776398;21.1180124223602
353;0;"tavius";353;100;0
10;0;"taviyon";10;100;0
0;6;"tavleen";6;0;100
10;0;"tavo";10;100;0
3779;78;"tavon";3857;97.9777028778844;2.02229712211563
0;10;"tavona";10;0;100
0;5;"tavonda";5;0;100
66;0;"tavone";66;100;0
5;0;"tavonn";5;100;0
0;111;"tavonna";111;0;100
16;5;"tavonne";21;76.1904761904762;23.8095238095238
12;0;"tavonta";12;100;0
5;0;"tavontae";5;100;0
131;0;"tavonte";131;100;0
0;6;"tavonya";6;0;100
5;0;"tavores";5;100;0
10;0;"tavorian";10;100;0
532;0;"tavoris";532;100;0
12;0;"tavorris";12;100;0
0;5;"tavy";5;0;100
146;12;"tavyn";158;92.4050632911392;7.59493670886076
31;0;"tavyon";31;100;0
10;0;"tawain";10;100;0
0;34;"tawaina";34;0;100
334;60;"tawan";394;84.7715736040609;15.2284263959391
0;6540;"tawana";6540;0;100
0;4058;"tawanda";4058;0;100
0;137;"tawania";137;0;100
0;5;"tawanica";5;0;100
0;5;"tawann";5;0;100
0;3874;"tawanna";3874;0;100
0;5;"tawanne";5;0;100
0;54;"tawanya";54;0;100
0;11;"tawasha";11;0;100
0;24;"tawatha";24;0;100
0;6;"tawauna";6;0;100
0;15;"tawayna";15;0;100
15;0;"tawayne";15;100;0
10;0;"tawfeeq";10;100;0
7;0;"tawfik";7;100;0
84;0;"tawfiq";84;100;0
5;0;"tawheed";5;100;0
34;0;"tawhid";34;100;0
0;5;"tawiana";5;0;100
32;270;"tawn";302;10.5960264900662;89.4039735099338
0;889;"tawna";889;0;100
0;5;"tawne";5;0;100
0;778;"tawnee";778;0;100
0;575;"tawney";575;0;100
0;1876;"tawni";1876;0;100
0;632;"tawnia";632;0;100
0;871;"tawnie";871;0;100
0;10;"tawnja";10;0;100
0;5;"tawnjai";5;0;100
0;22;"tawnni";22;0;100
0;4206;"tawny";4206;0;100
0;4943;"tawnya";4943;0;100
42;0;"tawon";42;100;0
0;78;"tawona";78;0;100
0;82;"tawonda";82;0;100
0;82;"tawonna";82;0;100
0;84;"tawsha";84;0;100
10;0;"tawsif";10;100;0
0;100;"tawyna";100;0;100
158;50;"tay";208;75.9615384615385;24.0384615384615
0;5422;"taya";5422;0;100
0;1167;"tayah";1167;0;100
0;731;"tayana";731;0;100
0;5;"tayani";5;0;100
0;474;"tayanna";474;0;100
72;13;"tayari";85;84.7058823529412;15.2941176470588
10;0;"tayber";10;100;0
5;0;"taybor";5;100;0
0;10;"taybree";10;0;100
5;0;"tayce";5;100;0
0;57;"taycee";57;0;100
16;0;"taycen";16;100;0
0;11;"taycie";11;0;100
16;0;"taydan";16;100;0
5;27;"tayde";32;15.625;84.375
24;105;"taydem";129;18.6046511627907;81.3953488372093
1889;150;"tayden";2039;92.6434526728789;7.35654732712114
22;0;"taydin";22;100;0
79;0;"taydon";79;100;0
0;31;"taydra";31;0;100
5;0;"taydum";5;100;0
524;43;"taye";567;92.4162257495591;7.58377425044092
0;5;"tayea";5;0;100
0;20;"tayeko";20;0;100
0;170;"tayelor";170;0;100
19;0;"tayem";19;100;0
36;65;"tayen";101;35.6435643564356;64.3564356435644
0;5;"tayesha";5;0;100
5;0;"tayeshawn";5;100;0
20;152;"taygan";172;11.6279069767442;88.3720930232558
145;186;"taygen";331;43.8066465256798;56.1933534743202
0;15;"tayha";15;0;100
0;5;"tayhlor";5;0;100
0;170;"tayia";170;0;100
0;39;"tayiah";39;0;100
0;5;"tayisha";5;0;100
0;163;"tayja";163;0;100
0;104;"tayjah";104;0;100
66;0;"tayjon";66;100;0
10;0;"tayjuan";10;100;0
0;4843;"tayla";4843;0;100
0;527;"taylah";527;0;100
643;275;"taylan";918;70.0435729847495;29.9564270152505
0;16;"taylani";16;0;100
27;2410;"taylar";2437;1.10791957324579;98.8920804267542
0;27;"taylea";27;0;100
0;5;"tayleah";5;0;100
0;1506;"taylee";1506;0;100
0;248;"tayleigh";248;0;100
1153;811;"taylen";1964;58.7067209775967;41.2932790224033
0;5;"taylene";5;0;100
0;5;"taylenn";5;0;100
2422;10871;"tayler";13293;18.2201158504476;81.7798841495524
0;50;"tayley";50;0;100
0;102;"tayli";102;0;100
0;86;"taylia";86;0;100
0;16;"tayliana";16;0;100
0;6;"taylianna";6;0;100
0;258;"taylie";258;0;100
393;1909;"taylin";2302;17.0721112076455;82.9278887923545
0;143;"taylinn";143;0;100
0;59;"taylir";59;0;100
0;131;"tayllor";131;0;100
0;12;"tayln";12;0;100
902;157;"taylon";1059;85.1746931067044;14.8253068932956
108743;315215;"taylor";423958;25.6494747121177;74.3505252878823
0;271;"taylorann";271;0;100
0;79;"tayloranne";79;0;100
0;671;"taylore";671;0;100
0;5;"taylorgrace";5;0;100
5;0;"taylorjames";5;100;0
0;11;"taylorjo";11;0;100
0;10;"taylorlynn";10;0;100
0;156;"taylormarie";156;0;100
0;22;"taylorrae";22;0;100
0;15;"taylorrose";15;0;100
29;467;"taylour";496;5.84677419354839;94.1532258064516
0;80;"taylr";80;0;100
0;60;"taylre";60;0;100
0;17;"taylur";17;0;100
17;642;"taylyn";659;2.57966616084977;97.4203338391502
0;836;"taylynn";836;0;100
169;0;"taym";169;100;0
0;12;"tayma";12;0;100
42;32;"taymar";74;56.7567567567568;43.2432432432432
16;0;"taymon";16;100;0
5;0;"taymour";5;100;0
6;0;"taymur";6;100;0
0;874;"tayna";874;0;100
11;5;"tayne";16;68.75;31.25
0;10;"taynia";10;0;100
89;0;"tayo";89;100;0
401;5;"tayon";406;98.7684729064039;1.23152709359606
0;149;"tayona";149;0;100
0;5;"tayonia";5;0;100
0;403;"tayonna";403;0;100
256;0;"tayquan";256;100;0
0;111;"tayra";111;0;100
196;0;"tayron";196;100;0
0;11;"tays";11;0;100
208;0;"taysean";208;100;0
30;0;"tayseer";30;100;0
159;0;"taysen";159;100;0
0;687;"taysha";687;0;100
1221;10;"tayshaun";1231;99.1876523151909;0.812347684809098
1178;0;"tayshawn";1178;100;0
0;10;"tayshawna";10;0;100
0;40;"tayshia";40;0;100
219;0;"tayshon";219;100;0
74;0;"tayshun";74;100;0
0;499;"taysia";499;0;100
17;0;"taysir";17;100;0
132;0;"taysom";132;100;0
675;0;"tayson";675;100;0
64;0;"tayt";64;100;0
401;107;"tayte";508;78.9370078740157;21.0629921259843
16;180;"taytem";196;8.16326530612245;91.8367346938776
489;76;"tayten";565;86.5486725663717;13.4513274336283
0;15;"taytiana";15;0;100
925;21;"tayton";946;97.7801268498943;2.21987315010571
225;1532;"taytum";1757;12.8059191804212;87.1940808195788
0;71;"tayva";71;0;100
5;0;"tayvan";5;100;0
11;0;"tayveion";11;100;0
514;37;"tayven";551;93.2849364791289;6.71506352087114
484;0;"tayveon";484;100;0
0;119;"tayvia";119;0;100
211;0;"tayvian";211;100;0
0;5;"tayvianna";5;0;100
66;0;"tayvien";66;100;0
342;19;"tayvin";361;94.7368421052632;5.26315789473684
992;0;"tayvion";992;100;0
0;5;"tayviona";5;0;100
6;0;"tayvione";6;100;0
0;5;"tayvionna";5;0;100
1261;0;"tayvon";1261;100;0
5;0;"tayvone";5;100;0
5;0;"tayvonne";5;100;0
39;0;"tayyab";39;100;0
0;5;"tayyaba";5;0;100
0;5;"tayyibah";5;0;100
5;0;"tayzen";5;100;0
0;20;"tayzha";20;0;100
0;23;"tayzia";23;0;100
0;25;"tayzlee";25;0;100
390;10;"taz";400;97.5;2.5
0;10;"tazanna";10;0;100
0;86;"tazaria";86;0;100
0;8;"tazariah";8;0;100
0;5;"tazaya";5;0;100
22;0;"taze";22;100;0
7;0;"tazeem";7;100;0
5;0;"tazewell";5;100;0
0;46;"tazhane";46;0;100
0;303;"tazia";303;0;100
0;65;"taziah";65;0;100
19;0;"tazio";19;100;0
11;0;"tazion";11;100;0
0;31;"taziya";31;0;100
12;104;"taziyah";116;10.3448275862069;89.6551724137931
0;6;"tazkia";6;0;100
0;6;"tazlyn";6;0;100
10;0;"tazman";10;100;0
0;17;"tazmeen";17;0;100
5;18;"tazmin";23;21.7391304347826;78.2608695652174
0;19;"tazuko";19;0;100
41;0;"tazz";41;100;0
64;0;"tc";64;100;0
8;0;"tchalla";8;100;0
0;5;"tchanavian";5;0;100
0;10;"te";10;0;100
0;2318;"tea";2318;0;100
0;10;"teadora";10;0;100
0;24;"teadra";24;0;100
0;12;"teaera";12;0;100
0;5;"teaerra";5;0;100
12;0;"teag";12;100;0
4395;17738;"teagan";22133;19.8572267654633;80.1427732345367
0;20;"teagann";20;0;100
11;0;"teage";11;100;0
601;610;"teagen";1211;49.6284062758051;50.3715937241949
64;791;"teaghan";855;7.48538011695906;92.5146198830409
0;18;"teaghen";18;0;100
15;26;"teagin";41;36.5853658536585;63.4146341463415
119;12;"teagon";131;90.8396946564885;9.16030534351145
1440;32;"teague";1472;97.8260869565217;2.17391304347826
54;0;"teagun";54;100;0
18;149;"teagyn";167;10.7784431137725;89.2215568862275
0;1359;"teah";1359;0;100
0;5;"teahna";5;0;100
0;1152;"teaira";1152;0;100
0;18;"teairah";18;0;100
0;15;"teaire";15;0;100
0;732;"teairra";732;0;100
0;5;"teaisha";5;0;100
0;33;"teaja";33;0;100
0;11;"teajah";11;0;100
42;0;"teak";42;100;0
0;15;"teaka";15;0;100
202;1430;"teal";1632;12.3774509803922;87.6225490196078
0;518;"teala";518;0;100
0;116;"teale";116;0;100
0;955;"teana";955;0;100
184;0;"teancum";184;100;0
0;309;"teandra";309;0;100
270;0;"teandre";270;100;0
0;33;"teandrea";33;0;100
0;5;"teandria";5;0;100
0;5;"teangela";5;0;100
0;17;"teani";17;0;100
0;5;"teanisha";5;0;100
0;5;"teann";5;0;100
0;2270;"teanna";2270;0;100
0;18;"teaona";18;0;100
0;14;"teaonna";14;0;100
0;10;"tear";10;0;100
0;1260;"teara";1260;0;100
0;63;"tearah";63;0;100
0;16;"tearesa";16;0;100
0;140;"tearia";140;0;100
17;0;"tearle";17;100;0
0;11;"tearney";11;0;100
0;753;"tearra";753;0;100
0;44;"tearria";44;0;100
0;203;"tearsa";203;0;100
0;30;"tearza";30;0;100
0;42;"teasa";42;0;100
0;665;"teasha";665;0;100
0;43;"teashia";43;0;100
0;678;"teasia";678;0;100
0;30;"teather";30;0;100
0;128;"teauna";128;0;100
0;18;"teaundra";18;0;100
0;31;"teaunna";31;0;100
0;47;"teaya";47;0;100
0;123;"tecia";123;0;100
0;152;"teckla";152;0;100
0;135;"tecla";135;0;100
9;0;"teco";9;100;0
0;6;"tecoa";6;0;100
0;5;"tecola";5;0;100
0;199;"tecora";199;0;100
64;0;"tecumseh";64;100;0
74368;264;"ted";74632;99.6462643370136;0.353735662986387
34;0;"tedarius";34;100;0
1262;0;"tedd";1262;100;0
0;1577;"teddi";1577;0;100
1424;914;"teddie";2338;60.9067579127459;39.0932420872541
0;6;"teddra";6;0;100
223;0;"teddrick";223;100;0
31979;1445;"teddy";33424;95.6767592149354;4.32324078506462
0;5;"teddye";5;0;100
11;0;"tederick";11;100;0
67;0;"tedford";67;100;0
0;420;"tedi";420;0;100
25;0;"tedman";25;100;0
0;822;"tedra";822;0;100
242;0;"tedric";242;100;0
698;0;"tedrick";698;100;0
0;6;"tedrina";6;0;100
5;0;"tedros";5;100;0
385;51;"tee";436;88.302752293578;11.697247706422
0;65;"teea";65;0;100
0;5;"teeana";5;0;100
0;11;"teeanna";11;0;100
0;11;"teeara";11;0;100
1252;1318;"teegan";2570;48.715953307393;51.284046692607
17;0;"teegen";17;100;0
0;92;"teeghan";92;0;100
7;0;"teegun";7;100;0
105;0;"teejay";105;100;0
0;15;"teeka";15;0;100
0;18;"teel";18;0;100
0;822;"teela";822;0;100
0;5746;"teena";5746;0;100
0;7;"teenamarie";7;0;100
0;5;"teenia";5;0;100
0;5;"teenie";5;0;100
0;51;"teera";51;0;100
0;44;"teerica";44;0;100
0;5;"teerra";5;0;100
0;11;"teesa";11;0;100
0;478;"teesha";478;0;100
0;32;"teeya";32;0;100
0;5;"teffani";5;0;100
0;6;"teffanie";6;0;100
0;253;"teffany";253;0;100
0;6;"tefta";6;0;100
1974;5310;"tegan";7284;27.1004942339374;72.8995057660626
32;5;"tegen";37;86.4864864864865;13.5135135135135
18;0;"tegh";18;100;0
49;290;"teghan";339;14.4542772861357;85.5457227138643
5;0;"teghveer";5;100;0
5;0;"tegon";5;100;0
0;24;"tegra";24;0;100
0;10;"teguila";10;0;100
0;5;"teha";5;0;100
0;6;"tehana";6;0;100
0;444;"tehani";444;0;100
0;5;"tehesha";5;0;100
0;579;"tehila";579;0;100
0;11;"tehilah";11;0;100
0;341;"tehilla";341;0;100
0;95;"tehillah";95;0;100
0;46;"tehra";46;0;100
119;5;"tehran";124;95.9677419354839;4.03225806451613
0;53;"tehreem";53;0;100
33;0;"tehron";33;100;0
0;1936;"tehya";1936;0;100
11;0;"tei";11;100;0
0;977;"teia";977;0;100
0;11;"teiah";11;0;100
0;69;"teiana";69;0;100
0;32;"teianna";32;0;100
0;121;"teiara";121;0;100
0;5;"teiarra";5;0;100
0;5;"teidra";5;0;100
12;0;"teig";12;100;0
374;661;"teigan";1035;36.1352657004831;63.8647342995169
66;0;"teige";66;100;0
211;146;"teigen";357;59.1036414565826;40.8963585434174
5;90;"teighan";95;5.26315789473684;94.7368421052632
0;268;"teighlor";268;0;100
0;19;"teija";19;0;100
0;6;"teijah";6;0;100
0;16;"teika";16;0;100
0;310;"teila";310;0;100
0;17;"teilor";17;0;100
5;0;"tein";5;100;0
0;30;"teina";30;0;100
124;0;"teion";124;100;0
0;44;"teiona";44;0;100
0;54;"teionna";54;0;100
0;292;"teira";292;0;100
0;7;"teirney";7;0;100
0;389;"teirra";389;0;100
0;22;"teisa";22;0;100
0;1240;"teisha";1240;0;100
0;16;"teiya";16;0;100
534;0;"tej";534;100;0
73;571;"teja";644;11.3354037267081;88.6645962732919
0;97;"tejah";97;0;100
0;299;"tejal";299;0;100
41;0;"tejan";41;100;0
1145;0;"tejas";1145;100;0
6;0;"tejash";6;100;0
0;90;"tejasvi";90;0;100
0;10;"tejaswini";10;0;100
14;0;"tejaun";14;100;0
162;0;"tejay";162;100;0
16;0;"tejean";16;100;0
167;0;"tejon";167;100;0
68;0;"tejuan";68;100;0
0;23;"tejuana";23;0;100
19;0;"tejus";19;100;0
16;0;"tejveer";16;100;0
0;236;"teka";236;0;100
0;22;"tekara";22;0;100
0;59;"tekayla";59;0;100
0;23;"tekeema";23;0;100
0;5;"tekeira";5;0;100
0;149;"tekeisha";149;0;100
0;121;"tekela";121;0;100
0;67;"tekelia";67;0;100
0;5;"tekenya";5;0;100
0;19;"tekera";19;0;100
0;23;"tekeria";23;0;100
0;222;"tekesha";222;0;100
0;103;"tekeshia";103;0;100
0;10;"teketa";10;0;100
0;117;"tekeya";117;0;100
0;89;"tekeyah";89;0;100
0;21;"tekeyla";21;0;100
16;0;"tekhi";16;100;0
0;377;"tekia";377;0;100
0;57;"tekila";57;0;100
0;57;"tekira";57;0;100
0;340;"tekisha";340;0;100
0;5;"tekita";5;0;100
0;5;"tekiya";5;0;100
0;27;"tekiyah";27;0;100
0;377;"tekla";377;0;100
11;0;"teko";11;100;0
73;150;"tekoa";223;32.7354260089686;67.2645739910314
0;12;"tekoah";12;0;100
5;0;"tekulve";5;100;0
0;5;"tekyra";5;0;100
162;0;"tel";162;100;0
7;679;"tela";686;1.02040816326531;98.9795918367347
0;33;"telah";33;0;100
0;22;"telana";22;0;100
0;5;"telaya";5;0;100
0;5;"telaysia";5;0;100
0;129;"teleah";129;0;100
0;200;"telecia";200;0;100
0;304;"telena";304;0;100
0;108;"telesa";108;0;100
28;0;"telesfor";28;100;0
0;10;"telesfora";10;0;100
251;0;"telesforo";251;100;0
0;120;"telesha";120;0;100
0;54;"teleshia";54;0;100
0;95;"telesia";95;0;100
5;0;"telesphore";5;100;0
0;86;"teletha";86;0;100
0;18;"telethia";18;0;100
348;0;"telford";348;100;0
0;672;"telia";672;0;100
0;74;"teliah";74;0;100
0;5;"telica";5;0;100
0;489;"telicia";489;0;100
0;9;"teliea";9;0;100
0;281;"telina";281;0;100
5;0;"telio";5;100;0
0;1097;"telisa";1097;0;100
0;5;"telise";5;0;100
0;1182;"telisha";1182;0;100
0;6;"telishia";6;0;100
0;118;"telissa";118;0;100
0;194;"telitha";194;0;100
0;174;"teliyah";174;0;100
168;0;"tell";168;100;0
0;44;"tella";44;0;100
46;0;"tellas";46;100;0
42;0;"teller";42;100;0
45;0;"telley";45;100;0
0;11;"telli";11;0;100
5;52;"tellie";57;8.7719298245614;91.2280701754386
285;0;"tellis";285;100;0
1497;82;"telly";1579;94.8068397720076;5.1931602279924
7;0;"tellys";7;100;0
0;255;"telma";255;0;100
0;11;"telor";11;0;100
0;74;"telsa";74;0;100
0;5;"telsha";5;0;100
542;0;"telvin";542;100;0
21;0;"telvis";21;100;0
0;151;"tema";151;0;100
0;31;"temaka";31;0;100
5;0;"teman";5;100;0
10;10;"temani";20;50;50
13;0;"temar";13;100;0
0;61;"temara";61;0;100
8;0;"temarcus";8;100;0
5;63;"temari";68;7.35294117647059;92.6470588235294
0;7;"temaria";7;0;100
22;0;"temarion";22;100;0
0;21;"tember";21;0;100
0;93;"temeca";93;0;100
0;6;"temecia";6;0;100
0;7;"temecka";7;0;100
0;5;"temeeka";5;0;100
0;54;"temeika";54;0;100
5;1414;"temeka";1419;0.352360817477097;99.6476391825229
0;259;"temekia";259;0;100
0;5;"temeko";5;0;100
0;31;"temera";31;0;100
0;5;"temesa";5;0;100
50;0;"temesgen";50;100;0
0;131;"temesha";131;0;100
0;38;"temeshia";38;0;100
0;5;"temetria";5;0;100
0;5;"temetrius";5;0;100
0;10;"temi";10;0;100
0;164;"temia";164;0;100
0;150;"temica";150;0;100
0;19;"temicka";19;0;100
44;15;"temidayo";59;74.5762711864407;25.4237288135593
0;911;"temika";911;0;100
0;7;"temikia";7;0;100
0;17;"temiko";17;0;100
0;7;"temilade";7;0;100
0;6;"temilayo";6;0;100
0;31;"temilola";31;0;100
109;181;"temiloluwa";290;37.5862068965517;62.4137931034483
0;186;"temima";186;0;100
0;11;"temira";11;0;100
0;104;"temisha";104;0;100
71;39;"temitayo";110;64.5454545454545;35.4545454545455
118;240;"temitope";358;32.9608938547486;67.0391061452514
0;5;"temkia";5;0;100
0;7;"temmy";7;0;100
5;0;"temon";5;100;0
0;51;"tempa";51;0;100
0;44;"tempe";44;0;100
0;2507;"temperance";2507;0;100
0;72;"temperence";72;0;100
0;11;"tempess";11;0;100
0;5;"tempesst";5;0;100
0;1168;"tempest";1168;0;100
0;643;"tempestt";643;0;100
0;1405;"tempie";1405;0;100
794;1432;"temple";2226;35.6693620844564;64.3306379155436
11;0;"templeton";11;100;0
0;140;"temprance";140;0;100
0;105;"temprence";105;0;100
0;18;"tempress";18;0;100
0;5;"temprince";5;0;100
0;10;"temprynce";10;0;100
0;5;"tempsett";5;0;100
0;30;"tempy";30;0;100
0;13;"temre";13;0;100
6;0;"temuge";6;100;0
52;0;"temujin";52;100;0
41;0;"temur";41;100;0
5;0;"temuujin";5;100;0
7;0;"temuulen";7;100;0
0;38;"temya";38;0;100
0;7412;"tena";7412;0;100
0;136;"tenae";136;0;100
0;43;"tenaj";43;0;100
0;29;"tenaja";29;0;100
0;11;"tenajah";11;0;100
0;5;"tenara";5;0;100
0;24;"tenasha";24;0;100
0;79;"tenasia";79;0;100
0;44;"tenay";44;0;100
0;912;"tenaya";912;0;100
0;5;"tenayah";5;0;100
5;0;"tench";5;100;0
10;0;"tenchi";10;100;0
0;5;"tency";5;0;100
5;0;"tendai";5;100;0
0;5;"tendra";5;0;100
0;5;"tendria";5;0;100
0;324;"tene";324;0;100
0;168;"tenea";168;0;100
0;39;"teneal";39;0;100
0;5;"teneasha";5;0;100
0;5;"teneca";5;0;100
0;301;"tenecia";301;0;100
0;91;"tenee";91;0;100
0;5;"teneeka";5;0;100
0;5;"teneesha";5;0;100
0;29;"teneeshia";29;0;100
0;6;"teneha";6;0;100
0;5;"teneia";5;0;100
0;19;"teneika";19;0;100
0;73;"teneil";73;0;100
0;5;"teneile";5;0;100
0;50;"teneille";50;0;100
0;430;"teneisha";430;0;100
0;508;"teneka";508;0;100
0;5;"teneke";5;0;100
0;7;"tenell";7;0;100
0;67;"tenelle";67;0;100
0;34;"tenequa";34;0;100
0;46;"tenesa";46;0;100
0;1438;"tenesha";1438;0;100
0;558;"teneshia";558;0;100
0;169;"tenesia";169;0;100
0;74;"tenessa";74;0;100
0;44;"teneya";44;0;100
354;0;"teng";354;100;0
5;0;"tengis";5;100;0
0;6;"teni";6;0;100
0;975;"tenia";975;0;100
0;34;"teniah";34;0;100
0;37;"tenica";37;0;100
0;6;"tenice";6;0;100
0;5;"tenicha";5;0;100
0;139;"tenicia";139;0;100
0;11;"tenicka";11;0;100
0;5;"tenie";5;0;100
0;5;"teniel";5;0;100
0;24;"tenielle";24;0;100
0;49;"teniesha";49;0;100
0;5;"tenijah";5;0;100
0;1029;"tenika";1029;0;100
0;25;"tenile";25;0;100
0;955;"tenille";955;0;100
0;7;"tenina";7;0;100
5;112;"teniola";117;4.27350427350427;95.7264957264957
0;125;"teniqua";125;0;100
0;19;"tenisa";19;0;100
0;301;"tenise";301;0;100
0;3501;"tenisha";3501;0;100
0;137;"tenishia";137;0;100
0;219;"tenita";219;0;100
0;226;"teniya";226;0;100
0;179;"teniyah";179;0;100
0;218;"tenlee";218;0;100
0;175;"tenleigh";175;0;100
0;4952;"tenley";4952;0;100
0;32;"tenli";32;0;100
0;20;"tenlie";20;0;100
0;27;"tenly";27;0;100
0;559;"tenna";559;0;100
0;10;"tennasyn";10;0;100
0;8;"tenneal";8;0;100
0;5;"tenneh";5;0;100
0;12;"tenneil";12;0;100
0;5;"tenneill";5;0;100
0;5;"tenneille";5;0;100
5;13;"tennell";18;27.7777777777778;72.2222222222222
0;64;"tennelle";64;0;100
0;15;"tenner";15;0;100
0;6;"tennesha";6;0;100
0;5;"tennesia";5;0;100
216;597;"tennessee";813;26.5682656826568;73.4317343173432
0;36;"tennia";36;0;100
19;2087;"tennie";2106;0.902184235517569;99.0978157644824
0;11;"tenniel";11;0;100
0;13;"tennielle";13;0;100
0;132;"tennile";132;0;100
0;5;"tennill";5;0;100
15;2172;"tennille";2187;0.685871056241427;99.3141289437586
0;7;"tennillie";7;0;100
202;0;"tennis";202;100;0
0;44;"tennisha";44;0;100
17;7;"tennison";24;70.8333333333333;29.1666666666667
0;40;"tennley";40;0;100
31;39;"tenny";70;44.2857142857143;55.7142857142857
898;230;"tennyson";1128;79.6099290780142;20.3900709219858
174;0;"tenoch";174;100;0
25;0;"tenor";25;100;0
0;5;"tenora";5;0;100
0;15;"tensie";15;0;100
0;5;"tenslee";5;0;100
0;155;"tensley";155;0;100
16;0;"tenuun";16;100;0
0;10;"teny";10;0;100
0;82;"tenya";82;0;100
0;6;"tenyah";6;0;100
0;5;"tenyce";5;0;100
0;7;"tenyia";7;0;100
1074;812;"tenzin";1886;56.9459172852598;43.0540827147402
59;16;"tenzing";75;78.6666666666667;21.3333333333333
0;6;"tenzley";6;0;100
1132;0;"teo";1132;100;0
168;0;"teodor";168;100;0
0;1141;"teodora";1141;0;100
3004;0;"teodoro";3004;100;0
48;0;"teodulo";48;100;0
68;0;"teofil";68;100;0
0;80;"teofila";80;0;100
994;0;"teofilo";994;100;0
0;198;"teola";198;0;100
50;0;"teoman";50;100;0
920;15;"teon";935;98.3957219251337;1.60427807486631
0;869;"teona";869;0;100
0;115;"teondra";115;0;100
66;0;"teondre";66;100;0
0;15;"teoni";15;0;100
0;104;"teonia";104;0;100
0;1088;"teonna";1088;0;100
0;5;"teonni";5;0;100
8;0;"teontae";8;100;0
15;0;"teonte";15;100;0
0;119;"teosha";119;0;100
0;11;"teoshia";11;0;100
0;5;"tepanga";5;0;100
0;135;"tephanie";135;0;100
11;0;"tephen";11;100;0
5;0;"teppei";5;100;0
396;0;"tequan";396;100;0
0;5;"tequana";5;0;100
7;0;"tequarius";7;100;0
0;5;"tequela";5;0;100
0;5;"tequella";5;0;100
0;17;"tequesta";17;0;100
0;68;"tequia";68;0;100
0;2134;"tequila";2134;0;100
0;6;"tequilia";6;0;100
0;840;"tequilla";840;0;100
0;5;"tequira";5;0;100
0;90;"tequisha";90;0;100
0;150;"tequita";150;0;100
0;71;"tequlia";71;0;100
0;11;"tequoia";11;0;100
0;9794;"tera";9794;0;100
5;5;"terae";10;50;50
43;1363;"terah";1406;3.05832147937411;96.9416785206259
0;47;"teraji";47;0;100
5;0;"teral";5;100;0
62;0;"terald";62;100;0
0;5;"teralee";5;0;100
0;220;"teralyn";220;0;100
0;16;"teralynn";16;0;100
355;185;"teran";540;65.7407407407407;34.2592592592593
2787;0;"terance";2787;100;0
0;5;"terani";5;0;100
0;6;"teranique";6;0;100
0;367;"terasa";367;0;100
0;10;"terase";10;0;100
0;13;"terasha";13;0;100
17;0;"teray";17;100;0
12;0;"tercel";12;100;0
13;0;"terdell";13;100;0
6;385;"tere";391;1.53452685421995;98.4654731457801
0;195;"terea";195;0;100
12;0;"tereance";12;100;0
0;20;"tereas";20;0;100
0;1415;"tereasa";1415;0;100
0;66;"terease";66;0;100
0;28;"tereatha";28;0;100
0;16;"tereca";16;0;100
0;11;"terece";11;0;100
0;91;"terecia";91;0;100
0;43;"terecita";43;0;100
0;29;"teree";29;0;100
267;0;"terek";267;100;0
0;107;"tereka";107;0;100
145;0;"terel";145;100;0
2585;38;"terell";2623;98.5512771635532;1.44872283644682
352;5;"terelle";357;98.5994397759104;1.40056022408964
5;0;"teremy";5;100;0
122;57;"teren";179;68.1564245810056;31.8435754189944
0;565;"terena";565;0;100
33726;170;"terence";33896;99.4984658956809;0.501534104319094
0;10;"terene";10;0;100
0;15;"terenia";15;0;100
0;5;"terenna";5;0;100
5;0;"tereon";5;100;0
0;45;"teres";45;0;100
1164;410575;"teresa";411739;0.282703363052808;99.7172966369472
0;5;"teresaann";5;0;100
0;6469;"terese";6469;0;100
0;460;"teresea";460;0;100
0;150;"teresha";150;0;100
0;1133;"teresia";1133;0;100
0;163;"teresina";163;0;100
0;3246;"teresita";3246;0;100
0;17;"tereska";17;0;100
140;0;"tereso";140;100;0
0;6443;"teressa";6443;0;100
0;39;"teressia";39;0;100
0;665;"teretha";665;0;100
0;11;"tereva";11;0;100
386;146;"terez";532;72.5563909774436;27.4436090225564
0;720;"tereza";720;0;100
214;43899;"teri";44113;0.485117765737991;99.514882234262
0;582;"teria";582;0;100
0;70;"teriah";70;0;100
0;240;"teriana";240;0;100
0;176;"teriann";176;0;100
0;92;"terianna";92;0;100
0;69;"terianne";69;0;100
54;0;"teric";54;100;0
0;1033;"terica";1033;0;100
0;16;"terice";16;0;100
50;0;"terick";50;100;0
0;151;"tericka";151;0;100
5;0;"terico";5;100;0
0;355;"terie";355;0;100
114;0;"terik";114;100;0
0;637;"terika";637;0;100
0;28;"terilee";28;0;100
0;622;"terilyn";622;0;100
0;120;"terilynn";120;0;100
181;343;"terin";524;34.5419847328244;65.4580152671756
0;1148;"terina";1148;0;100
219;0;"terion";219;100;0
0;31;"teriona";31;0;100
0;20;"terionna";20;0;100
59;0;"teriq";59;100;0
68;0;"terique";68;100;0
5;0;"teris";5;100;0
0;1030;"terisa";1030;0;100
0;28;"terise";28;0;100
0;155;"terisha";155;0;100
0;239;"terissa";239;0;100
0;96;"terita";96;0;100
87;0;"terius";87;100;0
0;6;"teriya";6;0;100
0;68;"teriyah";68;0;100
0;6;"teriyana";6;0;100
11;0;"termain";11;100;0
672;13;"termaine";685;98.1021897810219;1.8978102189781
10;0;"termayne";10;100;0
5;0;"termell";5;100;0
5;0;"ternell";5;100;0
0;12;"ternesha";12;0;100
0;28;"ternisha";28;0;100
945;0;"teron";945;100;0
0;19;"teronda";19;0;100
40;0;"terone";40;100;0
0;23;"teronica";23;0;100
5;0;"terr";5;100;0
5;14686;"terra";14691;0.0340344428561704;99.9659655571438
714;107;"terrace";821;86.9671132764921;13.0328867235079
0;10;"terrae";10;0;100
0;653;"terrah";653;0;100
40;0;"terrail";40;100;0
5;0;"terrain";5;100;0
5;5;"terraine";10;50;50
586;20;"terral";606;96.6996699669967;3.3003300330033
130;0;"terrall";130;100;0
0;117;"terralyn";117;0;100
0;5;"terralynn";5;0;100
1353;554;"terran";1907;70.9491347666492;29.0508652333508
6;0;"terranc";6;100;0
68314;750;"terrance";69064;98.9140507355496;1.08594926445036
5;0;"terrane";5;100;0
0;5;"terraneisha";5;0;100
0;6;"terranesha";6;0;100
0;16;"terranisha";16;0;100
11;0;"terray";11;100;0
0;5;"terrayne";5;0;100
99;838;"terre";937;10.5656350053362;89.4343649946638
0;92;"terrea";92;0;100
5;0;"terreal";5;100;0
54;0;"terreance";54;100;0
0;100;"terree";100;0;100
0;12;"terreka";12;0;100
2893;81;"terrel";2974;97.2763954270343;2.7236045729657
34978;1585;"terrell";36563;95.6650165467823;4.33498345321773
568;34;"terrelle";602;94.3521594684385;5.64784053156146
520;169;"terren";689;75.4716981132076;24.5283018867925
0;53;"terrena";53;0;100
70818;527;"terrence";71345;99.2613357628425;0.738664237157474
0;25;"terrencia";25;0;100
95;0;"terreon";95;100;0
0;1571;"terresa";1571;0;100
0;12;"terresha";12;0;100
0;5;"terresia";5;0;100
0;401;"terressa";401;0;100
161;0;"terrez";161;100;0
916;145819;"terri";146735;0.624254608648243;99.3757453913518
0;1059;"terria";1059;0;100
0;135;"terriah";135;0;100
28;0;"terrial";28;100;0
261;119;"terrian";380;68.6842105263158;31.3157894736842
0;602;"terriana";602;0;100
24;0;"terriance";24;100;0
0;505;"terriann";505;0;100
0;361;"terrianna";361;0;100
0;227;"terrianne";227;0;100
0;10;"terriauna";10;0;100
36;0;"terric";36;100;0
0;1406;"terrica";1406;0;100
15;15;"terrice";30;50;50
0;5;"terricia";5;0;100
818;0;"terrick";818;100;0
0;210;"terricka";210;0;100
35;0;"terrico";35;100;0
338;19710;"terrie";20048;1.68595371109338;98.3140462889066
5;0;"terriek";5;100;0
32;5;"terriel";37;86.4864864864865;13.5135135135135
5;0;"terriell";5;100;0
0;17;"terrielle";17;0;100
0;11;"terrijo";11;0;100
29;0;"terrik";29;100;0
0;570;"terrika";570;0;100
512;83;"terril";595;86.0504201680672;13.9495798319328
0;154;"terrilee";154;0;100
4277;714;"terrill";4991;85.6942496493689;14.3057503506311
0;930;"terrilyn";930;0;100
0;419;"terrilynn";419;0;100
0;5;"terrilynne";5;0;100
547;394;"terrin";941;58.1296493092455;41.8703506907545
0;420;"terrina";420;0;100
0;5;"terrineka";5;0;100
21;0;"terrio";21;100;0
1416;111;"terrion";1527;92.7308447937132;7.26915520628684
0;358;"terriona";358;0;100
0;240;"terrionna";240;0;100
9;0;"terriq";9;100;0
5;0;"terrique";5;100;0
829;143;"terris";972;85.2880658436214;14.7119341563786
0;287;"terrisa";287;0;100
0;130;"terrisha";130;0;100
12;0;"terriss";12;100;0
0;5;"terrissa";5;0;100
0;25;"territa";25;0;100
162;0;"terrius";162;100;0
0;12;"terriya";12;0;100
0;100;"terriyah";100;0;100
0;15;"terriyana";15;0;100
5;0;"terriyon";5;100;0
0;12;"terrlyn";12;0;100
16;0;"terrod";16;100;0
42;0;"terrol";42;100;0
0;5;"terrolyn";5;0;100
2371;32;"terron";2403;98.6683312526009;1.33166874739908
0;5;"terronda";5;0;100
6;0;"terrone";6;100;0
421992;96870;"terry";518862;81.3302959168334;18.6697040831666
0;15;"terryana";15;0;100
0;118;"terryann";118;0;100
0;5;"terryanna";5;0;100
0;485;"terrye";485;0;100
23;0;"terryion";23;100;0
740;717;"terryl";1457;50.7892930679478;49.2107069320522
0;8;"terrylea";8;0;100
10;30;"terrylee";40;25;75
0;33;"terrylynn";33;0;100
186;507;"terryn";693;26.8398268398268;73.1601731601732
255;0;"terryon";255;100;0
0;10;"terryona";10;0;100
0;17;"terryonna";17;0;100
0;222;"tersa";222;0;100
0;73;"tersea";73;0;100
0;30;"tersia";30;0;100
0;10;"tertia";10;0;100
6;0;"tertius";6;100;0
0;405;"teruko";405;0;100
274;0;"teruo";274;100;0
0;11;"teruyo";11;0;100
5;0;"tervell";5;100;0
5;0;"tervin";5;100;0
21;0;"tervon";21;100;0
131;34;"tery";165;79.3939393939394;20.6060606060606
0;7;"terykah";7;0;100
263;779;"teryl";1042;25.2399232245681;74.7600767754319
256;1271;"teryn";1527;16.7648984937787;83.2351015062214
0;6;"terynn";6;0;100
5;0;"teryon";5;100;0
0;5;"tes";5;0;100
0;1348;"tesa";1348;0;100
126;0;"tesean";126;100;0
38;0;"tesfa";38;100;0
0;1804;"tesha";1804;0;100
0;17;"teshana";17;0;100
0;56;"teshara";56;0;100
202;0;"teshaun";202;100;0
0;21;"teshauna";21;0;100
343;26;"teshawn";369;92.9539295392954;7.04607046070461
0;54;"teshawna";54;0;100
0;5;"teshayla";5;0;100
0;13;"tesheena";13;0;100
0;11;"tesheka";11;0;100
0;5;"teshena";5;0;100
12;0;"tesher";12;100;0
0;452;"teshia";452;0;100
0;6;"teshika";6;0;100
0;12;"teshima";12;0;100
0;5;"teshina";5;0;100
0;5;"teshira";5;0;100
50;0;"teshon";50;100;0
0;1069;"tesia";1069;0;100
65;2162;"tesla";2227;2.91872474180512;97.0812752581949
0;5;"tesley";5;0;100
0;35;"teslyn";35;0;100
0;71;"tesneem";71;0;100
0;13410;"tess";13410;0;100
13;45738;"tessa";45751;0.0284146794605582;99.9715853205394
0;249;"tessah";249;0;100
0;6;"tessalee";6;0;100
0;22;"tessalyn";22;0;100
0;12;"tessalynn";12;0;100
0;19;"tessanne";19;0;100
0;15;"tesse";15;0;100
0;69;"tessi";69;0;100
0;371;"tessia";371;0;100
0;7;"tessibel";7;0;100
0;229;"tessica";229;0;100
10;9057;"tessie";9067;0.110290062865336;99.8897099371347
0;200;"tessla";200;0;100
0;5;"tessley";5;0;100
0;54;"tesslyn";54;0;100
0;11;"tesslynn";11;0;100
0;194;"tessy";194;0;100
0;7;"testimony";7;0;100
0;10;"tetra";10;0;100
5;0;"tetsu";5;100;0
268;0;"tetsuo";268;100;0
6;0;"tetsuro";6;100;0
12;0;"tetsuya";12;100;0
0;54;"teuila";54;0;100
0;6;"teuna";6;0;100
0;43;"teuta";43;0;100
16;119;"teva";135;11.8518518518519;88.1481481481482
279;0;"tevan";279;100;0
18;0;"tevante";18;100;0
12;0;"tevaris";12;100;0
5;0;"tevarus";5;100;0
56;0;"tevaughn";56;100;0
5;0;"tevell";5;100;0
281;0;"teven";281;100;0
10;0;"teveon";10;100;0
6;0;"tevez";6;100;0
15;0;"tevian";15;100;0
10918;59;"tevin";10977;99.4625125261911;0.537487473808873
181;0;"tevion";181;100;0
485;64;"tevis";549;88.3424408014572;11.6575591985428
694;0;"tevita";694;100;0
1003;0;"tevon";1003;100;0
36;0;"tevonte";36;100;0
0;6;"tevy";6;0;100
5;0;"tevye";5;100;0
246;5;"tevyn";251;98.00796812749;1.99203187250996
0;73;"tewana";73;0;100
0;35;"tewanda";35;0;100
0;55;"tewanna";55;0;100
1907;11;"tex";1918;99.4264859228363;0.573514077163712
0;46;"texana";46;0;100
0;179;"texanna";179;0;100
363;163;"texas";526;69.0114068441065;30.9885931558935
0;545;"texie";545;0;100
0;1114;"teya";1114;0;100
0;330;"teyah";330;0;100
0;5;"teyahna";5;0;100
0;725;"teyana";725;0;100
0;5;"teyanah";5;0;100
0;11;"teyani";11;0;100
0;515;"teyanna";515;0;100
5;0;"teyden";5;100;0
15;27;"teygan";42;35.7142857142857;64.2857142857143
0;20;"teyha";20;0;100
0;239;"teyla";239;0;100
0;16;"teylar";16;0;100
0;18;"teyler";18;0;100
45;341;"teylor";386;11.6580310880829;88.3419689119171
52;0;"teyo";52;100;0
189;0;"teyon";189;100;0
0;308;"teyona";308;0;100
0;25;"teyonce";25;0;100
0;5;"teyonda";5;0;100
0;430;"teyonna";430;0;100
5;0;"teysean";5;100;0
0;13;"teysha";13;0;100
81;0;"teyton";81;100;0
19;0;"teyvon";19;100;0
0;56;"tezra";56;0;100
18;15;"tha";33;54.5454545454545;45.4545454545455
5;0;"thabit";5;100;0
16;0;"thabiti";16;100;0
11;0;"thach";11;100;0
14;0;"thacher";14;100;0
24;0;"thackery";24;100;0
7923;5;"thad";7928;99.9369323915237;0.0630676084762866
0;11;"thada";11;0;100
145;0;"thadd";145;100;0
887;0;"thaddaeus";887;100;0
11;0;"thaddaus";11;100;0
0;5;"thaddea";5;0;100
138;0;"thaddeaus";138;100;0
45;0;"thaddeous";45;100;0
23015;32;"thaddeus";23047;99.8611532954397;0.138846704560246
10;0;"thaddis";10;100;0
568;0;"thaddius";568;100;0
55;0;"thaddues";55;100;0
86;0;"thaddus";86;100;0
27;0;"thade";27;100;0
55;0;"thaden";55;100;0
18;0;"thadeo";18;100;0
17;0;"thadeous";17;100;0
1086;0;"thadeus";1086;100;0
0;5;"thadine";5;0;100
31;0;"thadis";31;100;0
487;0;"thadius";487;100;0
11;0;"thadus";11;100;0
61;0;"thaer";61;100;0
1133;190;"thai";1323;85.6386999244142;14.3613000755858
12;0;"thaiden";12;100;0
0;92;"thaila";92;0;100
124;0;"thailan";124;100;0
102;10;"thailand";112;91.0714285714286;8.92857142857143
0;7;"thailee";7;0;100
5;0;"thailen";5;100;0
33;6;"thailer";39;84.6153846153846;15.3846153846154
0;19;"thailia";19;0;100
0;286;"thaily";286;0;100
10;75;"thailyn";85;11.7647058823529;88.2352941176471
0;16;"thailynn";16;0;100
5;0;"thain";5;100;0
0;26;"thaina";26;0;100
166;0;"thaine";166;100;0
12;0;"thair";12;100;0
0;1984;"thais";1984;0;100
0;5;"thaisa";5;0;100
0;15;"thaisha";15;0;100
56;0;"thaison";56;100;0
0;5;"thaissa";5;0;100
0;54;"thaiz";54;0;100
5;0;"thaj";5;100;0
0;10;"thala";10;0;100
15;0;"thalamus";15;100;0
0;6;"thalassa";6;0;100
0;37;"thaleia";37;0;100
5;0;"thalen";5;100;0
75;0;"thales";75;100;0
0;12582;"thalia";12582;0;100
0;28;"thaliah";28;0;100
0;8;"thaliana";8;0;100
0;13;"thalina";13;0;100
0;16;"thalita";16;0;100
0;10;"thaliya";10;0;100
0;45;"thaliyah";45;0;100
0;11;"thalma";11;0;100
29;0;"thalmus";29;100;0
0;138;"thalya";138;0;100
19;0;"thaman";19;100;0
5;85;"thamar";90;5.55555555555556;94.4444444444444
0;219;"thamara";219;0;100
91;0;"thamas";91;100;0
18;0;"thamer";18;100;0
5;0;"thames";5;100;0
0;5;"thamia";5;0;100
5;0;"thamos";5;100;0
36;0;"than";36;100;0
0;68;"thana";68;0;100
5;0;"thanasi";5;100;0
0;36;"thandi";36;0;100
0;13;"thandie";13;0;100
0;100;"thandiwe";100;0;100
2225;0;"thane";2225;100;0
488;12;"thang";500;97.6;2.4
1087;650;"thanh";1737;62.5791594703512;37.4208405296488
5;0;"thanhphong";5;100;0
0;5;"thanhtruc";5;0;100
0;1344;"thania";1344;0;100
56;0;"thaniel";56;100;0
0;22;"thanna";22;0;100
48;0;"thanos";48;100;0
0;63;"thanvi";63;0;100
0;249;"thanya";249;0;100
192;1035;"thao";1227;15.6479217603912;84.3520782396088
0;163;"thara";163;0;100
9;0;"tharan";9;100;0
5;0;"tharel";5;100;0
43;0;"tharen";43;100;0
11;0;"tharin";11;100;0
476;167;"tharon";643;74.0279937791602;25.9720062208398
6;0;"tharron";6;100;0
69;0;"tharun";69;100;0
0;12;"thary";12;0;100
5;0;"tharyn";5;100;0
0;22;"thasha";22;0;100
2696;11;"thatcher";2707;99.5936461026967;0.406353897303288
0;68;"thatiana";68;0;100
0;17;"thavy";17;0;100
0;5;"thawann";5;0;100
26;0;"thawng";26;100;0
5;0;"thaxter";5;100;0
119;0;"thaxton";119;100;0
0;6;"thaya";6;0;100
146;0;"thayden";146;100;0
1100;66;"thayer";1166;94.3396226415094;5.66037735849057
0;5;"thayla";5;0;100
0;6;"thayle";6;0;100
0;6;"thayli";6;0;100
0;5;"thaylia";5;0;100
0;5;"thayna";5;0;100
1314;0;"thayne";1314;100;0
0;5;"thays";5;0;100
5;0;"the";5;100;0
5;10457;"thea";10462;0.0477920091760658;99.9522079908239
0;36;"theada";36;0;100
45;0;"theado";45;100;0
86;0;"theador";86;100;0
0;839;"theadora";839;0;100
3867;0;"theadore";3867;100;0
0;5;"theanna";5;0;100
31;0;"thearon";31;100;0
0;21;"thearsa";21;0;100
5;0;"thearthur";5;100;0
22;0;"theartis";22;100;0
0;12;"theary";12;0;100
0;11;"theatus";11;0;100
0;21;"theckla";21;0;100
0;257;"thecla";257;0;100
0;6473;"theda";6473;0;100
153;0;"thedford";153;100;0
0;16;"thedis";16;0;100
0;103;"thedora";103;0;100
1132;0;"thedore";1132;100;0
0;6;"thedosia";6;0;100
0;15;"thedra";15;0;100
0;10;"thedy";10;0;100
5;0;"theeran";5;100;0
0;310;"theia";310;0;100
0;168;"thekla";168;0;100
5;0;"thel";5;100;0
0;51;"thela";51;0;100
931;0;"thelbert";931;100;0
0;521;"thelda";521;0;100
5;0;"theldon";5;100;0
0;85;"thelia";85;0;100
0;5;"thelisa";5;0;100
11;0;"thell";11;100;0
0;43;"thella";43;0;100
1131;222743;"thelma";223874;0.50519488640932;99.4948051135907
7;0;"thelman";7;100;0
0;5;"thelmar";5;0;100
142;47;"thelmer";189;75.1322751322751;24.8677248677249
27;0;"thelmon";27;100;0
311;0;"thelonious";311;100;0
21;0;"thelonius";21;100;0
102;0;"thelton";102;100;0
0;40;"thema";40;0;100
5;0;"themba";5;100;0
0;35;"thembi";35;0;100
5;5;"themis";10;50;50
0;217;"thena";217;0;100
0;12;"thenia";12;0;100
10013;2864;"theo";12877;77.75879475033;22.24120524967
10;0;"theobald";10;100;0
10;20;"theoda";30;33.3333333333333;66.6666666666667
151;0;"theoden";151;100;0
10;0;"theodia";10;100;0
5;0;"theodie";5;100;0
21;0;"theodies";21;100;0
2236;0;"theodis";2236;100;0
0;36;"theodocia";36;0;100
1525;0;"theodor";1525;100;0
49;9502;"theodora";9551;0.513035284263428;99.4869647157366
226094;894;"theodore";226988;99.606146580436;0.39385341956403
49;0;"theodoric";49;100;0
144;0;"theodoro";144;100;0
374;0;"theodoros";374;100;0
0;1290;"theodosia";1290;0;100
27;0;"theodric";27;100;0
178;0;"theodus";178;100;0
10;0;"theofanis";10;100;0
5;0;"theofilos";5;100;0
0;2081;"theola";2081;0;100
0;10;"theolia";10;0;100
213;9;"theon";222;95.9459459459459;4.05405405405405
0;192;"theona";192;0;100
5;311;"theone";316;1.58227848101266;98.4177215189873
0;5;"theoni";5;0;100
0;17;"theonita";17;0;100
0;5;"theopa";5;0;100
0;11;"theopal";11;0;100
0;5;"theophane";5;0;100
197;0;"theophil";197;100;0
0;10;"theophila";10;0;100
174;0;"theophile";174;100;0
0;11;"theophilia";11;0;100
1956;0;"theophilus";1956;100;0
5;0;"theophus";5;100;0
204;0;"theoplis";204;100;0
251;0;"theopolis";251;100;0
0;819;"theora";819;0;100
401;0;"theordore";401;100;0
86;0;"theoren";86;100;0
0;7;"theoria";7;0;100
26;45;"theory";71;36.6197183098592;63.3802816901408
934;0;"theotis";934;100;0
0;858;"thera";858;0;100
5;0;"theral";5;100;0
5;0;"therald";5;100;0
261;0;"theran";261;100;0
0;136;"therasa";136;0;100
10;0;"therdore";10;100;0
0;11;"therea";11;0;100
0;21;"thereas";21;0;100
0;345;"thereasa";345;0;100
0;5;"therease";5;0;100
8;0;"theren";8;100;0
0;23;"theres";23;0;100
1212;395858;"theresa";397070;0.305235852620445;99.6947641473796
0;41;"theresaann";41;0;100
0;17;"theresamarie";17;0;100
0;5;"theresann";5;0;100
5;34687;"therese";34692;0.0144125446788885;99.9855874553211
0;273;"theresea";273;0;100
0;1765;"theresia";1765;0;100
0;26;"theresita";26;0;100
0;2111;"theressa";2111;0;100
0;5;"theressia";5;0;100
0;21;"theretha";21;0;100
0;5;"thereza";5;0;100
0;22;"theria";22;0;100
79;0;"therin";79;100;0
16;0;"therion";16;100;0
0;352;"therisa";352;0;100
0;114;"therma";114;0;100
1885;0;"therman";1885;100;0
723;0;"thermon";723;100;0
16;0;"thermond";16;100;0
12247;32;"theron";12279;99.7393924586693;0.260607541330727
5;0;"therone";5;100;0
5;0;"therrell";5;100;0
5;0;"therrin";5;100;0
241;0;"therron";241;100;0
0;1071;"thersa";1071;0;100
0;5;"therse";5;0;100
0;125;"thersea";125;0;100
0;73;"thersia";73;0;100
30;16;"theryn";46;65.2173913043478;34.7826086956522
0;5;"thesa";5;0;100
204;0;"theseus";204;100;0
0;6;"thesha";6;0;100
5;0;"thessalonia";5;100;0
0;59;"thessaly";59;0;100
0;402;"theta";402;0;100
0;147;"thetis";147;0;100
59;0;"theus";59;100;0
63;402;"thi";465;13.5483870967742;86.4516129032258
0;233;"thia";233;0;100
5128;0;"thiago";5128;100;0
12;0;"thian";12;100;0
0;40;"thiana";40;0;100
0;42;"thiara";42;0;100
24;0;"thibault";24;100;0
0;23;"thida";23;0;100
5;0;"thiego";5;100;0
5;0;"thiel";5;100;0
912;29;"thien";941;96.9181721572795;3.08182784272051
50;29;"thienan";79;63.2911392405063;36.7088607594937
0;38;"thienkim";38;0;100
6;0;"thienlong";6;100;0
263;0;"thierno";263;100;0
672;26;"thierry";698;96.2750716332378;3.72492836676218
96;0;"thijs";96;100;0
0;5;"thilda";5;0;100
6;0;"thilo";6;100;0
757;0;"thimothy";757;100;0
222;0;"thinh";222;100;0
0;5;"thira";5;0;100
5;0;"thirl";5;100;0
6;0;"thirston";6;100;0
0;183;"thirza";183;0;100
0;13;"thisbe";13;0;100
0;5;"thistle";5;0;100
0;5;"thiya";5;0;100
0;5;"thlema";5;0;100
46;6;"tho";52;88.4615384615385;11.5384615384615
0;5;"thoa";5;0;100
185;0;"thoams";185;100;0
5;0;"thobias";5;100;0
18;0;"thoburn";18;100;0
6;0;"thoedore";6;100;0
10;0;"thoeun";10;100;0
835;0;"thom";835;100;0
78;20;"thoma";98;79.5918367346939;20.4081632653061
0;5;"thomara";5;0;100
2252894;8243;"thomas";2261137;99.6354488914206;0.364551108579445
0;304;"thomasa";304;0;100
0;768;"thomasena";768;0;100
0;200;"thomasene";200;0;100
0;63;"thomasenia";63;0;100
0;10;"thomasin";10;0;100
0;3754;"thomasina";3754;0;100
0;2234;"thomasine";2234;0;100
0;5;"thomasita";5;0;100
54;0;"thomasjames";54;100;0
16;0;"thomasjohn";16;100;0
7;0;"thomaslee";7;100;0
11;0;"thomasmichael";11;100;0
5;0;"thomason";5;100;0
5;0;"thomass";5;100;0
411;0;"thomes";411;100;0
0;5;"thomesa";5;0;100
0;33;"thomesha";33;0;100
0;16;"thomia";16;0;100
7;0;"thomias";7;100;0
0;7;"thomisha";7;0;100
12;0;"thommas";12;100;0
17;0;"thommy";17;100;0
121;0;"thomos";121;100;0
2182;0;"thompson";2182;100;0
215;0;"thoms";215;100;0
214;0;"thomson";214;100;0
5;0;"thon";5;100;0
0;26;"thonda";26;0;100
305;0;"thong";305;100;0
5;0;"thony";5;100;0
4135;0;"thor";4135;100;0
0;1912;"thora";1912;0;100
5;0;"thorald";5;100;0
5;0;"thoralf";5;100;0
10;0;"thoran";10;100;0
0;10;"thordis";10;0;100
11;0;"thoreau";11;100;0
116;0;"thoren";116;100;0
10;0;"thorian";10;100;0
1026;0;"thorin";1026;100;0
0;5;"thorine";5;0;100
0;6;"thoris";6;0;100
245;0;"thorn";245;100;0
396;0;"thorne";396;100;0
22;0;"thornell";22;100;0
2845;0;"thornton";2845;100;0
5;0;"thornwell";5;100;0
6;0;"thorpe";6;100;0
16;0;"thorsen";16;100;0
11;0;"thorson";11;100;0
107;0;"thorsten";107;100;0
42;0;"thorton";42;100;0
5;0;"thorval";5;100;0
109;0;"thorvald";109;100;0
46;0;"thorwald";46;100;0
32;0;"thoryn";32;100;0
118;0;"thos";118;100;0
0;659;"threasa";659;0;100
0;22;"threase";22;0;100
0;2240;"thresa";2240;0;100
0;10;"threse";10;0;100
0;182;"thresea";182;0;100
0;220;"thresia";220;0;100
0;973;"thressa";973;0;100
0;5;"thressia";5;0;100
0;6;"thressie";6;0;100
0;5;"thrisa";5;0;100
0;18;"thrisha";18;0;100
30;0;"thristan";30;100;0
6;0;"thristen";6;100;0
17;0;"thristian";17;100;0
5;810;"thu";815;0.613496932515337;99.3865030674847
207;5;"thuan";212;97.6415094339623;2.35849056603774
0;5;"thuhuong";5;0;100
0;148;"thula";148;0;100
376;0;"thunder";376;100;0
7;37;"thuong";44;15.9090909090909;84.0909090909091
0;5;"thuraya";5;0;100
0;5;"thurayya";5;0;100
5;0;"thurber";5;100;0
18;0;"thure";18;100;0
5;0;"thurgood";5;100;0
295;0;"thurl";295;100;0
0;5;"thurla";5;0;100
0;70;"thurley";70;0;100
39;0;"thurlo";39;100;0
416;0;"thurlow";416;100;0
0;67;"thurma";67;0;100
15984;5;"thurman";15989;99.9687285008443;0.0312714991556695
1053;0;"thurmon";1053;100;0
1002;0;"thurmond";1002;100;0
6;0;"thurnell";6;100;0
0;134;"thursa";134;0;100
0;6;"thursie";6;0;100
3392;0;"thurston";3392;100;0
0;71;"thurza";71;0;100
0;10;"thusnelda";10;0;100
0;5;"thuthuy";5;0;100
17;1076;"thuy";1093;1.55535224153705;98.4446477584629
0;39;"thuytien";39;0;100
0;24;"thuytrang";24;0;100
0;28;"thuyvi";28;0;100
0;5;"thuyvy";5;0;100
0;361;"thy";361;0;100
13;0;"thyago";13;100;0
0;7;"thyais";7;0;100
0;19;"thyda";19;0;100
10;0;"thyler";10;100;0
0;45;"thyme";45;0;100
0;1227;"thyra";1227;0;100
5;0;"thyrome";5;100;0
5;0;"thyron";5;100;0
5;0;"thyrone";5;100;0
0;16;"thyrza";16;0;100
5;0;"thys";5;100;0
57;12;"ti";69;82.6086956521739;17.3913043478261
64;32545;"tia";32609;0.196264834861541;99.8037351651385
0;29;"tiaa";29;0;100
0;5;"tiadra";5;0;100
1738;0;"tiago";1738;100;0
0;551;"tiah";551;0;100
0;7;"tiahja";7;0;100
0;434;"tiahna";434;0;100
0;461;"tiaira";461;0;100
0;59;"tiairra";59;0;100
0;14;"tiaisha";14;0;100
0;140;"tiaja";140;0;100
0;114;"tiajah";114;0;100
0;374;"tiajuana";374;0;100
0;5;"tiaka";5;0;100
0;5;"tiala";5;0;100
0;36;"tialisa";36;0;100
28;0;"tiam";28;100;0
0;17;"tiamara";17;0;100
0;134;"tiamarie";134;0;100
0;5;"tiamia";5;0;100
214;148;"tian";362;59.1160220994475;40.8839779005525
9;25645;"tiana";25654;0.0350822483823185;99.9649177516177
0;218;"tianah";218;0;100
0;10;"tianamarie";10;0;100
0;29;"tianca";29;0;100
0;13;"tianda";13;0;100
0;484;"tiandra";484;0;100
66;0;"tiandre";66;100;0
0;7;"tiandrea";7;0;100
0;5;"tiandria";5;0;100
0;71;"tiane";71;0;100
0;6;"tianee";6;0;100
0;663;"tiani";663;0;100
0;15;"tiania";15;0;100
0;6;"tianie";6;0;100
0;67;"tiann";67;0;100
0;12344;"tianna";12344;0;100
0;227;"tiannah";227;0;100
0;190;"tianne";190;0;100
0;149;"tianni";149;0;100
0;5;"tianny";5;0;100
16;0;"tiano";16;100;0
61;0;"tiant";61;100;0
5;16;"tiante";21;23.8095238095238;76.1904761904762
0;5;"tiany";5;0;100
5;0;"tianyi";5;100;0
0;5;"tiaona";5;0;100
61;23043;"tiara";23104;0.264023545706371;99.7359764542936
0;452;"tiarah";452;0;100
0;17;"tiaraoluwa";17;0;100
0;1191;"tiare";1191;0;100
0;61;"tiari";61;0;100
0;92;"tiaria";92;0;100
26;0;"tiarnan";26;100;0
0;3505;"tiarra";3505;0;100
0;68;"tiarrah";68;0;100
0;5;"tiarre";5;0;100
0;371;"tiasha";371;0;100
0;455;"tiasia";455;0;100
0;552;"tiauna";552;0;100
0;7;"tiaundra";7;0;100
0;80;"tiaunna";80;0;100
0;9;"tiaura";9;0;100
58;0;"tiawan";58;100;0
0;135;"tiawana";135;0;100
0;5;"tiawanda";5;0;100
0;95;"tiawanna";95;0;100
0;22;"tiawna";22;0;100
0;5;"tiaya";5;0;100
0;28;"tiayana";28;0;100
0;5;"tiayanna";5;0;100
5;0;"tibby";5;100;0
5;0;"tiberias";5;100;0
658;0;"tiberius";658;100;0
0;6;"tibisay";6;0;100
215;0;"tibor";215;100;0
0;16;"tiburcia";16;0;100
302;0;"tiburcio";302;100;0
0;7;"tica";7;0;100
0;56;"ticara";56;0;100
0;5;"ticarra";5;0;100
49;0;"tice";49;100;0
0;37;"ticey";37;0;100
0;5;"ticha";5;0;100
0;33;"tichelle";33;0;100
0;379;"tichina";379;0;100
0;100;"ticia";100;0;100
81;0;"tico";81;100;0
0;92;"tida";92;0;100
6;0;"tidiane";6;100;0
440;0;"tidus";440;100;0
0;75;"tiea";75;0;100
0;11;"tieanna";11;0;100
0;229;"tieara";229;0;100
0;150;"tiearra";150;0;100
0;118;"tieasha";118;0;100
0;24;"tieesha";24;0;100
15;0;"tieg";15;100;0
82;207;"tiegan";289;28.3737024221453;71.6262975778547
5;0;"tiege";5;100;0
11;0;"tiegen";11;100;0
0;90;"tieisha";90;0;100
0;18;"tieka";18;0;100
0;28;"tiela";28;0;100
193;35;"tieler";228;84.6491228070175;15.3508771929825
10;0;"tielor";10;100;0
0;11;"tiembra";11;0;100
15;0;"tiemeyer";15;100;0
723;476;"tien";1199;60.3002502085071;39.6997497914929
0;75;"tiena";75;0;100
0;74;"tienna";74;0;100
0;5;"tier";5;0;100
6;4042;"tiera";4048;0.148221343873518;99.8517786561265
0;54;"tierah";54;0;100
22;6;"tieran";28;78.5714285714286;21.4285714285714
0;5;"tieranee";5;0;100
0;40;"tieraney";40;0;100
0;5;"tierani";5;0;100
0;156;"tierany";156;0;100
0;5;"tiere";5;0;100
0;5;"tiereney";5;0;100
0;6;"tiereny";6;0;100
0;15;"tieria";15;0;100
0;29;"tierica";29;0;100
0;5;"tiericka";5;0;100
0;5;"tierna";5;0;100
1219;185;"tiernan";1404;86.8233618233618;13.1766381766382
23;3641;"tierney";3664;0.627729257641921;99.3722707423581
0;6;"tierni";6;0;100
0;30;"tierny";30;0;100
70;14668;"tierra";14738;0.474962681503596;99.5250373184964
0;103;"tierrah";103;0;100
375;117;"tierre";492;76.219512195122;23.780487804878
0;78;"tierria";78;0;100
0;99;"tiersa";99;0;100
0;47;"tierza";47;0;100
0;5;"tiesa";5;0;100
0;24;"tiese";24;0;100
0;2848;"tiesha";2848;0;100
0;192;"tieshia";192;0;100
0;7;"tieshka";7;0;100
6;0;"tieson";6;100;0
0;5;"tiessa";5;0;100
0;6;"tieysha";6;0;100
0;45;"tifa";45;0;100
0;36;"tifanee";36;0;100
0;872;"tifani";872;0;100
0;407;"tifanie";407;0;100
0;11;"tifanni";11;0;100
0;149;"tifanny";149;0;100
0;960;"tifany";960;0;100
6;0;"tifeoluwa";6;100;0
0;20;"tiferet";20;0;100
0;5;"tiffaine";5;0;100
0;48;"tiffancy";48;0;100
0;200;"tiffane";200;0;100
0;596;"tiffanee";596;0;100
0;2281;"tiffaney";2281;0;100
0;14839;"tiffani";14839;0;100
0;28;"tiffaniamber";28;0;100
0;8994;"tiffanie";8994;0;100
0;11;"tiffanique";11;0;100
0;5;"tiffannee";5;0;100
0;110;"tiffanni";110;0;100
0;182;"tiffannie";182;0;100
0;374;"tiffanny";374;0;100
1191;335593;"tiffany";336784;0.353639127749537;99.6463608722505
0;38;"tiffanyamber";38;0;100
0;91;"tiffanyann";91;0;100
0;54;"tiffanye";54;0;100
0;25;"tiffanymarie";25;0;100
0;139;"tiffay";139;0;100
0;53;"tiffeney";53;0;100
0;838;"tiffeny";838;0;100
0;6;"tifffany";6;0;100
0;10;"tiffiani";10;0;100
0;839;"tiffiany";839;0;100
0;60;"tiffin";60;0;100
0;37;"tiffinay";37;0;100
0;156;"tiffine";156;0;100
0;55;"tiffinee";55;0;100
0;1040;"tiffiney";1040;0;100
0;1290;"tiffini";1290;0;100
0;304;"tiffinie";304;0;100
0;2388;"tiffiny";2388;0;100
0;71;"tiffnay";71;0;100
0;1138;"tiffney";1138;0;100
0;17;"tiffni";17;0;100
0;5;"tiffnie";5;0;100
0;95;"tiffny";95;0;100
0;6;"tiffoni";6;0;100
0;15;"tiffonie";15;0;100
0;137;"tiffony";137;0;100
0;24;"tiffy";24;0;100
0;101;"tifini";101;0;100
0;11;"tifinie";11;0;100
0;11;"tifiny";11;0;100
0;35;"tifney";35;0;100
0;5;"tifni";5;0;100
0;6;"tifphanie";6;0;100
333;0;"tige";333;100;0
945;35;"tiger";980;96.4285714285714;3.57142857142857
0;17;"tigerlilly";17;0;100
0;236;"tigerlily";236;0;100
34;0;"tigh";34;100;0
463;0;"tighe";463;100;0
0;10;"tigra";10;0;100
309;0;"tigran";309;100;0
0;5;"tigre";5;0;100
0;24;"tihani";24;0;100
0;67;"tihanna";67;0;100
0;5;"tihara";5;0;100
5;0;"tiheim";5;100;0
0;48;"tihesha";48;0;100
0;5;"tihisha";5;0;100
0;38;"tiina";38;0;100
0;5;"tiiu";5;0;100
5;114;"tija";119;4.20168067226891;95.7983193277311
0;6;"tijae";6;0;100
5;89;"tijah";94;5.31914893617021;94.6808510638298
19;0;"tijan";19;100;0
0;69;"tijana";69;0;100
0;6;"tijanae";6;0;100
6;5;"tijay";11;54.5454545454545;45.4545454545455
0;35;"tijera";35;0;100
47;0;"tijon";47;100;0
408;0;"tijuan";408;100;0
0;1336;"tijuana";1336;0;100
0;26;"tijuanna";26;0;100
0;18;"tijwana";18;0;100
0;348;"tika";348;0;100
0;18;"tikara";18;0;100
0;11;"tikayla";11;0;100
0;21;"tikeisha";21;0;100
0;5;"tikela";5;0;100
0;5;"tikera";5;0;100
0;5;"tikeria";5;0;100
0;109;"tikesha";109;0;100
0;10;"tikeshia";10;0;100
0;43;"tikeya";43;0;100
0;7;"tikeyah";7;0;100
6;0;"tikhon";6;100;0
23;356;"tiki";379;6.06860158311346;93.9313984168866
0;254;"tikia";254;0;100
0;11;"tikila";11;0;100
0;7;"tikina";7;0;100
0;11;"tikira";11;0;100
0;278;"tikisha";278;0;100
0;62;"tikita";62;0;100
0;15;"tikiya";15;0;100
0;5;"tikiyah";5;0;100
0;22;"tikki";22;0;100
40;0;"tiko";40;100;0
0;6;"tikva";6;0;100
0;32;"tikvah";32;0;100
0;5;"tikyra";5;0;100
0;425;"tila";425;0;100
61;0;"tilak";61;100;0
6;0;"tilan";6;100;0
13;20;"tilar";33;39.3939393939394;60.6060606060606
0;1516;"tilda";1516;0;100
1024;38;"tilden";1062;96.4218455743879;3.57815442561205
108;0;"tildon";108;100;0
0;18;"tileah";18;0;100
0;5;"tilena";5;0;100
286;59;"tiler";345;82.8985507246377;17.1014492753623
0;17;"tilesha";17;0;100
634;0;"tilford";634;100;0
49;0;"tilghman";49;100;0
0;78;"tilia";78;0;100
13;0;"tilian";13;100;0
5;0;"tilio";5;100;0
0;23;"tilisa";23;0;100
0;49;"tilisha";49;0;100
0;17;"tiliyah";17;0;100
29;0;"till";29;100;0
0;36;"tilla";36;0;100
0;8;"tillee";8;0;100
5;0;"tiller";5;100;0
0;75;"tilley";75;0;100
7;0;"tillian";7;100;0
27;11276;"tillie";11303;0.238874635052641;99.7611253649474
5;0;"tillis";5;100;0
3270;0;"tillman";3270;100;0
146;0;"tillmon";146;100;0
0;838;"tilly";838;0;100
874;0;"tilman";874;100;0
16;0;"tilmer";16;100;0
557;0;"tilmon";557;100;0
5;0;"tilon";5;100;0
10;0;"tilor";10;100;0
372;0;"tilton";372;100;0
0;5;"tilwanda";5;0;100
0;11;"tilynn";11;0;100
82713;188;"tim";82901;99.773223483432;0.226776516567955
0;139;"tima";139;0;100
13;0;"timaeus";13;100;0
5;0;"timaj";5;100;0
0;39;"timaka";39;0;100
0;12;"timani";12;0;100
5;0;"timar";5;100;0
0;621;"timara";621;0;100
0;5;"timarah";5;0;100
5;0;"timarcus";5;100;0
0;10;"timaree";10;0;100
27;50;"timari";77;35.0649350649351;64.9350649350649
0;74;"timarie";74;0;100
85;0;"timarion";85;100;0
279;0;"timathy";279;100;0
0;223;"timaya";223;0;100
0;6;"timayah";6;0;100
478;957;"timber";1435;33.3101045296167;66.6898954703833
36;0;"timberland";36;100;0
0;76;"timberlee";76;0;100
0;6;"timberley";6;0;100
0;931;"timberly";931;0;100
0;102;"timberlyn";102;0;100
0;52;"timberlynn";52;0;100
0;15;"timbra";15;0;100
0;20;"timbre";20;0;100
0;151;"timea";151;0;100
0;5;"timeah";5;0;100
0;24;"timeca";24;0;100
0;16;"timeisha";16;0;100
0;1000;"timeka";1000;0;100
0;19;"timekia";19;0;100
0;37;"timeko";37;0;100
0;211;"timera";211;0;100
0;6;"timeria";6;0;100
0;498;"timesha";498;0;100
0;58;"timeshia";58;0;100
5;0;"timetrius";5;100;0
5;649;"timi";654;0.764525993883792;99.2354740061162
0;1059;"timia";1059;0;100
0;59;"timiah";59;0;100
0;107;"timica";107;0;100
0;7;"timicka";7;0;100
0;1006;"timika";1006;0;100
0;12;"timiki";12;0;100
0;32;"timikia";32;0;100
0;97;"timiko";97;0;100
6;0;"timileyin";6;100;0
10;0;"timiothy";10;100;0
0;63;"timira";63;0;100
0;295;"timisha";295;0;100
391;0;"timithy";391;100;0
0;23;"timitra";23;0;100
0;182;"timiya";182;0;100
0;172;"timiyah";172;0;100
649;0;"timm";649;100;0
0;23;"timmeka";23;0;100
0;27;"timmesha";27;0;100
0;6;"timmeshia";6;0;100
83;0;"timmey";83;100;0
0;124;"timmi";124;0;100
0;89;"timmia";89;0;100
0;5;"timmiah";5;0;100
3240;340;"timmie";3580;90.5027932960894;9.49720670391061
5;0;"timmithy";5;100;0
6;0;"timmon";6;100;0
13;0;"timmons";13;100;0
4060;0;"timmothy";4060;100;0
25537;168;"timmy";25705;99.3464306555145;0.653569344485509
0;67;"timmya";67;0;100
0;5;"timmyah";5;0;100
0;6;"timnesha";6;0;100
173;0;"timo";173;100;0
19;0;"timofei";19;100;0
336;0;"timofey";336;100;0
272;0;"timohty";272;100;0
11;0;"timohy";11;100;0
0;40;"timolin";40;0;100
0;9;"timolyn";9;0;100
438;0;"timon";438;100;0
5;0;"timone";5;100;0
850;0;"timonthy";850;100;0
0;23;"timora";23;0;100
12;0;"timorthy";12;100;0
5;0;"timote";5;100;0
0;55;"timotea";55;0;100
1215;0;"timoteo";1215;100;0
113;0;"timoth";113;100;0
15;0;"timothe";15;100;0
0;157;"timothea";157;0;100
212;0;"timothee";212;100;0
183;0;"timotheus";183;100;0
591;0;"timothey";591;100;0
6;0;"timothhy";6;100;0
17;0;"timothie";17;100;0
1064787;4326;"timothy";1069113;99.5953655039271;0.404634496072913
46;0;"timothyjames";46;100;0
5;0;"timothyjohn";5;100;0
11;0;"timothyy";11;100;0
141;0;"timoty";141;100;0
76;0;"timouthy";76;100;0
18;0;"timthoy";18;100;0
28;0;"timthy";28;100;0
80;0;"timtohy";80;100;0
542;0;"timur";542;100;0
0;372;"timya";372;0;100
0;49;"timyah";49;0;100
0;15;"timyia";15;0;100
0;53;"timyra";53;0;100
418;0;"tin";418;100;0
905;290581;"tina";291486;0.31047803325031;99.6895219667497
0;11;"tinaka";11;0;100
0;12;"tinalouise";12;0;100
0;10;"tinamaria";10;0;100
0;1159;"tinamarie";1159;0;100
0;10;"tinasha";10;0;100
5;13;"tinashe";18;27.7777777777778;72.2222222222222
0;5;"tinasia";5;0;100
0;109;"tinaya";109;0;100
0;16;"tincie";16;0;100
0;29;"tincy";29;0;100
0;5;"tindra";5;0;100
0;108;"tine";108;0;100
0;60;"tinea";60;0;100
0;26;"tineisha";26;0;100
0;255;"tineka";255;0;100
0;23;"tineke";23;0;100
0;6;"tinelle";6;0;100
0;762;"tinesha";762;0;100
0;92;"tineshia";92;0;100
0;5;"tinette";5;0;100
5;290;"tiney";295;1.69491525423729;98.3050847457627
15;73;"ting";88;17.0454545454545;82.9545454545455
15;0;"tinh";15;100;0
0;10;"tini";10;0;100
0;387;"tinia";387;0;100
0;11;"tinica";11;0;100
0;61;"tinie";61;0;100
0;564;"tinika";564;0;100
0;8;"tiniki";8;0;100
0;6;"tinina";6;0;100
0;6;"tiniqua";6;0;100
0;1145;"tinisha";1145;0;100
0;29;"tinishia";29;0;100
0;99;"tinita";99;0;100
0;50;"tiniya";50;0;100
0;18;"tiniyah";18;0;100
0;10;"tinka";10;0;100
10;10;"tinker";20;50;50
0;234;"tinlee";234;0;100
0;187;"tinleigh";187;0;100
0;2019;"tinley";2019;0;100
0;317;"tinna";317;0;100
0;5;"tinnelle";5;0;100
0;799;"tinnie";799;0;100
0;12;"tinnley";12;0;100
0;13;"tinny";13;0;100
1884;0;"tino";1884;100;0
6;0;"tinothy";6;100;0
5;0;"tinsae";5;100;0
0;137;"tinslee";137;0;100
0;70;"tinsleigh";70;0;100
88;2016;"tinsley";2104;4.18250950570342;95.8174904942966
0;5;"tinslie";5;0;100
161;1944;"tiny";2105;7.64845605700713;92.3515439429929
0;143;"tinya";143;0;100
0;7;"tinyah";7;0;100
0;51;"tinzlee";51;0;100
0;10;"tinzleigh";10;0;100
0;82;"tinzley";82;0;100
12;0;"tio";12;100;0
0;5;"tiodora";5;0;100
29;0;"tiodoro";29;100;0
0;5;"tiofila";5;0;100
51;0;"tiofilo";51;100;0
5;0;"tioluwani";5;100;0
0;100;"tiombe";100;0;100
5;0;"tiomthy";5;100;0
403;16;"tion";419;96.18138424821;3.81861575178998
0;1311;"tiona";1311;0;100
0;5;"tionah";5;0;100
0;82;"tiondra";82;0;100
12;15;"tione";27;44.4444444444444;55.5555555555556
0;5;"tionee";5;0;100
0;10;"tioni";10;0;100
0;2481;"tionna";2481;0;100
86;698;"tionne";784;10.969387755102;89.030612244898
0;43;"tionni";43;0;100
0;34;"tionnie";34;0;100
0;22;"tiosha";22;0;100
161;0;"tip";161;100;0
0;5;"tiphaine";5;0;100
0;5;"tiphanee";5;0;100
0;266;"tiphani";266;0;100
0;623;"tiphanie";623;0;100
0;235;"tiphany";235;0;100
0;6;"tippany";6;0;100
0;100;"tippi";100;0;100
5;6;"tippy";11;45.4545454545455;54.5454545454545
198;5;"tipton";203;97.5369458128079;2.46305418719212
287;0;"tiquan";287;100;0
0;23;"tiquana";23;0;100
0;5;"tiquila";5;0;100
0;5;"tiquisha";5;0;100
0;11;"tiquita";11;0;100
0;974;"tira";974;0;100
0;30;"tirah";30;0;100
81;0;"tiran";81;100;0
0;6;"tiranke";6;0;100
183;0;"tiras";183;100;0
5;0;"tircio";5;100;0
39;0;"tiree";39;100;0
22;0;"tirek";22;100;0
55;0;"tirell";55;100;0
5;0;"tirelle";5;100;0
0;19;"tirenioluwa";19;0;100
5;0;"tirese";5;100;0
0;5;"tiria";5;0;100
11;0;"tirian";11;100;0
5;0;"tirik";5;100;0
0;5;"tirina";5;0;100
6;0;"tiriq";6;100;0
175;0;"tiron";175;100;0
12;0;"tirone";12;100;0
0;6;"tirra";6;0;100
0;5;"tirrany";5;0;100
759;13;"tirrell";772;98.3160621761658;1.6839378238342
0;127;"tirsa";127;0;100
234;0;"tirso";234;100;0
93;0;"tirth";93;100;0
16;0;"tirus";16;100;0
0;323;"tirza";323;0;100
0;1613;"tirzah";1613;0;100
12;0;"tirzo";12;100;0
0;1442;"tisa";1442;0;100
0;57;"tischa";57;0;100
13;0;"tisean";13;100;0
0;798;"tish";798;0;100
0;9422;"tisha";9422;0;100
0;5;"tishae";5;0;100
0;233;"tishana";233;0;100
0;63;"tishanna";63;0;100
0;176;"tishara";176;0;100
46;0;"tishaun";46;100;0
0;29;"tishauna";29;0;100
222;52;"tishawn";274;81.021897810219;18.978102189781
0;78;"tishawna";78;0;100
0;5;"tishay";5;0;100
0;5;"tishayla";5;0;100
0;15;"tishea";15;0;100
0;60;"tisheena";60;0;100
0;5;"tisheka";5;0;100
0;5;"tishena";5;0;100
0;5;"tishera";5;0;100
0;292;"tishia";292;0;100
0;203;"tishie";203;0;100
0;6;"tishika";6;0;100
0;68;"tishina";68;0;100
35;0;"tishon";35;100;0
0;18;"tishona";18;0;100
0;13;"tishonda";13;0;100
0;5;"tishonna";5;0;100
0;5;"tishya";5;0;100
7;0;"tiso";7;100;0
189;0;"tison";189;100;0
0;20;"tisya";20;0;100
0;236;"tita";236;0;100
2702;0;"titan";2702;100;0
0;25;"titana";25;0;100
0;520;"titania";520;0;100
0;43;"titanna";43;0;100
0;13;"titeanna";13;0;100
0;11;"tithi";11;0;100
0;24;"titia";24;0;100
0;562;"titiana";562;0;100
0;139;"titianna";139;0;100
0;101;"titilayo";101;0;100
0;6;"titilope";6;0;100
0;5;"titiyana";5;0;100
3172;0;"tito";3172;100;0
17954;11;"titus";17965;99.9387698302254;0.0612301697745617
0;79;"tityana";79;0;100
0;19;"tityanna";19;0;100
0;5;"tiuana";5;0;100
0;23;"tiva";23;0;100
84;0;"tivis";84;100;0
0;5;"tivoli";5;0;100
318;0;"tivon";318;100;0
0;38;"tivona";38;0;100
0;5;"tiwaloluwa";5;0;100
123;10;"tiwan";133;92.4812030075188;7.5187969924812
0;463;"tiwana";463;0;100
0;177;"tiwanda";177;0;100
0;259;"tiwanna";259;0;100
0;40;"tiwatope";40;0;100
0;6;"tiy";6;0;100
0;639;"tiya";639;0;100
0;89;"tiyah";89;0;100
0;1078;"tiyana";1078;0;100
0;10;"tiyanah";10;0;100
0;760;"tiyanna";760;0;100
0;5;"tiyanni";5;0;100
0;240;"tiye";240;0;100
16;0;"tiyler";16;100;0
224;0;"tiyon";224;100;0
0;114;"tiyona";114;0;100
0;315;"tiyonna";315;0;100
0;141;"tiziana";141;0;100
33;0;"tiziano";33;100;0
51;0;"tizoc";51;100;0
1859;10;"tj";1869;99.4649545211343;0.535045478865704
44;0;"tjaden";44;100;0
125;0;"tjay";125;100;0
24;0;"tjuan";24;100;0
0;127;"tjuana";127;0;100
72;72;"tkai";144;50;50
0;11;"tkaia";11;0;100
0;8;"tkaiya";8;0;100
0;5;"tkara";5;0;100
0;5;"tkayah";5;0;100
0;78;"tkeya";78;0;100
0;1020;"tkeyah";1020;0;100
0;20;"tkeyha";20;0;100
0;52;"tkia";52;0;100
0;32;"tkiyah";32;0;100
0;11;"tkya";11;0;100
0;6;"tkyra";6;0;100
0;11;"tlalli";11;0;100
190;0;"tlaloc";190;100;0
0;5;"tleah";5;0;100
0;6;"tliyah";6;0;100
6;0;"tlyer";6;100;0
0;10;"tmara";10;0;100
10;0;"tmarion";10;100;0
0;5;"tmaya";5;0;100
0;28;"tmia";28;0;100
25;0;"tmothy";25;100;0
0;73;"tmya";73;0;100
0;5;"tmyra";5;0;100
0;10;"tnaya";10;0;100
0;61;"tnia";61;0;100
0;21;"tnisha";21;0;100
0;104;"tniya";104;0;100
0;115;"tniyah";115;0;100
0;78;"tnya";78;0;100
0;17;"tnyah";17;0;100
75;0;"toa";75;100;0
400;0;"toan";400;100;0
0;317;"toba";317;0;100
10;0;"tobais";10;100;0
17;17;"tobbie";34;50;50
394;0;"tobby";394;100;0
720;29;"tobe";749;96.128170894526;3.87182910547397
13;0;"tobechi";13;100;0
130;0;"tobechukwu";130;100;0
122;0;"toben";122;100;0
154;0;"tobenna";154;100;0
1614;758;"tobey";2372;68.0438448566611;31.956155143339
418;2806;"tobi";3224;12.9652605459057;87.0347394540943
5;0;"tobia";5;100;0
509;0;"tobiah";509;100;0
12;0;"tobian";12;100;0
0;7;"tobiann";7;0;100
17775;0;"tobias";17775;100;0
883;1353;"tobie";2236;39.4901610017889;60.5098389982111
16;0;"tobijah";16;100;0
15;0;"tobiloba";15;100;0
4959;83;"tobin";5042;98.3538278460928;1.64617215390718
0;16;"tobitha";16;0;100
27;0;"tobius";27;100;0
32895;7601;"toby";40496;81.2302449624654;18.7697550375346
15;0;"tobyas";15;100;0
0;5;"tobye";5;0;100
239;22;"tobyn";261;91.5708812260536;8.42911877394636
0;68;"tocara";68;0;100
0;226;"tocarra";226;0;100
0;6;"tocarro";6;0;100
14;966;"toccara";980;1.42857142857143;98.5714285714286
0;15;"toccaro";15;0;100
0;60;"toccarra";60;0;100
0;32;"toccora";32;0;100
0;5;"tocha";5;0;100
21;55;"tochi";76;27.6315789473684;72.3684210526316
35;0;"tochukwu";35;100;0
7694;0;"tod";7694;100;0
281221;1061;"todd";282282;99.6241347305177;0.375865269482291
14;0;"todderick";14;100;0
402;0;"toddrick";402;100;0
70;0;"toddy";70;100;0
26;0;"toderick";26;100;0
6;0;"todo";6;100;0
90;0;"todrick";90;100;0
53;1493;"toi";1546;3.42820181112549;96.5717981888745
0;74;"toia";74;0;100
0;6;"toie";6;0;100
0;12;"toika";12;0;100
0;18;"toinetta";18;0;100
0;502;"toinette";502;0;100
0;84;"toini";84;0;100
0;7;"toisha";7;0;100
535;0;"toivo";535;100;0
0;123;"toiya";123;0;100
0;11;"tojuana";11;0;100
0;34;"toka";34;0;100
5;0;"tokala";5;100;0
5;12;"toki";17;29.4117647058824;70.5882352941177
0;56;"tokie";56;0;100
0;88;"tokiko";88;0;100
0;5;"tokina";5;0;100
55;0;"tokio";55;100;0
5;0;"tokuichi";5;100;0
5;5;"tokunbo";10;50;50
25;0;"tokuo";25;100;0
5;0;"tokyo";5;100;0
5;0;"tol";5;100;0
6;88;"tola";94;6.38297872340426;93.6170212765958
44;0;"tolan";44;100;0
25;0;"toland";25;100;0
0;58;"tolanda";58;0;100
0;15;"tolani";15;0;100
744;0;"tolbert";744;100;0
0;5;"toleda";5;0;100
0;17;"toledo";17;0;100
0;116;"toleen";116;0;100
5;0;"toler";5;100;0
33;0;"tolga";33;100;0
0;12;"tolisha";12;0;100
41;0;"toliver";41;100;0
536;34;"tollie";570;94.0350877192982;5.96491228070175
27;0;"tolliver";27;100;0
11;6;"tolly";17;64.7058823529412;35.2941176470588
0;10;"tolonda";10;0;100
0;6;"toltu";6;0;100
38;152;"tolulope";190;20;80
13;11;"toluwalase";24;54.1666666666667;45.8333333333333
0;5;"toluwalope";5;0;100
54;54;"toluwani";108;50;50
38;67;"toluwanimi";105;36.1904761904762;63.8095238095238
132013;595;"tom";132608;99.5513091216216;0.448690878378378
496;216;"toma";712;69.6629213483146;30.3370786516854
0;5;"tomacina";5;0;100
0;17;"tomacita";17;0;100
0;29;"tomaka";29;0;100
0;5;"tomako";5;0;100
45;0;"tomar";45;100;0
0;400;"tomara";400;0;100
5;0;"tomari";5;100;0
5;0;"tomario";5;100;0
34;0;"tomarion";34;100;0
0;43;"tomarra";43;0;100
27152;27;"tomas";27179;99.9006585967107;0.0993414032893042
0;3022;"tomasa";3022;0;100
31;0;"tomasi";31;100;0
0;434;"tomasina";434;0;100
0;919;"tomasita";919;0;100
691;0;"tomasz";691;100;0
6;0;"tomatra";6;100;0
0;5;"tomaya";5;0;100
62;0;"tomaz";62;100;0
68;0;"tome";68;100;0
0;5;"tomea";5;0;100
0;15;"tomeaka";15;0;100
0;159;"tomeca";159;0;100
0;12;"tomecca";12;0;100
0;50;"tomecia";50;0;100
0;30;"tomecka";30;0;100
0;21;"tomeco";21;0;100
0;75;"tomeeka";75;0;100
0;9;"tomeica";9;0;100
0;252;"tomeika";252;0;100
0;15;"tomeisha";15;0;100
6;3627;"tomeka";3633;0.165152766308836;99.8348472336912
0;22;"tomeki";22;0;100
0;709;"tomekia";709;0;100
0;161;"tomeko";161;0;100
408;0;"tomer";408;100;0
5;0;"tomes";5;100;0
0;249;"tomesha";249;0;100
0;76;"tomeshia";76;0;100
0;5;"tomesia";5;0;100
18;0;"tomey";18;100;0
120;2561;"tomi";2681;4.47594181275643;95.5240581872436
0;206;"tomia";206;0;100
0;5;"tomiah";5;0;100
11;0;"tomias";11;100;0
0;574;"tomica";574;0;100
0;10;"tomicia";10;0;100
0;108;"tomicka";108;0;100
0;5;"tomicko";5;0;100
0;22;"tomico";22;0;100
852;470;"tomie";1322;64.4478063540091;35.5521936459909
0;48;"tomieka";48;0;100
0;6;"tomii";6;0;100
5;2781;"tomika";2786;0.179468772433597;99.8205312275664
0;55;"tomikia";55;0;100
7;918;"tomiko";925;0.756756756756757;99.2432432432432
102;0;"tomio";102;100;0
0;311;"tomisha";311;0;100
197;0;"tomislav";197;100;0
5;0;"tomiwa";5;100;0
0;38;"tomiya";38;0;100
0;6;"tomiyah";6;0;100
0;26;"tomiye";26;0;100
0;5;"tomkia";5;0;100
8;0;"tomm";8;100;0
0;106;"tomma";106;0;100
57;0;"tommas";57;100;0
454;0;"tommaso";454;100;0
5;0;"tomme";5;100;0
0;5;"tommesha";5;0;100
112;0;"tommey";112;100;0
16;1551;"tommi";1567;1.02105934907467;98.9789406509253
0;38;"tommia";38;0;100
33598;16787;"tommie";50385;66.682544408058;33.317455591942
0;5;"tommisha";5;0;100
175176;2815;"tommy";177991;98.4184593603047;1.58154063969527
0;5;"tommya";5;0;100
52;1456;"tommye";1508;3.44827586206897;96.551724137931
46;0;"tommylee";46;100;0
12;0;"tomo";12;100;0
10;0;"tomoaki";10;100;0
0;57;"tomoe";57;0;100
35;0;"tomohiro";35;100;0
0;11;"tomoka";11;0;100
150;0;"tomoki";150;100;0
0;123;"tomoko";123;0;100
0;50;"tomomi";50;0;100
0;5;"tomora";5;0;100
0;6;"tomorra";6;0;100
0;260;"tomorrow";260;0;100
119;0;"tomothy";119;100;0
74;0;"tomoya";74;100;0
0;5;"tomoye";5;0;100
7;0;"tomoyuki";7;100;0
471;0;"tomy";471;100;0
0;25;"tomya";25;0;100
0;5;"tomyka";5;0;100
0;7;"tomyra";7;0;100
27;0;"ton";27;100;0
0;1415;"tona";1415;0;100
0;101;"tonae";101;0;100
0;194;"tonantzin";194;0;100
0;29;"tonasia";29;0;100
243;0;"tonatiuh";243;100;0
0;7;"tonay";7;0;100
0;11;"tonaya";11;0;100
0;2426;"tonda";2426;0;100
0;184;"tondalaya";184;0;100
0;7;"tondalayo";7;0;100
0;17;"tondelayo";17;0;100
0;6;"tondi";6;0;100
0;11;"tondia";11;0;100
0;632;"tondra";632;0;100
0;6;"tondrea";6;0;100
0;6;"tondria";6;0;100
45;49;"tone";94;47.8723404255319;52.1276595744681
0;65;"tonea";65;0;100
0;19;"tonecia";19;0;100
5;170;"tonee";175;2.85714285714286;97.1428571428571
0;5;"toneesha";5;0;100
0;176;"toneisha";176;0;100
0;179;"toneka";179;0;100
0;359;"tonesha";359;0;100
0;91;"toneshia";91;0;100
0;12;"tonesia";12;0;100
0;321;"tonetta";321;0;100
0;1505;"tonette";1505;0;100
6182;194;"toney";6376;96.9573400250941;3.0426599749059
304;0;"tong";304;100;0
0;159;"tonga";159;0;100
0;79;"tongela";79;0;100
0;26;"tongia";26;0;100
1474;99165;"toni";100639;1.4646409443655;98.5353590556345
53;22148;"tonia";22201;0.238727985225891;99.7612720147741
0;35;"toniah";35;0;100
0;1287;"toniann";1287;0;100
0;225;"tonianne";225;0;100
0;248;"tonica";248;0;100
0;5;"tonice";5;0;100
0;46;"tonicia";46;0;100
0;6;"tonicka";6;0;100
347;2876;"tonie";3223;10.766366739063;89.233633260937
0;6;"tonielle";6;0;100
0;147;"toniesha";147;0;100
0;67;"toniette";67;0;100
0;17;"tonii";17;0;100
0;5;"tonija";5;0;100
0;853;"tonika";853;0;100
0;11;"tonilyn";11;0;100
0;71;"tonilynn";71;0;100
0;303;"tonimarie";303;0;100
338;0;"tonio";338;100;0
0;122;"toniqua";122;0;100
0;207;"tonique";207;0;100
0;6;"tonirose";6;0;100
0;5;"tonisa";5;0;100
0;5;"tonise";5;0;100
0;2225;"tonisha";2225;0;100
0;87;"tonishia";87;0;100
0;5;"tonisia";5;0;100
0;1101;"tonita";1101;0;100
0;140;"toniya";140;0;100
0;87;"toniyah";87;0;100
5;6989;"tonja";6994;0.0714898484415213;99.9285101515585
0;102;"tonji";102;0;100
0;305;"tonjia";305;0;100
0;114;"tonjua";114;0;100
5;0;"tonka";5;100;0
0;794;"tonna";794;0;100
0;11;"tonnesha";11;0;100
0;16;"tonnetta";16;0;100
0;382;"tonnette";382;0;100
0;261;"tonni";261;0;100
0;112;"tonnia";112;0;100
0;9;"tonnica";9;0;100
473;684;"tonnie";1157;40.8815903197926;59.1184096802074
0;27;"tonnisha";27;0;100
849;0;"tonny";849;100;0
0;72;"tonnya";72;0;100
0;38;"tonoa";38;0;100
0;11;"tonora";11;0;100
0;8;"tonta";8;0;100
0;10;"tonua";10;0;100
247090;2863;"tony";249953;98.8545846619164;1.14541533808356
435;120278;"tonya";120713;0.360358867727585;99.6396411322724
0;68;"tonye";68;0;100
0;6;"tonyeka";6;0;100
0;11;"tonyell";11;0;100
0;94;"tonyetta";94;0;100
0;16;"tonyette";16;0;100
0;572;"tonyia";572;0;100
0;6;"tonyna";6;0;100
0;18;"tonysha";18;0;100
0;6;"tonyua";6;0;100
0;5;"tonza";5;0;100
0;40;"tooba";40;0;100
54;0;"tood";54;100;0
0;12;"toosdhi";12;0;100
0;5;"tootie";5;0;100
0;5;"toots";5;0;100
0;58;"tootsie";58;0;100
0;151;"topacio";151;0;100
0;527;"topanga";527;0;100
6;288;"topaz";294;2.04081632653061;97.9591836734694
0;5;"topazio";5;0;100
0;118;"topeka";118;0;100
76;0;"topher";76;100;0
5;0;"topper";5;100;0
37;0;"toprak";37;100;0
0;17;"topsy";17;0;100
789;0;"tor";789;100;0
26;868;"tora";894;2.9082774049217;97.0917225950783
0;175;"torah";175;0;100
40;0;"toraino";40;100;0
0;26;"toral";26;0;100
316;0;"toran";316;100;0
42;39;"torance";81;51.8518518518518;48.1481481481481
5;0;"toranio";5;100;0
53;0;"torao";53;100;0
5;0;"toray";5;100;0
176;0;"torben";176;100;0
0;5;"torchie";5;0;100
0;8;"torchy";8;0;100
75;11;"tore";86;87.2093023255814;12.7906976744186
41;0;"torean";41;100;0
30;418;"toree";448;6.69642857142857;93.3035714285714
0;5;"torei";5;0;100
63;0;"torell";63;100;0
737;6;"toren";743;99.1924629878869;0.807537012113055
70;5;"torence";75;93.3333333333333;6.66666666666667
11;0;"torenzo";11;100;0
37;0;"toretto";37;100;0
2840;1421;"torey";4261;66.6510208871157;33.3489791128843
90;0;"torez";90;100;0
1125;34762;"tori";35887;3.13483991417505;96.865160085825
0;1119;"toria";1119;0;100
0;37;"toriah";37;0;100
1320;225;"torian";1545;85.4368932038835;14.5631067961165
5;575;"toriana";580;0.862068965517241;99.1379310344828
0;169;"toriann";169;0;100
0;422;"torianna";422;0;100
0;78;"torianne";78;0;100
5;0;"torianno";5;100;0
1163;0;"toriano";1163;100;0
0;6;"toribia";6;0;100
822;0;"toribio";822;100;0
0;7;"torica";7;0;100
268;2740;"torie";3008;8.90957446808511;91.0904255319149
83;0;"torien";83;100;0
17;59;"torii";76;22.3684210526316;77.6315789473684
0;5;"torika";5;0;100
0;30;"torilyn";30;0;100
0;43;"torilynn";43;0;100
3661;170;"torin";3831;95.5625163142783;4.43748368572174
0;212;"torina";212;0;100
45;12;"torino";57;78.9473684210526;21.0526315789474
187;0;"torion";187;100;0
0;30;"toriona";30;0;100
0;39;"torionna";39;0;100
6;0;"toriono";6;100;0
5;0;"torique";5;100;0
120;0;"toris";120;100;0
0;5;"torita";5;0;100
32;0;"torivio";32;100;0
0;5;"toriyah";5;0;100
5;0;"torlan";5;100;0
5;0;"torland";5;100;0
5;0;"tornell";5;100;0
0;5;"tornisha";5;0;100
61;0;"toron";61;100;0
0;59;"toronda";59;0;100
49;0;"toronto";49;100;0
13;0;"torr";13;100;0
0;65;"torra";65;0;100
5;0;"torraine";5;100;0
37;0;"torran";37;100;0
3406;479;"torrance";3885;87.6705276705277;12.3294723294723
15;0;"torray";15;100;0
831;403;"torre";1234;67.3419773095624;32.6580226904376
50;0;"torrean";50;100;0
0;10;"torree";10;0;100
11;0;"torrel";11;100;0
374;0;"torrell";374;100;0
561;27;"torren";588;95.4081632653061;4.59183673469388
3033;166;"torrence";3199;94.8108783994998;5.18912160050016
45;0;"torreon";45;100;0
276;0;"torres";276;100;0
4901;1197;"torrey";6098;80.3706133158413;19.6293866841587
110;0;"torrez";110;100;0
341;2929;"torri";3270;10.4281345565749;89.5718654434251
0;181;"torria";181;0;100
481;11;"torrian";492;97.7642276422764;2.23577235772358
0;53;"torriana";53;0;100
0;6;"torrianna";6;0;100
44;0;"torriano";44;100;0
0;6;"torrica";6;0;100
16;0;"torrick";16;100;0
586;2809;"torrie";3395;17.260677466863;82.739322533137
43;0;"torrien";43;100;0
677;100;"torrin";777;87.1299871299871;12.8700128700129
134;0;"torrion";134;100;0
364;5;"torris";369;98.6449864498645;1.3550135501355
0;5;"torriyah";5;0;100
24;0;"torron";24;100;0
1431;236;"torry";1667;85.8428314337133;14.1571685662867
0;18;"torrye";18;0;100
29;95;"torryn";124;23.3870967741935;76.6129032258064
0;134;"torsha";134;0;100
11;0;"torstein";11;100;0
501;0;"torsten";501;100;0
60;0;"toru";60;100;0
0;46;"torunn";46;0;100
6698;3717;"tory";10415;64.3110897743639;35.6889102256361
0;60;"torya";60;0;100
0;5;"torye";5;0;100
302;271;"toryn";573;52.7050610820244;47.2949389179756
0;5;"torynn";5;0;100
0;372;"tosca";372;0;100
0;59;"toscha";59;0;100
0;5;"toschia";5;0;100
538;0;"tosh";538;100;0
0;6719;"tosha";6719;0;100
0;5;"toshana";5;0;100
0;34;"tosheba";34;0;100
14;85;"toshi";99;14.1414141414141;85.8585858585859
0;1154;"toshia";1154;0;100
43;0;"toshiaki";43;100;0
0;21;"toshiana";21;0;100
0;408;"toshiba";408;0;100
0;168;"toshie";168;0;100
12;0;"toshiharu";12;100;0
0;66;"toshika";66;0;100
5;0;"toshiki";5;100;0
0;799;"toshiko";799;0;100
0;11;"toshima";11;0;100
0;21;"toshina";21;0;100
737;0;"toshio";737;100;0
71;0;"toshiro";71;100;0
0;65;"toshiye";65;0;100
94;0;"toshiyuki";94;100;0
55;129;"toshua";184;29.8913043478261;70.1086956521739
0;5;"toshya";5;0;100
0;32;"tossie";32;0;100
0;106;"totiana";106;0;100
0;34;"totianna";34;0;100
0;5;"totiyana";5;0;100
0;32;"totsie";32;0;100
1254;0;"tou";1254;100;0
170;0;"toua";170;100;0
7;0;"toufic";7;100;0
47;0;"touger";47;100;0
0;176;"toula";176;0;100
387;0;"toure";387;100;0
0;20;"tousha";20;0;100
409;0;"toussaint";409;100;0
0;2128;"tova";2128;0;100
0;531;"tovah";531;0;100
5;0;"tovan";5;100;0
5;0;"tovaris";5;100;0
0;147;"tove";147;0;100
40;0;"tovi";40;100;0
182;41;"tovia";223;81.6143497757848;18.3856502242152
6;0;"toviah";6;100;0
5;0;"tovias";5;100;0
5;0;"tovin";5;100;0
5;0;"toviyah";5;100;0
5;0;"towa";5;100;0
27;0;"towan";27;100;0
0;801;"towana";801;0;100
0;2140;"towanda";2140;0;100
0;708;"towanna";708;0;100
501;0;"townes";501;100;0
654;0;"townsend";654;100;0
0;11;"towonda";11;0;100
0;5;"toxi";5;0;100
33;0;"toxie";33;100;0
1094;957;"toy";2051;53.3398342272062;46.6601657727938
23;3964;"toya";3987;0.576874843240532;99.4231251567595
0;8;"toyah";8;0;100
0;5;"toyana";5;0;100
0;6;"toyce";6;0;100
21;388;"toye";409;5.13447432762836;94.8655256723716
0;5;"toyea";5;0;100
0;565;"toyia";565;0;100
0;18;"toyin";18;0;100
0;11;"toyka";11;0;100
0;276;"toyna";276;0;100
0;6;"toynelle";6;0;100
0;196;"toyoko";196;0;100
0;6;"toyota";6;0;100
0;22;"toyya";22;0;100
0;6;"tpring";6;0;100
6;0;"tquan";6;100;0
5;0;"tr";5;100;0
241;7;"tra";248;97.1774193548387;2.82258064516129
6;0;"trabian";6;100;0
0;26;"traca";26;0;100
10704;343;"trace";11047;96.8950846383634;3.10491536163664
10;3412;"tracee";3422;0.292226767971946;99.707773232028
0;5;"tracei";5;0;100
379;0;"tracen";379;100;0
140;0;"tracer";140;100;0
8618;86381;"tracey";94999;9.0716744386783;90.9283255613217
0;6;"trachell";6;0;100
0;100;"trachelle";100;0;100
233;52093;"traci";52326;0.445285326606276;99.5547146733937
0;414;"tracia";414;0;100
0;19;"traciann";19;0;100
0;5;"tracianne";5;0;100
218;32522;"tracie";32740;0.6658521686011;99.3341478313989
0;5;"tracilyn";5;0;100
0;6;"tracilynn";6;0;100
0;103;"tracina";103;0;100
0;28;"tracine";28;0;100
8;0;"track";8;100;0
55;0;"tracker";55;100;0
60899;250541;"tracy";311440;19.5540071923966;80.4459928076034
0;181;"tracyann";181;0;100
5;1080;"tracye";1085;0.460829493087558;99.5391705069124
0;12;"tracylee";12;0;100
0;15;"tracylynn";15;0;100
32;0;"tracyn";32;100;0
31;0;"trad";31;100;0
119;0;"tradarius";119;100;0
16;0;"tradarrius";16;100;0
41;0;"tradd";41;100;0
13;0;"tradell";13;100;0
53;0;"traden";53;100;0
16;0;"tradon";16;100;0
3633;46;"trae";3679;98.7496602337592;1.25033976624083
23;0;"traeden";23;100;0
18;0;"traedyn";18;100;0
31;0;"traegan";31;100;0
62;0;"traeger";62;100;0
29;71;"traeh";100;29;71
15;0;"traelon";15;100;0
15;0;"traelyn";15;100;0
6;0;"traequan";6;100;0
12;0;"traesean";12;100;0
5;0;"traeshaun";5;100;0
35;0;"traeshawn";35;100;0
6;0;"traeshon";6;100;0
73;0;"traeson";73;100;0
13;0;"traesyn";13;100;0
156;0;"traeton";156;100;0
5;0;"traetyn";5;100;0
5;0;"traeven";5;100;0
17;0;"traeveon";17;100;0
12;0;"traevin";12;100;0
114;0;"traevion";114;100;0
715;0;"traevon";715;100;0
15;0;"traevyn";15;100;0
73;0;"trafton";73;100;0
15;0;"tragen";15;100;0
15;0;"trager";15;100;0
11;0;"trahern";11;100;0
269;0;"trai";269;100;0
5;13;"traice";18;27.7777777777778;72.2222222222222
41;0;"traiden";41;100;0
0;7;"traie";7;0;100
5;0;"traig";5;100;0
14;0;"traigh";14;100;0
5;0;"trail";5;100;0
6;0;"trais";6;100;0
11;0;"traison";11;100;0
6;0;"traiten";6;100;0
22;0;"traiton";22;100;0
5;0;"traiveon";5;100;0
241;0;"traivon";241;100;0
690;0;"trajan";690;100;0
55;0;"trajen";55;100;0
71;0;"trajon";71;100;0
5;0;"trajuan";5;100;0
0;7;"trakeila";7;0;100
0;6;"trakelia";6;0;100
0;5;"trakia";5;0;100
0;5;"tralaina";5;0;100
0;18;"tralana";18;0;100
0;5;"tralaya";5;0;100
0;10;"tralena";10;0;100
10;0;"tralon";10;100;0
23;0;"tralyn";23;100;0
0;10;"tralynn";10;0;100
0;455;"tram";455;0;100
141;0;"tramain";141;100;0
1760;561;"tramaine";2321;75.8293838862559;24.1706161137441
5;0;"tramal";5;100;0
10;0;"tramale";10;100;0
67;0;"tramane";67;100;0
0;24;"tramanh";24;0;100
61;0;"tramar";61;100;0
5;0;"tramarcus";5;100;0
5;0;"tramari";5;100;0
19;0;"tramarion";19;100;0
259;0;"tramayne";259;100;0
0;131;"trameka";131;0;100
491;0;"tramel";491;100;0
634;0;"tramell";634;100;0
16;0;"tramelle";16;100;0
0;20;"tramesha";20;0;100
0;6;"trami";6;0;100
0;36;"tramia";36;0;100
0;7;"tramiah";7;0;100
0;36;"tramika";36;0;100
30;5;"tramine";35;85.7142857142857;14.2857142857143
0;5;"tramisha";5;0;100
0;33;"tramiya";33;0;100
0;31;"tramiyah";31;0;100
116;0;"trammell";116;100;0
311;0;"tramon";311;100;0
67;0;"tramond";67;100;0
29;0;"tramone";29;100;0
395;0;"trampas";395;100;0
29;0;"trampis";29;100;0
277;0;"trampus";277;100;0
0;103;"tramya";103;0;100
123;554;"tran";677;18.1683899556869;81.8316100443131
0;119;"trana";119;0;100
0;191;"tranae";191;0;100
11;0;"tranard";11;100;0
0;5;"tranasia";5;0;100
0;5;"tranay";5;0;100
0;7;"tranaya";7;0;100
41;0;"trance";41;100;0
0;5;"tranda";5;0;100
29;0;"trandon";29;100;0
0;54;"trane";54;0;100
0;5;"tranea";5;0;100
0;15;"tranecia";15;0;100
0;11;"tranee";11;0;100
0;10;"traneice";10;0;100
0;22;"traneisha";22;0;100
0;5;"traneka";5;0;100
8;0;"tranel";8;100;0
98;40;"tranell";138;71.0144927536232;28.9855072463768
0;29;"tranese";29;0;100
0;95;"tranesha";95;0;100
0;13;"traneshia";13;0;100
0;7;"tranessa";7;0;100
0;17;"tranette";17;0;100
8;955;"trang";963;0.83073727933541;99.1692627206646
0;26;"trania";26;0;100
0;76;"tranice";76;0;100
0;95;"traniece";95;0;100
0;75;"tranika";75;0;100
0;20;"traniqua";20;0;100
6;0;"tranis";6;100;0
0;78;"tranise";78;0;100
0;189;"tranisha";189;0;100
0;22;"tranita";22;0;100
0;170;"traniya";170;0;100
0;158;"traniyah";158;0;100
0;167;"trannie";167;0;100
173;0;"tranquilino";173;100;0
0;308;"trany";308;0;100
0;18;"tranya";18;0;100
0;5;"tranyah";5;0;100
0;11;"tranyce";11;0;100
5;0;"trapp";5;100;0
801;0;"trapper";801;100;0
328;0;"traquan";328;100;0
5;0;"traquez";5;100;0
0;16;"trasa";16;0;100
71;0;"trase";71;100;0
72;0;"trasean";72;100;0
5;0;"trasen";5;100;0
0;29;"trasha";29;0;100
127;0;"trashaun";127;100;0
384;29;"trashawn";413;92.9782082324455;7.02179176755448
0;5;"trashell";5;0;100
34;0;"trashon";34;100;0
0;5;"trashonda";5;0;100
11;0;"trashun";11;100;0
0;6;"trasi";6;0;100
0;5;"trasia";5;0;100
113;0;"trask";113;100;0
153;0;"trason";153;100;0
22;0;"trauis";22;100;0
17;0;"traun";17;100;0
0;5;"trava";5;0;100
15;0;"travail";15;100;0
21;0;"travan";21;100;0
68;0;"travante";68;100;0
81;0;"travanti";81;100;0
85;0;"travares";85;100;0
41;0;"travarious";41;100;0
408;0;"travaris";408;100;0
103;0;"travarius";103;100;0
77;0;"travarus";77;100;0
199;0;"travas";199;100;0
158;0;"travaughn";158;100;0
5;0;"travaun";5;100;0
65;0;"traveion";65;100;0
5;0;"travel";5;100;0
782;0;"travell";782;100;0
280;0;"travelle";280;100;0
772;0;"traven";772;100;0
1006;0;"traveon";1006;100;0
290;0;"traver";290;100;0
382;0;"travers";382;100;0
5;0;"traverse";5;100;0
306;0;"traves";306;100;0
0;11;"travette";11;0;100
6;0;"traveyon";6;100;0
76;0;"travez";76;100;0
0;208;"travia";208;0;100
310;0;"travian";310;100;0
0;5;"travianna";5;0;100
10;0;"travie";10;100;0
41;0;"travien";41;100;0
423;0;"travin";423;100;0
0;28;"travina";28;0;100
2225;0;"travion";2225;100;0
0;18;"traviona";18;0;100
15;0;"travione";15;100;0
0;19;"travionna";19;0;100
5;0;"travionne";5;100;0
320;0;"travious";320;100;0
299919;2116;"travis";302035;99.2994189415134;0.700581058486599
0;8;"travisha";8;0;100
12;0;"traviss";12;100;0
195;0;"travius";195;100;0
11;0;"travolta";11;100;0
6245;28;"travon";6273;99.5536425952495;0.446357404750518
0;10;"travona";10;0;100
6;0;"travond";6;100;0
0;37;"travonda";37;0;100
252;0;"travone";252;100;0
47;0;"travonn";47;100;0
0;78;"travonna";78;0;100
122;0;"travonne";122;100;0
119;0;"travonta";119;100;0
159;0;"travontae";159;100;0
5;0;"travontay";5;100;0
462;0;"travonte";462;100;0
109;0;"travor";109;100;0
144;0;"travoris";144;100;0
85;0;"travus";85;100;0
38;0;"travyn";38;100;0
26;0;"travyon";26;100;0
34;0;"travys";34;100;0
6;0;"trawn";6;100;0
19;0;"trax";19;100;0
114;0;"traxton";114;100;0
1455;0;"tray";1455;100;0
0;45;"trayana";45;0;100
0;20;"trayanna";20;0;100
5;0;"trayc";5;100;0
367;208;"trayce";575;63.8260869565217;36.1739130434783
0;10;"traycee";10;0;100
76;0;"traycen";76;100;0
0;6;"trayci";6;0;100
243;0;"trayden";243;100;0
13;0;"traydon";13;100;0
103;0;"traye";103;100;0
5;0;"traylan";5;100;0
97;0;"traylen";97;100;0
35;0;"traylin";35;100;0
249;0;"traylon";249;100;0
11;0;"traylor";11;100;0
25;0;"traymon";25;100;0
394;0;"trayon";394;100;0
0;7;"trayona";7;0;100
0;64;"trayonna";64;0;100
90;0;"trayquan";90;100;0
5;0;"trayse";5;100;0
6;0;"traysean";6;100;0
58;0;"traysen";58;100;0
21;0;"trayshaun";21;100;0
228;0;"trayshawn";228;100;0
13;0;"trayshon";13;100;0
6;0;"trayshun";6;100;0
338;0;"trayson";338;100;0
38;0;"trayten";38;100;0
819;0;"trayton";819;100;0
104;0;"trayven";104;100;0
378;0;"trayveon";378;100;0
28;0;"trayvin";28;100;0
423;0;"trayvion";423;100;0
10;0;"trayvis";10;100;0
3002;0;"trayvon";3002;100;0
79;0;"trayvond";79;100;0
50;0;"trayvone";50;100;0
30;0;"trayvonne";30;100;0
0;12;"trcy";12;0;100
5370;58;"tre";5428;98.9314664701547;1.06853352984525
300;112;"trea";412;72.8155339805825;27.1844660194175
0;78;"treacy";78;0;100
17;0;"treagan";17;100;0
0;312;"treana";312;0;100
0;277;"treanna";277;0;100
20;0;"treanthony";20;100;0
0;1671;"treasa";1671;0;100
0;145;"trease";145;0;100
0;29;"treasea";29;0;100
0;6;"treasia";6;0;100
0;11;"treasie";11;0;100
117;5548;"treasure";5665;2.06531332744925;97.9346866725508
10;0;"treat";10;100;0
0;12;"treauna";12;0;100
0;5;"treava";5;0;100
5;0;"treaven";5;100;0
21;0;"treaver";21;100;0
5;0;"treavion";5;100;0
230;0;"treavon";230;100;0
740;0;"treavor";740;100;0
0;257;"treazure";257;0;100
0;32;"treba";32;0;100
10;0;"treble";10;100;0
487;0;"trebor";487;100;0
0;21;"treca";21;0;100
0;21;"trechelle";21;0;100
0;691;"trecia";691;0;100
0;22;"trecie";22;0;100
10;0;"tred";10;100;0
0;5;"treda";5;0;100
5;0;"tredan";5;100;0
134;0;"tredarius";134;100;0
12;0;"tredell";12;100;0
0;6;"tredena";6;0;100
5;0;"tredon";5;100;0
20;0;"tredyn";20;100;0
0;852;"treena";852;0;100
0;68;"treesa";68;0;100
297;0;"treg";297;100;0
64;0;"tregan";64;100;0
42;0;"tregg";42;100;0
149;0;"trei";149;100;0
20;0;"treigh";20;100;0
49;0;"treighton";49;100;0
0;77;"treina";77;0;100
0;15;"treisa";15;0;100
0;5;"treisha";5;0;100
12;0;"treivon";12;100;0
90;0;"trejan";90;100;0
12;0;"trejaun";12;100;0
18;0;"trejean";18;100;0
20;0;"trejohn";20;100;0
308;0;"trejon";308;100;0
62;0;"trejuan";62;100;0
0;22;"trejure";22;0;100
104;0;"trek";104;100;0
0;18;"treka";18;0;100
5;0;"trekwan";5;100;0
11;0;"trekwon";11;100;0
0;33;"trela";33;0;100
10;0;"trelan";10;100;0
0;6;"trelana";6;0;100
8;0;"trelen";8;100;0
17;0;"trelin";17;100;0
0;5;"trelisa";5;0;100
79;0;"trell";79;100;0
0;465;"trella";465;0;100
0;10;"trellany";10;0;100
103;344;"trellis";447;23.0425055928412;76.9574944071588
116;0;"trelon";116;100;0
121;0;"trelyn";121;100;0
12;10;"trelynn";22;54.5454545454545;45.4545454545455
0;6;"trema";6;0;100
937;0;"tremain";937;100;0
4125;288;"tremaine";4413;93.4738273283481;6.52617267165194
5;0;"tremal";5;100;0
73;0;"tremane";73;100;0
65;0;"tremar";65;100;0
10;0;"tremarcus";10;100;0
14;0;"tremari";14;100;0
39;0;"tremarion";39;100;0
0;11;"tremaya";11;0;100
3773;39;"tremayne";3812;98.9769150052466;1.02308499475341
0;100;"tremeka";100;0;100
0;6;"tremekia";6;0;100
337;0;"tremel";337;100;0
570;0;"tremell";570;100;0
18;0;"tremelle";18;100;0
6;0;"tremere";6;100;0
0;5;"tremesha";5;0;100
0;21;"tremia";21;0;100
0;5;"tremica";5;0;100
0;34;"tremika";34;0;100
5;0;"tremir";5;100;0
0;10;"tremiyah";10;0;100
347;0;"tremon";347;100;0
87;0;"tremond";87;100;0
28;0;"tremone";28;100;0
77;0;"tremont";77;100;0
20;0;"tremonte";20;100;0
0;58;"tremya";58;0;100
0;7;"tremyah";7;0;100
10;0;"tren";10;100;0
0;5160;"trena";5160;0;100
0;100;"trenace";100;0;100
0;5;"trenadi";5;0;100
0;36;"trenady";36;0;100
0;233;"trenae";233;0;100
39;0;"trenard";39;100;0
0;5;"trenasia";5;0;100
0;5;"trenaty";5;0;100
0;26;"trenay";26;0;100
25;0;"trence";25;100;0
0;673;"trenda";673;0;100
5;0;"trendan";5;100;0
5;0;"trendarius";5;100;0
30;0;"trendell";30;100;0
93;0;"trenden";93;100;0
252;0;"trendon";252;100;0
26;0;"trendyn";26;100;0
0;32;"trene";32;0;100
0;10;"trenea";10;0;100
0;15;"trenece";15;0;100
0;40;"trenecia";40;0;100
0;13;"trenedy";13;0;100
0;113;"trenee";113;0;100
0;49;"treneice";49;0;100
0;5;"treneisha";5;0;100
0;25;"treneka";25;0;100
286;144;"trenell";430;66.5116279069767;33.4883720930233
0;72;"trenese";72;0;100
0;59;"trenesha";59;0;100
0;10;"trenetta";10;0;100
0;15;"trenette";15;0;100
0;364;"trenia";364;0;100
0;6;"trenica";6;0;100
0;351;"trenice";351;0;100
0;17;"trenicia";17;0;100
29;26;"trenidad";55;52.7272727272727;47.2727272727273
0;46;"trenidy";46;0;100
0;185;"treniece";185;0;100
0;117;"trenika";117;0;100
0;475;"trenise";475;0;100
0;191;"trenisha";191;0;100
0;106;"trenita";106;0;100
0;10;"trenitee";10;0;100
0;38;"treniti";38;0;100
23;720;"trenity";743;3.09555854643338;96.9044414535666
0;71;"treniya";71;0;100
0;62;"treniyah";62;0;100
0;736;"trenna";736;0;100
10;0;"trennan";10;100;0
0;10;"trennedy";10;0;100
35;0;"trennen";35;100;0
27;0;"trennis";27;100;0
64;0;"trennon";64;100;0
0;33;"trenny";33;0;100
11;0;"trenon";11;100;0
49566;102;"trent";49668;99.7946363856004;0.205363614399613
135;0;"trentan";135;100;0
5;0;"trentavious";5;100;0
3109;0;"trenten";3109;100;0
1230;0;"trentin";1230;100;0
0;6;"trentity";6;0;100
6;0;"trento";6;100;0
54804;78;"trenton";54882;99.8578768995299;0.142123100470099
536;0;"trentyn";536;100;0
0;15;"trenya";15;0;100
0;123;"trenyce";123;0;100
247;0;"treon";247;100;0
0;47;"treona";47;0;100
0;121;"treonna";121;0;100
807;0;"trequan";807;100;0
46;0;"trequon";46;100;0
6;0;"treqwan";6;100;0
21;0;"treron";21;100;0
405;5;"tres";410;98.780487804878;1.21951219512195
0;4823;"tresa";4823;0;100
10;0;"tresaun";10;100;0
0;5;"tresca";5;0;100
0;60;"trese";60;0;100
0;396;"tresea";396;0;100
597;0;"tresean";597;100;0
0;649;"tresha";649;0;100
6;0;"treshad";6;100;0
760;5;"treshaun";765;99.3464052287582;0.65359477124183
1393;5;"treshawn";1398;99.6423462088698;0.357653791130186
0;5;"treshell";5;0;100
0;6;"treshia";6;0;100
407;0;"treshon";407;100;0
126;0;"treshun";126;100;0
0;492;"tresia";492;0;100
86;0;"treson";86;100;0
14;5;"tresor";19;73.6842105263158;26.3157894736842
0;23;"tress";23;0;100
0;6612;"tressa";6612;0;100
16;0;"tressel";16;100;0
0;351;"tressia";351;0;100
6;4877;"tressie";4883;0.122875281589187;99.8771247184108
0;171;"tressy";171;0;100
0;5;"tresta";5;0;100
129;0;"trestan";129;100;0
134;0;"tresten";134;100;0
183;0;"trestin";183;100;0
1167;0;"treston";1167;100;0
33;0;"trestyn";33;100;0
0;59;"tresure";59;0;100
5;0;"tresvon";5;100;0
0;16;"tretha";16;0;100
50;0;"treton";50;100;0
78;0;"trev";78;100;0
6;9483;"treva";9489;0.0632311097059753;99.936768890294
24;0;"trevahn";24;100;0
6;0;"trevail";6;100;0
934;0;"trevan";934;100;0
194;0;"trevante";194;100;0
367;0;"trevar";367;100;0
5;0;"trevares";5;100;0
7;0;"trevarious";7;100;0
102;0;"trevaris";102;100;0
56;0;"trevarius";56;100;0
5;0;"trevathan";5;100;0
816;0;"trevaughn";816;100;0
236;0;"trevaun";236;100;0
5;0;"treve";5;100;0
54;0;"treveion";54;100;0
89;0;"trevel";89;100;0
617;0;"trevell";617;100;0
184;0;"trevelle";184;100;0
6;0;"trevelyan";6;100;0
1035;0;"treven";1035;100;0
1315;0;"treveon";1315;100;0
6181;0;"trever";6181;100;0
5;0;"treves";5;100;0
31;0;"treveyon";31;100;0
11;0;"trevez";11;100;0
5;0;"trevhon";5;100;0
0;22;"trevi";22;0;100
0;258;"trevia";258;0;100
430;0;"trevian";430;100;0
11;0;"trevien";11;100;0
5;0;"trevier";5;100;0
4364;0;"trevin";4364;100;0
0;27;"trevina";27;0;100
162;0;"trevino";162;100;0
2875;0;"trevion";2875;100;0
70;0;"trevione";70;100;0
64;0;"trevionne";64;100;0
81;0;"trevious";81;100;0
0;5;"trevira";5;0;100
1744;10;"trevis";1754;99.4298745724059;0.570125427594071
34;0;"trevius";34;100;0
16;0;"trevohn";16;100;0
13413;25;"trevon";13438;99.8139604107754;0.186039589224587
0;5;"trevona";5;0;100
22;0;"trevond";22;100;0
256;0;"trevone";256;100;0
210;0;"trevonn";210;100;0
0;27;"trevonna";27;0;100
287;0;"trevonne";287;100;0
60;0;"trevonta";60;100;0
149;0;"trevontae";149;100;0
16;0;"trevontay";16;100;0
559;0;"trevonte";559;100;0
155229;611;"trevor";155840;99.607931211499;0.392068788501027
5;0;"trevore";5;100;0
22;0;"trevoris";22;100;0
5;0;"trevorjames";5;100;0
31;0;"trevour";31;100;0
5;0;"trevun";5;100;0
5;0;"trevvor";5;100;0
718;0;"trevyn";718;100;0
133;0;"trevyon";133;100;0
96;11;"trew";107;89.7196261682243;10.2803738317757
39;0;"trexton";39;100;0
36862;97;"trey";36959;99.7375470115533;0.262452988446657
0;41;"treya";41;0;100
0;71;"treyana";71;0;100
0;43;"treyanna";43;0;100
254;0;"treyce";254;100;0
41;0;"treycen";41;100;0
25;0;"treydan";25;100;0
412;0;"treyden";412;100;0
149;0;"treydon";149;100;0
45;0;"treye";45;100;0
32;0;"treygan";32;100;0
130;0;"treylan";130;100;0
97;0;"treylen";97;100;0
117;0;"treylin";117;100;0
269;0;"treylon";269;100;0
6;0;"treylyn";6;100;0
5;0;"treymaine";5;100;0
5;0;"treymane";5;100;0
55;0;"treymon";55;100;0
384;0;"treyon";384;100;0
0;33;"treyonna";33;0;100
13;0;"treyor";13;100;0
43;0;"treyquan";43;100;0
75;0;"treysean";75;100;0
226;0;"treysen";226;100;0
121;0;"treyshaun";121;100;0
327;0;"treyshawn";327;100;0
62;0;"treyshon";62;100;0
7;0;"treyshun";7;100;0
5;0;"treysin";5;100;0
1390;0;"treyson";1390;100;0
5;0;"treyston";5;100;0
123;0;"treyten";123;100;0
10;0;"treytin";10;100;0
2801;0;"treyton";2801;100;0
38;0;"treyvan";38;100;0
46;0;"treyvaughn";46;100;0
122;0;"treyven";122;100;0
340;0;"treyveon";340;100;0
37;0;"treyvian";37;100;0
128;0;"treyvin";128;100;0
567;0;"treyvion";567;100;0
3509;0;"treyvon";3509;100;0
19;0;"treyvond";19;100;0
64;0;"treyvone";64;100;0
32;0;"treyvonn";32;100;0
69;0;"treyvonne";69;100;0
7;0;"treyvonte";7;100;0
31;0;"treyvor";31;100;0
39;0;"trez";39;100;0
13;0;"trezden";13;100;0
19;0;"trezdon";19;100;0
12;0;"trezon";12;100;0
0;162;"trezure";162;0;100
639;0;"tri";639;100;0
0;239;"tria";239;0;100
0;929;"triana";929;0;100
5;0;"triandos";5;100;0
0;435;"trianna";435;0;100
0;6;"tribeca";6;0;100
0;5;"tribecca";5;0;100
0;200;"trica";200;0;100
92;0;"trice";92;100;0
0;99;"tricha";99;0;100
0;165;"trichelle";165;0;100
0;31;"trichia";31;0;100
88;40044;"tricia";40132;0.219276387919864;99.7807236120801
0;9;"tricity";9;0;100
0;25;"triena";25;0;100
0;6;"trier";6;0;100
0;45;"trieste";45;0;100
15;0;"trieu";15;100;0
5;0;"trifon";5;100;0
152;0;"trig";152;100;0
285;0;"trigg";285;100;0
150;0;"trigger";150;100;0
68;0;"trigo";68;100;0
5;0;"trijal";5;100;0
0;27;"trilba";27;0;100
0;549;"trilby";549;0;100
5;0;"trill";5;100;0
0;59;"trilla";59;0;100
5;37;"trillian";42;11.9047619047619;88.0952380952381
40;0;"trillion";40;100;0
0;5;"trillis";5;0;100
0;44;"trillium";44;0;100
64;0;"trimaine";64;100;0
5;0;"trimayne";5;100;0
0;36;"trimeka";36;0;100
0;6;"trimika";6;0;100
30;32406;"trina";32436;0.0924898261191269;99.9075101738809
0;62;"trinadee";62;0;100
0;5;"trinadi";5;0;100
0;160;"trinady";160;0;100
0;48;"trinae";48;0;100
0;18;"trinatee";18;0;100
0;23;"trinati";23;0;100
0;144;"trinaty";144;0;100
5;0;"trinay";5;100;0
0;309;"trinda";309;0;100
12;0;"trinden";12;100;0
101;0;"trindon";101;100;0
40;307;"trine";347;11.5273775216138;88.4726224783862
0;5;"trinea";5;0;100
0;14;"trineka";14;0;100
5;40;"trinell";45;11.1111111111111;88.8888888888889
0;5;"trinere";5;0;100
0;25;"trinese";25;0;100
0;26;"trinesha";26;0;100
0;126;"trinetta";126;0;100
0;956;"trinette";956;0;100
0;13;"trinety";13;0;100
0;443;"trinh";443;0;100
236;703;"trini";939;25.1331203407881;74.8668796592119
0;316;"trinia";316;0;100
0;36;"trinice";36;0;100
0;6;"trinicia";6;0;100
5;0;"trinida";5;100;0
5169;4209;"trinidad";9378;55.1183621241203;44.8816378758797
0;128;"trinidee";128;0;100
0;63;"trinidi";63;0;100
0;5;"trinidie";5;0;100
33;793;"trinidy";826;3.99515738498789;96.0048426150121
0;42;"trinie";42;0;100
0;39;"triniece";39;0;100
0;79;"trinika";79;0;100
0;13;"trinisa";13;0;100
0;17;"trinise";17;0;100
0;84;"trinisha";84;0;100
0;205;"trinita";205;0;100
0;11;"trinite";11;0;100
0;1331;"trinitee";1331;0;100
0;86;"trinitey";86;0;100
0;2476;"triniti";2476;0;100
0;298;"trinitie";298;0;100
0;16;"trinitty";16;0;100
2718;74056;"trinity";76774;3.54026102586813;96.4597389741319
0;10;"triniya";10;0;100
0;6;"triniyah";6;0;100
0;81;"trinka";81;0;100
0;16;"trinket";16;0;100
0;18;"trinley";18;0;100
0;134;"trinna";134;0;100
0;35;"trinnie";35;0;100
0;185;"trinnity";185;0;100
299;0;"trino";299;100;0
16;0;"trint";16;100;0
106;0;"trinten";106;100;0
60;0;"trintin";60;100;0
0;12;"trintiy";12;0;100
698;0;"trinton";698;100;0
0;137;"trinty";137;0;100
5;0;"trintyn";5;100;0
0;11;"triny";11;0;100
0;19;"trinyti";19;0;100
5;0;"trion";5;100;0
0;22;"triona";22;0;100
0;25;"trionna";25;0;100
262;0;"trip";262;100;0
3869;0;"tripp";3869;100;0
27;0;"tripper";27;100;0
6;0;"trippton";6;100;0
58;0;"tripton";58;100;0
59;118;"tris";177;33.3333333333333;66.6666666666667
0;475;"trisa";475;0;100
0;5;"trisca";5;0;100
0;50;"trischa";50;0;100
0;19;"triscia";19;0;100
0;7;"triscilla";7;0;100
6;0;"trisco";6;100;0
35;0;"trisden";35;100;0
0;3063;"trish";3063;0;100
53;39773;"trisha";39826;0.133078893185356;99.8669211068146
0;5;"trishalana";5;0;100
0;5;"trishamae";5;0;100
5;0;"trishan";5;100;0
0;53;"trishana";53;0;100
0;15;"trishanna";15;0;100
10;12;"trishawn";22;45.4545454545455;54.5454545454545
0;5;"trishawna";5;0;100
0;12;"trishell";12;0;100
0;210;"trishelle";210;0;100
0;701;"trishia";701;0;100
0;18;"trishika";18;0;100
0;95;"trishna";95;0;100
0;5;"trishona";5;0;100
0;11;"trishonda";11;0;100
0;52;"trisia";52;0;100
0;5;"trisity";5;0;100
0;5;"triska";5;0;100
37;0;"trison";37;100;0
0;14;"triss";14;0;100
0;214;"trissa";214;0;100
0;6;"trissie";6;0;100
5;12363;"trista";12368;0.0404269081500647;99.9595730918499
0;22;"tristaca";22;0;100
0;6;"tristah";6;0;100
343;11;"tristain";354;96.8926553672316;3.10734463276836
5;0;"tristam";5;100;0
105625;6273;"tristan";111898;94.3940016801015;5.60599831989848
0;25;"tristana";25;0;100
5;0;"tristanjames";5;100;0
0;5;"tristann";5;0;100
5;0;"tristano";5;100;0
0;31;"tristany";31;0;100
0;5;"triste";5;0;100
19350;4093;"tristen";23443;82.5406304653841;17.4593695346159
0;25;"tristi";25;0;100
0;14;"tristia";14;0;100
6463;628;"tristian";7091;91.1437032858553;8.85629671414469
0;11;"tristiana";11;0;100
0;10;"tristianna";10;0;100
0;6;"tristica";6;0;100
6;0;"tristien";6;100;0
9108;2775;"tristin";11883;76.647311285029;23.352688714971
0;437;"tristina";437;0;100
5;201;"tristine";206;2.42718446601942;97.5728155339806
44;0;"tristion";44;100;0
10874;274;"triston";11148;97.5421600287047;2.4578399712953
114;0;"tristram";114;100;0
16;0;"tristun";16;100;0
0;64;"tristy";64;0;100
1849;1958;"tristyn";3807;48.568426582611;51.431573417389
0;57;"tristynn";57;0;100
30;0;"tritan";30;100;0
0;79;"tritia";79;0;100
1000;0;"triton";1000;100;0
38;0;"triumph";38;100;0
0;97;"triva";97;0;100
0;160;"trivia";160;0;100
0;5;"trivian";5;0;100
15;0;"trivon";15;100;0
0;10;"trixi";10;0;100
0;1236;"trixie";1236;0;100
0;174;"trixy";174;0;100
0;6;"triya";6;0;100
0;5;"troas";5;0;100
115;705;"troi";820;14.0243902439024;85.9756097560976
0;17;"troian";17;0;100
17;0;"tromaine";17;100;0
529;7;"tron";536;98.6940298507463;1.30597014925373
0;18;"trona";18;0;100
10;0;"trond";10;100;0
0;60;"tronda";60;0;100
19;0;"trone";19;100;0
61;0;"trong";61;100;0
86;0;"trooper";86;100;0
21;0;"trotter";21;100;0
16;0;"trovon";16;100;0
17;0;"trowa";17;100;0
209275;2616;"troy";211891;98.7654029666196;1.23459703338037
0;58;"troya";58;0;100
7;0;"troyal";7;100;0
0;6;"troyanne";6;0;100
393;62;"troyce";455;86.3736263736264;13.6263736263736
75;22;"troye";97;77.319587628866;22.680412371134
0;23;"troylene";23;0;100
0;52;"troylynn";52;0;100
10;0;"troyvon";10;100;0
801;812;"tru";1613;49.6590204587725;50.3409795412275
33;34;"truby";67;49.2537313432836;50.7462686567164
17;226;"truc";243;6.99588477366255;93.0041152263374
19;0;"truce";19;100;0
0;5;"trucilla";5;0;100
15;0;"trucker";15;100;0
0;114;"truda";114;0;100
0;5;"truddie";5;0;100
0;267;"trude";267;0;100
0;97;"trudee";97;0;100
0;54;"trudell";54;0;100
0;7;"trudence";7;0;100
0;3210;"trudi";3210;0;100
0;2953;"trudie";2953;0;100
0;5;"trudis";5;0;100
0;28;"trudith";28;0;100
5;25384;"trudy";25389;0.0196935680806649;99.9803064319193
941;759;"true";1700;55.3529411764706;44.6470588235294
6;0;"truel";6;100;0
0;10;"truely";10;0;100
273;0;"trueman";273;100;0
21;0;"truen";21;100;0
1884;5;"truett";1889;99.7353096876654;0.264690312334569
5;0;"truette";5;100;0
966;0;"truitt";966;100;0
0;2005;"trula";2005;0;100
0;71;"trulee";71;0;100
0;9;"truley";9;0;100
0;45;"trulie";45;0;100
5;617;"truly";622;0.803858520900322;99.1961414790997
0;6;"truma";6;0;100
400;0;"trumaine";400;100;0
14408;26;"truman";14434;99.8198697519745;0.180130248025495
5;0;"trumell";5;100;0
41;0;"trumon";41;100;0
5;0;"trunell";5;100;0
0;7;"trunetta";7;0;100
760;0;"trung";760;100;0
237;0;"truong";237;100;0
0;7;"trupti";7;0;100
0;5;"trusha";5;0;100
141;64;"trust";205;68.780487804878;31.219512195122
87;0;"trusten";87;100;0
522;0;"trustin";522;100;0
41;0;"truston";41;100;0
23;0;"trustyn";23;100;0
461;316;"truth";777;59.3307593307593;40.6692406692407
102;0;"truxton";102;100;0
15;0;"trvis";15;100;0
23;0;"tryan";23;100;0
128;0;"tryce";128;100;0
5;0;"tryell";5;100;0
26;0;"tryg";26;100;0
74;0;"trygg";74;100;0
333;0;"trygve";333;100;0
0;57;"tryna";57;0;100
0;5;"trynati";5;0;100
0;59;"trynitee";59;0;100
0;154;"tryniti";154;0;100
0;393;"trynity";393;0;100
30;0;"trynt";30;100;0
20;0;"trynton";20;100;0
34;0;"tryon";34;100;0
253;0;"tryone";253;100;0
6;0;"tryp";6;100;0
0;110;"tryphena";110;0;100
83;0;"trypp";83;100;0
0;27;"trysha";27;0;100
99;0;"tryson";99;100;0
0;354;"trysta";354;0;100
0;5;"trystal";5;0;100
3985;643;"trystan";4628;86.1063094209162;13.8936905790838
1274;285;"trysten";1559;81.7190506735087;18.2809493264913
167;0;"trystian";167;100;0
754;283;"trystin";1037;72.7097396335583;27.2902603664417
5;0;"trystn";5;100;0
1263;10;"tryston";1273;99.2144540455617;0.785545954438335
200;79;"trystyn";279;71.6845878136201;28.3154121863799
174;0;"tryton";174;100;0
10;0;"tsai";10;100;0
10;0;"tsean";10;100;0
0;10;"tsega";10;0;100
0;10;"tselane";10;0;100
23;77;"tsering";100;23;77
0;5;"tshai";5;0;100
12;0;"tshaka";12;100;0
0;7;"tshanti";7;0;100
0;10;"tshara";10;0;100
24;0;"tshawn";24;100;0
0;5;"tshaye";5;0;100
42;0;"tshombe";42;100;0
0;9;"tshwanda";9;0;100
0;5;"tsianina";5;0;100
0;5;"tsianna";5;0;100
37;217;"tsion";254;14.5669291338583;85.4330708661417
0;8;"tsitsiki";8;0;100
12;0;"tsosie";12;100;0
0;10;"tsubaki";10;0;100
39;0;"tsubasa";39;100;0
0;17;"tsugie";17;0;100
123;0;"tsugio";123;100;0
25;0;"tsukasa";25;100;0
0;5;"tsunade";5;0;100
0;12;"tsunami";12;0;100
0;43;"tsuneko";43;0;100
113;0;"tsuneo";113;100;0
0;25;"tsurue";25;0;100
0;185;"tsuruko";185;0;100
0;5;"tsuruyo";5;0;100
0;5;"tsutako";5;0;100
352;0;"tsutomu";352;100;0
0;126;"tsuyako";126;0;100
34;0;"tsuyoshi";34;100;0
0;51;"tsuyuko";51;0;100
0;5;"tsvia";5;0;100
318;109;"tu";427;74.4730679156909;25.5269320843091
1392;0;"tuan";1392;100;0
0;62;"tuana";62;0;100
0;37;"tuba";37;0;100
145;0;"tuck";145;100;0
36991;289;"tucker";37280;99.2247854077253;0.775214592274678
5;0;"tucson";5;100;0
59;0;"tudor";59;100;0
0;5;"tudy";5;0;100
11;0;"tue";11;100;0
0;103;"tuere";103;0;100
0;25;"tuesdae";25;0;100
0;5;"tuesdai";5;0;100
0;2422;"tuesday";2422;0;100
0;15;"tuesdee";15;0;100
25;0;"tuf";25;100;0
462;0;"tuff";462;100;0
35;0;"tug";35;100;0
5;0;"tugg";5;100;0
5;0;"tujuan";5;100;0
0;155;"tujuana";155;0;100
0;5;"tukesha";5;0;100
68;0;"tukker";68;100;0
0;1382;"tula";1382;0;100
0;16;"tulah";16;0;100
0;63;"tulani";63;0;100
0;12;"tulasi";12;0;100
0;115;"tuleen";115;0;100
0;28;"tulia";28;0;100
237;0;"tulio";237;100;0
0;83;"tulip";83;0;100
0;5;"tulisa";5;0;100
0;16;"tullia";16;0;100
17;0;"tullie";17;100;0
150;0;"tullio";150;100;0
5;0;"tullis";5;100;0
927;47;"tully";974;95.1745379876797;4.82546201232033
6;0;"tulon";6;100;0
0;21;"tulsa";21;0;100
0;359;"tulsi";359;0;100
0;65;"tumeka";65;0;100
0;5;"tumekia";5;0;100
0;11;"tumika";11;0;100
6;0;"tunde";6;100;0
0;36;"tundra";36;0;100
0;45;"tunesia";45;0;100
221;0;"tung";221;100;0
153;0;"tunis";153;100;0
0;17;"tunisa";17;0;100
0;301;"tunisha";301;0;100
0;596;"tunisia";596;0;100
0;22;"tunja";22;0;100
40;0;"tunney";40;100;0
7;0;"tunny";7;100;0
0;258;"tunya";258;0;100
0;5;"tunyia";5;0;100
6;5;"tuong";11;54.5454545454545;45.4545454545455
0;35;"tuongvi";35;0;100
0;10;"tuongvy";10;0;100
73;0;"tupac";73;100;0
5;12;"tupou";17;29.4117647058824;70.5882352941177
0;168;"tura";168;0;100
31;0;"turan";31;100;0
0;5;"turea";5;0;100
0;11;"tureka";11;0;100
11;0;"turell";11;100;0
258;0;"turhan";258;100;0
5;19;"turi";24;20.8333333333333;79.1666666666667
0;11;"turia";11;0;100
5;0;"turin";5;100;0
0;19;"turina";19;0;100
0;13;"turiya";13;0;100
46;0;"turk";46;100;0
0;19;"turkesa";19;0;100
0;21;"turkesha";21;0;100
0;280;"turkessa";280;0;100
77;0;"turki";77;100;0
5;0;"turley";5;100;0
6;0;"turmaine";6;100;0
7727;232;"turner";7959;97.0850609373037;2.91493906269632
22;0;"turney";22;100;0
95;0;"turon";95;100;0
0;539;"turquoise";539;0;100
82;0;"turrell";82;100;0
5;0;"turron";5;100;0
5;0;"tuscan";5;100;0
0;35;"tuscany";35;0;100
0;10;"tusha";10;0;100
240;0;"tushar";240;100;0
0;5;"tushara";5;0;100
0;5;"tushima";5;0;100
5;0;"tuson";5;100;0
24;0;"tustin";24;100;0
0;15;"tuula";15;0;100
167;0;"tuvia";167;100;0
5;0;"tuvya";5;100;0
0;176;"tuwana";176;0;100
0;161;"tuwanda";161;0;100
0;152;"tuwanna";152;0;100
26;160;"tuyen";186;13.9784946236559;86.0215053763441
0;298;"tuyet";298;0;100
0;10;"tuyetnhi";10;0;100
0;5;"tuyetnhung";5;0;100
0;223;"tvisha";223;0;100
130;0;"twain";130;100;0
0;13;"twaina";13;0;100
0;109;"twala";109;0;100
0;47;"twalla";47;0;100
211;27;"twan";238;88.6554621848739;11.3445378151261
0;2224;"twana";2224;0;100
0;1362;"twanda";1362;0;100
0;9;"twanetta";9;0;100
0;31;"twanette";31;0;100
0;63;"twania";63;0;100
0;6;"twanika";6;0;100
0;5;"twaniqua";5;0;100
0;54;"twanisha";54;0;100
0;1332;"twanna";1332;0;100
0;60;"twanya";60;0;100
15;0;"twayne";15;100;0
5;0;"twig";5;100;0
0;12;"twiggy";12;0;100
0;11556;"twila";11556;0;100
0;20;"twilah";20;0;100
0;71;"twilia";71;0;100
0;18;"twilight";18;0;100
0;1205;"twilla";1205;0;100
0;7;"twina";7;0;100
0;84;"twinkle";84;0;100
0;43;"twisha";43;0;100
5;0;"twon";5;100;0
0;5;"twonda";5;0;100
0;6802;"twyla";6802;0;100
0;134;"twylah";134;0;100
0;94;"twylia";94;0;100
0;292;"twylla";292;0;100
30;0;"twyman";30;100;0
0;6;"twynette";6;0;100
44095;711;"ty";44806;98.4131589519261;1.58684104807392
0;766;"tya";766;0;100
0;90;"tyah";90;0;100
0;34;"tyahna";34;0;100
30;0;"tyair";30;100;0
0;148;"tyaira";148;0;100
0;5;"tyairah";5;0;100
160;5;"tyaire";165;96.969696969697;3.03030303030303
0;26;"tyaisa";26;0;100
0;120;"tyaisha";120;0;100
0;31;"tyaja";31;0;100
0;43;"tyajah";43;0;100
210;68;"tyan";278;75.5395683453237;24.4604316546763
0;2562;"tyana";2562;0;100
0;53;"tyanah";53;0;100
0;15;"tyandra";15;0;100
8;0;"tyandre";8;100;0
0;6;"tyane";6;0;100
0;33;"tyani";33;0;100
0;18;"tyania";18;0;100
0;886;"tyann";886;0;100
0;3526;"tyanna";3526;0;100
0;85;"tyannah";85;0;100
0;477;"tyanne";477;0;100
0;5;"tyanni";5;0;100
0;5;"tyannia";5;0;100
52;0;"tyanthony";52;100;0
0;508;"tyara";508;0;100
0;5;"tyaria";5;0;100
0;63;"tyarra";63;0;100
20;0;"tyas";20;100;0
0;40;"tyasha";40;0;100
0;95;"tyashia";95;0;100
0;2044;"tyasia";2044;0;100
0;27;"tyasiah";27;0;100
30;0;"tyaun";30;100;0
0;149;"tyauna";149;0;100
0;12;"tyaunna";12;0;100
0;10;"tyazia";10;0;100
0;17;"tybee";17;0;100
5;0;"tyber";5;100;0
57;0;"tyberious";57;100;0
245;0;"tyberius";245;100;0
0;6;"tybrea";6;0;100
0;6;"tybresha";6;0;100
0;39;"tybria";39;0;100
0;5;"tybriana";5;0;100
1936;0;"tyce";1936;100;0
0;24;"tycee";24;0;100
405;0;"tycen";405;100;0
11;0;"tycere";11;100;0
0;5;"tyche";5;0;100
0;10;"tychell";10;0;100
0;90;"tychelle";90;0;100
28;0;"tychicus";28;100;0
0;11;"tychina";11;0;100
189;0;"tycho";189;100;0
0;31;"tycie";31;0;100
0;5;"tydaisha";5;0;100
19;0;"tydan";19;100;0
5;0;"tydarian";5;100;0
17;0;"tydarious";17;100;0
272;0;"tydarius";272;100;0
24;0;"tydarrius";24;100;0
0;5;"tydashia";5;0;100
102;0;"tyde";102;100;0
21;0;"tydell";21;100;0
258;0;"tyden";258;100;0
7;0;"tydon";7;100;0
24;0;"tydre";24;100;0
60;0;"tydrick";60;100;0
253;0;"tydus";253;100;0
4785;330;"tye";5115;93.5483870967742;6.45161290322581
0;29;"tyease";29;0;100
0;208;"tyeasha";208;0;100
0;17;"tyeast";17;0;100
0;10;"tyece";10;0;100
0;6;"tyecha";6;0;100
0;156;"tyechia";156;0;100
0;5;"tyecia";5;0;100
296;0;"tyee";296;100;0
0;230;"tyeesha";230;0;100
0;1553;"tyeisha";1553;0;100
0;5;"tyeishia";5;0;100
0;6;"tyeka";6;0;100
6;0;"tyelar";6;100;0
267;27;"tyeler";294;90.8163265306122;9.18367346938776
0;6;"tyelise";6;0;100
5;0;"tyell";5;100;0
51;0;"tyelor";51;100;0
0;23;"tyena";23;0;100
0;11;"tyenna";11;0;100
6;0;"tyequan";6;100;0
6;0;"tyer";6;100;0
0;152;"tyera";152;0;100
5;0;"tyere";5;100;0
38;0;"tyerell";38;100;0
0;176;"tyerra";176;0;100
0;5;"tyesa";5;0;100
0;321;"tyese";321;0;100
0;4559;"tyesha";4559;0;100
11;0;"tyeshawn";11;100;0
0;1092;"tyeshia";1092;0;100
0;10;"tyesia";10;0;100
210;0;"tyeson";210;100;0
0;7;"tyfani";7;0;100
0;132;"tyffani";132;0;100
0;18;"tyffanie";18;0;100
0;207;"tyffany";207;0;100
29;0;"tyga";29;100;0
5;0;"tygan";5;100;0
72;0;"tyge";72;100;0
351;54;"tyger";405;86.6666666666667;13.3333333333333
5;0;"tygh";5;100;0
6;0;"tyghe";6;100;0
0;5;"tyhecia";5;0;100
19;0;"tyheed";19;100;0
332;0;"tyheem";332;100;0
202;0;"tyheim";202;100;0
5;0;"tyheir";5;100;0
0;5;"tyheisha";5;0;100
0;118;"tyhesha";118;0;100
0;5;"tyheshia";5;0;100
0;37;"tyhesia";37;0;100
0;17;"tyhessia";17;0;100
36;0;"tyhiem";36;100;0
71;0;"tyhir";71;100;0
0;10;"tyhira";10;0;100
0;6;"tyhisa";6;0;100
0;17;"tyhisha";17;0;100
7;0;"tyhler";7;100;0
12;0;"tyi";12;100;0
0;232;"tyia";232;0;100
0;160;"tyiana";160;0;100
0;100;"tyianna";100;0;100
0;5;"tyice";5;0;100
0;699;"tyiesha";699;0;100
0;5;"tyieshia";5;0;100
0;28;"tyina";28;0;100
288;0;"tyion";288;100;0
0;33;"tyiona";33;0;100
0;49;"tyionna";49;0;100
0;5;"tyira";5;0;100
0;1829;"tyisha";1829;0;100
0;62;"tyishia";62;0;100
0;13;"tyissha";13;0;100
7;0;"tyius";7;100;0
0;96;"tyja";96;0;100
173;187;"tyjae";360;48.0555555555556;51.9444444444444
58;174;"tyjah";232;25;75
92;82;"tyjai";174;52.8735632183908;47.1264367816092
0;12;"tyjana";12;0;100
0;163;"tyjanae";163;0;100
0;6;"tyjanay";6;0;100
0;5;"tyjanea";5;0;100
0;6;"tyjanique";6;0;100
14;0;"tyjaun";14;100;0
91;0;"tyjay";91;100;0
7;0;"tyjhawn";7;100;0
5;0;"tyjhon";5;100;0
5;0;"tyji";5;100;0
5;0;"tyjier";5;100;0
5;0;"tyjir";5;100;0
33;0;"tyjohn";33;100;0
279;0;"tyjon";279;100;0
1466;0;"tyjuan";1466;100;0
0;51;"tyjuana";51;0;100
0;5;"tyka";5;0;100
0;18;"tykara";18;0;100
0;5;"tykaria";5;0;100
0;5;"tykayla";5;0;100
179;0;"tyke";179;100;0
0;5;"tykea";5;0;100
81;0;"tykee";81;100;0
318;0;"tykeem";318;100;0
0;38;"tykeia";38;0;100
0;40;"tykeira";40;0;100
0;246;"tykeisha";246;0;100
5;0;"tykeith";5;100;0
117;0;"tykel";117;100;0
33;0;"tykell";33;100;0
0;6;"tykenya";6;0;100
5;0;"tyker";5;100;0
0;179;"tykera";179;0;100
0;638;"tykeria";638;0;100
0;5;"tykeriah";5;0;100
0;11;"tykerra";11;0;100
0;176;"tykerria";176;0;100
53;0;"tykese";53;100;0
0;214;"tykesha";214;0;100
0;90;"tykeshia";90;0;100
6;0;"tykevion";6;100;0
42;0;"tykevious";42;100;0
0;43;"tykeya";43;0;100
0;46;"tykeyah";46;0;100
16;0;"tyki";16;100;0
0;624;"tykia";624;0;100
0;5;"tykiana";5;0;100
0;15;"tykiara";15;0;100
6;0;"tykie";6;100;0
0;63;"tykiera";63;0;100
0;5;"tykierra";5;0;100
0;5;"tykiesha";5;0;100
23;0;"tykim";23;100;0
20;0;"tyking";20;100;0
0;294;"tykira";294;0;100
0;5;"tykirah";5;0;100
0;11;"tykiria";11;0;100
0;6;"tykirra";6;0;100
0;181;"tykisha";181;0;100
49;0;"tykwan";49;100;0
79;0;"tykwon";79;100;0
7;2753;"tyla";2760;0.253623188405797;99.7463768115942
0;454;"tylah";454;0;100
0;10;"tylaisha";10;0;100
0;15;"tylajah";15;0;100
2512;152;"tylan";2664;94.2942942942943;5.70570570570571
112;0;"tyland";112;100;0
5;0;"tylane";5;100;0
1538;1172;"tylar";2710;56.7527675276753;43.2472324723247
0;10;"tylasha";10;0;100
0;35;"tylashia";35;0;100
0;170;"tylasia";170;0;100
0;22;"tylaya";22;0;100
0;23;"tylayah";23;0;100
0;5;"tylayshia";5;0;100
0;24;"tylaysia";24;0;100
48;0;"tyle";48;100;0
0;192;"tylea";192;0;100
0;462;"tyleah";462;0;100
0;21;"tylecia";21;0;100
346;1141;"tylee";1487;23.2683254875588;76.7316745124412
227;0;"tyleek";227;100;0
0;28;"tyleen";28;0;100
0;6;"tyleesha";6;0;100
5;5;"tylei";10;50;50
0;10;"tyleia";10;0;100
0;222;"tyleigh";222;0;100
34;0;"tyleik";34;100;0
0;32;"tyleisha";32;0;100
114;0;"tylek";114;100;0
10;0;"tyleke";10;100;0
1121;10;"tylen";1131;99.1158267020336;0.884173297966401
0;53;"tylena";53;0;100
0;365;"tylene";365;0;100
580335;16245;"tyler";596580;97.2769787790405;2.72302122095947
27;0;"tylere";27;100;0
112;0;"tylerjames";112;100;0
5;0;"tylerjohn";5;100;0
5;0;"tylerlee";5;100;0
0;8;"tylese";8;0;100
0;210;"tylesha";210;0;100
0;18;"tyleshia";18;0;100
0;5;"tyletha";5;0;100
0;11;"tylette";11;0;100
0;19;"tyley";19;0;100
0;6;"tyleyah";6;0;100
0;36;"tyli";36;0;100
0;514;"tylia";514;0;100
0;346;"tyliah";346;0;100
0;93;"tylicia";93;0;100
0;360;"tylie";360;0;100
105;0;"tyliek";105;100;0
5;0;"tylier";5;100;0
379;0;"tylik";379;100;0
34;0;"tylil";34;100;0
618;197;"tylin";815;75.8282208588957;24.1717791411043
0;15;"tylina";15;0;100
5;0;"tyliq";5;100;0
95;0;"tylique";95;100;0
5;0;"tylis";5;100;0
0;132;"tylisa";132;0;100
0;497;"tylisha";497;0;100
0;6;"tylissa";6;0;100
0;419;"tyliyah";419;0;100
142;46;"tyller";188;75.531914893617;24.468085106383
27;13;"tylo";40;67.5;32.5
1044;0;"tylon";1044;100;0
5;0;"tylone";5;100;0
7863;451;"tylor";8314;94.5754149627135;5.4245850372865
6;0;"tylr";6;100;0
15;0;"tylre";15;100;0
11;0;"tylun";11;100;0
5;0;"tylur";5;100;0
66;251;"tylyn";317;20.820189274448;79.179810725552
46;451;"tylynn";497;9.25553319919517;90.7444668008048
22;0;"tymaine";22;100;0
63;0;"tymar";63;100;0
0;64;"tymara";64;0;100
50;0;"tymari";50;100;0
5;0;"tymarian";5;100;0
130;0;"tymarion";130;100;0
5;0;"tymarius";5;100;0
17;380;"tymber";397;4.28211586901763;95.7178841309824
0;5;"tymberlyn";5;0;100
20;49;"tyme";69;28.9855072463768;71.0144927536232
21;0;"tymeek";21;100;0
62;0;"tymeer";62;100;0
63;0;"tymeir";63;100;0
0;41;"tymeisha";41;0;100
0;191;"tymeka";191;0;100
0;7;"tymekia";7;0;100
172;0;"tymel";172;100;0
16;0;"tymell";16;100;0
0;19;"tymera";19;0;100
451;0;"tymere";451;100;0
0;24;"tymeria";24;0;100
5;0;"tymerius";5;100;0
0;251;"tymesha";251;0;100
0;71;"tymeshia";71;0;100
5;0;"tymetrius";5;100;0
0;260;"tymia";260;0;100
112;0;"tymier";112;100;0
19;0;"tymiere";19;100;0
0;5;"tymiesha";5;0;100
0;116;"tymika";116;0;100
857;0;"tymir";857;100;0
0;82;"tymira";82;0;100
0;11;"tymirah";11;0;100
43;0;"tymire";43;100;0
0;51;"tymisha";51;0;100
463;0;"tymon";463;100;0
5;0;"tymond";5;100;0
5;0;"tymonte";5;100;0
268;0;"tymothy";268;100;0
0;17;"tymya";17;0;100
0;628;"tyna";628;0;100
0;57;"tynae";57;0;100
0;20;"tynaisha";20;0;100
0;11;"tynaja";11;0;100
0;19;"tynajah";19;0;100
689;0;"tynan";689;100;0
0;28;"tynasha";28;0;100
0;19;"tynashia";19;0;100
0;279;"tynasia";279;0;100
0;6;"tynaya";6;0;100
0;5;"tynayah";5;0;100
5;0;"tyndale";5;100;0
0;10;"tyndall";10;0;100
18;429;"tyne";447;4.02684563758389;95.9731543624161
0;17;"tynea";17;0;100
0;5;"tyneal";5;0;100
0;7;"tyneasha";7;0;100
0;33;"tynecia";33;0;100
0;5;"tyneeka";5;0;100
0;53;"tyneesha";53;0;100
0;5;"tyneice";5;0;100
0;6;"tyneika";6;0;100
5;0;"tyneil";5;100;0
0;613;"tyneisha";613;0;100
0;131;"tyneka";131;0;100
112;0;"tynell";112;100;0
0;37;"tynequa";37;0;100
98;0;"tyner";98;100;0
0;11;"tynese";11;0;100
0;1317;"tynesha";1317;0;100
0;574;"tyneshia";574;0;100
0;97;"tynesia";97;0;100
0;307;"tynetta";307;0;100
0;28;"tynette";28;0;100
0;565;"tynia";565;0;100
0;122;"tyniah";122;0;100
0;5;"tynica";5;0;100
0;5;"tynie";5;0;100
0;28;"tyniece";28;0;100
0;5;"tynieka";5;0;100
0;114;"tyniesha";114;0;100
0;5;"tynija";5;0;100
0;6;"tynijah";6;0;100
0;312;"tynika";312;0;100
0;56;"tyniqua";56;0;100
0;16;"tynique";16;0;100
0;215;"tynisa";215;0;100
0;33;"tynise";33;0;100
0;1668;"tynisha";1668;0;100
0;36;"tynishia";36;0;100
0;6;"tynisia";6;0;100
0;44;"tynita";44;0;100
0;71;"tyniya";71;0;100
0;11;"tyniyah";11;0;100
0;299;"tynlee";299;0;100
0;101;"tynleigh";101;0;100
0;49;"tynley";49;0;100
0;6;"tynli";6;0;100
0;16;"tynlie";16;0;100
0;43;"tynnetta";43;0;100
0;63;"tynslee";63;0;100
0;24;"tynsley";24;0;100
0;5;"tynzlee";5;0;100
588;0;"tyon";588;100;0
0;333;"tyona";333;0;100
23;0;"tyone";23;100;0
0;40;"tyonia";40;0;100
0;1222;"tyonna";1222;0;100
0;5;"tyonnah";5;0;100
33;16;"tyonne";49;67.3469387755102;32.6530612244898
0;23;"typhani";23;0;100
0;15;"typhanie";15;0;100
16;0;"tyquail";16;100;0
3410;10;"tyquan";3420;99.7076023391813;0.292397660818713
0;45;"tyquana";45;0;100
19;0;"tyquane";19;100;0
23;0;"tyquann";23;100;0
0;5;"tyquanna";5;0;100
5;0;"tyquarious";5;100;0
112;0;"tyquarius";112;100;0
0;55;"tyquasha";55;0;100
0;16;"tyquashia";16;0;100
0;84;"tyquasia";84;0;100
46;0;"tyquavion";46;100;0
169;0;"tyquavious";169;100;0
16;0;"tyquavius";16;100;0
17;0;"tyquawn";17;100;0
33;0;"tyquell";33;100;0
6;0;"tyquese";6;100;0
0;42;"tyquesha";42;0;100
253;0;"tyquez";253;100;0
17;0;"tyquil";17;100;0
5;0;"tyquin";5;100;0
5;0;"tyquis";5;100;0
33;0;"tyquise";33;100;0
0;96;"tyquisha";96;0;100
0;5;"tyquita";5;0;100
182;0;"tyquon";182;100;0
65;0;"tyqwan";65;100;0
139;0;"tyr";139;100;0
142;14237;"tyra";14379;0.987551290075805;99.0124487099242
309;35;"tyrae";344;89.8255813953488;10.1744186046512
14;0;"tyrael";14;100;0
0;638;"tyrah";638;0;100
138;0;"tyrail";138;100;0
24;0;"tyral";24;100;0
5;0;"tyrale";5;100;0
2090;56;"tyran";2146;97.3904939422181;2.60950605778192
0;5;"tyranae";5;0;100
43;0;"tyrance";43;100;0
6;0;"tyrand";6;100;0
22;0;"tyrane";22;100;0
0;10;"tyranesha";10;0;100
0;5;"tyranika";5;0;100
0;5;"tyranique";5;0;100
0;14;"tyranisha";14;0;100
73;0;"tyrann";73;100;0
0;22;"tyranny";22;0;100
10;0;"tyras";10;100;0
331;0;"tyray";331;100;0
0;5;"tyraya";5;0;100
1997;50;"tyre";2047;97.5574010747435;2.44259892525647
13;88;"tyrea";101;12.8712871287129;87.1287128712871
9;0;"tyreace";9;100;0
142;0;"tyreak";142;100;0
0;55;"tyreana";55;0;100
0;87;"tyreanna";87;0;100
207;0;"tyrease";207;100;0
58;0;"tyrec";58;100;0
703;0;"tyrece";703;100;0
0;6;"tyrecia";6;0;100
73;0;"tyreck";73;100;0
5;0;"tyreco";5;100;0
13662;735;"tyree";14397;94.8947697436966;5.1052302563034
5;0;"tyreec";5;100;0
641;0;"tyreece";641;100;0
5;0;"tyreeck";5;100;0
5;0;"tyreef";5;100;0
2076;0;"tyreek";2076;100;0
0;15;"tyreeka";15;0;100
19;0;"tyreem";19;100;0
12;0;"tyreeq";12;100;0
61;0;"tyrees";61;100;0
1833;49;"tyreese";1882;97.3963868225292;2.60361317747078
0;66;"tyreesha";66;0;100
22;0;"tyrei";22;100;0
15;0;"tyreice";15;100;0
8;0;"tyreick";8;100;0
533;0;"tyreik";533;100;0
5;0;"tyreike";5;100;0
20;0;"tyreion";20;100;0
7;0;"tyreise";7;100;0
0;76;"tyreisha";76;0;100
2049;0;"tyrek";2049;100;0
0;180;"tyreka";180;0;100
1293;0;"tyreke";1293;100;0
5;0;"tyrekus";5;100;0
3294;0;"tyrel";3294;100;0
14993;145;"tyrell";15138;99.0421455938697;0.957854406130268
776;16;"tyrelle";792;97.979797979798;2.02020202020202
1890;5;"tyren";1895;99.7361477572559;0.263852242744063
0;95;"tyrena";95;0;100
23;0;"tyrence";23;100;0
0;89;"tyrene";89;0;100
263;0;"tyreon";263;100;0
0;63;"tyreona";63;0;100
0;80;"tyreonna";80;0;100
39;0;"tyreq";39;100;0
90;0;"tyreque";90;100;0
45;0;"tyres";45;100;0
0;79;"tyresa";79;0;100
8372;148;"tyrese";8520;98.2629107981221;1.73708920187793
0;607;"tyresha";607;0;100
0;82;"tyreshia";82;0;100
146;0;"tyress";146;100;0
268;0;"tyresse";268;100;0
242;0;"tyrez";242;100;0
0;5;"tyrhiana";5;0;100
0;43;"tyrhianna";43;0;100
0;120;"tyrhonda";120;0;100
95;0;"tyri";95;100;0
6;333;"tyria";339;1.76991150442478;98.2300884955752
0;33;"tyriah";33;0;100
136;6;"tyrian";142;95.7746478873239;4.22535211267606
0;265;"tyriana";265;0;100
0;262;"tyrianna";262;0;100
0;7;"tyrianne";7;0;100
411;0;"tyric";411;100;0
0;64;"tyrica";64;0;100
917;29;"tyrice";946;96.9344608879493;3.06553911205074
345;0;"tyrick";345;100;0
0;12;"tyricka";12;0;100
22;0;"tyrico";22;100;0
658;41;"tyrie";699;94.1344778254649;5.86552217453505
49;0;"tyriece";49;100;0
672;0;"tyriek";672;100;0
0;33;"tyriel";33;0;100
0;60;"tyrielle";60;0;100
8;0;"tyriese";8;100;0
0;71;"tyrihanna";71;0;100
1302;0;"tyrik";1302;100;0
0;137;"tyrika";137;0;100
46;0;"tyrike";46;100;0
1696;11;"tyrin";1707;99.3555946104277;0.644405389572349
0;132;"tyrina";132;0;100
0;5;"tyrine";5;0;100
426;7;"tyrion";433;98.3833718244804;1.61662817551963
0;5;"tyriona";5;0;100
0;46;"tyrionna";46;0;100
1455;0;"tyriq";1455;100;0
1739;0;"tyrique";1739;100;0
601;0;"tyris";601;100;0
8;0;"tyrise";8;100;0
0;262;"tyrisha";262;0;100
0;16;"tyrissa";16;0;100
0;10;"tyrita";10;0;100
11;0;"tyrius";11;100;0
11;0;"tyrod";11;100;0
897;0;"tyrome";897;100;0
7240;16;"tyron";7256;99.7794928335171;0.220507166482911
0;10;"tyrona";10;0;100
0;540;"tyronda";540;0;100
78045;709;"tyrone";78754;99.0997282677705;0.900271732229474
0;5;"tyronesha";5;0;100
0;145;"tyronica";145;0;100
236;0;"tyronn";236;100;0
1158;0;"tyronne";1158;100;0
6;108;"tyronza";114;5.26315789473684;94.7368421052632
0;5;"tyronzia";5;0;100
0;11;"tyrra";11;0;100
10;0;"tyrrel";10;100;0
643;0;"tyrrell";643;100;0
10;0;"tyrun";10;100;0
4412;0;"tyrus";4412;100;0
5;0;"tyruss";5;100;0
15;0;"tyryn";15;100;0
0;37;"tysa";37;0;100
5;0;"tysaiah";5;100;0
16;0;"tysan";16;100;0
8;0;"tysaun";8;100;0
84;0;"tyse";84;100;0
934;0;"tysean";934;100;0
0;6;"tyseana";6;0;100
1389;10;"tysen";1399;99.2852037169407;0.714796283059328
0;853;"tysha";853;0;100
0;229;"tyshae";229;0;100
0;25;"tyshai";25;0;100
96;0;"tyshan";96;100;0
0;67;"tyshana";67;0;100
0;41;"tyshanna";41;0;100
0;6;"tyshanta";6;0;100
0;12;"tyshanti";12;0;100
0;26;"tyshara";26;0;100
1759;5;"tyshaun";1764;99.7165532879819;0.283446712018141
0;74;"tyshauna";74;0;100
4747;134;"tyshawn";4881;97.2546609301373;2.74533906986273
0;194;"tyshawna";194;0;100
0;5;"tyshawnna";5;0;100
0;207;"tyshay";207;0;100
0;11;"tyshayla";11;0;100
0;5;"tyshe";5;0;100
0;136;"tyshea";136;0;100
0;5;"tysheana";5;0;100
0;12;"tysheanna";12;0;100
5;0;"tysheed";5;100;0
154;0;"tysheem";154;100;0
0;16;"tysheema";16;0;100
49;0;"tysheen";49;100;0
0;99;"tysheena";99;0;100
0;5;"tysheera";5;0;100
0;5;"tysheia";5;0;100
0;12;"tysheika";12;0;100
6;0;"tysheim";6;100;0
0;123;"tysheka";123;0;100
0;5;"tyshekia";5;0;100
0;70;"tyshell";70;0;100
0;10;"tyshelle";10;0;100
0;32;"tyshema";32;0;100
0;5;"tysheonna";5;0;100
0;25;"tyshera";25;0;100
0;43;"tysheria";43;0;100
0;192;"tyshia";192;0;100
0;17;"tyshiana";17;0;100
0;14;"tyshianna";14;0;100
5;0;"tyshiem";5;100;0
0;55;"tyshika";55;0;100
0;23;"tyshira";23;0;100
1289;11;"tyshon";1300;99.1538461538462;0.846153846153846
0;27;"tyshonda";27;0;100
11;0;"tyshone";11;100;0
0;37;"tyshonna";37;0;100
353;0;"tyshun";353;100;0
0;18;"tysie";18;0;100
112;0;"tysin";112;100;0
55;0;"tysir";55;100;0
5;0;"tyski";5;100;0
40780;308;"tyson";41088;99.2503894080997;0.749610591900312
34;0;"tysun";34;100;0
6;0;"tysyn";6;100;0
679;0;"tytan";679;100;0
0;24;"tytana";24;0;100
0;5;"tytanna";5;0;100
0;37;"tyteana";37;0;100
0;154;"tyteanna";154;0;100
34;0;"tyten";34;100;0
0;11;"tyteona";11;0;100
0;20;"tyteonna";20;0;100
0;1358;"tytiana";1358;0;100
0;1014;"tytianna";1014;0;100
0;17;"tytiauna";17;0;100
5;0;"tytin";5;100;0
0;58;"tytiona";58;0;100
0;94;"tytionna";94;0;100
0;51;"tytiyana";51;0;100
135;0;"tyton";135;100;0
10;0;"tytrell";10;100;0
999;0;"tytus";999;100;0
0;5;"tyuana";5;0;100
7;0;"tyun";7;100;0
0;6;"tyunna";6;0;100
819;0;"tyus";819;100;0
0;5;"tyvaeh";5;0;100
43;0;"tyvan";43;100;0
5;0;"tyvaughn";5;100;0
39;0;"tyvell";39;100;0
20;0;"tyven";20;100;0
40;0;"tyveon";40;100;0
5;0;"tyvez";5;100;0
52;0;"tyvin";52;100;0
101;0;"tyvion";101;100;0
762;0;"tyvon";762;100;0
25;0;"tyvone";25;100;0
0;5;"tyvonna";5;0;100
10;0;"tyvonne";10;100;0
54;0;"tywain";54;100;0
1208;15;"tywan";1223;98.7735077677841;1.22649223221586
0;583;"tywana";583;0;100
5;0;"tywand";5;100;0
0;547;"tywanda";547;0;100
5;0;"tywane";5;100;0
0;5;"tywania";5;0;100
59;0;"tywann";59;100;0
0;625;"tywanna";625;0;100
216;0;"tywaun";216;100;0
28;0;"tywayne";28;100;0
15;0;"tywin";15;100;0
825;0;"tywon";825;100;0
0;12;"tywona";12;0;100
0;5;"tywonda";5;0;100
165;0;"tywone";165;100;0
50;0;"tywuan";50;100;0
0;29;"tyyana";29;0;100
0;37;"tyyanna";37;0;100
0;118;"tyyne";118;0;100
24;0;"tyyon";24;100;0
0;65;"tyyonna";65;0;100
5;0;"tyzae";5;100;0
5;0;"tyzaiah";5;100;0
7;0;"tyzell";7;100;0
5;0;"tyzen";5;100;0
5;0;"tyzer";5;100;0
0;20;"tyzhane";20;0;100
5;0;"tyzion";5;100;0
13;0;"tyzir";13;100;0
10;0;"tyzjuan";10;100;0
5;0;"tyzon";5;100;0
38;12;"tziah";50;76;24
132;0;"tzion";132;100;0
0;25;"tzipa";25;0;100
0;894;"tzipora";894;0;100
0;727;"tziporah";727;0;100
0;42;"tzippora";42;0;100
0;275;"tzipporah";275;0;100
0;124;"tzippy";124;0;100
0;371;"tzirel";371;0;100
0;11;"tziry";11;0;100
0;11;"tzivi";11;0;100
0;483;"tzivia";483;0;100
0;18;"tzivy";18;0;100
0;17;"tzivya";17;0;100
0;5;"tzofia";5;0;100
27;0;"tzuriel";27;100;0
0;18;"tzurty";18;0;100
2626;0;"tzvi";2626;100;0
0;10;"ualani";10;0;100
0;21;"uarda";21;0;100
0;5;"uba";5;0;100
0;53;"ubah";53;0;100
37;0;"ubaid";37;100;0
5;0;"ubaidullah";5;100;0
5;0;"ubald";5;100;0
2077;0;"ubaldo";2077;100;0
36;0;"uber";36;100;0
10;0;"ubong";10;100;0
5;0;"uche";5;100;0
0;97;"uchechi";97;0;100
117;24;"uchechukwu";141;82.9787234042553;17.0212765957447
380;190;"uchenna";570;66.6666666666667;33.3333333333333
5;0;"uciel";5;100;0
0;11;"uda";11;0;100
0;30;"udana";30;0;100
167;0;"uday";167;100;0
10;0;"udbhav";10;100;0
0;5;"udelia";5;0;100
489;134;"udell";623;78.4911717495987;21.5088282504013
0;5;"udella";5;0;100
5;0;"udit";5;100;0
11;0;"udochukwu";11;100;0
0;5;"udona";5;0;100
5;0;"udonis";5;100;0
0;5;"udonna";5;0;100
0;6;"udora";6;0;100
0;17;"udy";17;0;100
75;0;"uel";75;100;0
0;7;"ufemia";7;0;100
12;46;"uganda";58;20.6896551724138;79.3103448275862
5;0;"ugene";5;100;0
0;5;"ugne";5;0;100
302;0;"ugo";302;100;0
0;106;"ugochi";106;0;100
241;0;"ugochukwu";241;100;0
133;47;"ugonna";180;73.8888888888889;26.1111111111111
6;0;"uhl";6;100;0
0;32;"uhura";32;0;100
28;5;"uhuru";33;84.8484848484848;15.1515151515152
0;97;"uilani";97;0;100
11;0;"uilliam";11;100;0
0;5;"ujala";5;0;100
5;0;"ujjwal";5;100;0
5;0;"ujwal";5;100;0
0;16;"ukari";16;0;100
80;6;"ukiah";86;93.0232558139535;6.97674418604651
31;1455;"ula";1486;2.08613728129206;97.9138627187079
6;0;"uladimir";6;100;0
0;83;"ulah";83;0;100
6;0;"ulan";6;100;0
0;18;"ulana";18;0;100
6;0;"uland";6;100;0
0;364;"ulanda";364;0;100
0;226;"ulani";226;0;100
102;0;"ulas";102;100;0
0;10;"uldean";10;0;100
0;37;"uldene";37;0;100
0;228;"uldine";228;0;100
7;0;"uldis";7;100;0
69;0;"ules";69;100;0
56;0;"uless";56;100;0
5;0;"ulesses";5;100;0
0;10;"uleta";10;0;100
0;5;"uli";5;0;100
0;55;"uliana";55;0;100
134;0;"ulice";134;100;0
1072;0;"ulices";1072;100;0
256;0;"ulis";256;100;0
0;17;"ulisa";17;0;100
5;0;"ulise";5;100;0
9794;15;"ulises";9809;99.8470792129677;0.152920787032317
10;0;"ulisess";10;100;0
12;0;"ulisis";12;100;0
0;28;"ulissa";28;0;100
1173;0;"ulisses";1173;100;0
15;0;"ulizes";15;100;0
0;61;"ulla";61;0;100
0;24;"ullanda";24;0;100
0;17;"ulma";17;0;100
88;0;"ulmer";88;100;0
0;176;"ulonda";176;0;100
441;0;"ulric";441;100;0
0;60;"ulrica";60;0;100
388;0;"ulrich";388;100;0
85;0;"ulrick";85;100;0
19;0;"ulrik";19;100;0
0;8;"ulrika";8;0;100
0;34;"ulrike";34;0;100
155;0;"ulus";155;100;0
0;5;"ulva";5;0;100
0;92;"ulyana";92;0;100
143;0;"ulyess";143;100;0
36;0;"ulyesses";36;100;0
134;0;"ulys";134;100;0
503;0;"ulysee";503;100;0
397;0;"ulysees";397;100;0
1374;0;"ulyses";1374;100;0
463;0;"ulysess";463;100;0
22;0;"ulysis";22;100;0
54;0;"ulyss";54;100;0
0;189;"ulyssa";189;0;100
240;0;"ulysse";240;100;0
39;0;"ulyssee";39;100;0
16517;25;"ulysses";16542;99.8488695441905;0.151130455809455
5;0;"ulyssess";5;100;0
0;5;"ulyssia";5;0;100
5;0;"ulyssis";5;100;0
0;1283;"uma";1283;0;100
0;44;"umaima";44;0;100
433;0;"umair";433;100;0
0;6;"umaira";6;0;100
0;129;"umaiza";129;0;100
0;5;"umama";5;0;100
0;6;"umamah";6;0;100
5;0;"umang";5;100;0
1940;0;"umar";1940;100;0
5;0;"umarbek";5;100;0
5;0;"umari";5;100;0
0;5;"umaya";5;0;100
0;7;"umayah";7;0;100
0;5;"umayma";5;0;100
0;5;"umber";5;0;100
15;0;"umbert";15;100;0
983;0;"umberto";983;100;0
0;5;"ume";5;0;100
0;109;"umeka";109;0;100
0;17;"umeki";17;0;100
0;15;"umekia";15;0;100
0;52;"umeko";52;0;100
0;10;"umeno";10;0;100
310;0;"umer";310;100;0
5;0;"umesh";5;100;0
0;5;"umeyma";5;0;100
0;5;"umeyo";5;0;100
0;57;"umi";57;0;100
0;23;"umika";23;0;100
5;0;"umit";5;100;0
0;25;"umme";25;0;100
0;5;"ummehani";5;0;100
5;0;"umoja";5;100;0
0;5;"umrah";5;0;100
0;20;"umu";20;0;100
24;0;"umut";24;100;0
7;7;"un";14;50;50
0;6895;"una";6895;0;100
8;32;"unborn";40;20;80
15;0;"underwood";15;100;0
0;95;"undine";95;0;100
558;75;"undra";633;88.1516587677725;11.8483412322275
5;0;"undrae";5;100;0
105;0;"undray";105;100;0
15;0;"undre";15;100;0
70;186;"undrea";256;27.34375;72.65625
0;5;"undria";5;0;100
0;31;"uneeda";31;0;100
0;6;"uneek";6;0;100
0;6;"uneka";6;0;100
0;5;"unia";5;0;100
0;5;"uniah";5;0;100
0;42;"unica";42;0;100
30;300;"unice";330;9.09090909090909;90.9090909090909
0;123;"unika";123;0;100
11;0;"union";11;100;0
0;488;"uniqua";488;0;100
739;6627;"unique";7366;10.0325821341298;89.9674178658702
0;19;"uniquea";19;0;100
0;17;"uniqueka";17;0;100
0;5;"uniquewa";5;0;100
0;25;"uniquia";25;0;100
0;84;"unita";84;0;100
0;453;"unity";453;0;100
0;5;"uniya";5;0;100
0;8;"uniyah";8;0;100
37;17;"unk";54;68.5185185185185;31.4814814814815
9092;9312;"unknown";18404;49.4023038469898;50.5976961530102
49;42;"unkown";91;53.8461538461538;46.1538461538462
331;249;"unnamed";580;57.0689655172414;42.9310344827586
103;0;"uno";103;100;0
5;0;"unseld";5;100;0
5;0;"unto";5;100;0
0;12;"unyque";12;0;100
5;0;"upshur";5;100;0
144;0;"upton";144;100;0
60;384;"ura";444;13.5135135135135;86.4864864864865
0;35;"uraina";35;0;100
401;0;"ural";401;100;0
0;5;"urana";5;0;100
0;202;"urania";202;0;100
0;5;"uranus";5;0;100
57;0;"urbain";57;100;0
2871;0;"urban";2871;100;0
0;5;"urbana";5;0;100
5;0;"urbane";5;100;0
747;0;"urbano";747;100;0
5;0;"urbin";5;100;0
0;15;"ureka";15;0;100
0;5;"urena";5;0;100
0;10;"urenna";10;0;100
0;10;"uretta";10;0;100
6;0;"urey";6;100;0
72;0;"urho";72;100;0
0;5;"urhonda";5;0;100
898;46;"uri";944;95.1271186440678;4.8728813559322
5;0;"uria";5;100;0
8133;687;"uriah";8820;92.2108843537415;7.7891156462585
265;0;"urian";265;100;0
0;17;"uriana";17;0;100
203;0;"urias";203;100;0
0;19;"urica";19;0;100
135;0;"urie";135;100;0
15458;197;"uriel";15655;98.7416160970936;1.25838390290642
0;12;"urielle";12;0;100
2857;85;"urijah";2942;97.1108089734874;2.88919102651258
6;0;"urijha";6;100;0
0;5;"urika";5;0;100
0;5;"urina";5;0;100
0;6;"urith";6;0;100
244;94;"uriyah";338;72.189349112426;27.810650887574
0;37;"urja";37;0;100
5;0;"urlin";5;100;0
0;5;"urline";5;0;100
0;45;"urmi";45;0;100
0;5;"urmila";5;0;100
0;7;"uronda";7;0;100
0;31;"urooj";31;0;100
0;16;"uroosa";16;0;100
5;0;"uros";5;100;0
0;18;"ursa";18;0;100
0;92;"ursala";92;0;100
0;5;"ursaline";5;0;100
5;16;"ursel";21;23.8095238095238;76.1904761904762
0;35;"ursela";35;0;100
0;18;"ursla";18;0;100
0;14140;"ursula";14140;0;100
0;6;"ursule";6;0;100
0;25;"ursuline";25;0;100
0;10;"ursulla";10;0;100
0;5;"urszula";5;0;100
0;234;"urvi";234;0;100
0;29;"urwa";29;0;100
21;0;"uryah";21;100;0
161;0;"usama";161;100;0
42;0;"usamah";42;100;0
6;0;"usayd";6;100;0
90;0;"usbaldo";90;100;0
5;0;"usef";5;100;0
0;147;"usha";147;0;100
850;0;"usher";850;100;0
0;15;"ushna";15;0;100
228;0;"usiel";228;100;0
9;0;"usmaan";9;100;0
1079;0;"usman";1079;100;0
0;5;"usra";5;0;100
113;0;"ustin";113;100;0
17;0;"usvaldo";17;100;0
0;5;"uswa";5;0;100
0;20;"uta";20;0;100
347;0;"utah";347;100;0
0;25;"utahna";25;0;100
0;12;"utako";12;0;100
0;25;"ute";25;0;100
0;23;"utha";23;0;100
156;0;"uthman";156;100;0
0;5;"utica";5;0;100
32;0;"utkarsh";32;100;0
0;44;"utopia";44;0;100
15;0;"utsav";15;100;0
6;0;"uuno";6;100;0
0;176;"uva";176;0;100
617;0;"uvaldo";617;100;0
5;0;"uver";5;100;0
0;5;"uvonka";5;0;100
27;0;"uwais";27;100;0
35;0;"uwe";35;100;0
0;379;"uyen";379;0;100
11;0;"uyiosa";11;100;0
39;0;"uyless";39;100;0
412;0;"uzair";412;100;0
19;0;"uzay";19;100;0
15;0;"uzayr";15;100;0
0;5;"uzella";5;0;100
112;0;"uziah";112;100;0
5;0;"uzias";5;100;0
1591;0;"uziel";1591;100;0
0;150;"uzma";150;0;100
0;40;"uzoamaka";40;0;100
112;8;"uzoma";120;93.3333333333333;6.66666666666667
0;10;"uzuri";10;0;100
552;7;"uzziah";559;98.7477638640429;1.25223613595707
462;0;"uzziel";462;100;0
56;0;"va";56;100;0
5;0;"vaahin";5;100;0
0;106;"vaani";106;0;100
0;63;"vaanya";63;0;100
5;0;"vachan";5;100;0
5;0;"vache";5;100;0
20;0;"vachel";20;100;0
15;0;"vachon";15;100;0
0;6;"vacie";6;0;100
10;0;"vaclav";10;100;0
162;9398;"vada";9560;1.69456066945607;98.3054393305439
0;5;"vadah";5;0;100
5;0;"vadal";5;100;0
5;0;"vadell";5;100;0
481;6;"vaden";487;98.7679671457906;1.23203285420945
5;44;"vader";49;10.2040816326531;89.7959183673469
174;0;"vadhir";174;100;0
0;5;"vadia";5;0;100
0;391;"vadie";391;0;100
434;0;"vadim";434;100;0
31;0;"vadin";31;100;0
11;0;"vadir";11;100;0
5;82;"vadis";87;5.74712643678161;94.2528735632184
0;47;"vadna";47;0;100
0;16;"vadra";16;0;100
0;5;"vadys";5;0;100
0;5;"vae";5;0;100
0;235;"vaeda";235;0;100
0;26;"vaelyn";26;0;100
5;0;"vagas";5;100;0
5;0;"vahagn";5;100;0
157;0;"vahan";157;100;0
237;0;"vahe";237;100;0
22;0;"vahid";22;100;0
36;0;"vahin";36;100;0
20;0;"vahn";20;100;0
5;0;"vahram";5;100;0
5;0;"vai";5;100;0
478;0;"vaibhav";478;100;0
0;31;"vaibhavi";31;0;100
0;470;"vaida";470;0;100
0;159;"vaidehi";159;0;100
50;0;"vaiden";50;100;0
0;10;"vaiga";10;0;100
72;168;"vail";240;30;70
0;10;"vaila";10;0;100
0;5;"vaile";5;0;100
0;5;"vaimoana";5;0;100
0;16;"vainavi";16;0;100
8;0;"vaino";8;100;0
0;10;"vaira";10;0;100
16;0;"vairon";16;100;0
0;204;"vaishali";204;0;100
54;0;"vaishnav";54;100;0
0;715;"vaishnavi";715;0;100
0;15;"vaishvi";15;0;100
0;5;"vaitea";5;0;100
0;5;"vaitiare";5;0;100
0;5;"vakesha";5;0;100
5505;1731;"val";7236;76.0779436152571;23.922056384743
0;166;"vala";166;0;100
0;60;"valada";60;0;100
0;17;"valaida";17;0;100
0;11;"valaire";11;0;100
0;7;"valancia";7;0;100
0;21;"valanda";21;0;100
0;241;"valaree";241;0;100
0;93;"valari";93;0;100
0;268;"valaria";268;0;100
0;18287;"valarie";18287;0;100
0;88;"valary";88;0;100
0;5;"valasia";5;0;100
0;5;"valaska";5;0;100
0;6;"valasta";6;0;100
0;10;"valaysia";10;0;100
0;74;"valbona";74;0;100
0;278;"valborg";278;0;100
0;1856;"valda";1856;0;100
6;5;"valdean";11;54.5454545454545;45.4545454545455
918;0;"valdemar";918;100;0
0;5;"valdene";5;0;100
5;0;"valder";5;100;0
258;0;"valdez";258;100;0
5;0;"valdimir";5;100;0
0;5;"valdine";5;0;100
5;0;"valdir";5;100;0
82;0;"valdis";82;100;0
33;0;"valdo";33;100;0
16;0;"valdon";16;100;0
102;121;"vale";223;45.7399103139013;54.2600896860987
0;434;"valecia";434;0;100
0;426;"valeda";426;0;100
0;140;"valeen";140;0;100
0;12;"valeire";12;0;100
28;0;"valek";28;100;0
0;23;"valeka";23;0;100
622;329;"valen";951;65.4048370136698;34.5951629863302
0;613;"valena";613;0;100
11;10769;"valencia";10780;0.102040816326531;99.8979591836735
11;0;"valencio";11;100;0
0;11;"valency";11;0;100
0;27;"valenda";27;0;100
0;901;"valene";901;0;100
0;22;"valenica";22;0;100
1675;0;"valente";1675;100;0
0;10;"valentia";10;0;100
8902;0;"valentin";8902;100;0
7;30197;"valentina";30204;0.0231757383128063;99.9768242616872
5823;1724;"valentine";7547;77.1564860209355;22.8435139790645
0;11;"valentinna";11;0;100
7055;0;"valentino";7055;100;0
0;19;"valentyna";19;0;100
0;1031;"valera";1031;0;100
0;33;"valere";33;0;100
0;96;"valeree";96;0;100
0;1816;"valeri";1816;0;100
105;62612;"valeria";62717;0.167418722196534;99.8325812778035
359;6;"valerian";365;98.3561643835616;1.64383561643836
0;11;"valeriana";11;0;100
115;0;"valeriano";115;100;0
694;255611;"valerie";256305;0.270771151557714;99.7292288484423
0;23;"valerieann";23;0;100
0;5;"valerieanne";5;0;100
0;5;"valerine";5;0;100
355;0;"valerio";355;100;0
21;0;"valeriy";21;100;0
0;28;"valeriya";28;0;100
97;6014;"valery";6111;1.58730158730159;98.4126984126984
0;120;"valerya";120;0;100
0;117;"valerye";117;0;100
0;22;"valesha";22;0;100
0;6;"valeshia";6;0;100
0;15;"valesia";15;0;100
0;633;"valeska";633;0;100
0;6;"valesta";6;0;100
0;661;"valeta";661;0;100
0;5;"valetina";5;0;100
0;601;"valetta";601;0;100
0;16;"valette";16;0;100
177;11;"valgene";188;94.1489361702128;5.85106382978723
10;102;"vali";112;8.92857142857143;91.0714285714286
0;73;"valia";73;0;100
158;0;"valiant";158;100;0
5;0;"valice";5;100;0
0;251;"valicia";251;0;100
0;17;"valicity";17;0;100
0;5;"valier";5;0;100
0;10;"valiere";10;0;100
5;0;"valik";5;100;0
117;5;"valin";122;95.9016393442623;4.0983606557377
0;106;"valina";106;0;100
0;63;"valincia";63;0;100
0;1363;"valinda";1363;0;100
0;105;"valine";105;0;100
0;26;"valire";26;0;100
0;6;"valiree";6;0;100
0;5;"valirie";5;0;100
0;336;"valisa";336;0;100
0;248;"valisha";248;0;100
0;214;"valissa";214;0;100
0;98;"valita";98;0;100
0;43;"valiyah";43;0;100
39;425;"valjean";464;8.4051724137931;91.5948275862069
0;319;"valkyrie";319;0;100
0;216;"valla";216;0;100
0;138;"vallarie";138;0;100
0;34;"valle";34;0;100
6;10;"vallee";16;37.5;62.5
110;34;"vallen";144;76.3888888888889;23.6111111111111
0;7;"vallene";7;0;100
0;76;"valleri";76;0;100
0;12;"valleria";12;0;100
0;1068;"vallerie";1068;0;100
0;683;"vallery";683;0;100
43;297;"valley";340;12.6470588235294;87.3529411764706
0;676;"valli";676;0;100
138;2637;"vallie";2775;4.97297297297297;95.027027027027
10;22;"vallon";32;31.25;68.75
0;99;"vallorie";99;0;100
0;67;"vallory";67;0;100
0;6;"vally";6;0;100
0;5;"vallyn";5;0;100
0;388;"valma";388;0;100
10;0;"valmond";10;100;0
197;0;"valmore";197;100;0
11;0;"valo";11;100;0
0;60;"valois";60;0;100
188;5;"valon";193;97.4093264248705;2.59067357512953
0;36;"valonda";36;0;100
445;44;"valor";489;91.0020449897751;8.99795501022495
0;355;"valora";355;0;100
0;129;"valoree";129;0;100
0;297;"valori";297;0;100
0;68;"valoria";68;0;100
0;7314;"valorie";7314;0;100
0;5;"valoris";5;0;100
0;292;"valory";292;0;100
0;11;"valoy";11;0;100
0;8;"valoyce";8;0;100
0;6;"valrea";6;0;100
0;131;"valree";131;0;100
0;36;"valri";36;0;100
5;909;"valrie";914;0.547045951859956;99.45295404814
0;130;"valta";130;0;100
299;0;"valton";299;100;0
0;156;"valyn";156;0;100
0;112;"valyncia";112;0;100
0;41;"valynda";41;0;100
0;62;"valynn";62;0;100
0;5;"valyre";5;0;100
0;5;"valyssa";5;0;100
0;5;"vamika";5;0;100
74;0;"vamsi";74;100;0
26428;1657;"van";28085;94.1000534092932;5.89994659070678
0;482;"vana";482;0;100
0;31;"vanae";31;0;100
0;10;"vananh";10;0;100
0;5;"vanasia";5;0;100
0;369;"vanassa";369;0;100
0;13;"vanaya";13;0;100
18;0;"vanburen";18;100;0
24642;133;"vance";24775;99.4631685166498;0.536831483350151
41;0;"vancil";41;100;0
0;6;"vancy";6;0;100
0;1664;"vanda";1664;0;100
0;5;"vandalia";5;0;100
39;0;"vandan";39;100;0
0;97;"vandana";97;0;100
0;6;"vandela";6;0;100
0;11;"vandelia";11;0;100
86;0;"vandell";86;100;0
0;103;"vandella";103;0;100
127;0;"vanden";127;100;0
1108;0;"vander";1108;100;0
70;0;"vanderbilt";70;100;0
11;0;"vanderlei";11;100;0
0;38;"vandetta";38;0;100
0;34;"vandi";34;0;100
6;0;"vandiver";6;100;0
43;0;"vandon";43;100;0
0;82;"vandora";82;0;100
0;5;"vandra";5;0;100
0;5;"vandrea";5;0;100
299;193;"vandy";492;60.7723577235772;39.2276422764228
146;0;"vane";146;100;0
0;164;"vanecia";164;0;100
0;5;"vaneda";5;0;100
0;10;"vaneesa";10;0;100
0;15;"vaneeza";15;0;100
0;33;"vaneisha";33;0;100
0;6;"vaneka";6;0;100
0;10;"vanella";10;0;100
0;258;"vanellope";258;0;100
0;10;"vanelly";10;0;100
0;32;"vanelope";32;0;100
0;24;"vanely";24;0;100
5;6284;"vanesa";6289;0.0795038956908889;99.9204961043091
0;342;"vanesha";342;0;100
0;53;"vaneshia";53;0;100
0;57;"vanesia";57;0;100
0;293;"vaness";293;0;100
983;251007;"vanessa";251990;0.390094845033533;99.6099051549665
0;5;"vanessaanne";5;0;100
0;16;"vanessah";16;0;100
0;40;"vanessamarie";40;0;100
0;29;"vanesse";29;0;100
0;297;"vanessia";297;0;100
0;18;"vanesta";18;0;100
0;13;"vanester";13;0;100
0;189;"vaneta";189;0;100
0;1224;"vanetta";1224;0;100
0;292;"vanette";292;0;100
0;399;"vaneza";399;0;100
0;39;"vanezza";39;0;100
325;11;"vang";336;96.7261904761905;3.27380952380952
0;11;"vangela";11;0;100
0;648;"vangie";648;0;100
0;291;"vani";291;0;100
0;2437;"vania";2437;0;100
0;67;"vaniah";67;0;100
0;161;"vanice";161;0;100
0;10;"vanicia";10;0;100
0;35;"vanida";35;0;100
0;5;"vanie";5;0;100
0;5;"vaniecia";5;0;100
0;16;"vanika";16;0;100
0;195;"vanilla";195;0;100
0;11;"vanille";11;0;100
10;0;"vanis";10;100;0
0;12;"vanisa";12;0;100
0;6;"vanise";6;0;100
0;434;"vanisha";434;0;100
0;239;"vanissa";239;0;100
0;2055;"vanita";2055;0;100
0;5;"vanitie";5;0;100
0;1660;"vanity";1660;0;100
0;101;"vaniya";101;0;100
0;89;"vaniyah";89;0;100
0;5;"vanja";5;0;100
1800;24;"vann";1824;98.6842105263158;1.31578947368421
59;1559;"vanna";1618;3.64647713226205;96.353522867738
0;80;"vannah";80;0;100
50;0;"vannak";50;100;0
16;0;"vannara";16;100;0
0;41;"vannary";41;0;100
5;0;"vanner";5;100;0
0;1214;"vannesa";1214;0;100
13;5;"vanness";18;72.2222222222222;27.7777777777778
0;3189;"vannessa";3189;0;100
0;15;"vannetta";15;0;100
0;34;"vannette";34;0;100
0;127;"vannia";127;0;100
0;23;"vannida";23;0;100
180;685;"vannie";865;20.8092485549133;79.1907514450867
16;49;"vanny";65;24.6153846153846;75.3846153846154
0;33;"vannya";33;0;100
0;11;"vanora";11;0;100
489;0;"vansh";489;100;0
0;214;"vanshika";214;0;100
5;0;"vanshon";5;100;0
20;0;"vanson";20;100;0
0;65;"vantasia";65;0;100
0;5;"vanteen";5;0;100
11;0;"vantrell";11;100;0
0;15;"vantrice";15;0;100
5;0;"vanus";5;100;0
0;667;"vanya";667;0;100
0;5;"vanyah";5;0;100
0;588;"vara";588;0;100
36;0;"varad";36;100;0
25;0;"vard";25;100;0
0;5;"varda";5;0;100
46;0;"vardaan";46;100;0
13;0;"vardaman";13;100;0
27;0;"vardan";27;100;0
30;0;"vardell";30;100;0
5;0;"varden";5;100;0
8;0;"vardhan";8;100;0
6;0;"vardie";6;100;0
13;0;"vareck";13;100;0
0;6;"varee";6;0;100
5;0;"varek";5;100;0
32;0;"varen";32;100;0
0;8;"varena";8;0;100
0;39;"varenya";39;0;100
0;63;"varetta";63;0;100
0;15;"variah";15;0;100
304;5;"varian";309;98.3818770226537;1.61812297734628
212;0;"varick";212;100;0
0;78;"varie";78;0;100
6;0;"varik";6;100;0
5;0;"varin";5;100;0
0;181;"varina";181;0;100
0;18;"varinia";18;0;100
7;0;"varion";7;100;0
36;0;"varish";36;100;0
0;10;"varna";10;0;100
180;98;"varnell";278;64.7482014388489;35.2517985611511
43;0;"varner";43;100;0
29;0;"varney";29;100;0
0;5;"varnie";5;0;100
0;180;"varnika";180;0;100
5;0;"varnum";5;100;0
10;0;"varon";10;100;0
0;11;"varonda";11;0;100
0;231;"varonica";231;0;100
0;842;"varsha";842;0;100
0;11;"varshika";11;0;100
0;167;"varshini";167;0;100
0;6;"varshita";6;0;100
0;8;"varshitha";8;0;100
175;0;"vartan";175;100;0
2331;0;"varun";2331;100;0
0;105;"varvara";105;0;100
15;0;"vasanth";15;100;0
0;5;"vasanti";5;0;100
447;0;"vasco";447;100;0
16;0;"vasean";16;100;0
202;0;"vash";202;100;0
0;5;"vasha";5;0;100
0;33;"vashanti";33;0;100
204;6;"vashaun";210;97.1428571428571;2.85714285714286
474;33;"vashawn";507;93.491124260355;6.50887573964497
11;5;"vashion";16;68.75;31.25
0;5;"vashni";5;0;100
747;69;"vashon";816;91.5441176470588;8.45588235294118
0;11;"vashonda";11;0;100
12;0;"vashone";12;100;0
0;2117;"vashti";2117;0;100
0;47;"vashtie";47;0;100
0;5;"vasia";5;0;100
79;0;"vasil";79;100;0
16;0;"vasile";16;100;0
140;0;"vasili";140;100;0
0;80;"vasilia";80;0;100
5;0;"vasilije";5;100;0
0;18;"vasilike";18;0;100
0;1116;"vasiliki";1116;0;100
1358;0;"vasilios";1358;100;0
175;0;"vasilis";175;100;0
0;140;"vasilisa";140;0;100
67;0;"vasiliy";67;100;0
68;0;"vasily";68;100;0
6;0;"vasisht";6;100;0
5;0;"vasken";5;100;0
5;0;"vaso";5;100;0
21;0;"vassar";21;100;0
0;650;"vassie";650;0;100
23;0;"vassilios";23;100;0
0;6;"vasta";6;0;100
0;13;"vasthi";13;0;100
0;206;"vasti";206;0;100
0;69;"vastie";69;0;100
33;0;"vastine";33;100;0
57;0;"vasu";57;100;0
17;0;"vasudev";17;100;0
0;31;"vasudha";31;0;100
0;6;"vatasha";6;0;100
25;0;"vatche";25;100;0
36;0;"vatsal";36;100;0
0;70;"vauda";70;0;100
0;95;"vaudie";95;0;100
0;73;"vaudine";73;0;100
0;16;"vaudis";16;0;100
12;0;"vaugh";12;100;0
1517;22;"vaughan";1539;98.5705003248863;1.42949967511371
19633;936;"vaughn";20569;95.4494627838009;4.55053721619913
0;10;"vaughna";10;0;100
81;0;"vaun";81;100;0
0;32;"vauna";32;0;100
0;130;"vaunda";130;0;100
0;34;"vaune";34;0;100
0;5;"vaunita";5;0;100
0;11;"vava";11;0;100
0;5;"vawn";5;0;100
0;13;"vay";13;0;100
0;36;"vaya";36;0;100
0;13;"vayah";13;0;100
0;1133;"vayda";1133;0;100
118;0;"vayden";118;100;0
0;107;"vayla";107;0;100
28;0;"vaylen";28;100;0
5;0;"vayne";5;100;0
5;0;"vayron";5;100;0
18;0;"veachel";18;100;0
0;89;"veanna";89;0;100
0;5;"veanne";5;0;100
0;165;"vear";165;0;100
453;70;"vearl";523;86.6156787762906;13.3843212237094
146;0;"veasna";146;100;0
0;443;"veatrice";443;0;100
806;0;"ved";806;100;0
0;10655;"veda";10655;0;100
42;0;"vedaant";42;100;0
45;0;"vedad";45;100;0
113;0;"vedansh";113;100;0
0;76;"vedanshi";76;0;100
788;0;"vedant";788;100;0
219;0;"vedanth";219;100;0
12;0;"vedat";12;100;0
74;0;"vedder";74;100;0
0;5;"vedette";5;0;100
98;0;"vedh";98;100;0
0;126;"vedha";126;0;100
0;11;"vedhika";11;0;100
0;38;"vedia";38;0;100
0;276;"vedika";276;0;100
0;20;"vedra";20;0;100
10;257;"vee";267;3.74531835205993;96.2546816479401
0;60;"veeda";60;0;100
0;7;"veeha";7;0;100
0;28;"veeksha";28;0;100
0;525;"veena";525;0;100
1208;0;"veer";1208;100;0
0;207;"veera";207;0;100
14;0;"veeraj";14;100;0
0;10;"veeta";10;0;100
0;7;"veeya";7;0;100
80;382;"vega";462;17.3160173160173;82.6839826839827
198;115;"vegas";313;63.258785942492;36.741214057508
10;0;"vegeta";10;100;0
0;73;"veida";73;0;100
59;0;"veikko";59;100;0
0;7;"veira";7;0;100
11;13;"vel";24;45.8333333333333;54.1666666666667
0;855;"vela";855;0;100
0;6;"velah";6;0;100
5;0;"velan";5;100;0
0;5;"velanie";5;0;100
0;5;"velarie";5;0;100
0;6;"velcie";6;0;100
0;7514;"velda";7514;0;100
0;5;"veldia";5;0;100
241;0;"veldon";241;100;0
0;77;"velecia";77;0;100
0;122;"veleda";122;0;100
0;146;"veleka";146;0;100
0;41;"velen";41;0;100
0;62;"velena";62;0;100
0;135;"velencia";135;0;100
0;80;"velera";80;0;100
0;221;"veleria";221;0;100
0;13;"velerie";13;0;100
0;248;"veleta";248;0;100
0;57;"veletta";57;0;100
0;2766;"velia";2766;0;100
0;240;"velicia";240;0;100
0;16;"velicity";16;0;100
0;5;"velika";5;0;100
0;360;"velina";360;0;100
0;891;"velinda";891;0;100
0;153;"velisa";153;0;100
0;47;"velisha";47;0;100
0;42;"velissa";42;0;100
0;96;"velita";96;0;100
7;0;"velkan";7;100;0
0;1886;"vella";1886;0;100
450;84137;"velma";84587;0.531996642510078;99.4680033574899
22;54;"velmar";76;28.9473684210526;71.0526315789474
0;11;"velmarie";11;0;100
190;220;"velmer";410;46.3414634146341;53.6585365853659
0;5;"velmo";5;0;100
0;11;"velmon";11;0;100
0;558;"velna";558;0;100
0;5;"velois";5;0;100
0;430;"velora";430;0;100
0;12;"veloria";12;0;100
0;21;"velouria";21;0;100
0;6;"velsie";6;0;100
0;1106;"velta";1106;0;100
603;0;"velton";603;100;0
0;4144;"velva";4144;0;100
0;31;"velveeta";31;0;100
5;2991;"velvet";2996;0.166889185580774;99.8331108144192
0;5;"velvett";5;0;100
0;10;"velvetta";10;0;100
0;7;"velvette";7;0;100
0;165;"velvia";165;0;100
0;225;"velvie";225;0;100
0;27;"vema";27;0;100
0;2381;"vena";2381;0;100
481;0;"venancio";481;100;0
47;0;"venard";47;100;0
0;6;"venassa";6;0;100
0;46;"venba";46;0;100
78;0;"vence";78;100;0
228;0;"vencent";228;100;0
0;11;"vencie";11;0;100
155;0;"vencil";155;100;0
0;152;"venda";152;0;100
0;64;"vendela";64;0;100
0;195;"vendetta";195;0;100
0;5;"vendla";5;0;100
0;744;"venecia";744;0;100
0;233;"veneda";233;0;100
0;11;"veneita";11;0;100
0;6;"venellope";6;0;100
0;32;"venelope";32;0;100
0;122;"venera";122;0;100
0;309;"venesa";309;0;100
0;96;"venesha";96;0;100
0;10;"veneshia";10;0;100
0;38;"venesia";38;0;100
0;5703;"venessa";5703;0;100
0;17;"venessia";17;0;100
0;12;"venesta";12;0;100
0;738;"veneta";738;0;100
0;1270;"venetia";1270;0;100
0;995;"venetta";995;0;100
0;27;"venette";27;0;100
0;284;"venezia";284;0;100
0;225;"venia";225;0;100
84;0;"veniamin";84;100;0
0;11;"venica";11;0;100
212;2594;"venice";2806;7.55523877405559;92.4447612259444
0;189;"venicia";189;0;100
38;0;"venicio";38;100;0
0;154;"venida";154;0;100
0;240;"venie";240;0;100
0;27;"veniece";27;0;100
0;6;"venika";6;0;100
11;47;"venis";58;18.9655172413793;81.0344827586207
0;78;"venisa";78;0;100
0;465;"venise";465;0;100
0;266;"venisha";266;0;100
0;6;"venishia";6;0;100
0;127;"venissa";127;0;100
0;5684;"venita";5684;0;100
0;5;"venitra";5;0;100
0;36;"venitta";36;0;100
106;0;"venkat";106;100;0
0;498;"venna";498;0;100
0;69;"vennela";69;0;100
0;53;"vennesa";53;0;100
0;217;"vennessa";217;0;100
0;21;"vennetta";21;0;100
71;1192;"vennie";1263;5.6215360253365;94.3784639746635
10;0;"vennis";10;100;0
0;89;"venola";89;0;100
0;23;"venona";23;0;100
0;261;"venora";261;0;100
5;0;"venoy";5;100;0
664;0;"venson";664;100;0
14;0;"vent";14;100;0
58;0;"venton";58;100;0
5;0;"ventrell";5;100;0
1249;221;"ventura";1470;84.9659863945578;15.0340136054422
6;0;"venture";6;100;0
6;0;"ventus";6;100;0
91;8679;"venus";8770;1.03762827822121;98.9623717217788
0;34;"venya";34;0;100
15;6;"veo";21;71.4285714285714;28.5714285714286
0;1798;"veola";1798;0;100
0;5;"veolia";5;0;100
5;0;"veon";5;100;0
0;124;"veona";124;0;100
0;17;"veonica";17;0;100
0;6;"veonka";6;0;100
0;131;"veora";131;0;100
391;129936;"vera";130327;0.300014578713544;99.6999854212865
0;5;"verabelle";5;0;100
0;17;"verah";17;0;100
49;13;"veral";62;79.0322580645161;20.9677419354839
7;0;"verald";7;100;0
0;37;"veralee";37;0;100
0;111;"veralyn";111;0;100
0;40;"veralynn";40;0;100
0;39;"veramae";39;0;100
0;37;"veranda";37;0;100
0;249;"verania";249;0;100
0;598;"verba";598;0;100
0;49;"verbal";49;0;100
0;98;"verbena";98;0;100
0;5;"verbia";5;0;100
5;183;"verbie";188;2.65957446808511;97.3404255319149
57;80;"verble";137;41.6058394160584;58.3941605839416
206;0;"verbon";206;100;0
0;205;"vercie";205;0;100
7;7375;"verda";7382;0.0948252506095909;99.9051747493904
6;0;"verdale";6;100;0
0;74;"verdean";74;0;100
0;5;"verdeen";5;0;100
5;5;"verdel";10;50;50
1340;2085;"verdell";3425;39.1240875912409;60.8759124087591
0;274;"verdella";274;0;100
0;242;"verdelle";242;0;100
29;0;"verden";29;100;0
0;23;"verdena";23;0;100
0;88;"verdene";88;0;100
11;5;"verdi";16;68.75;31.25
0;653;"verdia";653;0;100
211;2272;"verdie";2483;8.49778493757551;91.5022150624245
0;16;"verdina";16;0;100
0;168;"verdine";168;0;100
166;69;"verdis";235;70.6382978723404;29.3617021276596
5;0;"verdo";5;100;0
226;0;"verdon";226;100;0
0;5;"verdonna";5;0;100
81;8;"verdun";89;91.0112359550562;8.98876404494382
170;11;"vere";181;93.9226519337017;6.07734806629834
0;5;"vereda";5;0;100
0;5;"veree";5;0;100
0;10;"vereen";10;0;100
0;1621;"verena";1621;0;100
0;17;"verenda";17;0;100
0;55;"verene";55;0;100
0;1556;"verenice";1556;0;100
0;68;"verenis";68;0;100
0;292;"verenise";292;0;100
0;22;"verenisse";22;0;100
0;13;"vereniz";13;0;100
0;15;"verenize";15;0;100
0;170;"veretta";170;0;100
0;28;"verga";28;0;100
6;0;"vergal";6;100;0
12;0;"verge";12;100;0
0;7;"vergean";7;0;100
5;0;"vergel";5;100;0
0;137;"vergene";137;0;100
0;397;"vergia";397;0;100
47;4262;"vergie";4309;1.09074031097702;98.909259689023
1813;56;"vergil";1869;97.0037453183521;2.99625468164794
0;10;"vergina";10;0;100
0;171;"verginia";171;0;100
0;358;"veria";358;0;100
0;5;"verian";5;0;100
0;17;"veridiana";17;0;100
22;5;"veril";27;81.4814814814815;18.5185185185185
0;7;"verilea";7;0;100
0;181;"verina";181;0;100
0;6;"verinda";6;0;100
0;5;"verinica";5;0;100
0;165;"verita";165;0;100
0;830;"verity";830;0;100
0;44;"verjean";44;0;100
2510;205;"verl";2715;92.4493554327808;7.55064456721915
0;6098;"verla";6098;0;100
0;115;"verlaine";115;0;100
319;5;"verlan";324;98.4567901234568;1.54320987654321
0;6;"verlana";6;0;100
253;0;"verland";253;100;0
0;5;"verlanda";5;0;100
0;8;"verlane";8;0;100
1758;498;"verle";2256;77.9255319148936;22.0744680851064
0;453;"verlean";453;0;100
0;573;"verlee";573;0;100
0;192;"verleen";192;0;100
17;6;"verlen";23;73.9130434782609;26.0869565217391
0;348;"verlena";348;0;100
0;1873;"verlene";1873;0;100
0;54;"verletta";54;0;100
21;84;"verley";105;20;80
0;232;"verlia";232;0;100
178;2144;"verlie";2322;7.66580534022395;92.3341946597761
3801;291;"verlin";4092;92.8885630498534;7.11143695014663
0;43;"verlina";43;0;100
0;610;"verlinda";610;0;100
0;1088;"verline";1088;0;100
15;0;"verlis";15;100;0
0;62;"verlisa";62;0;100
0;5;"verlla";5;0;100
1697;326;"verlon";2023;83.8853188334157;16.1146811665843
0;5;"verly";5;0;100
1432;488;"verlyn";1920;74.5833333333333;25.4166666666667
5;5;"verlynn";10;50;50
0;923;"verma";923;0;100
0;44;"vermel";44;0;100
0;726;"vermell";726;0;100
0;234;"vermelle";234;0;100
247;0;"vermon";247;100;0
0;5;"vermonica";5;0;100
21;7;"vermont";28;75;25
10869;467;"vern";11336;95.8803810868031;4.11961891319689
519;64667;"verna";65186;0.796183229527813;99.2038167704722
0;43;"vernabelle";43;0;100
0;10;"vernada";10;0;100
0;26;"vernadean";26;0;100
0;5;"vernadeen";5;0;100
0;65;"vernadette";65;0;100
0;231;"vernadine";231;0;100
0;49;"vernae";49;0;100
1770;353;"vernal";2123;83.3725859632595;16.6274140367405
0;40;"vernalee";40;0;100
5;0;"vernall";5;100;0
0;26;"vernamae";26;0;100
18;0;"vernan";18;100;0
5;0;"vernando";5;100;0
2066;0;"vernard";2066;100;0
0;5;"vernasia";5;0;100
0;5;"vernay";5;0;100
5513;767;"verne";6280;87.7866242038217;12.2133757961783
5;171;"verneal";176;2.84090909090909;97.1590909090909
0;6;"vernease";6;0;100
0;16;"vernece";16;0;100
0;84;"vernecia";84;0;100
0;631;"verneda";631;0;100
0;92;"vernee";92;0;100
0;10;"verneeda";10;0;100
0;170;"verneice";170;0;100
0;34;"verneil";34;0;100
0;5;"verneisha";5;0;100
0;5;"verneita";5;0;100
249;85;"vernel";334;74.5508982035928;25.4491017964072
0;10;"vernelda";10;0;100
3321;7119;"vernell";10440;31.8103448275862;68.1896551724138
0;62;"vernella";62;0;100
5;1245;"vernelle";1250;0.4;99.6
7;0;"vernen";7;100;0
1825;171;"verner";1996;91.4328657314629;8.56713426853707
10;0;"vernes";10;100;0
0;10;"vernesa";10;0;100
0;39;"vernese";39;0;100
0;104;"vernesha";104;0;100
0;881;"vernessa";881;0;100
0;15;"vernessia";15;0;100
28;0;"vernest";28;100;0
0;7;"vernesta";7;0;100
0;6;"vernesteen";6;0;100
0;137;"vernestine";137;0;100
11;10;"vernet";21;52.3809523809524;47.6190476190476
0;230;"verneta";230;0;100
0;30;"vernetha";30;0;100
0;5;"vernetia";5;0;100
0;54;"vernett";54;0;100
0;3024;"vernetta";3024;0;100
0;1254;"vernette";1254;0;100
17;0;"verney";17;100;0
0;5;"vernez";5;0;100
0;1222;"vernia";1222;0;100
0;145;"vernica";145;0;100
789;7174;"vernice";7963;9.90832600778601;90.091673992214
0;36;"vernicia";36;0;100
0;72;"vernida";72;0;100
2587;3438;"vernie";6025;42.9377593360996;57.0622406639004
0;294;"verniece";294;0;100
0;23;"vernika";23;0;100
0;26;"vernique";26;0;100
292;187;"vernis";479;60.9603340292276;39.0396659707724
0;5;"vernisa";5;0;100
0;10;"vernise";10;0;100
0;333;"vernisha";333;0;100
0;4017;"vernita";4017;0;100
0;41;"vernitta";41;0;100
0;11;"verniya";11;0;100
0;11;"vernoica";11;0;100
0;10;"vernola";10;0;100
143482;1872;"vernon";145354;98.7121097458618;1.28789025413817
0;251;"vernona";251;0;100
0;44;"vernonica";44;0;100
118;0;"vernor";118;100;0
20;0;"vernus";20;100;0
5;5;"vero";10;50;50
467;5;"veron";472;98.9406779661017;1.0593220338983
0;3904;"verona";3904;0;100
0;359;"veroncia";359;0;100
0;360;"veronda";360;0;100
0;30;"verone";30;0;100
0;280;"veronia";280;0;100
0;19;"veronic";19;0;100
835;214852;"veronica";215687;0.387135061454793;99.6128649385452
0;16;"veronice";16;0;100
0;10;"veronicia";10;0;100
0;5;"veronicka";5;0;100
0;2959;"veronika";2959;0;100
0;1413;"veronique";1413;0;100
0;59;"veronnica";59;0;100
0;6;"veronyca";6;0;100
0;11;"verree";11;0;100
17;0;"verron";17;100;0
0;5;"verrona";5;0;100
0;12;"verronica";12;0;100
0;621;"versa";621;0;100
10;0;"versace";10;100;0
0;5;"versailles";5;0;100
0;5;"versal";5;0;100
0;10;"versavia";10;0;100
10;0;"versel";10;100;0
0;10;"versey";10;0;100
6;0;"vershaun";6;100;0
80;5;"vershawn";85;94.1176470588235;5.88235294117647
10;0;"vershon";10;100;0
0;5;"vershonda";5;0;100
0;223;"versia";223;0;100
103;2490;"versie";2593;3.97223293482453;96.0277670651755
0;1039;"verta";1039;0;100
0;52;"vertell";52;0;100
0;47;"vertia";47;0;100
0;19;"vertice";19;0;100
5;1329;"vertie";1334;0.374812593703148;99.6251874062969
0;52;"vertina";52;0;100
587;333;"vertis";920;63.804347826087;36.195652173913
5;0;"vertle";5;100;0
5;0;"vertner";5;100;0
5;0;"verton";5;100;0
0;5;"veruca";5;0;100
0;38;"verva";38;0;100
686;374;"veryl";1060;64.7169811320755;35.2830188679245
6;28;"veryle";34;17.6470588235294;82.3529411764706
0;35;"vesa";35;0;100
0;40;"vesenia";40;0;100
7;0;"veshawn";7;100;0
0;228;"vesna";228;0;100
41;405;"vesper";446;9.19282511210762;90.8071748878924
0;33;"vessica";33;0;100
5;426;"vessie";431;1.16009280742459;98.8399071925754
27;7055;"vesta";7082;0.381248234961875;99.6187517650381
367;125;"vestal";492;74.5934959349593;25.4065040650407
38;0;"vestel";38;100;0
2448;636;"vester";3084;79.3774319066148;20.6225680933852
0;48;"vestie";48;0;100
0;5;"vestina";5;0;100
31;0;"veston";31;100;0
0;1918;"veta";1918;0;100
0;5;"vetha";5;0;100
205;0;"veto";205;100;0
8;0;"veton";8;100;0
0;74;"vetra";74;0;100
0;5;"vetrice";5;0;100
0;155;"vetta";155;0;100
0;1350;"veva";1350;0;100
0;29;"vevelyn";29;0;100
0;138;"veverly";138;0;100
0;20;"veya";20;0;100
0;12;"veyah";12;0;100
0;183;"veyda";183;0;100
0;52;"veyonce";52;0;100
17;0;"veyron";17;100;0
0;13;"vhonda";13;0;100
125;870;"vi";995;12.5628140703518;87.4371859296482
0;82;"via";82;0;100
518;0;"viaan";518;100;0
107;22;"vian";129;82.9457364341085;17.0542635658915
0;532;"viana";532;0;100
0;5;"vianay";5;0;100
0;1800;"vianca";1800;0;100
0;16;"viance";16;0;100
0;44;"vianet";44;0;100
0;13;"vianeth";13;0;100
0;16;"vianette";16;0;100
0;3235;"vianey";3235;0;100
0;18;"viani";18;0;100
0;437;"vianka";437;0;100
0;132;"viann";132;0;100
0;1312;"vianna";1312;0;100
0;335;"vianne";335;0;100
0;2074;"vianney";2074;0;100
0;30;"vianni";30;0;100
0;128;"vianny";128;0;100
0;27;"viany";27;0;100
0;388;"vibha";388;0;100
172;0;"vibhav";172;100;0
28;0;"vibhu";28;100;0
0;12;"vibiana";12;0;100
5;0;"vibol";5;100;0
2083;0;"vic";2083;100;0
0;8;"vica";8;0;100
0;294;"vicci";294;0;100
5;0;"vice";5;100;0
638;0;"vicent";638;100;0
0;1113;"vicenta";1113;0;100
18450;0;"vicente";18450;100;0
37;0;"vicenzo";37;100;0
0;5;"vicey";5;0;100
0;5;"vichelle";5;0;100
0;224;"vici";224;0;100
0;645;"vicie";645;0;100
578;5;"vick";583;99.1423670668954;0.857632933104631
0;163;"vicke";163;0;100
0;79;"vickee";79;0;100
21;0;"vicken";21;100;0
140;5806;"vickey";5946;2.35452404978137;97.6454759502186
295;153186;"vicki";153481;0.192206201419068;99.8077937985809
0;38;"vickiana";38;0;100
0;15;"vickiann";15;0;100
388;109970;"vickie";110358;0.351583029775821;99.6484169702242
0;139;"vickii";139;0;100
0;12;"vickilee";12;0;100
0;10;"vickilyn";10;0;100
0;21;"vickilynn";21;0;100
0;97;"vickki";97;0;100
32;0;"vicktor";32;100;0
0;371;"vicktoria";371;0;100
439;53160;"vicky";53599;0.819045131439019;99.180954868561
0;187;"vickye";187;0;100
0;22;"vicotria";22;0;100
0;53;"victoire";53;0;100
309972;1808;"victor";311780;99.4201039194304;0.579896080569632
0;197;"victora";197;0;100
15;0;"victoralfonso";15;100;0
0;21;"victorea";21;0;100
0;5;"victorene";5;0;100
126;0;"victorhugo";126;100;0
0;40;"victori";40;0;100
1232;475323;"victoria";476555;0.258522101331431;99.7414778986686
0;44;"victoriaann";44;0;100
0;103;"victoriah";103;0;100
0;22;"victorialynn";22;0;100
0;18;"victoriamarie";18;0;100
0;98;"victorian";98;0;100
0;332;"victoriana";332;0;100
0;37;"victorianna";37;0;100
1340;0;"victoriano";1340;100;0
0;25;"victoriarose";25;0;100
0;16;"victorie";16;0;100
0;104;"victorina";104;0;100
0;599;"victorine";599;0;100
354;0;"victorino";354;100;0
485;0;"victorio";485;100;0
62;58;"victorious";120;51.6666666666667;48.3333333333333
0;95;"victoriya";95;0;100
10;0;"victorjr";10;100;0
228;0;"victormanuel";228;100;0
0;11;"victorria";11;0;100
540;1277;"victory";1817;29.7193175564117;70.2806824435883
0;523;"victorya";523;0;100
0;89;"vicy";89;0;100
38;9581;"vida";9619;0.395051460650795;99.6049485393492
3896;10;"vidal";3906;99.7439836149514;0.256016385048643
0;6;"vidala";6;0;100
13;0;"vidale";13;100;0
0;160;"vidalia";160;0;100
19;59;"videl";78;24.3589743589744;75.6410256410256
13;5;"videll";18;72.2222222222222;27.7777777777778
0;16;"vidella";16;0;100
0;23;"vidette";23;0;100
5;0;"vidhaan";5;100;0
0;477;"vidhi";477;0;100
5;0;"vidhu";5;100;0
15;0;"vidhur";15;100;0
0;29;"vidhya";29;0;100
0;40;"vidia";40;0;100
0;7;"vidisha";7;0;100
45;0;"vidit";45;100;0
0;6;"vidula";6;0;100
47;0;"vidur";47;100;0
0;37;"vidushi";37;0;100
0;393;"vidya";393;0;100
44;0;"vidyut";44;100;0
48;0;"vidyuth";48;100;0
0;19;"vie";19;0;100
0;5;"vieda";5;0;100
0;168;"vielka";168;0;100
0;5;"viella";5;0;100
16;0;"vien";16;100;0
0;31;"viena";31;0;100
5;0;"vience";5;100;0
0;3761;"vienna";3761;0;100
0;176;"vienne";176;0;100
0;200;"vieno";200;0;100
0;102;"viera";102;0;100
6;0;"vieri";6;100;0
0;5;"vierra";5;0;100
0;5;"viesha";5;0;100
1067;11;"viet";1078;98.9795918367347;1.02040816326531
0;363;"vietta";363;0;100
0;68;"vieva";68;0;100
470;0;"viggo";470;100;0
0;15;"viginia";15;0;100
252;0;"vignesh";252;100;0
18;0;"vigo";18;100;0
0;87;"viha";87;0;100
0;6;"vihaa";6;0;100
2726;0;"vihaan";2726;100;0
25;0;"vihaanreddy";25;100;0
10;0;"vihaas";10;100;0
282;0;"vihan";282;100;0
0;54;"vihana";54;0;100
26;0;"vihas";26;100;0
0;5;"vija";5;0;100
1438;0;"vijay";1438;100;0
0;5;"vijaya";5;0;100
0;117;"vika";117;0;100
519;0;"vikas";519;100;0
162;0;"vikash";162;100;0
5;0;"vikesh";5;100;0
5;0;"vikhyath";5;100;0
0;1817;"viki";1817;0;100
0;16;"vikie";16;0;100
0;7;"vikita";7;0;100
0;6488;"vikki";6488;0;100
0;62;"vikkie";62;0;100
0;5;"vikky";5;0;100
1649;0;"vikram";1649;100;0
5;0;"vikramjit";5;100;0
175;0;"vikrant";175;100;0
41;0;"vikranth";41;100;0
2243;0;"viktor";2243;100;0
0;2073;"viktoria";2073;0;100
0;12;"viktorija";12;0;100
0;176;"viktoriya";176;0;100
0;95;"viktorya";95;0;100
0;24;"viky";24;0;100
0;509;"vila";509;0;100
493;14;"vilas";507;97.2386587771203;2.76134122287968
0;18;"vilate";18;0;100
0;88;"vilda";88;0;100
0;5;"vildan";5;0;100
0;26;"vilena";26;0;100
0;6;"vilene";6;0;100
0;36;"viletta";36;0;100
5;0;"vilho";5;100;0
5;0;"vili";5;100;0
0;15;"vilia";15;0;100
434;0;"viliami";434;100;0
6;0;"viliamu";6;100;0
0;5;"vilija";5;0;100
0;16;"vilinda";16;0;100
27;604;"villa";631;4.27892234548336;95.7210776545166
21;0;"villard";21;100;0
15;0;"ville";15;100;0
0;12;"villie";12;0;100
0;4823;"vilma";4823;0;100
0;15;"vilmarie";15;0;100
97;0;"vimal";97;100;0
0;5;"vimala";5;0;100
173;0;"vin";173;100;0
0;4273;"vina";4273;0;100
131;0;"vinal";131;100;0
0;6;"vinathi";6;0;100
1073;0;"vinay";1073;100;0
0;90;"vinaya";90;0;100
127;0;"vinayak";127;100;0
0;6;"vincci";6;0;100
11534;5;"vince";11539;99.9566686887945;0.0433313112054771
20;0;"vincel";20;100;0
118;0;"vincen";118;100;0
0;7;"vincene";7;0;100
332436;1383;"vincent";333819;99.5857036298114;0.414296370188635
0;114;"vincenta";114;0;100
2708;0;"vincente";2708;100;0
0;54;"vincentia";54;0;100
0;80;"vincentina";80;0;100
0;18;"vincentine";18;0;100
6;0;"vincentmichael";6;100;0
0;3462;"vincenza";3462;0;100
0;11;"vincenzia";11;0;100
0;107;"vincenzina";107;0;100
5;0;"vincenzio";5;100;0
7503;0;"vincenzo";7503;100;0
0;56;"vincetta";56;0;100
28;0;"vinchenzo";28;100;0
8;5;"vinci";13;61.5384615384615;38.4615384615385
0;153;"vincie";153;0;100
212;0;"vincient";212;100;0
36;0;"vincil";36;100;0
30;0;"vincint";30;100;0
0;81;"vincy";81;0;100
0;26;"vinda";26;0;100
0;5;"vindetta";5;0;100
0;22;"vindhya";22;0;100
0;5;"vine";5;0;100
0;6;"vinecia";6;0;100
5;0;"vineel";5;100;0
247;0;"vineet";247;100;0
0;11;"vineeta";11;0;100
83;0;"vineeth";83;100;0
0;5;"vineisha";5;0;100
0;10;"vinell";10;0;100
20;0;"vinesh";20;100;0
0;18;"vinesha";18;0;100
0;362;"vinessa";362;0;100
0;225;"vineta";225;0;100
0;329;"vinetta";329;0;100
0;71;"vinette";71;0;100
0;317;"viney";317;0;100
1405;10;"vinh";1415;99.2932862190813;0.706713780918728
0;233;"vinia";233;0;100
267;0;"vinicio";267;100;0
307;0;"vinicius";307;100;0
0;299;"vinie";299;0;100
0;73;"vinisha";73;0;100
21;0;"vinit";21;100;0
0;1227;"vinita";1227;0;100
19;0;"vinn";19;100;0
0;15;"vinna";15;0;100
0;5;"vinni";5;0;100
0;34;"vinnia";34;0;100
715;2453;"vinnie";3168;22.5694444444444;77.4305555555556
953;0;"vinny";953;100;0
154;0;"vinod";154;100;0
0;5;"vinola";5;0;100
0;5;"vinona";5;0;100
3643;0;"vinson";3643;100;0
10;0;"vinston";10;100;0
85;0;"vint";85;100;0
1037;0;"vinton";1037;100;0
10;0;"vintrell";10;100;0
0;7;"vinyette";7;0;100
18;0;"vinzent";18;100;0
417;117756;"viola";118173;0.352872483562235;99.6471275164378
0;105;"violanda";105;0;100
0;34;"violar";34;0;100
257;128456;"violet";128713;0.1996690311002;99.8003309688998
5;5584;"violeta";5589;0.0894614421184469;99.9105385578816
0;11;"violeth";11;0;100
0;11;"violetrose";11;0;100
0;347;"violett";347;0;100
0;1995;"violetta";1995;0;100
0;4027;"violette";4027;0;100
0;69;"violia";69;0;100
0;512;"viona";512;0;100
0;6;"vionda";6;0;100
0;28;"vione";28;0;100
0;5;"vionette";5;0;100
0;17;"vionna";17;0;100
0;10;"viora";10;0;100
70;0;"vipul";70;100;0
221;0;"vir";221;100;0
0;979;"vira";979;0;100
199;0;"viraaj";199;100;0
85;0;"viraat";85;100;0
809;0;"viraj";809;100;0
25;0;"virak";25;100;0
63;0;"viral";63;100;0
5;0;"viransh";5;100;0
140;0;"virat";140;100;0
0;5;"virble";5;0;100
0;359;"virda";359;0;100
17;97;"virdell";114;14.9122807017544;85.0877192982456
48;0;"virden";48;100;0
0;59;"virdia";59;0;100
0;15;"virdiana";15;0;100
0;491;"virdie";491;0;100
171;0;"viren";171;100;0
0;21;"virene";21;0;100
0;64;"virga";64;0;100
220;5;"virgal";225;97.7777777777778;2.22222222222222
46;0;"virge";46;100;0
0;6;"virgean";6;0;100
1179;6;"virgel";1185;99.4936708860759;0.506329113924051
0;397;"virgen";397;0;100
0;18;"virgena";18;0;100
0;496;"virgene";496;0;100
0;1120;"virgia";1120;0;100
655;19195;"virgie";19850;3.29974811083123;96.7002518891688
68928;1349;"virgil";70277;98.0804530643027;1.91954693569731
0;87;"virgilene";87;0;100
0;99;"virgilia";99;0;100
0;35;"virgiline";35;0;100
1398;0;"virgilio";1398;100;0
30;210;"virgin";240;12.5;87.5
0;1590;"virgina";1590;0;100
0;5;"virgine";5;0;100
0;5;"virgini";5;0;100
1998;638961;"virginia";640959;0.311720406453455;99.6882795935466
0;21;"virginialee";21;0;100
0;5;"virginiamae";5;0;100
0;62;"virginie";62;0;100
90;0;"virginio";90;100;0
5;0;"virginius";5;100;0
0;16;"virginnia";16;0;100
2135;33;"virgle";2168;98.4778597785978;1.52214022140221
0;5;"virgnia";5;0;100
6;0;"virgus";6;100;0
5;4048;"viridiana";4053;0.123365408339502;99.8766345916605
0;6;"virigina";6;0;100
0;167;"viriginia";167;0;100
0;17;"virignia";17;0;100
0;10;"viririana";10;0;100
0;86;"virjean";86;0;100
0;21;"virjinia";21;0;100
196;27;"virl";223;87.8923766816144;12.1076233183857
0;50;"virla";50;0;100
9;0;"virlan";9;100;0
0;87;"virlee";87;0;100
0;10;"virley";10;0;100
0;34;"virlie";34;0;100
0;5;"virlinda";5;0;100
39;0;"virlyn";39;100;0
0;11;"virma";11;0;100
0;193;"virna";193;0;100
46;0;"viron";46;100;0
0;5;"vironica";5;0;100
0;10;"virsaviya";10;0;100
0;6;"virsie";6;0;100
0;139;"virtie";139;0;100
0;23;"virtue";23;0;100
31;0;"virtus";31;100;0
155;0;"visente";155;100;0
87;0;"vishaal";87;100;0
11;0;"vishaan";11;100;0
16;0;"vishak";16;100;0
7;0;"vishakan";7;100;0
1705;0;"vishal";1705;100;0
28;0;"vishan";28;100;0
6;0;"vishanth";6;100;0
12;0;"vishesh";12;100;0
0;5;"vishika";5;0;100
920;0;"vishnu";920;100;0
15;0;"vishrut";15;100;0
125;0;"vishruth";125;100;0
5;0;"vishv";5;100;0
11;11;"vishva";22;50;50
173;16;"vishwa";189;91.5343915343915;8.46560846560847
16;0;"vishwak";16;100;0
5;0;"vishwesh";5;100;0
0;31;"vision";31;0;100
0;20;"vismaya";20;0;100
0;328;"vista";328;0;100
0;4264;"vita";4264;0;100
88;0;"vitali";88;100;0
0;116;"vitalia";116;0;100
0;36;"vitalina";36;0;100
361;0;"vitaliy";361;100;0
150;0;"vitaly";150;100;0
0;5;"vitani";5;0;100
15;0;"vitas";15;100;0
0;58;"vitina";58;0;100
14149;0;"vito";14149;100;0
58;0;"vitold";58;100;0
126;0;"vitor";126;100;0
0;327;"vitoria";327;0;100
17;0;"vitorio";17;100;0
0;1180;"vittoria";1180;0;100
1061;0;"vittorio";1061;100;0
0;6;"vitula";6;0;100
19;0;"vitus";19;100;0
0;5;"viv";5;0;100
0;3081;"viva";3081;0;100
1357;0;"vivaan";1357;100;0
234;341;"vivan";575;40.695652173913;59.304347826087
0;17;"vivana";17;0;100
0;433;"viveca";433;0;100
1692;0;"vivek";1692;100;0
0;92;"viveka";92;0;100
0;7;"vivenne";7;0;100
0;6;"vivette";6;0;100
0;481;"vivi";481;0;100
0;376;"vivia";376;0;100
2353;199355;"vivian";201708;1.16653776746584;98.8334622325341
22;20028;"viviana";20050;0.109725685785536;99.8902743142145
0;795;"viviane";795;0;100
0;10;"viviani";10;0;100
0;414;"viviann";414;0;100
0;3014;"vivianna";3014;0;100
0;1867;"vivianne";1867;0;100
179;0;"viviano";179;100;0
0;864;"vivica";864;0;100
0;6;"vividiana";6;0;100
0;43;"vivie";43;0;100
26;5915;"vivien";5941;0.437636761487965;99.562363238512
0;55;"viviene";55;0;100
0;5;"vivienna";5;0;100
0;12317;"vivienne";12317;0;100
0;11;"viviette";11;0;100
0;160;"vivika";160;0;100
16;5;"vivin";21;76.1904761904762;23.8095238095238
10;82;"vivion";92;10.8695652173913;89.1304347826087
0;6;"vivvian";6;0;100
0;6;"vivy";6;0;100
0;89;"vivyan";89;0;100
0;37;"vivyana";37;0;100
0;16;"vivyanna";16;0;100
0;36;"viya";36;0;100
65;0;"viyaan";65;100;0
96;0;"viyan";96;100;0
0;6;"viyana";6;0;100
0;22;"viyona";22;0;100
394;0;"vlad";394;100;0
0;56;"vlada";56;0;100
5;0;"vladik";5;100;0
5133;0;"vladimir";5133;100;0
509;0;"vladislav";509;100;0
0;10;"vladislava";10;0;100
22;0;"vladyslav";22;100;0
0;826;"vlasta";826;0;100
0;44;"vlora";44;0;100
0;5;"voctoria";5;0;100
0;22;"voda";22;0;100
5;0;"vohn";5;100;0
24;9;"void";33;72.7272727272727;27.2727272727273
5;0;"voight";5;100;0
0;16;"voila";16;0;100
0;33;"voilet";33;0;100
16;0;"vol";16;100;0
17;629;"vola";646;2.63157894736842;97.3684210526316
0;97;"volanda";97;0;100
0;5;"volare";5;0;100
0;29;"volena";29;0;100
0;5;"voleta";5;0;100
5;0;"volf";5;100;0
0;5;"volia";5;0;100
0;10;"volina";10;0;100
5;0;"volker";5;100;0
19;0;"volley";19;100;0
360;64;"vollie";424;84.9056603773585;15.0943396226415
558;0;"volney";558;100;0
46;0;"voltaire";46;100;0
17;0;"volvi";17;100;0
15;0;"volvy";15;100;0
4927;453;"von";5380;91.5799256505576;8.42007434944238
0;838;"vona";838;0;100
0;5;"vonceal";5;0;100
0;281;"vonceil";281;0;100
0;29;"voncia";29;0;100
0;50;"vonciel";50;0;100
0;6;"voncil";6;0;100
0;1445;"voncile";1445;0;100
0;554;"voncille";554;0;100
11;10305;"vonda";10316;0.106630476929042;99.893369523071
7;0;"vondal";7;100;0
6;0;"vondale";6;100;0
0;24;"vondalee";24;0;100
204;279;"vondell";483;42.2360248447205;57.7639751552795
0;13;"vondella";13;0;100
0;5;"vondia";5;0;100
0;90;"vondra";90;0;100
17;0;"vondre";17;100;0
5;0;"vondrell";5;100;0
0;5;"voneda";5;0;100
0;5;"vonell";5;0;100
0;5;"vonessa";5;0;100
0;11;"voneta";11;0;100
0;866;"vonetta";866;0;100
0;67;"vonette";67;0;100
124;0;"vong";124;100;0
0;43;"voni";43;0;100
0;5;"vonica";5;0;100
0;38;"vonice";38;0;100
0;8;"vonie";8;0;100
0;5;"vonisha";5;0;100
0;394;"vonita";394;0;100
7;0;"vonley";7;100;0
0;6;"vonmarie";6;0;100
193;5;"vonn";198;97.4747474747475;2.52525252525253
0;1090;"vonna";1090;0;100
0;84;"vonne";84;0;100
0;18;"vonnell";18;0;100
0;6;"vonnesha";6;0;100
0;81;"vonnetta";81;0;100
0;5;"vonnette";5;0;100
424;3615;"vonnie";4039;10.4976479326566;89.5023520673434
0;5;"vonnita";5;0;100
0;5;"vonshae";5;0;100
55;0;"vontae";55;100;0
5;0;"vontarius";5;100;0
47;0;"vontavious";47;100;0
10;0;"vontavius";10;100;0
135;0;"vonte";135;100;0
0;36;"vontella";36;0;100
0;11;"vontese";11;0;100
38;0;"vontez";38;100;0
0;15;"vontina";15;0;100
5;0;"vontray";5;100;0
14;0;"vontre";14;100;0
5;0;"vontrel";5;100;0
228;0;"vontrell";228;100;0
0;6;"vontresa";6;0;100
0;11;"vontressa";11;0;100
0;35;"vontrice";35;0;100
0;84;"vonya";84;0;100
5;0;"vonzel";5;100;0
167;0;"vonzell";167;100;0
0;111;"vonzella";111;0;100
0;17;"vonzetta";17;0;100
0;72;"vora";72;0;100
110;0;"voris";110;100;0
0;10;"voronica";10;0;100
80;0;"voshon";80;100;0
22;0;"voss";22;100;0
0;62;"voula";62;0;100
5;0;"voy";5;100;0
117;0;"voyd";117;100;0
49;0;"voyle";49;100;0
322;0;"vraj";322;100;0
0;191;"vrinda";191;0;100
0;5;"vrisa";5;0;100
87;0;"vrishank";87;100;0
0;11;"vriti";11;0;100
0;10;"vritika";10;0;100
0;6;"vrunda";6;0;100
5;0;"vsevolod";5;100;0
764;0;"vu";764;100;0
109;0;"vue";109;100;0
118;0;"vuk";118;100;0
5;0;"vukasin";5;100;0
0;18;"vula";18;0;100
0;6;"vulnavia";6;0;100
0;90;"vung";90;0;100
169;0;"vuong";169;100;0
0;10;"vurla";10;0;100
37;0;"vuthy";37;100;0
37;1087;"vy";1124;3.29181494661922;96.7081850533808
11;0;"vyaan";11;100;0
16;0;"vyacheslav";16;100;0
35;0;"vyan";35;100;0
0;11;"vyanna";11;0;100
18;0;"vyas";18;100;0
0;157;"vyctoria";157;0;100
0;5;"vyctorya";5;0;100
0;5;"vydia";5;0;100
0;31;"vyktoria";31;0;100
0;51;"vyla";51;0;100
0;55;"vylet";55;0;100
0;49;"vylette";49;0;100
68;0;"vyncent";68;100;0
0;6;"vynessa";6;0;100
0;37;"vyola";37;0;100
0;71;"vyolet";71;0;100
0;12;"vyolette";12;0;100
202;0;"vyom";202;100;0
0;56;"vyonne";56;0;100
10;0;"vyrl";10;100;0
94;0;"vyron";94;100;0
0;23;"vyshnavi";23;0;100
8;0;"vyshonn";8;100;0
12;0;"vyshonne";12;100;0
15;0;"vytas";15;100;0
52;0;"vytautas";52;100;0
6;0;"vyto";6;100;0
0;23;"vyvian";23;0;100
0;42;"vyvy";42;0;100
0;37;"vyvyan";37;0;100
48;0;"wa";48;100;0
0;18;"waad";18;0;100
5;0;"waard";5;100;0
5;0;"waaris";5;100;0
287;0;"wacey";287;100;0
0;7;"wachovia";7;0;100
51;0;"waclaw";51;100;0
160;0;"waco";160;100;0
0;5;"waconda";5;0;100
775;0;"waddell";775;100;0
16;5;"waddie";21;76.1904761904762;23.8095238095238
5;0;"waddy";5;100;0
66779;163;"wade";66942;99.7565056317409;0.24349436825909
5;0;"wadee";5;100;0
0;8;"wadeeah";8;0;100
316;0;"wadell";316;100;0
29;0;"waden";29;100;0
0;7;"wadena";7;0;100
0;5;"wadia";5;0;100
90;85;"wadie";175;51.4285714285714;48.5714285714286
0;10;"wadine";10;0;100
0;29;"wadiya";29;0;100
5;0;"wadley";5;100;0
76;0;"wadsworth";76;100;0
372;0;"wael";372;100;0
0;5;"waelynn";5;0;100
0;392;"wafa";392;0;100
0;62;"wafaa";62;0;100
27;0;"wafi";27;100;0
5;0;"waford";5;100;0
275;0;"wagner";275;100;0
61;0;"wah";61;100;0
44;0;"wahab";44;100;0
5;0;"wahaj";5;100;0
52;0;"waheed";52;100;0
0;7;"waheedah";7;0;100
99;0;"wahid";99;100;0
0;12;"wahneeta";12;0;100
0;117;"wahneta";117;0;100
0;6;"wahnetta";6;0;100
0;5;"wahnita";5;0;100
174;88;"wai";262;66.412213740458;33.587786259542
45;0;"waid";45;100;0
11;0;"waide";11;100;0
5;0;"wailyn";5;100;0
16;0;"wain";16;100;0
36;0;"waine";36;100;0
347;0;"waino";347;100;0
6;0;"wainwright";6;100;0
5;0;"wais";5;100;0
21;0;"waite";21;100;0
48;0;"waitman";48;100;0
5;0;"waitus";5;100;0
0;26;"waive";26;0;100
10;0;"waiz";10;100;0
0;5;"wajd";5;0;100
0;20;"wajeeha";20;0;100
0;46;"wajiha";46;0;100
0;20;"wakana";20;0;100
87;0;"wake";87;100;0
5;0;"wakeel";5;100;0
0;95;"wakeelah";95;0;100
29;0;"wakeem";29;100;0
5;0;"wakeen";5;100;0
15;0;"wakefield";15;100;0
0;15;"wakeisha";15;0;100
5;33;"wakely";38;13.1578947368421;86.8421052631579
0;5;"wakenda";5;0;100
5;0;"waker";5;100;0
0;11;"wakesha";11;0;100
0;6;"wakia";6;0;100
10;0;"wakil";10;100;0
0;9;"wakina";9;0;100
18;0;"wakinyan";18;100;0
0;86;"wakisha";86;0;100
0;23;"wakita";23;0;100
7;0;"wakiyan";7;100;0
0;6;"wala";6;0;100
0;66;"walaa";66;0;100
11;0;"walace";11;100;0
17;0;"walbert";17;100;0
54;0;"walberto";54;100;0
0;52;"walburga";52;0;100
0;20;"walcie";20;0;100
0;330;"walda";330;0;100
10;33;"waldean";43;23.2558139534884;76.7441860465116
1475;0;"waldemar";1475;100;0
1139;0;"walden";1139;100;0
0;5;"waldena";5;0;100
0;37;"waldene";37;0;100
0;203;"waldine";203;0;100
5341;6;"waldo";5347;99.8877875444174;0.11221245558257
681;0;"waldon";681;100;0
198;0;"waldron";198;100;0
17;0;"waldy";17;100;0
29;0;"wale";29;100;0
5;0;"waled";5;100;0
5;0;"walee";5;100;0
1561;0;"waleed";1561;100;0
0;7;"walela";7;0;100
0;5;"walene";5;0;100
38;0;"wales";38;100;0
0;23;"walesca";23;0;100
0;470;"waleska";470;0;100
8;0;"walford";8;100;0
227;0;"walfred";227;100;0
5;0;"walfrid";5;100;0
827;0;"wali";827;100;0
0;5;"walia";5;0;100
807;0;"walid";807;100;0
0;66;"walida";66;0;100
0;15;"walidah";15;0;100
10;0;"walik";10;100;0
0;16;"walisha";16;0;100
0;5;"waliyah";5;0;100
22012;288;"walker";22300;98.7085201793722;1.2914798206278
0;5;"walkidia";5;0;100
0;15;"walkiria";15;0;100
78927;537;"wallace";79464;99.3242222893386;0.675777710661432
10;0;"wallen";10;100;0
0;20;"wallene";20;0;100
225;0;"waller";225;100;0
55;0;"walley";55;100;0
80;0;"wallice";80;100;0
340;52;"wallie";392;86.734693877551;13.265306122449
0;7;"walline";7;0;100
626;475;"wallis";1101;56.8574023614895;43.1425976385104
4824;147;"wally";4971;97.0428485214243;2.95715147857574
6;0;"walmer";6;100;0
5;0;"walsh";5;100;0
0;95;"walsie";95;0;100
2278;0;"walt";2278;100;0
0;115;"walta";115;0;100
581724;3445;"walter";585169;99.4112811854353;0.588718814564681
0;5;"walterene";5;0;100
0;390;"walterine";390;0;100
5;0;"walters";5;100;0
85;0;"walther";85;100;0
0;30;"waltina";30;0;100
5360;10;"walton";5370;99.8137802607076;0.186219739292365
0;6;"wambui";6;0;100
5;0;"wamon";5;100;0
5;10;"wan";15;33.3333333333333;66.6666666666667
0;195;"wana";195;0;100
0;37;"wanakee";37;0;100
972;280226;"wanda";281198;0.345663909416141;99.6543360905839
0;12;"wandalea";12;0;100
0;231;"wandalee";231;0;100
0;64;"wandalene";64;0;100
0;5;"wandalid";5;0;100
0;34;"wandalyn";34;0;100
82;5;"wandell";87;94.2528735632184;5.74712643678161
0;54;"wander";54;0;100
5;0;"wanderlei";5;100;0
0;313;"wandra";313;0;100
0;100;"wandy";100;0;100
160;0;"wane";160;100;0
0;132;"waneda";132;0;100
0;6;"waneeta";6;0;100
0;5;"waneita";5;0;100
0;118;"wanell";118;0;100
0;10;"wanema";10;0;100
0;12;"wanesha";12;0;100
0;2444;"waneta";2444;0;100
0;6;"wanetah";6;0;100
0;1114;"wanetta";1114;0;100
0;85;"wanette";85;0;100
70;0;"wang";70;100;0
7;0;"wani";7;100;0
0;140;"wania";140;0;100
0;46;"wanika";46;0;100
0;74;"wanisha";74;0;100
0;2492;"wanita";2492;0;100
0;54;"waniya";54;0;100
0;5;"wanjiku";5;0;100
0;8;"wanjiru";8;0;100
0;550;"wanna";550;0;100
0;10;"wannell";10;0;100
0;356;"wannetta";356;0;100
0;14;"wannette";14;0;100
11;39;"wannie";50;22;78
0;102;"wanona";102;0;100
458;17;"wanya";475;96.4210526315789;3.57894736842105
10;0;"wanyae";10;100;0
22;0;"wanye";22;100;0
0;418;"wanza";418;0;100
0;5;"wanzie";5;0;100
5;0;"waqar";5;100;0
72;0;"waqas";72;100;0
13968;33;"ward";14001;99.7643025498179;0.23569745018213
0;139;"warda";139;0;100
0;42;"wardah";42;0;100
0;12;"wardean";12;0;100
11;0;"wardel";11;100;0
4268;36;"wardell";4304;99.1635687732342;0.836431226765799
295;0;"warden";295;100;0
6;0;"warder";6;100;0
49;13;"wardie";62;79.0322580645161;20.9677419354839
0;36;"wardine";36;0;100
6;0;"wardner";6;100;0
7;0;"ware";7;100;0
0;5;"wareef";5;0;100
6;0;"warees";6;100;0
0;32;"wareesha";32;0;100
20;0;"waren";20;100;0
30;0;"warfield";30;100;0
26;0;"waring";26;100;0
66;0;"waris";66;100;0
17;0;"warith";17;100;0
41;0;"warn";41;100;0
0;11;"warna";11;0;100
32;0;"warne";32;100;0
160;16;"warnell";176;90.9090909090909;9.09090909090909
7078;49;"warner";7127;99.3124736915953;0.687526308404658
0;42;"warnetta";42;0;100
141;0;"warnie";141;100;0
5;0;"warran";5;100;0
171794;897;"warren";172691;99.4805751313039;0.51942486869611
0;63;"warrene";63;0;100
0;6;"warrenetta";6;0;100
597;0;"warrick";597;100;0
0;5;"warrine";5;0;100
30;0;"warrior";30;100;0
34;0;"warsame";34;100;0
50;0;"warwick";50;100;0
5;0;"wasay";5;100;0
12;0;"wasco";12;100;0
596;0;"waseem";596;100;0
918;0;"wash";918;100;0
2178;0;"washington";2178;100;0
10;0;"wasi";10;100;0
107;0;"wasif";107;100;0
91;0;"wasil";91;100;0
132;0;"wasim";132;100;0
6;0;"wasseem";6;100;0
17;0;"wassil";17;100;0
13;0;"wassillie";13;100;0
180;0;"wassim";180;100;0
64;0;"wasyl";64;100;0
137;0;"wataru";137;100;0
0;11;"watasha";11;0;100
0;48;"wateen";48;0;100
0;5;"watha";5;0;100
0;51;"wathena";51;0;100
13;0;"watie";13;100;0
0;11;"watisha";11;0;100
21;0;"watkins";21;100;0
5;0;"watler";5;100;0
3480;0;"watson";3480;100;0
383;0;"watt";383;100;0
5;0;"wattie";5;100;0
36;0;"watts";36;100;0
0;25;"waukesha";25;0;100
0;6;"wauline";6;0;100
0;37;"waunda";37;0;100
0;23;"waunell";23;0;100
0;552;"wauneta";552;0;100
0;166;"waunetta";166;0;100
0;865;"waunita";865;0;100
0;1678;"wava";1678;0;100
0;5;"wavalene";5;0;100
0;88;"wave";88;0;100
0;41;"wavel";41;0;100
0;16;"wavelene";16;0;100
0;21;"waveline";21;0;100
7;0;"wavell";7;100;0
31;0;"wavely";31;100;0
0;5;"wavelyn";5;0;100
11;69;"waver";80;13.75;86.25
0;7;"waverlee";7;0;100
11;64;"waverley";75;14.6666666666667;85.3333333333333
1875;1720;"waverly";3595;52.1557719054242;47.8442280945758
46;245;"wavie";291;15.807560137457;84.192439862543
17;0;"wavy";17;100;0
11;0;"way";11;100;0
68;0;"wayburn";68;100;0
10;0;"wayd";10;100;0
1934;0;"wayde";1934;100;0
90;0;"wayden";90;100;0
5;0;"wayford";5;100;0
829;0;"waylan";829;100;0
3774;0;"wayland";3774;100;0
693;0;"waylen";693;100;0
184;6;"waylin";190;96.8421052631579;3.15789473684211
17980;50;"waylon";18030;99.7226844148641;0.277315585135885
56;10;"waylyn";66;84.8484848484848;15.1515151515152
14;36;"waylynn";50;28;72
2779;0;"wayman";2779;100;0
4647;0;"waymon";4647;100;0
1480;0;"waymond";1480;100;0
0;59;"wayna";59;0;100
10;0;"waynard";10;100;0
350934;1604;"wayne";352538;99.5450135871878;0.454986412812236
0;50;"wayneisha";50;0;100
0;62;"waynesha";62;0;100
0;11;"wayneshia";11;0;100
0;183;"waynetta";183;0;100
0;588;"waynette";588;0;100
0;28;"waynisha";28;0;100
5;0;"waynne";5;100;0
5;0;"wc";5;100;0
0;21;"wealtha";21;0;100
0;149;"wealthy";149;0;100
0;15;"weatherly";15;0;100
456;0;"weaver";456;100;0
1325;0;"webb";1325;100;0
87;0;"webber";87;100;0
86;0;"weber";86;100;0
4056;0;"webster";4056;100;0
0;68;"weda";68;0;100
0;10;"wedad";10;0;100
0;942;"wednesday";942;0;100
0;11;"weeda";11;0;100
0;26;"weena";26;0;100
275;78;"wei";353;77.9036827195467;22.0963172804533
0;10;"weida";10;0;100
33;0;"weikko";33;100;0
66;0;"weiland";66;100;0
46;0;"weir";46;100;0
0;5;"wejdan";5;0;100
7;0;"welbert";7;100;0
119;0;"welborn";119;100;0
12;0;"welburn";12;100;0
366;0;"welby";366;100;0
51;0;"welch";51;100;0
147;23;"welcome";170;86.4705882352941;13.5294117647059
0;118;"welda";118;0;100
92;0;"welden";92;100;0
13727;25;"weldon";13752;99.8182082606166;0.181791739383362
487;0;"welford";487;100;0
5;0;"welker";5;100;0
101;0;"welles";101;100;0
6;6;"wellesley";12;50;50
2418;0;"wellington";2418;100;0
45;0;"wellman";45;100;0
1664;48;"wells";1712;97.196261682243;2.80373831775701
0;10;"wellsley";10;0;100
0;189;"welma";189;0;100
10;0;"welmer";10;100;0
33;0;"welsey";33;100;0
0;362;"weltha";362;0;100
2586;0;"welton";2586;100;0
5;0;"welty";5;100;0
87;65;"wen";152;57.2368421052632;42.7631578947368
16;0;"wencel";16;100;0
30;0;"wences";30;100;0
326;0;"wenceslao";326;100;0
61;0;"wenceslaus";61;100;0
10;0;"wencil";10;100;0
0;1000;"wenda";1000;0;100
194;0;"wendal";194;100;0
2359;6;"wendall";2365;99.7463002114165;0.25369978858351
0;50;"wendalyn";50;0;100
0;1378;"wende";1378;0;100
0;790;"wendee";790;0;100
2099;0;"wendel";2099;100;0
190;369;"wendelin";559;33.9892665474061;66.0107334525939
0;12;"wendeline";12;0;100
52770;562;"wendell";53332;98.9462236555914;1.05377634440861
0;41;"wendella";41;0;100
0;17;"wendellyn";17;0;100
0;397;"wendelyn";397;0;100
0;7;"wendey";7;0;100
0;14483;"wendi";14483;0;100
0;2200;"wendie";2200;0;100
0;11;"wendla";11;0;100
129;0;"wendle";129;100;0
0;5;"wendlyn";5;0;100
0;11;"wendolee";11;0;100
0;53;"wendoly";53;0;100
10;1144;"wendolyn";1154;0.866551126516464;99.1334488734835
0;5;"wendolyne";5;0;100
0;12;"wendra";12;0;100
952;260443;"wendy";261395;0.364199774287955;99.635800225712
0;10;"wendyann";10;0;100
0;28;"wendye";28;0;100
11;0;"wendyl";11;100;0
0;5;"wendylee";5;0;100
12;0;"wenford";12;100;0
0;5;"wengel";5;0;100
0;5;"wenndy";5;0;100
0;5;"wenola";5;0;100
0;1153;"wenona";1153;0;100
0;500;"wenonah";500;0;100
5;0;"wensel";5;100;0
12;0;"wensley";12;100;0
5;0;"wenson";5;100;0
62;0;"wentworth";62;100;0
136;0;"wenzel";136;100;0
0;5;"weona";5;0;100
0;10;"wera";10;0;100
3325;0;"werner";3325;100;0
0;281;"weronika";281;0;100
10;0;"wert";10;100;0
4341;0;"wes";4341;100;0
317;0;"wesam";317;100;0
27;0;"wesely";27;100;0
824;119;"weslee";943;87.3806998939555;12.6193001060445
5;174;"wesleigh";179;2.79329608938547;97.2067039106145
206234;2381;"wesley";208615;98.8586630875057;1.14133691249431
0;5;"wesli";5;0;100
361;217;"weslie";578;62.4567474048443;37.5432525951557
11;0;"weslin";11;100;0
1332;0;"wesly";1332;100;0
31;164;"weslyn";195;15.8974358974359;84.1025641025641
0;109;"weslynn";109;0;100
16;0;"wesner";16;100;0
422;0;"wess";422;100;0
17;0;"wessam";17;100;0
5;0;"wessen";5;100;0
0;353;"wessie";353;0;100
252;0;"wessley";252;100;0
938;0;"wesson";938;100;0
2500;0;"west";2500;100;0
24;0;"westan";24;100;0
939;0;"westen";939;100;0
31;0;"wester";31;100;0
19;0;"western";19;100;0
4176;7;"westin";4183;99.832655988525;0.167344011475018
106;0;"westlee";106;100;0
5;0;"westleigh";5;100;0
6917;10;"westley";6927;99.855637361051;0.14436263894904
817;0;"westly";817;100;0
0;29;"westlyn";29;0;100
0;13;"westlynn";13;0;100
6;0;"westmoreland";6;100;0
38944;37;"weston";38981;99.9050819630076;0.0949180369923809
0;5;"westonia";5;0;100
1017;65;"westyn";1082;93.992606284658;6.00739371534196
0;17;"weta";17;0;100
0;63;"wetona";63;0;100
180;0;"wetzel";180;100;0
6;0;"weylan";6;100;0
43;0;"weyland";43;100;0
552;0;"weylin";552;100;0
5;0;"weylon";5;100;0
49;8;"weylyn";57;85.9649122807018;14.0350877192982
562;0;"weyman";562;100;0
11;0;"weymon";11;100;0
10;0;"weymouth";10;100;0
15;0;"wezley";15;100;0
111;0;"whalen";111;100;0
11;0;"whaley";11;100;0
38;0;"wharton";38;100;0
5;0;"wheaton";5;100;0
1487;5;"wheeler";1492;99.6648793565684;0.335120643431635
16;0;"whelan";16;100;0
0;12;"whendy";12;0;100
0;20;"whilma";20;0;100
0;698;"whisper";698;0;100
777;0;"whit";777;100;0
350;5;"whitaker";355;98.5915492957747;1.40845070422535
31;0;"white";31;100;0
0;29;"whiteny";29;0;100
374;0;"whitfield";374;100;0
5;0;"whitford";5;100;0
0;484;"whitlee";484;0;100
0;87;"whitleigh";87;0;100
316;5219;"whitley";5535;5.70912375790425;94.2908762420957
0;5;"whitli";5;0;100
0;5;"whitlie";5;0;100
627;0;"whitman";627;100;0
5;0;"whitmore";5;100;0
0;6;"whitnay";6;0;100
0;5;"whitne";5;0;100
0;606;"whitnee";606;0;100
0;31;"whitnei";31;0;100
5837;95214;"whitney";101051;5.77629117970134;94.2237088202987
0;333;"whitni";333;0;100
0;416;"whitnie";416;0;100
0;28;"whitny";28;0;100
0;5;"whitnye";5;0;100
7;0;"whitson";7;100;0
215;0;"whitt";215;100;0
128;0;"whittaker";128;100;0
0;129;"whittany";129;0;100
212;5;"whitten";217;97.6958525345622;2.30414746543779
0;69;"whittley";69;0;100
5;1633;"whittney";1638;0.305250305250305;99.6947496947497
0;52;"whittni";52;0;100
0;5;"whittnie";5;0;100
17;0;"whitton";17;100;0
0;5;"whtiney";5;0;100
286;0;"whyatt";286;100;0
0;5;"whynter";5;0;100
0;5;"whysper";5;0;100
5;0;"wialliam";5;100;0
0;5;"wiam";5;0;100
105;0;"wiatt";105;100;0
0;6;"wicahpi";6;0;100
18;0;"wick";18;100;0
0;18;"widad";18;0;100
0;9;"widline";9;0;100
14;0;"wigberto";14;100;0
25;0;"wiiliam";25;100;0
41;0;"wiktor";41;100;0
0;270;"wiktoria";270;0;100
1018;0;"wil";1018;100;0
0;5;"wila";5;0;100
0;5;"wiladean";5;0;100
13;0;"wilard";13;100;0
0;165;"wilba";165;0;100
6260;11;"wilber";6271;99.8245893796843;0.175410620315739
577;0;"wilbern";577;100;0
39186;178;"wilbert";39364;99.5478101818921;0.452189818107916
0;451;"wilberta";451;0;100
75;0;"wilberth";75;100;0
512;0;"wilberto";512;100;0
93;0;"wilbon";93;100;0
22;0;"wilbor";22;100;0
396;0;"wilborn";396;100;0
13;0;"wilbourn";13;100;0
54558;290;"wilbur";54848;99.4712660443407;0.528733955659276
10045;15;"wilburn";10060;99.8508946322068;0.149105367793241
6;0;"wilburne";6;100;0
1104;0;"wilburt";1104;100;0
0;88;"wilburta";88;0;100
8;0;"wilby";8;100;0
5;0;"wilce";5;100;0
0;5;"wilcie";5;0;100
5;0;"wilco";5;100;0
15;12320;"wilda";12335;0.121605188488042;99.878394811512
5;0;"wildan";5;100;0
23;0;"wilde";23;100;0
1790;113;"wilder";1903;94.062007356805;5.93799264319496
165;0;"wildon";165;100;0
5;31;"wildred";36;13.8888888888889;86.1111111111111
0;90;"wileen";90;0;100
0;5;"wilella";5;0;100
5;0;"wilem";5;100;0
0;68;"wilena";68;0;100
0;156;"wilene";156;0;100
0;5;"wilesha";5;0;100
0;76;"wiletta";76;0;100
15617;193;"wiley";15810;98.7792536369386;1.22074636306135
481;0;"wilferd";481;100;0
10025;5;"wilford";10030;99.950149551346;0.0498504486540379
28356;103;"wilfred";28459;99.6380758283847;0.361924171615306
0;11;"wilfreda";11;0;100
9241;0;"wilfredo";9241;100;0
1362;0;"wilfrid";1362;100;0
357;0;"wilfrido";357;100;0
15;0;"wilfried";15;100;0
87;0;"wilgus";87;100;0
1540;0;"wilhelm";1540;100;0
0;763;"wilhelmena";763;0;100
0;1125;"wilhelmenia";1125;0;100
5;10250;"wilhelmina";10255;0.0487567040468064;99.9512432959532
0;297;"wilhelmine";297;0;100
0;22;"wilhelminia";22;0;100
10;0;"wilhem";10;100;0
0;42;"wilhemena";42;0;100
0;264;"wilhemenia";264;0;100
0;910;"wilhemina";910;0;100
181;0;"wilho";181;100;0
1158;0;"wiliam";1158;100;0
173;0;"wilian";173;100;0
6;0;"wilibaldo";6;100;0
10;0;"wilie";10;100;0
0;5;"wilisha";5;0;100
6;0;"wiljo";6;100;0
30;0;"wilkens";30;100;0
143;0;"wilkes";143;100;0
344;18;"wilkie";362;95.0276243093923;4.97237569060773
95;0;"wilkin";95;100;0
271;0;"wilkins";271;100;0
10;0;"wilkinson";10;100;0
32718;575;"will";33293;98.2729102213679;1.72708977863214
24;24881;"willa";24905;0.0963661915278057;99.9036338084722
0;5;"willabell";5;0;100
0;23;"willabelle";23;0;100
0;880;"willadean";880;0;100
0;75;"willadeen";75;0;100
0;220;"willadene";220;0;100
0;16;"willadine";16;0;100
0;6;"willah";6;0;100
1576;0;"willaim";1576;100;0
3316;0;"willam";3316;100;0
0;370;"willamae";370;0;100
0;15;"willamena";15;0;100
0;182;"willamina";182;0;100
0;11;"willanna";11;0;100
0;17;"willar";17;0;100
75062;871;"willard";75933;98.8529361410717;1.14706385892827
5;0;"willas";5;100;0
0;5;"willasia";5;0;100
0;17;"willavene";17;0;100
31;0;"willbert";31;100;0
11;0;"willburn";11;100;0
365;41;"wille";406;89.9014778325123;10.0985221674877
0;259;"willean";259;0;100
0;5;"willease";5;0;100
0;127;"willeen";127;0;100
0;70;"willella";70;0;100
2302;0;"willem";2302;100;0
0;31;"willemina";31;0;100
0;1067;"willena";1067;0;100
0;2927;"willene";2927;0;100
5;87;"willer";92;5.43478260869565;94.5652173913043
10;0;"willes";10;100;0
0;22;"willesha";22;0;100
94;6;"willet";100;94;6
0;20;"willeta";20;0;100
122;34;"willett";156;78.2051282051282;21.7948717948718
0;1843;"willetta";1843;0;100
0;2118;"willette";2118;0;100
282;0;"willey";282;100;0
146;0;"willford";146;100;0
20;0;"willfred";20;100;0
5;0;"willfredo";5;100;0
144;0;"willi";144;100;0
548;3199;"willia";3747;14.6250333600213;85.3749666399786
6;0;"williaa";6;100;0
0;5;"williadean";5;0;100
3930400;15192;"william";3945592;99.6149627229577;0.38503727704233
0;5;"williametta";5;0;100
5;0;"williamhenry";5;100;0
0;5;"williamina";5;0;100
10;0;"williamjames";10;100;0
5;0;"williamjohn";5;100;0
19;0;"williamjoseph";19;100;0
11;0;"williamm";11;100;0
12;0;"williammichael";12;100;0
6;0;"williamrobert";6;100;0
5505;24;"williams";5529;99.5659251220836;0.434074877916441
82;0;"williamson";82;100;0
3786;18;"willian";3804;99.5268138801262;0.473186119873817
1060;5;"williard";1065;99.5305164319249;0.469483568075117
5;0;"williaw";5;100;0
6;0;"willibaldo";6;100;0
0;29;"willidean";29;0;100
432647;135630;"willie";568277;76.1331181800425;23.8668818199575
0;5;"willielee";5;0;100
5;0;"williem";5;100;0
0;717;"williemae";717;0;100
0;5;"willien";5;0;100
0;23;"williene";23;0;100
85;0;"willies";85;100;0
0;11;"williesha";11;0;100
0;5;"willietta";5;0;100
0;127;"williette";127;0;100
16;0;"williford";16;100;0
30;0;"williiam";30;100;0
22;0;"willilam";22;100;0
262;0;"willim";262;100;0
10;0;"williman";10;100;0
0;5;"willimena";5;0;100
0;449;"willine";449;0;100
11;0;"willington";11;100;0
175;0;"williom";175;100;0
49101;810;"willis";49911;98.3771112580393;1.62288874196069
0;11;"willisa";11;0;100
0;95;"willisha";95;0;100
5;0;"willison";5;100;0
0;88;"willistine";88;0;100
13;0;"willkie";13;100;0
245;0;"willliam";245;100;0
0;668;"willma";668;0;100
114;0;"willman";114;100;0
65;0;"willmar";65;100;0
309;6;"willmer";315;98.0952380952381;1.9047619047619
0;16;"willmetta";16;0;100
23;0;"willmon";23;100;0
0;576;"willo";576;0;100
0;1236;"willodean";1236;0;100
0;29;"willodeen";29;0;100
0;241;"willodene";241;0;100
0;10;"willodine";10;0;100
0;27;"willoe";27;0;100
0;29;"willoh";29;0;100
0;27;"willola";27;0;100
0;82;"willona";82;0;100
0;6;"willora";6;0;100
205;25;"willoughby";230;89.1304347826087;10.8695652173913
200;23986;"willow";24186;0.826924667162821;99.1730753328372
0;63;"willowdean";63;0;100
30;0;"wills";30;100;0
291;0;"willson";291;100;0
5;0;"willum";5;100;0
20;0;"willus";20;100;0
3663;116;"willy";3779;96.930404869013;3.06959513098703
0;367;"willye";367;0;100
103;0;"willys";103;100;0
754;138389;"wilma";139143;0.541888560689363;99.4581114393106
0;13;"wilmah";13;0;100
0;6;"wilmajean";6;0;100
200;0;"wilman";200;100;0
545;16;"wilmar";561;97.1479500891266;2.85204991087344
0;113;"wilmarie";113;0;100
0;92;"wilmary";92;0;100
14721;743;"wilmer";15464;95.1952922917745;4.80470770822556
5;5;"wilmeth";10;50;50
0;162;"wilmetta";162;0;100
0;153;"wilmina";153;0;100
355;0;"wilmon";355;100;0
203;0;"wilmont";203;100;0
5;0;"wilmor";5;100;0
80;0;"wilmore";80;100;0
454;5;"wilmot";459;98.9106753812636;1.08932461873638
30;178;"wilmoth";208;14.4230769230769;85.5769230769231
6;0;"wilmur";6;100;0
0;51;"wilmuth";51;0;100
0;542;"wilna";542;0;100
0;7;"wilnelia";7;0;100
27;0;"wilner";27;100;0
0;20;"wilnesha";20;0;100
0;10;"wilnette";10;0;100
0;5;"wilniya";5;0;100
0;55;"wilodean";55;0;100
0;11;"wilodene";11;0;100
0;6;"wilodyne";6;0;100
0;10;"wilona";10;0;100
5;0;"wilroy";5;100;0
5;0;"wilsey";5;100;0
27;261;"wilsie";288;9.375;90.625
43885;188;"wilson";44073;99.5734349828693;0.42656501713067
0;11;"wilta";11;0;100
8358;41;"wilton";8399;99.5118466484105;0.488153351589475
7;0;"wiltz";7;100;0
0;40;"wilva";40;0;100
165;0;"wilver";165;100;0
6;0;"wily";6;100;0
0;5;"wimberley";5;0;100
0;39;"wimberly";39;0;100
104;11;"win";115;90.4347826086957;9.56521739130435
0;13;"wina";13;0;100
0;18;"winafred";18;0;100
11;0;"winburn";11;100;0
16;0;"wince";16;100;0
5;0;"winchell";5;100;0
24;0;"winchester";24;100;0
0;42;"wincie";42;0;100
0;172;"winda";172;0;100
5;0;"windale";5;100;0
0;26;"windee";26;0;100
234;0;"windel";234;100;0
2975;21;"windell";2996;99.2990654205608;0.700934579439252
5;0;"windfield";5;100;0
11;0;"windford";11;100;0
10;0;"windham";10;100;0
0;458;"windi";458;0;100
0;135;"windie";135;0;100
413;0;"windle";413;100;0
11;0;"windol";11;100;0
21;0;"windom";21;100;0
453;204;"windsor";657;68.9497716894977;31.0502283105023
12;4918;"windy";4930;0.243407707910751;99.7565922920893
0;105;"winefred";105;0;100
0;18;"winell";18;0;100
0;10;"winetta";10;0;100
0;22;"winette";22;0;100
390;0;"winferd";390;100;0
4482;0;"winfield";4482;100;0
4472;0;"winford";4472;100;0
9870;351;"winfred";10221;96.5658937481655;3.43410625183446
144;0;"winfrey";144;100;0
5;0;"winfried";5;100;0
146;22;"wing";168;86.9047619047619;13.0952380952381
5;0;"wingate";5;100;0
0;10;"wini";10;0;100
0;16;"winiferd";16;0;100
11;0;"winiford";11;100;0
1101;39488;"winifred";40589;2.71255758949469;97.2874424105053
0;6;"winifrede";6;0;100
227;0;"winn";227;100;0
0;113;"winna";113;0;100
0;49;"winnefred";49;0;100
0;72;"winnell";72;0;100
30;34;"winner";64;46.875;53.125
0;23;"winnette";23;0;100
0;111;"winni";111;0;100
187;20166;"winnie";20353;0.91878347172407;99.0812165282759
0;54;"winniefred";54;0;100
0;4206;"winnifred";4206;0;100
0;138;"winnona";138;0;100
0;41;"winny";41;0;100
0;28;"winogene";28;0;100
0;101;"winola";101;0;100
0;10573;"winona";10573;0;100
0;7;"winonah";7;0;100
0;5;"winrey";5;0;100
0;228;"winry";228;0;100
5;0;"winsel";5;100;0
0;27;"winslet";27;0;100
6;0;"winsley";6;100;0
1462;129;"winslow";1591;91.8918918918919;8.10810810810811
0;26;"winsome";26;0;100
357;0;"winson";357;100;0
53;0;"winsor";53;100;0
6;0;"winsten";6;100;0
25552;92;"winston";25644;99.6412416159725;0.358758384027453
0;82;"winta";82;0;100
0;10;"wintana";10;0;100
526;7646;"winter";8172;6.43661282427802;93.563387175722
0;22;"winterrose";22;0;100
18;0;"wintford";18;100;0
1150;0;"winthrop";1150;100;0
1873;5;"winton";1878;99.7337593184239;0.266240681576145
0;26;"wintress";26;0;100
0;15;"wiona";15;0;100
251;0;"wirt";251;100;0
211;0;"wisam";211;100;0
545;615;"wisdom";1160;46.9827586206897;53.0172413793103
53;0;"wise";53;100;0
6;0;"wishard";6;100;0
27;0;"wisin";27;100;0
5;0;"wisler";5;100;0
0;5;"wisper";5;0;100
148;0;"wissam";148;100;0
85;0;"wister";85;100;0
0;17;"wisteria";17;0;100
0;184;"witney";184;0;100
45;0;"witold";45;100;0
128;0;"witt";128;100;0
356;12;"witten";368;96.7391304347826;3.26086956521739
0;29;"wittney";29;0;100
0;5;"wiyaka";5;0;100
5;0;"wizdom";5;100;0
11;0;"wladimir";11;100;0
119;0;"wladyslaw";119;100;0
0;105;"wladyslawa";105;0;100
97;0;"wlliam";97;100;0
2292;86;"wm";2378;96.3835155592935;3.61648444070648
0;5;"wnedy";5;0;100
92;0;"wofford";92;100;0
54;0;"wojciech";54;100;0
7;0;"wolcott";7;100;0
855;0;"wolf";855;100;0
141;0;"wolfe";141;100;0
2037;0;"wolfgang";2037;100;0
12;0;"wolford";12;100;0
22;0;"wolfram";22;100;0
97;0;"won";97;100;0
0;1776;"wonda";1776;0;100
0;166;"wonder";166;0;100
0;33;"wondra";33;0;100
69;0;"wong";69;100;0
11;43;"wonnie";54;20.3703703703704;79.6296296296296
6;0;"wonya";6;100;0
10;0;"woo";10;100;0
248;0;"wood";248;100;0
283;0;"woodard";283;100;0
56;0;"woodfin";56;100;0
558;0;"woodford";558;100;0
1819;320;"woodie";2139;85.0397381954184;14.9602618045816
10;0;"woodland";10;100;0
192;0;"woodley";192;100;0
16;0;"woodro";16;100;0
784;0;"woodroe";784;100;0
38311;139;"woodrow";38450;99.6384915474642;0.361508452535761
147;0;"woodruff";147;100;0
108;0;"woods";108;100;0
994;0;"woodson";994;100;0
205;0;"woodward";205;100;0
4096;10;"woody";4106;99.7564539698003;0.243546030199708
5;0;"woojin";5;100;0
40;0;"worden";40;100;0
5;0;"wordie";5;100;0
692;0;"worley";692;100;0
10;0;"worn";10;100;0
5;0;"worner";5;100;0
14;0;"worren";14;100;0
1964;0;"worth";1964;100;0
0;8;"wortha";8;0;100
5;0;"wortham";5;100;0
5;0;"worthie";5;100;0
62;0;"worthington";62;100;0
358;5;"worthy";363;98.6225895316804;1.37741046831956
24;0;"wraith";24;100;0
184;0;"wrangler";184;100;0
858;23;"wray";881;97.3893303064699;2.61066969353008
0;5;"wrayanne";5;0;100
0;211;"wreatha";211;0;100
727;3509;"wren";4236;17.162417374882;82.837582625118
0;5;"wrenda";5;0;100
0;9;"wrenlee";9;0;100
0;5;"wrenleigh";5;0;100
0;60;"wrenley";60;0;100
0;32;"wrenly";32;0;100
5;132;"wrenn";137;3.64963503649635;96.3503649635037
0;67;"wrenna";67;0;100
6;0;"wrennyn";6;100;0
0;206;"wretha";206;0;100
11;0;"wrett";11;100;0
1292;0;"wright";1292;100;0
260;169;"wrigley";429;60.6060606060606;39.3939393939394
12;16;"wriley";28;42.8571428571429;57.1428571428571
12;0;"wryan";12;100;0
18;0;"wryder";18;100;0
0;5;"wrylee";5;0;100
0;12;"wryn";12;0;100
0;10;"wrynn";10;0;100
0;15;"wuanita";15;0;100
0;5;"wuendi";5;0;100
0;20;"wuendy";20;0;100
5;0;"wuilber";5;100;0
5;0;"wuilian";5;100;0
16;0;"wuilmer";16;100;0
24;0;"wulfric";24;100;0
23;0;"wwilliam";23;100;0
22;0;"wwlliam";22;100;0
184;0;"wyat";184;100;0
137417;387;"wyatt";137804;99.7191663522104;0.280833647789614
336;0;"wyatte";336;100;0
0;10;"wyconda";10;0;100
50;5;"wydell";55;90.9090909090909;9.09090909090909
0;10;"wydia";10;0;100
292;0;"wyeth";292;100;0
280;0;"wyett";280;100;0
0;22;"wyetta";22;0;100
20;0;"wyette";20;100;0
5;0;"wyhatt";5;100;0
37;0;"wyitt";37;100;0
5;0;"wykeem";5;100;0
0;20;"wykeisha";20;0;100
0;5;"wykena";5;0;100
0;5;"wykeria";5;0;100
0;43;"wykesha";43;0;100
0;10;"wykeshia";10;0;100
0;18;"wykisha";18;0;100
0;5;"wyla";5;0;100
207;0;"wylan";207;100;0
217;0;"wyland";217;100;0
0;23;"wylda";23;0;100
5;0;"wylde";5;100;0
292;22;"wylder";314;92.9936305732484;7.00636942675159
5;0;"wyle";5;100;0
0;10;"wylean";10;0;100
270;66;"wylee";336;80.3571428571429;19.6428571428571
0;6;"wyleen";6;0;100
0;11;"wyleigh";11;0;100
6;0;"wylen";6;100;0
0;980;"wylene";980;0;100
27;0;"wyler";27;100;0
130;0;"wyley";130;100;0
4736;344;"wylie";5080;93.2283464566929;6.77165354330709
0;5;"wyline";5;0;100
0;18;"wylla";18;0;100
21;0;"wylliam";21;100;0
11;0;"wyllis";11;100;0
0;82;"wyllow";82;0;100
10;0;"wyllys";10;100;0
0;536;"wylma";536;0;100
0;77;"wylodean";77;0;100
0;23;"wylodene";23;0;100
0;32;"wylodine";32;0;100
0;5;"wyma";5;0;100
2997;0;"wyman";2997;100;0
7;0;"wymer";7;100;0
89;0;"wymon";89;100;0
5;0;"wymond";5;100;0
80;17;"wyn";97;82.4742268041237;17.5257731958763
0;5;"wynda";5;0;100
0;23;"wynde";23;0;100
0;5;"wyndee";5;0;100
336;0;"wyndell";336;100;0
61;0;"wyndham";61;100;0
0;173;"wyndi";173;0;100
0;5;"wyndie";5;0;100
0;11;"wyndsor";11;0;100
0;28;"wyndy";28;0;100
0;83;"wynee";83;0;100
6;1026;"wynell";1032;0.581395348837209;99.4186046511628
0;548;"wynelle";548;0;100
0;736;"wynema";736;0;100
0;21;"wynesha";21;0;100
0;350;"wynetta";350;0;100
0;956;"wynette";956;0;100
0;9;"wynisha";9;0;100
1971;781;"wynn";2752;71.6206395348837;28.3793604651163
0;7;"wynna";7;0;100
162;1403;"wynne";1565;10.3514376996805;89.6485623003195
0;5;"wynnell";5;0;100
0;46;"wynnette";46;0;100
0;40;"wynnie";40;0;100
10;0;"wynnston";10;100;0
0;6;"wynogene";6;0;100
0;25;"wynola";25;0;100
0;5;"wynoma";5;0;100
0;3483;"wynona";3483;0;100
0;5;"wynonah";5;0;100
0;126;"wynonia";126;0;100
0;146;"wynonna";146;0;100
334;0;"wynston";334;100;0
99;4067;"wynter";4166;2.37638022083533;97.6236197791647
486;0;"wynton";486;100;0
0;64;"wyolene";64;0;100
0;459;"wyoma";459;0;100
0;30;"wyomia";30;0;100
0;16;"wyoming";16;0;100
0;782;"wyona";782;0;100
0;10;"wyonda";10;0;100
0;68;"wyonia";68;0;100
0;36;"wyonna";36;0;100
0;12;"wyonne";12;0;100
0;5;"wyonnia";5;0;100
0;5;"wyota";5;0;100
5;0;"wystan";5;100;0
0;11;"wysteria";11;0;100
0;5;"wyteria";5;0;100
0;10;"wytina";10;0;100
0;22;"wyvetta";22;0;100
0;11;"wyvette";11;0;100
0;51;"wyvonia";51;0;100
0;26;"wyvonna";26;0;100
0;179;"wyvonne";179;0;100
0;11;"wyvonnia";11;0;100
0;5;"wyzetta";5;0;100
80;0;"xabi";80;100;0
15;0;"xabian";15;100;0
45;0;"xabier";45;100;0
5;0;"xabriel";5;100;0
117;0;"xachary";117;100;0
5;0;"xachery";5;100;0
242;0;"xaden";242;100;0
8;0;"xadiel";8;100;0
319;0;"xadrian";319;100;0
14;0;"xadyn";14;100;0
30;0;"xaeden";30;100;0
5;0;"xaedyn";5;100;0
11;0;"xael";11;100;0
0;10;"xaela";10;0;100
0;10;"xaelah";10;0;100
114;20;"xai";134;85.0746268656716;14.9253731343284
0;11;"xaia";11;0;100
0;6;"xaida";6;0;100
630;0;"xaiden";630;100;0
51;0;"xaidyn";51;100;0
0;5;"xailey";5;0;100
41;0;"xain";41;100;0
49;0;"xaine";49;100;0
0;6;"xaira";6;0;100
12;0;"xaire";12;100;0
0;11;"xairexis";11;0;100
996;0;"xaiver";996;100;0
139;0;"xaivier";139;100;0
6;0;"xaivion";6;100;0
15;0;"xalen";15;100;0
0;15;"xalia";15;0;100
0;5;"xally";5;0;100
0;5;"xamara";5;0;100
16;0;"xamir";16;100;0
0;9;"xamira";9;0;100
0;5;"xamiyah";5;0;100
115;122;"xan";237;48.5232067510549;51.4767932489451
0;103;"xana";103;0;100
0;10;"xanadu";10;0;100
15;0;"xandar";15;100;0
5;0;"xande";5;100;0
5;0;"xanden";5;100;0
22482;22;"xander";22504;99.9022396018486;0.0977603981514397
11;0;"xandir";11;100;0
0;454;"xandra";454;0;100
0;68;"xandrea";68;0;100
0;726;"xandria";726;0;100
42;0;"xandyr";42;100;0
293;0;"xane";293;100;0
24;0;"xang";24;100;0
0;47;"xania";47;0;100
0;16;"xaniah";16;0;100
11;0;"xaniel";11;100;0
0;46;"xaniya";46;0;100
0;71;"xaniyah";71;0;100
5;0;"xannder";5;100;0
5;0;"xannon";5;100;0
0;278;"xanthe";278;0;100
0;37;"xanthia";37;0;100
11;0;"xanthus";11;100;0
13;0;"xanti";13;100;0
27;0;"xao";27;100;0
0;145;"xara";145;0;100
0;107;"xareni";107;0;100
0;10;"xareny";10;0;100
0;595;"xaria";595;0;100
0;111;"xariah";111;0;100
0;5;"xarianna";5;0;100
0;6;"xarielys";6;0;100
0;6;"xariya";6;0;100
0;40;"xariyah";40;0;100
38;0;"xaven";38;100;0
32;0;"xaveon";32;100;0
49;0;"xaver";49;100;0
0;14;"xaveria";14;0;100
1614;6;"xavi";1620;99.6296296296296;0.37037037037037
11;517;"xavia";528;2.08333333333333;97.9166666666667
1251;0;"xavian";1251;100;0
0;40;"xaviana";40;0;100
0;26;"xavianna";26;0;100
538;0;"xaviar";538;100;0
0;5;"xaviea";5;0;100
47;0;"xaviel";47;100;0
743;0;"xavien";743;100;0
125678;826;"xavier";126504;99.3470562195662;0.65294378043382
0;628;"xaviera";628;0;100
1834;0;"xavion";1834;100;0
0;5;"xaviona";5;0;100
1122;0;"xavior";1122;100;0
5;0;"xaviour";5;100;0
94;0;"xavious";94;100;0
185;0;"xavius";185;100;0
54;0;"xavy";54;100;0
127;0;"xavyer";127;100;0
403;0;"xayden";403;100;0
6;0;"xaydin";6;100;0
0;77;"xayla";77;0;100
0;26;"xaylee";26;0;100
12;0;"xaylen";12;100;0
0;5;"xaylie";5;0;100
67;0;"xayne";67;100;0
71;0;"xayvier";71;100;0
261;0;"xayvion";261;100;0
5;0;"xazavier";5;100;0
46;0;"xazier";46;100;0
0;92;"xcaret";92;0;100
0;12;"xea";12;0;100
0;118;"xee";118;0;100
0;147;"xela";147;0;100
0;14;"xelha";14;0;100
20;5;"xen";25;80;20
0;1734;"xena";1734;0;100
0;5;"xendaya";5;0;100
137;0;"xeng";137;100;0
0;2382;"xenia";2382;0;100
0;10;"xeniah";10;0;100
0;5;"xeniya";5;0;100
0;5;"xeniyah";5;0;100
0;16;"xenna";16;0;100
15;0;"xenophon";15;100;0
0;5;"xenya";5;0;100
164;0;"xerxes";164;100;0
12;0;"xeryus";12;100;0
108;0;"xhaiden";108;100;0
12;0;"xhavier";12;100;0
0;6;"xi";6;0;100
0;530;"xia";530;0;100
0;56;"xiadani";56;0;100
0;6;"xiah";6;0;100
0;88;"xiamara";88;0;100
218;87;"xian";305;71.4754098360656;28.5245901639344
0;276;"xiana";276;0;100
33;0;"xiang";33;100;0
0;17;"xiani";17;0;100
0;151;"xianna";151;0;100
6;65;"xiao";71;8.45070422535211;91.5492957746479
0;5;"xiaoxi";5;0;100
0;245;"xiara";245;0;100
5;0;"xiaver";5;100;0
0;8;"xica";8;0;100
0;50;"xiclali";50;0;100
0;49;"xiclaly";49;0;100
0;21;"xienna";21;0;100
12;21027;"ximena";21039;0.05703693141309;99.9429630685869
0;160;"ximenna";160;0;100
31;183;"xin";214;14.4859813084112;85.5140186915888
0;23;"xina";23;0;100
5;7;"xing";12;41.6666666666667;58.3333333333333
0;6;"xinia";6;0;100
0;6;"xinran";6;0;100
0;5;"xinrui";5;0;100
0;21;"xinyan";21;0;100
0;91;"xinyi";91;0;100
0;12;"xinyu";12;0;100
0;16;"xinyue";16;0;100
0;34;"xiola";34;0;100
54;0;"xiomar";54;100;0
0;7257;"xiomara";7257;0;100
0;35;"xiomari";35;0;100
0;15;"xiomary";15;0;100
0;6;"xiomayra";6;0;100
0;5;"xiomy";5;0;100
348;37;"xion";385;90.3896103896104;9.61038961038961
176;0;"xiong";176;100;0
0;5;"xirena";5;0;100
0;6;"xithlaly";6;0;100
0;1938;"xitlali";1938;0;100
0;283;"xitlalic";283;0;100
0;6;"xitlalie";6;0;100
0;5;"xitlalit";5;0;100
0;7;"xitlalith";7;0;100
0;298;"xitlalli";298;0;100
0;144;"xitlally";144;0;100
0;1549;"xitlaly";1549;0;100
0;52;"xitllali";52;0;100
0;16;"xiya";16;0;100
0;5;"xiyah";5;0;100
5;0;"xizavier";5;100;0
5;0;"xjavier";5;100;0
6;0;"xoaquin";6;100;0
0;27;"xochi";27;0;100
0;607;"xochil";607;0;100
0;1383;"xochilt";1383;0;100
0;100;"xochilth";100;0;100
0;5;"xochiquetzal";5;0;100
0;5;"xochithl";5;0;100
0;4669;"xochitl";4669;0;100
0;334;"xoe";334;0;100
0;209;"xoey";209;0;100
0;8;"xoi";8;0;100
0;107;"xoie";107;0;100
0;36;"xola";36;0;100
0;70;"xolani";70;0;100
5;16;"xong";21;23.8095238095238;76.1904761904762
0;21;"xophia";21;0;100
0;27;"xotchil";27;0;100
11;0;"xou";11;100;0
74;0;"xsavier";74;100;0
5;0;"xsavion";5;100;0
43;0;"xsavior";43;100;0
5;0;"xu";5;100;0
25;235;"xuan";260;9.61538461538462;90.3846153846154
110;29;"xue";139;79.136690647482;20.863309352518
0;6;"xuri";6;0;100
0;29;"xuxa";29;0;100
121;0;"xxavier";121;100;0
0;33;"xya";33;0;100
30;0;"xyaire";30;100;0
15;0;"xyan";15;100;0
0;6;"xyana";6;0;100
0;10;"xyanna";10;0;100
19;5;"xyion";24;79.1666666666667;20.8333333333333
0;427;"xyla";427;0;100
0;88;"xylah";88;0;100
58;0;"xylan";58;100;0
5;0;"xylar";5;100;0
0;12;"xylee";12;0;100
6;0;"xylen";6;100;0
151;0;"xyler";151;100;0
0;314;"xylia";314;0;100
0;11;"xyliah";11;0;100
0;18;"xyliana";18;0;100
0;39;"xylie";39;0;100
0;207;"xylina";207;0;100
125;0;"xylon";125;100;0
6;0;"xylus";6;100;0
0;22;"xymena";22;0;100
0;6;"xyomara";6;0;100
67;7;"xyon";74;90.5405405405405;9.45945945945946
0;7;"xyra";7;0;100
0;5;"xyriah";5;0;100
25;0;"xzadrian";25;100;0
5;0;"xzaevion";5;100;0
24;0;"xzaiden";24;100;0
84;0;"xzaiver";84;100;0
5;0;"xzaivier";5;100;0
427;0;"xzander";427;100;0
0;80;"xzandria";80;0;100
0;78;"xzaria";78;0;100
0;8;"xzariah";8;0;100
6;0;"xzarion";6;100;0
45;0;"xzaveon";45;100;0
26;60;"xzavia";86;30.2325581395349;69.7674418604651
300;0;"xzavian";300;100;0
85;0;"xzaviar";85;100;0
170;0;"xzavien";170;100;0
6709;0;"xzavier";6709;100;0
912;0;"xzavion";912;100;0
400;0;"xzavior";400;100;0
30;0;"xzavious";30;100;0
7;0;"xzavius";7;100;0
34;0;"xzavyer";34;100;0
36;0;"xzayden";36;100;0
18;0;"xzayvian";18;100;0
6;0;"xzayvien";6;100;0
245;0;"xzayvier";245;100;0
185;0;"xzayvion";185;100;0
43;0;"xzorion";43;100;0
5;34;"ya";39;12.8205128205128;87.1794871794872
0;234;"yaa";234;0;100
121;0;"yaacov";121;100;0
4144;0;"yaakov";4144;100;0
0;5;"yaalini";5;0;100
0;25;"yaara";25;0;100
13;0;"yaaseen";13;100;0
73;0;"yaasir";73;100;0
0;18;"yaasmeen";18;0;100
0;5;"yaasmiyn";5;0;100
32;0;"yabdiel";32;100;0
5;0;"yabriel";5;100;0
5;15;"yabsera";20;25;75
0;161;"yachet";161;0;100
0;23;"yachi";23;0;100
0;6;"yachica";6;0;100
0;5;"yachira";5;0;100
0;22;"yachiyo";22;0;100
20;0;"yaciel";20;100;0
80;60;"yacine";140;57.1428571428571;42.8571428571429
10;0;"yacir";10;100;0
0;36;"yackelin";36;0;100
5;0;"yackov";5;100;0
126;0;"yacob";126;100;0
126;0;"yacoub";126;100;0
5;0;"yacouba";5;100;0
28;0;"yacov";28;100;0
54;0;"yacqub";54;100;0
0;12;"yacquelin";12;0;100
0;18;"yacqueline";18;0;100
6;0;"yad";6;100;0
31;0;"yadel";31;100;0
0;13;"yadelin";13;0;100
0;5;"yadelis";5;0;100
0;15;"yadeliz";15;0;100
63;0;"yaden";63;100;0
93;0;"yader";93;100;0
5;0;"yadhiel";5;100;0
14;0;"yadhir";14;100;0
0;1305;"yadhira";1305;0;100
5;0;"yadian";5;100;0
12;0;"yadid";12;100;0
2231;0;"yadiel";2231;100;0
0;8;"yadieliz";8;0;100
518;0;"yadier";518;100;0
5;0;"yadin";5;100;0
125;0;"yadir";125;100;0
23;12343;"yadira";12366;0.185993854116125;99.8140061458839
0;46;"yadirah";46;0;100
0;6;"yaditzel";6;0;100
27;0;"yadon";27;100;0
0;5;"yadria";5;0;100
28;0;"yadrian";28;100;0
180;0;"yadriel";180;100;0
0;5;"yae";5;0;100
0;439;"yaeko";439;0;100
2965;3290;"yael";6255;47.4020783373301;52.5979216626699
0;128;"yaeli";128;0;100
0;40;"yaelin";40;0;100
0;78;"yaelis";78;0;100
0;31;"yaelle";31;0;100
0;5;"yaely";5;0;100
0;5;"yaeno";5;0;100
0;20;"yafa";20;0;100
304;0;"yafet";304;100;0
0;339;"yaffa";339;0;100
16;0;"yafi";16;100;0
0;24;"yagaira";24;0;100
0;50;"yagmur";50;0;100
159;0;"yago";159;100;0
0;5;"yahaida";5;0;100
0;4773;"yahaira";4773;0;100
0;10;"yahani";10;0;100
0;6;"yahara";6;0;100
0;5;"yahari";5;0;100
0;5;"yaharia";5;0;100
5;5;"yahav";10;50;50
0;204;"yahayra";204;0;100
0;60;"yahdira";60;0;100
540;16;"yahel";556;97.1223021582734;2.87769784172662
0;34;"yaheli";34;0;100
249;0;"yahia";249;100;0
0;13;"yahilin";13;0;100
9867;50;"yahir";9917;99.4958152667137;0.504184733286276
0;470;"yahira";470;0;100
0;6;"yahire";6;0;100
19;11;"yahli";30;63.3333333333333;36.6666666666667
88;0;"yahmir";88;100;0
0;5;"yahna";5;0;100
0;5;"yahne";5;0;100
5;0;"yahoshua";5;100;0
10;0;"yahriel";10;100;0
185;0;"yahshua";185;100;0
79;0;"yahsir";79;100;0
5;0;"yahushua";5;100;0
5;0;"yahve";5;100;0
5;0;"yahveh";5;100;0
0;42;"yahvi";42;0;100
22;0;"yahweh";22;100;0
2170;6;"yahya";2176;99.7242647058823;0.275735294117647
228;0;"yahye";228;100;0
0;5;"yahzarah";5;0;100
0;6;"yaicha";6;0;100
5;0;"yaidden";5;100;0
15;0;"yaidel";15;100;0
96;0;"yaiden";96;100;0
0;20;"yaila";20;0;100
0;238;"yaileen";238;0;100
0;9;"yailem";9;0;100
0;74;"yailen";74;0;100
0;120;"yailene";120;0;100
0;8;"yaileny";8;0;100
0;9;"yailenys";9;0;100
0;5;"yailet";5;0;100
0;5;"yaili";5;0;100
0;632;"yailin";632;0;100
0;72;"yailine";72;0;100
0;253;"yailyn";253;0;100
0;19;"yailynn";19;0;100
0;17;"yaima";17;0;100
0;7;"yaimara";7;0;100
6;0;"yain";6;100;0
0;29;"yaindhi";29;0;100
0;8;"yaindhy";8;0;100
3753;0;"yair";3753;100;0
0;480;"yaira";480;0;100
0;506;"yaire";506;0;100
0;5;"yairely";5;0;100
0;6;"yairet";6;0;100
0;31;"yaireth";31;0;100
0;41;"yairi";41;0;100
0;34;"yairis";34;0;100
6;0;"yairon";6;100;0
0;5;"yairy";5;0;100
0;60;"yaisa";60;0;100
0;7;"yaisha";7;0;100
0;28;"yaitza";28;0;100
0;298;"yaiza";298;0;100
0;195;"yajahira";195;0;100
0;7;"yajaida";7;0;100
5;5405;"yajaira";5410;0.0924214417744917;99.9075785582255
15;0;"yajat";15;100;0
0;304;"yajayra";304;0;100
6;0;"yakeem";6;100;0
0;17;"yakeisha";17;0;100
0;502;"yakelin";502;0;100
0;44;"yakeline";44;0;100
0;30;"yakelyn";30;0;100
0;6;"yakema";6;0;100
0;29;"yakia";29;0;100
0;261;"yakima";261;0;100
0;10;"yakina";10;0;100
0;15;"yakini";15;0;100
58;0;"yakir";58;100;0
0;806;"yakira";806;0;100
0;5;"yakirah";5;0;100
0;43;"yakisha";43;0;100
0;30;"yakita";30;0;100
17;0;"yakob";17;100;0
2159;0;"yakov";2159;100;0
7;0;"yaksh";7;100;0
65;0;"yakub";65;100;0
0;5;"yakyra";5;0;100
0;10;"yalaina";10;0;100
0;5;"yalana";5;0;100
0;652;"yalanda";652;0;100
0;40;"yalani";40;0;100
0;64;"yalda";64;0;100
1390;0;"yale";1390;100;0
0;6;"yaleena";6;0;100
0;6;"yaleiza";6;0;100
0;139;"yalena";139;0;100
0;5;"yaleni";5;0;100
0;16;"yaleska";16;0;100
0;129;"yalexa";129;0;100
0;23;"yalexi";23;0;100
0;8;"yalexia";8;0;100
0;10;"yalexis";10;0;100
0;7;"yaleyza";7;0;100
25;38;"yali";63;39.6825396825397;60.3174603174603
0;6;"yalia";6;0;100
0;9;"yalimar";9;0;100
0;39;"yalina";39;0;100
0;25;"yalini";25;0;100
0;20;"yalisa";20;0;100
0;122;"yalissa";122;0;100
0;713;"yalitza";713;0;100
0;27;"yalixa";27;0;100
0;10;"yaliyah";10;0;100
0;1076;"yalonda";1076;0;100
60;0;"yama";60;100;0
0;66;"yamaira";66;0;100
10;0;"yamajesty";10;100;0
5;0;"yamal";5;100;0
90;0;"yaman";90;100;0
5;43;"yamani";48;10.4166666666667;89.5833333333333
0;5;"yamara";5;0;100
11;135;"yamari";146;7.53424657534247;92.4657534246575
0;5;"yamarie";5;0;100
0;170;"yamaris";170;0;100
106;0;"yamato";106;100;0
0;8;"yamaya";8;0;100
18;0;"yameen";18;100;0
0;18;"yameka";18;0;100
26;153;"yamel";179;14.5251396648045;85.4748603351955
0;68;"yameli";68;0;100
0;11;"yamelin";11;0;100
0;44;"yamely";44;0;100
135;0;"yamen";135;100;0
0;5;"yami";5;0;100
0;19;"yamia";19;0;100
0;20;"yamiah";20;0;100
0;50;"yamika";50;0;100
1298;64;"yamil";1362;95.3010279001468;4.69897209985316
0;684;"yamila";684;0;100
0;1283;"yamile";1283;0;100
0;37;"yamiled";37;0;100
0;62;"yamilee";62;0;100
0;43;"yamiles";43;0;100
0;4167;"yamilet";4167;0;100
0;4195;"yamileth";4195;0;100
0;394;"yamilett";394;0;100
0;547;"yamilette";547;0;100
0;5;"yamiletz";5;0;100
0;1159;"yamilex";1159;0;100
0;17;"yamiley";17;0;100
0;23;"yamilez";23;0;100
0;79;"yamili";79;0;100
0;84;"yamilka";84;0;100
0;43;"yamille";43;0;100
0;35;"yamillet";35;0;100
0;54;"yamily";54;0;100
162;0;"yamin";162;100;0
0;136;"yamina";136;0;100
0;425;"yaminah";425;0;100
0;50;"yamini";50;0;100
513;0;"yamir";513;100;0
0;160;"yamira";160;0;100
0;5;"yamisha";5;0;100
0;5;"yamiyah";5;0;100
0;68;"yamna";68;0;100
667;94;"yan";761;87.6478318002628;12.3521681997372
0;1862;"yana";1862;0;100
0;5;"yanabah";5;0;100
0;50;"yanae";50;0;100
0;10;"yanahi";10;0;100
0;61;"yanai";61;0;100
0;42;"yanaira";42;0;100
0;5;"yanairis";5;0;100
0;5;"yanais";5;0;100
0;10;"yanaiza";10;0;100
6;0;"yanal";6;100;0
0;5;"yanali";5;0;100
0;5;"yanalis";5;0;100
0;5;"yanaliz";5;0;100
0;41;"yanara";41;0;100
0;11;"yanari";11;0;100
0;5;"yanay";5;0;100
40;0;"yancarlo";40;100;0
141;0;"yancarlos";141;100;0
29;0;"yance";29;100;0
1483;34;"yancey";1517;97.7587343441002;2.2412656558998
0;193;"yanci";193;0;100
2389;456;"yancy";2845;83.9718804920914;16.0281195079086
3269;9;"yandel";3278;99.725442342892;0.274557657107993
149;0;"yandell";149;100;0
19;0;"yander";19;100;0
0;13;"yanderi";13;0;100
5;13;"yandi";18;27.7777777777778;72.2222222222222
225;0;"yandiel";225;100;0
5;0;"yandier";5;100;0
67;0;"yandriel";67;100;0
5;0;"yandry";5;100;0
12;20;"yandy";32;37.5;62.5
0;5;"yaned";5;0;100
0;33;"yaneira";33;0;100
0;33;"yaneiry";33;0;100
0;5;"yaneisha";5;0;100
0;29;"yaneisi";29;0;100
0;145;"yaneisy";145;0;100
0;183;"yanel";183;0;100
0;13;"yanela";13;0;100
0;2731;"yaneli";2731;0;100
0;76;"yanelie";76;0;100
0;532;"yanelis";532;0;100
0;257;"yaneliz";257;0;100
0;50;"yanell";50;0;100
0;115;"yanelle";115;0;100
0;393;"yanelli";393;0;100
0;59;"yanellie";59;0;100
0;685;"yanelly";685;0;100
0;1371;"yanely";1371;0;100
0;35;"yanelys";35;0;100
0;35;"yaneri";35;0;100
0;20;"yaneris";20;0;100
0;11;"yanesa";11;0;100
0;7;"yanesha";7;0;100
0;369;"yanessa";369;0;100
0;2066;"yanet";2066;0;100
0;835;"yaneth";835;0;100
0;175;"yanett";175;0;100
0;277;"yanette";277;0;100
0;13;"yanetzi";13;0;100
0;15;"yanetzy";15;0;100
0;16;"yanexi";16;0;100
268;47;"yang";315;85.0793650793651;14.9206349206349
65;189;"yani";254;25.5905511811024;74.4094488188976
0;104;"yania";104;0;100
0;96;"yaniah";96;0;100
0;7;"yanibel";7;0;100
0;68;"yanice";68;0;100
0;11;"yanichel";11;0;100
57;45;"yanick";102;55.8823529411765;44.1176470588235
0;18;"yaniece";18;0;100
437;0;"yaniel";437;100;0
0;21;"yanielis";21;0;100
0;28;"yanieliz";28;0;100
16;0;"yanik";16;100;0
0;22;"yanika";22;0;100
0;66;"yanil";66;0;100
0;82;"yanilen";82;0;100
0;30;"yanilet";30;0;100
0;7;"yanileth";7;0;100
0;22;"yanill";22;0;100
0;129;"yanin";129;0;100
0;367;"yanina";367;0;100
0;26;"yanine";26;0;100
0;355;"yanique";355;0;100
0;3070;"yanira";3070;0;100
0;11;"yanire";11;0;100
0;108;"yaniris";108;0;100
225;99;"yanis";324;69.4444444444444;30.5555555555556
0;62;"yanisa";62;0;100
0;31;"yanise";31;0;100
0;43;"yanisha";43;0;100
0;9;"yanisley";9;0;100
0;68;"yanissa";68;0;100
0;7;"yanisse";7;0;100
0;11;"yanita";11;0;100
0;589;"yanitza";589;0;100
0;5;"yanitzi";5;0;100
0;26;"yanitzia";26;0;100
230;0;"yaniv";230;100;0
0;36;"yanixa";36;0;100
95;0;"yanixan";95;100;0
0;53;"yaniya";53;0;100
0;96;"yaniyah";96;0;100
0;10;"yaniz";10;0;100
6;0;"yankarlo";6;100;0
5;0;"yankee";5;100;0
5;0;"yankel";5;100;0
5;0;"yanko";5;100;0
69;0;"yanky";69;100;0
254;0;"yann";254;100;0
0;471;"yanna";471;0;100
5;0;"yannai";5;100;0
0;13;"yannel";13;0;100
0;56;"yanneli";56;0;100
0;77;"yannely";77;0;100
0;9;"yannery";9;0;100
0;104;"yannet";104;0;100
0;5;"yanneth";5;0;100
0;6;"yannette";6;0;100
618;193;"yanni";811;76.2022194821208;23.7977805178792
810;0;"yannick";810;100;0
0;10;"yannie";10;0;100
13;0;"yannik";13;100;0
0;6;"yannira";6;0;100
315;103;"yannis";418;75.3588516746411;24.6411483253589
6;0;"yannuel";6;100;0
39;0;"yansel";39;100;0
0;15;"yansi";15;0;100
5;0;"yansiel";5;100;0
236;0;"yanuel";236;100;0
5;0;"yanxiel";5;100;0
37;0;"yanzel";37;100;0
39;0;"yanziel";39;100;0
80;0;"yao";80;100;0
235;5;"yaphet";240;97.9166666666667;2.08333333333333
5;0;"yaphett";5;100;0
5;5;"yaqeen";10;50;50
28;0;"yaqoob";28;100;0
18;0;"yaqoub";18;100;0
283;0;"yaqub";283;100;0
0;1329;"yaquelin";1329;0;100
0;214;"yaqueline";214;0;100
0;40;"yaquelyn";40;0;100
0;29;"yar";29;0;100
0;3451;"yara";3451;0;100
0;168;"yarah";168;0;100
0;7;"yarali";7;0;100
0;6;"yaralis";6;0;100
0;27;"yaraliz";27;0;100
0;5;"yarazet";5;0;100
0;6;"yarazeth";6;0;100
72;106;"yarden";178;40.4494382022472;59.5505617977528
0;6;"yardena";6;0;100
99;86;"yardley";185;53.5135135135135;46.4864864864865
0;5;"yarecsi";5;0;100
438;87;"yared";525;83.4285714285714;16.5714285714286
0;6;"yareily";6;0;100
192;562;"yarel";754;25.4641909814324;74.5358090185676
0;7315;"yareli";7315;0;100
0;131;"yarelie";131;0;100
0;6;"yarelii";6;0;100
0;147;"yarelin";147;0;100
0;577;"yarelis";577;0;100
0;183;"yareliz";183;0;100
5;0;"yarell";5;100;0
0;221;"yarelli";221;0;100
0;228;"yarelly";228;0;100
0;2930;"yarely";2930;0;100
0;34;"yarelyn";34;0;100
0;13;"yarelys";13;0;100
0;157;"yaremi";157;0;100
0;5;"yaremy";5;0;100
0;16;"yaren";16;0;100
0;422;"yareni";422;0;100
0;35;"yarenis";35;0;100
0;34;"yareny";34;0;100
0;5;"yarenys";5;0;100
0;10;"yaresi";10;0;100
0;42;"yaresli";42;0;100
0;67;"yaresly";67;0;100
0;7;"yaressi";7;0;100
56;98;"yaret";154;36.3636363636364;63.6363636363636
0;5;"yaretci";5;0;100
0;5;"yaretcy";5;0;100
173;231;"yareth";404;42.8217821782178;57.1782178217822
0;82;"yarethzi";82;0;100
0;80;"yarethzy";80;0;100
0;129;"yaretsi";129;0;100
0;40;"yaretsy";40;0;100
0;5;"yarett";5;0;100
0;10;"yaretza";10;0;100
0;8243;"yaretzi";8243;0;100
0;43;"yaretzie";43;0;100
0;1951;"yaretzy";1951;0;100
0;132;"yarexi";132;0;100
0;38;"yarexy";38;0;100
24;294;"yari";318;7.54716981132075;92.4528301886792
0;105;"yariah";105;0;100
0;219;"yariana";219;0;100
0;74;"yarianna";74;0;100
0;12;"yarianny";12;0;100
0;51;"yaribel";51;0;100
0;33;"yaribeth";33;0;100
0;6;"yaricelis";6;0;100
0;13;"yaricsa";13;0;100
0;45;"yaricza";45;0;100
0;7;"yarida";7;0;100
1279;10;"yariel";1289;99.2242048099302;0.775795190069822
0;67;"yariela";67;0;100
0;11;"yarieli";11;0;100
0;247;"yarielis";247;0;100
0;118;"yarieliz";118;0;100
0;23;"yariely";23;0;100
0;108;"yarielys";108;0;100
6;0;"yarik";6;100;0
0;13;"yarilis";13;0;100
0;15;"yariliz";15;0;100
0;7;"yarilyn";7;0;100
0;66;"yarima";66;0;100
0;123;"yarimar";123;0;100
31;5;"yarin";36;86.1111111111111;13.8888888888889
0;5;"yarira";5;0;100
0;82;"yaris";82;0;100
0;67;"yarisa";67;0;100
0;5;"yarisamar";5;0;100
0;75;"yarisbel";75;0;100
0;47;"yarisbeth";47;0;100
0;38;"yarisel";38;0;100
0;6;"yarisleidi";6;0;100
0;5;"yarisleidy";5;0;100
0;5;"yarisley";5;0;100
0;5;"yarisma";5;0;100
0;5;"yarismar";5;0;100
0;183;"yarissa";183;0;100
0;104;"yarithza";104;0;100
0;116;"yaritsa";116;0;100
0;5;"yaritssa";5;0;100
5;6836;"yaritza";6841;0.0730887297178775;99.9269112702821
0;224;"yaritzel";224;0;100
0;262;"yaritzi";262;0;100
0;11;"yaritzia";11;0;100
0;187;"yaritzy";187;0;100
0;5;"yaritzza";5;0;100
0;159;"yarixa";159;0;100
0;6;"yarixsa";6;0;100
0;60;"yariza";60;0;100
0;5;"yarizel";5;0;100
0;5;"yarizmar";5;0;100
0;5;"yarleth";5;0;100
6;0;"yarley";6;100;0
0;102;"yarlin";102;0;100
0;5;"yarlyn";5;0;100
64;88;"yarnell";152;42.1052631578947;57.8947368421053
0;5;"yarnelle";5;0;100
25;0;"yaro";25;100;0
251;0;"yaron";251;100;0
174;0;"yaroslav";174;100;0
0;10;"yaroslava";10;0;100
16;54;"yarrow";70;22.8571428571429;77.1428571428572
0;10;"yary";10;0;100
0;40;"yasaira";40;0;100
0;108;"yasaman";108;0;100
0;22;"yasameen";22;0;100
0;200;"yasamin";200;0;100
0;28;"yasamine";28;0;100
0;13;"yasari";13;0;100
0;5;"yaschia";5;0;100
0;6;"yaschica";6;0;100
1841;0;"yaseen";1841;100;0
17;0;"yaseer";17;100;0
6;0;"yasel";6;100;0
0;16;"yaselin";16;0;100
0;408;"yasemin";408;0;100
11;0;"yasen";11;100;0
0;159;"yasenia";159;0;100
361;0;"yaser";361;100;0
2214;0;"yash";2214;100;0
42;198;"yasha";240;17.5;82.5
105;0;"yashar";105;100;0
98;0;"yashas";98;100;0
0;32;"yashasvi";32;0;100
0;6;"yashaswini";6;0;100
5;0;"yashdeep";5;100;0
0;6;"yasheca";6;0;100
0;27;"yasheika";27;0;100
0;87;"yasheka";87;0;100
0;10;"yashekia";10;0;100
0;37;"yashi";37;0;100
0;16;"yashia";16;0;100
0;1041;"yashica";1041;0;100
0;516;"yashika";516;0;100
0;6;"yashima";6;0;100
5;0;"yashir";5;100;0
0;485;"yashira";485;0;100
0;6;"yashita";6;0;100
0;6;"yashley";6;0;100
5;0;"yashmit";5;100;0
0;5;"yashoda";5;0;100
10;0;"yashraj";10;100;0
251;0;"yashua";251;100;0
5;0;"yashveer";5;100;0
0;262;"yashvi";262;0;100
5;0;"yashwant";5;100;0
20;0;"yashwanth";20;100;0
5;0;"yashwin";5;100;0
0;5;"yasiah";5;0;100
281;0;"yasiel";281;100;0
28;0;"yasiin";28;100;0
23;0;"yasim";23;100;0
1704;5;"yasin";1709;99.7074312463429;0.292568753657109
0;12;"yasina";12;0;100
10;0;"yasine";10;100;0
1806;0;"yasir";1806;100;0
0;67;"yasira";67;0;100
0;35;"yasirah";35;0;100
0;5;"yasiris";5;0;100
0;54;"yasleen";54;0;100
0;5;"yaslen";5;0;100
0;81;"yaslene";81;0;100
0;5;"yasley";5;0;100
0;449;"yaslin";449;0;100
0;21;"yasline";21;0;100
0;6;"yasly";6;0;100
0;123;"yaslyn";123;0;100
0;19;"yaslynn";19;0;100
0;20;"yasmaine";20;0;100
34;0;"yasmani";34;100;0
10;0;"yasmany";10;100;0
0;26;"yasmean";26;0;100
0;5240;"yasmeen";5240;0;100
0;22;"yasmeena";22;0;100
0;5;"yasmein";5;0;100
0;6;"yasmeli";6;0;100
0;6;"yasmely";6;0;100
0;224;"yasmen";224;0;100
0;75;"yasmene";75;0;100
0;10;"yasmiin";10;0;100
0;22;"yasmim";22;0;100
80;19256;"yasmin";19336;0.413736036408771;99.5862639635912
0;965;"yasmina";965;0;100
0;6;"yasminda";6;0;100
5;12271;"yasmine";12276;0.0407298794395569;99.9592701205604
0;5;"yasmir";5;0;100
0;6;"yasmira";6;0;100
0;135;"yasmyn";135;0;100
0;48;"yasmyne";48;0;100
0;33;"yasna";33;0;100
5;0;"yasniel";5;100;0
69;0;"yasseen";69;100;0
42;0;"yassen";42;100;0
777;0;"yasser";777;100;0
16;0;"yassiel";16;100;0
757;13;"yassin";770;98.3116883116883;1.68831168831169
358;0;"yassine";358;100;0
216;0;"yassir";216;100;0
0;119;"yassmin";119;0;100
0;105;"yassmine";105;0;100
0;10;"yastelin";10;0;100
6;0;"yasuhiro";6;100;0
0;294;"yasuko";294;0;100
5;0;"yasunobu";5;100;0
201;0;"yasuo";201;100;0
0;47;"yasuri";47;0;100
0;29;"yatana";29;0;100
0;16;"yatasha";16;0;100
407;0;"yates";407;100;0
5;0;"yatharth";5;100;0
0;11;"yathziri";11;0;100
0;12;"yathziry";12;0;100
12;0;"yatin";12;100;0
0;6;"yatisha";6;0;100
5;0;"yatniel";5;100;0
0;10;"yatta";10;0;100
0;181;"yatzari";181;0;100
0;71;"yatzary";71;0;100
0;25;"yatzel";25;0;100
5;0;"yatziel";5;100;0
0;289;"yatzil";289;0;100
0;757;"yatziri";757;0;100
0;412;"yatziry";412;0;100
0;5;"yavanna";5;0;100
0;40;"yavette";40;0;100
17;0;"yavian";17;100;0
63;0;"yaviel";63;100;0
70;0;"yavier";70;100;0
40;0;"yavin";40;100;0
0;43;"yavonda";43;0;100
0;6;"yavonna";6;0;100
0;216;"yavonne";216;0;100
62;0;"yavuz";62;100;0
329;0;"yaw";329;100;0
0;5;"yawanda";5;0;100
0;7;"yaxaira";7;0;100
10;0;"yaxel";10;100;0
0;38;"yaxeni";38;0;100
100;0;"yaxiel";100;100;0
0;6;"yaxiry";6;0;100
5;0;"yaxye";5;100;0
35;0;"yaya";35;100;0
0;11;"yayeko";11;0;100
0;7;"yaylin";7;0;100
0;11;"yayoi";11;0;100
0;5;"yayra";5;0;100
0;8;"yaz";8;0;100
0;142;"yazaira";142;0;100
1012;0;"yazan";1012;100;0
0;6;"yazareth";6;0;100
0;12;"yazayra";12;0;100
0;10;"yazbeth";10;0;100
306;0;"yazeed";306;100;0
0;10;"yazel";10;0;100
255;0;"yazen";255;100;0
0;34;"yazhini";34;0;100
249;0;"yazid";249;100;0
157;0;"yaziel";157;100;0
0;5;"yazil";5;0;100
7;0;"yazin";7;100;0
97;0;"yazir";97;100;0
0;31;"yazira";31;0;100
0;5;"yazlee";5;0;100
0;66;"yazleemar";66;0;100
0;71;"yazleen";71;0;100
0;5;"yazlen";5;0;100
0;41;"yazlene";41;0;100
0;270;"yazlin";270;0;100
0;10;"yazline";10;0;100
0;199;"yazlyn";199;0;100
0;93;"yazlynn";93;0;100
0;10;"yazmarie";10;0;100
0;463;"yazmeen";463;0;100
0;71;"yazmen";71;0;100
0;5;"yazmene";5;0;100
7;8181;"yazmin";8188;0.0854909623839765;99.914509037616
0;55;"yazmina";55;0;100
0;2351;"yazmine";2351;0;100
0;222;"yazmyn";222;0;100
0;157;"yazmyne";157;0;100
8;0;"yazn";8;100;0
0;19;"yazuri";19;0;100
5;0;"yazzie";5;100;0
5;0;"yazziel";5;100;0
0;17;"yazzmin";17;0;100
0;18;"yazzmine";18;0;100
0;6;"ydania";6;0;100
22;16;"ye";38;57.8947368421053;42.1052631578947
11;0;"yeab";11;100;0
0;5;"yeabsera";5;0;100
18;7;"yeabsira";25;72;28
5;1230;"yecenia";1235;0.404858299595142;99.5951417004049
283;0;"yecheskel";283;100;0
627;0;"yechezkel";627;100;0
1372;0;"yechiel";1372;100;0
0;48;"yecica";48;0;100
7;0;"yedaiah";7;100;0
0;5;"yedda";5;0;100
0;10;"yedid";10;0;100
0;5;"yedida";5;0;100
80;0;"yedidya";80;100;0
47;0;"yediel";47;100;0
232;201;"yee";433;53.5796766743649;46.4203233256351
40;0;"yeeleng";40;100;0
12;0;"yeferson";12;100;0
6;0;"yefim";6;100;0
43;0;"yefri";43;100;0
43;0;"yegor";43;100;0
5;0;"yehezkel";5;100;0
60;0;"yehia";60;100;0
54;0;"yehonatan";54;100;0
1708;0;"yehoshua";1708;100;0
5171;0;"yehuda";5171;100;0
599;0;"yehudah";599;100;0
0;1510;"yehudis";1510;0;100
0;96;"yehudit";96;0;100
65;0;"yehya";65;100;0
0;5;"yeicelyn";5;0;100
19;0;"yeico";19;100;0
14;0;"yeicob";14;100;0
5;0;"yeidan";5;100;0
101;0;"yeiden";101;100;0
0;5;"yeidy";5;0;100
0;74;"yeila";74;0;100
0;11;"yeilani";11;0;100
0;10;"yeilen";10;0;100
0;45;"yeili";45;0;100
0;230;"yeilin";230;0;100
0;119;"yeily";119;0;100
0;92;"yeilyn";92;0;100
0;541;"yeimi";541;0;100
0;326;"yeimy";326;0;100
0;234;"yeira";234;0;100
67;0;"yeiren";67;100;0
0;29;"yeiri";29;0;100
0;6;"yeiry";6;0;100
298;0;"yeison";298;100;0
0;5;"yeisy";5;0;100
0;7;"yeji";7;0;100
0;5;"yejide";5;0;100
0;42;"yejin";42;0;100
14;0;"yejun";14;100;0
0;79;"yekaterina";79;0;100
52;0;"yekusiel";52;100;0
0;5;"yelaina";5;0;100
0;15;"yeleina";15;0;100
0;6;"yeleini";6;0;100
0;1021;"yelena";1021;0;100
0;12;"yeleni";12;0;100
0;7;"yelenis";7;0;100
0;68;"yelina";68;0;100
0;6;"yelisa";6;0;100
5;0;"yelisey";5;100;0
0;25;"yelissa";25;0;100
0;880;"yelitza";880;0;100
0;8;"yelixa";8;0;100
0;5;"yeliz";5;0;100
0;5;"yelizaveta";5;0;100
0;46;"yelonda";46;0;100
27;0;"yeltsin";27;100;0
0;5;"yema";5;0;100
0;23;"yemariam";23;0;100
0;146;"yemaya";146;0;100
0;10;"yemisi";10;0;100
42;554;"yen";596;7.04697986577181;92.9530201342282
0;181;"yena";181;0;100
0;5;"yenci";5;0;100
0;11;"yency";11;0;100
0;48;"yendi";48;0;100
6;0;"yendriel";6;100;0
0;6;"yendy";6;0;100
0;33;"yeneisy";33;0;100
10;0;"yener";10;100;0
0;67;"yenesis";67;0;100
426;98;"yeng";524;81.2977099236641;18.7022900763359
45;0;"yengkong";45;100;0
0;444;"yeni";444;0;100
0;37;"yenia";37;0;100
22;0;"yeniel";22;100;0
0;1057;"yenifer";1057;0;100
0;20;"yenis";20;0;100
0;6;"yenisel";6;0;100
0;16;"yenitza";16;0;100
0;39;"yenna";39;0;100
0;15;"yennhi";15;0;100
0;72;"yenni";72;0;100
0;5;"yennie";5;0;100
0;437;"yennifer";437;0;100
0;222;"yenny";222;0;100
0;29;"yensi";29;0;100
0;5;"yensid";5;0;100
0;6;"yensy";6;0;100
0;11;"yenta";11;0;100
0;7;"yentel";7;0;100
0;51;"yentl";51;0;100
0;60;"yenty";60;0;100
0;108;"yeny";108;0;100
142;572;"yer";714;19.8879551820728;80.1120448179272
145;0;"yerachmiel";145;100;0
8;0;"yerai";8;100;0
0;171;"yeraldi";171;0;100
0;332;"yeraldin";332;0;100
0;95;"yeraldine";95;0;100
23;0;"yeraldo";23;100;0
0;73;"yeraldy";73;0;100
0;5;"yerani";5;0;100
0;67;"yerania";67;0;100
238;5;"yeray";243;97.9423868312757;2.05761316872428
6;0;"yered";6;100;0
0;7;"yerelin";7;0;100
52;0;"yeremi";52;100;0
29;0;"yeremiah";29;100;0
51;0;"yeremy";51;100;0
0;5;"yerenia";5;0;100
0;5;"yerica";5;0;100
141;0;"yerick";141;100;0
242;0;"yeriel";242;100;0
661;0;"yerik";661;100;0
0;11;"yerika";11;0;100
0;5;"yerimar";5;0;100
0;27;"yerin";27;0;100
0;6;"yeritza";6;0;100
0;6;"yerli";6;0;100
0;55;"yerlin";55;0;100
0;7;"yerly";7;0;100
6;0;"yermi";6;100;0
19;0;"yero";19;100;0
5;0;"yerucham";5;100;0
6;0;"yeruchem";6;100;0
0;6;"yesania";6;0;100
0;15;"yescenia";15;0;100
0;5;"yesel";5;0;100
0;14;"yesemia";14;0;100
0;66;"yesena";66;0;100
314;38280;"yesenia";38594;0.813597968596155;99.1864020314038
0;6;"yesenio";6;0;100
0;77;"yesennia";77;0;100
0;22;"yesenya";22;0;100
10;0;"yesh";10;100;0
0;99;"yesha";99;0;100
545;0;"yeshaya";545;100;0
26;0;"yeshayahu";26;100;0
0;6;"yeshi";6;0;100
5;32;"yeshia";37;13.5135135135135;86.4864864864865
1405;0;"yeshua";1405;100;0
5;0;"yeshwin";5;100;0
5;2293;"yesica";2298;0.217580504786771;99.7824194952132
0;98;"yesika";98;0;100
0;35;"yesina";35;0;100
0;48;"yesinia";48;0;100
0;5;"yesley";5;0;100
0;174;"yesli";174;0;100
0;27;"yeslie";27;0;100
0;176;"yeslin";176;0;100
0;172;"yesly";172;0;100
0;39;"yesmeen";39;0;100
0;5;"yesmi";5;0;100
0;150;"yesmin";150;0;100
0;5;"yesmine";5;0;100
0;18;"yesnia";18;0;100
0;7;"yessel";7;0;100
12;7138;"yessenia";7150;0.167832167832168;99.8321678321678
0;5;"yessenya";5;0;100
0;6;"yessi";6;0;100
0;8;"yessia";8;0;100
0;3719;"yessica";3719;0;100
0;103;"yessika";103;0;100
5;0;"yestin";5;100;0
0;51;"yetive";51;0;100
0;3512;"yetta";3512;0;100
0;192;"yetunde";192;0;100
48;0;"yetzael";48;100;0
0;149;"yetzali";149;0;100
0;10;"yetzaly";10;0;100
6;0;"yetziel";6;100;0
58;0;"yeudiel";58;100;0
0;124;"yeva";124;0;100
0;5;"yevetta";5;0;100
0;839;"yevette";839;0;100
6;0;"yevgeniy";6;100;0
0;303;"yevonne";303;0;100
0;28;"yewande";28;0;100
11;0;"yewell";11;100;0
0;5;"yewon";5;0;100
0;64;"yexalen";64;0;100
0;12;"yexenia";12;0;100
6;0;"yexian";6;100;0
5;0;"yexiel";5;100;0
0;6;"yeyetzi";6;0;100
0;29;"yeymi";29;0;100
20;0;"yeyson";20;100;0
5;0;"yezan";5;100;0
24;0;"yezen";24;100;0
0;497;"yezenia";497;0;100
0;10;"ygnacia";10;0;100
645;0;"ygnacio";645;100;0
0;6;"yhadira";6;0;100
11;0;"yhael";11;100;0
50;0;"yhair";50;100;0
0;12;"yhoalibeth";12;0;100
172;121;"yi";293;58.7030716723549;41.296928327645
32;0;"yia";32;100;0
25;0;"yian";25;100;0
0;5;"yiana";5;0;100
0;72;"yianna";72;0;100
327;0;"yianni";327;100;0
198;0;"yiannis";198;100;0
0;86;"yicel";86;0;100
63;35;"yichen";98;64.2857142857143;35.7142857142857
18;0;"yicheng";18;100;0
162;0;"yida";162;100;0
10;0;"yiddy";10;100;0
183;0;"yidel";183;100;0
0;596;"yides";596;0;100
5;0;"yien";5;100;0
0;6;"yiesha";6;0;100
51;10;"yifan";61;83.6065573770492;16.3934426229508
0;5;"yifei";5;0;100
49;0;"yigit";49;100;0
12;35;"yihan";47;25.531914893617;74.468085106383
0;33;"yilda";33;0;100
0;31;"yilia";31;0;100
5;55;"yilin";60;8.33333333333333;91.6666666666667
14;0;"yimi";14;100;0
39;0;"yiming";39;100;0
0;13;"yin";13;0;100
0;71;"yina";71;0;100
5;6;"yinessa";11;45.4545454545455;54.5454545454545
140;260;"ying";400;35;65
12;0;"yinon";12;100;0
12;10;"yinuo";22;54.5454545454545;45.4545454545455
5;0;"yiorgos";5;100;0
35;0;"yiovanni";35;100;0
0;5;"yiqing";5;0;100
0;13;"yira";13;0;100
10;24;"yiran";34;29.4117647058824;70.5882352941177
0;51;"yireh";51;0;100
5;0;"yirmeyah";5;100;0
0;5;"yiru";5;0;100
0;784;"yisel";784;0;100
0;38;"yisela";38;0;100
0;69;"yisell";69;0;100
0;126;"yiselle";126;0;100
0;5;"yisenia";5;0;100
260;0;"yishai";260;100;0
21;0;"yishay";21;100;0
0;5;"yisleine";5;0;100
926;0;"yisrael";926;100;0
4685;0;"yisroel";4685;100;0
30;0;"yissachar";30;100;0
0;337;"yissel";337;0;100
0;15;"yissell";15;0;100
0;17;"yisselle";17;0;100
23;0;"yissochor";23;100;0
0;45;"yita";45;0;100
0;5;"yitel";5;0;100
0;7;"yitong";7;0;100
0;5;"yitsel";5;0;100
0;237;"yitta";237;0;100
0;61;"yittel";61;0;100
0;1080;"yitty";1080;0;100
1012;0;"yitzchak";1012;100;0
10;0;"yitzchock";10;100;0
3587;0;"yitzchok";3587;100;0
0;167;"yitzel";167;0;100
177;0;"yitzhak";177;100;0
0;27;"yixin";27;0;100
5;16;"yixuan";21;23.8095238095238;76.1904761904762
19;0;"yiyang";19;100;0
0;19;"yiyi";19;0;100
0;174;"yizel";174;0;100
0;5;"yizelle";5;0;100
0;5;"yizza";5;0;100
0;10;"ykeisha";10;0;100
12;0;"yker";12;100;0
0;12;"ylan";12;0;100
0;22;"ylana";22;0;100
0;20;"ylanda";20;0;100
0;5;"ylani";5;0;100
5;0;"ylario";5;100;0
17;0;"yle";17;100;0
0;26;"yleana";26;0;100
0;22;"ylenia";22;0;100
5;0;"yler";5;100;0
0;453;"yliana";453;0;100
0;89;"ylianna";89;0;100
5;0;"yll";5;100;0
0;274;"ylonda";274;0;100
0;29;"yma";29;0;100
0;264;"ymani";264;0;100
0;17;"ymari";17;0;100
0;22;"ymelda";22;0;100
0;11;"yna";11;0;100
23;16;"ynes";39;58.974358974359;41.025641025641
5;129;"ynez";134;3.73134328358209;96.2686567164179
5;0;"yngwie";5;100;0
0;6;"ynhi";6;0;100
0;9;"yo";9;0;100
0;132;"yoali";132;0;100
0;12;"yoaly";12;0;100
318;0;"yoan";318;100;0
0;1366;"yoana";1366;0;100
8;0;"yoandi";8;100;0
0;32;"yoandra";32;0;100
152;0;"yoandri";152;100;0
42;0;"yoandry";42;100;0
34;0;"yoandy";34;100;0
12;0;"yoani";12;100;0
18;0;"yoann";18;100;0
0;583;"yoanna";583;0;100
0;5;"yoany";5;0;100
331;0;"yoav";331;100;0
0;105;"yobana";105;0;100
720;0;"yobani";720;100;0
209;0;"yobany";209;100;0
0;11;"yocasta";11;0;100
0;970;"yocelin";970;0;100
0;112;"yoceline";112;0;100
0;839;"yocelyn";839;0;100
0;24;"yocelyne";24;0;100
0;15;"yocelynn";15;0;100
198;0;"yochanan";198;100;0
34;0;"yochanon";34;100;0
0;1777;"yocheved";1777;0;100
0;5;"yodahe";5;0;100
0;41;"yodit";41;0;100
2941;0;"yoel";2941;100;0
0;33;"yoeli";33;0;100
7;0;"yoenis";7;100;0
6;0;"yoexis";6;100;0
51;0;"yogesh";51;100;0
128;0;"yogi";128;100;0
45;0;"yohaan";45;100;0
0;16;"yohali";16;0;100
896;0;"yohan";896;100;0
0;940;"yohana";940;0;100
44;5;"yohanan";49;89.7959183673469;10.2040816326531
377;0;"yohance";377;100;0
9;0;"yohandri";9;100;0
26;0;"yohandry";26;100;0
38;0;"yohanes";38;100;0
174;0;"yohann";174;100;0
0;621;"yohanna";621;0;100
250;0;"yohannes";250;100;0
34;0;"yohei";34;100;0
16;0;"yohel";16;100;0
5;0;"yohsuke";5;100;0
18;0;"yoichi";18;100;0
0;6;"yojaira";6;0;100
89;0;"yojan";89;100;0
0;19;"yojana";19;0;100
6;0;"yojhan";6;100;0
0;12;"yokasta";12;0;100
0;468;"yoko";468;0;100
0;587;"yola";587;0;100
0;8;"yolaine";8;0;100
0;10;"yolan";10;0;100
0;5;"yolana";5;0;100
0;260;"yoland";260;0;100
537;112251;"yolanda";112788;0.476114480263858;99.5238855197361
0;1619;"yolande";1619;0;100
0;269;"yolander";269;0;100
0;5;"yolandi";5;0;100
0;18;"yolandia";18;0;100
0;6;"yolandita";6;0;100
5;468;"yolando";473;1.05708245243129;98.9429175475687
0;128;"yolandra";128;0;100
0;75;"yolani";75;0;100
0;5;"yolanta";5;0;100
0;20;"yolany";20;0;100
0;14;"yolaunda";14;0;100
0;5;"yolenda";5;0;100
0;38;"yolet";38;0;100
0;8;"yoleth";8;0;100
0;115;"yolette";115;0;100
0;21;"yoli";21;0;100
0;10;"yolimar";10;0;100
0;181;"yolinda";181;0;100
0;5;"yolisma";5;0;100
0;10;"yollanda";10;0;100
0;3872;"yolonda";3872;0;100
0;5;"yolonde";5;0;100
0;55;"yolotzin";55;0;100
87;96;"yoltzin";183;47.5409836065574;52.4590163934426
0;240;"yolunda";240;0;100
6;0;"yom";6;100;0
0;451;"yomaira";451;0;100
0;10;"yomaly";10;0;100
287;0;"yomar";287;100;0
0;181;"yomara";181;0;100
0;24;"yomari";24;0;100
0;107;"yomaris";107;0;100
0;156;"yomayra";156;0;100
0;124;"yomira";124;0;100
0;43;"yomna";43;0;100
5;0;"yomo";5;100;0
9;0;"yomtov";9;100;0
87;0;"yon";87;100;0
283;218;"yona";501;56.4870259481038;43.5129740518962
55;0;"yonael";55;100;0
610;0;"yonah";610;100;0
317;0;"yonas";317;100;0
38;0;"yonason";38;100;0
2050;0;"yonatan";2050;100;0
1182;0;"yonathan";1182;100;0
11;0;"yonaton";11;100;0
0;10;"yonda";10;0;100
0;5;"yone";5;0;100
0;202;"yoneko";202;0;100
29;0;"yonel";29;100;0
34;0;"yoneo";34;100;0
305;124;"yong";429;71.0955710955711;28.9044289044289
662;20;"yoni";682;97.0674486803519;2.93255131964809
53;0;"yonic";53;100;0
80;0;"yoniel";80;100;0
0;5;"yonika";5;0;100
0;47;"yonina";47;0;100
284;0;"yonis";284;100;0
0;130;"yonna";130;0;100
11;0;"yonni";11;100;0
0;36;"yonnie";36;0;100
26;0;"yonny";26;100;0
167;0;"yony";167;100;0
0;12;"yoo";12;0;100
80;29;"yoon";109;73.394495412844;26.605504587156
0;50;"yoona";50;0;100
0;5;"yoonseo";5;0;100
6;0;"yoram";6;100;0
128;0;"yordan";128;100;0
5;0;"yordanny";5;100;0
23;0;"yordano";23;100;0
0;47;"yordanos";47;0;100
29;0;"yordany";29;100;0
508;0;"yordi";508;100;0
64;0;"yordin";64;100;0
261;0;"yordy";261;100;0
5;0;"yordyn";5;100;0
90;0;"yorel";90;100;0
0;6;"yorgelis";6;0;100
6;39;"yori";45;13.3333333333333;86.6666666666667
44;0;"yorick";44;100;0
14;0;"yoriel";14;100;0
850;0;"york";850;100;0
0;20;"yorlei";20;0;100
0;31;"yorleni";31;0;100
0;47;"yorleny";47;0;100
0;9;"yorlet";9;0;100
0;131;"yorley";131;0;100
22;0;"yorman";22;100;0
0;13;"yoruba";13;0;100
5;0;"yorvin";5;100;0
0;5;"yosaira";5;0;100
0;10;"yosalin";10;0;100
0;16;"yosan";16;0;100
26;0;"yosbel";26;100;0
31;0;"yoscar";31;100;0
6912;0;"yosef";6912;100;0
10;0;"yosel";10;100;0
0;29;"yoseli";29;0;100
0;5792;"yoselin";5792;0;100
0;5;"yoselina";5;0;100
0;776;"yoseline";776;0;100
0;1563;"yoselyn";1563;0;100
0;13;"yoselyne";13;0;100
0;33;"yoselynn";33;0;100
0;5;"yosemite";5;0;100
779;0;"yoseph";779;100;0
99;0;"yosgar";99;100;0
5;0;"yosgard";5;100;0
273;0;"yosgart";273;100;0
8;0;"yosgarth";8;100;0
0;37;"yosha";37;0;100
0;6;"yoshani";6;0;100
0;5;"yosheka";5;0;100
126;75;"yoshi";201;62.6865671641791;37.3134328358209
89;0;"yoshiaki";89;100;0
0;6;"yoshica";6;0;100
0;27;"yoshida";27;0;100
0;395;"yoshie";395;0;100
0;21;"yoshigei";21;0;100
0;6;"yoshigey";6;0;100
73;0;"yoshiharu";73;100;0
5;0;"yoshihiko";5;100;0
25;0;"yoshihiro";25;100;0
0;81;"yoshika";81;0;100
5;0;"yoshikatsu";5;100;0
12;0;"yoshikazu";12;100;0
22;0;"yoshiki";22;100;0
0;1330;"yoshiko";1330;0;100
65;30;"yoshimi";95;68.4210526315789;31.5789473684211
0;61;"yoshino";61;0;100
33;0;"yoshinobu";33;100;0
25;0;"yoshinori";25;100;0
1159;0;"yoshio";1159;100;0
0;8;"yoshira";8;0;100
27;0;"yoshiro";27;100;0
15;0;"yoshitaka";15;100;0
202;0;"yoshito";202;100;0
5;0;"yoshiyah";5;100;0
0;155;"yoshiye";155;0;100
36;0;"yoshiyuki";36;100;0
380;0;"yoshua";380;100;0
122;0;"yosiah";122;100;0
6;0;"yosief";6;100;0
44;0;"yosiel";44;100;0
37;0;"yosif";37;100;0
0;5;"yosilin";5;0;100
11;0;"yosimar";11;100;0
136;0;"yoskar";136;100;0
7;0;"yoslan";7;100;0
0;5;"yosmairy";5;0;100
5;0;"yosman";5;100;0
123;0;"yosmar";123;100;0
0;10;"yosmely";10;0;100
19;0;"yosniel";19;100;0
114;0;"yossef";114;100;0
0;448;"yosselin";448;0;100
0;40;"yosseline";40;0;100
0;175;"yosselyn";175;0;100
243;0;"yossi";243;100;0
10;0;"yost";10;100;0
205;0;"yostin";205;100;0
16;0;"yosue";16;100;0
7;0;"yosuel";7;100;0
28;0;"yosuf";28;100;0
28;0;"yosuke";28;100;0
22;0;"yosvani";22;100;0
5;0;"yosvany";5;100;0
127;0;"yotam";127;100;0
10;0;"you";10;100;0
0;175;"youa";175;0;100
68;0;"youcef";68;100;0
5;0;"youel";5;100;0
5;0;"youki";5;100;0
0;857;"youlanda";857;0;100
0;5;"youlander";5;0;100
0;41;"youlonda";41;0;100
244;0;"younes";244;100;0
35;0;"youness";35;100;0
2031;532;"young";2563;79.2430745220445;20.7569254779555
7;0;"younger";7;100;0
0;81;"younique";81;0;100
196;0;"younis";196;100;0
29;0;"younus";29;100;0
10;0;"youri";10;100;0
129;0;"yousaf";129;100;0
4310;0;"yousef";4310;100;0
6;0;"youseph";6;100;0
1072;0;"yousif";1072;100;0
70;0;"yousof";70;100;0
0;184;"yousra";184;0;100
2487;0;"youssef";2487;100;0
29;0;"youssif";29;100;0
167;0;"youssouf";167;100;0
0;22;"youstina";22;0;100
977;0;"yousuf";977;100;0
5;0;"yousuke";5;100;0
105;0;"yovan";105;100;0
0;466;"yovana";466;0;100
1779;16;"yovani";1795;99.108635097493;0.891364902506964
0;28;"yovanka";28;0;100
0;299;"yovanna";299;0;100
502;0;"yovanni";502;100;0
357;0;"yovanny";357;100;0
624;0;"yovany";624;100;0
0;5;"yovela";5;0;100
0;33;"yovonda";33;0;100
0;28;"yovonne";28;0;100
0;23;"yowanda";23;0;100
0;37;"yoyo";37;0;100
0;26;"yozelin";26;0;100
0;5;"yrania";5;0;100
0;5;"yridiana";5;0;100
0;22;"ysa";22;0;100
225;1324;"ysabel";1549;14.5255003227889;85.4744996772111
0;119;"ysabela";119;0;100
0;14;"ysabell";14;0;100
0;1489;"ysabella";1489;0;100
0;404;"ysabelle";404;0;100
0;42;"ysamar";42;0;100
0;24;"ysatis";24;0;100
0;5;"ysaura";5;0;100
0;149;"ysela";149;0;100
0;378;"ysenia";378;0;100
0;6;"ysidora";6;0;100
35;0;"ysidoro";35;100;0
0;97;"ysidra";97;0;100
1389;0;"ysidro";1389;100;0
169;0;"ysmael";169;100;0
0;6;"ysobel";6;0;100
19;0;"ysrael";19;100;0
0;203;"ytzel";203;0;100
369;365;"yu";734;50.2724795640327;49.7275204359673
96;21;"yuan";117;82.051282051282;17.9487179487179
0;5;"yuba";5;0;100
7;0;"yubal";7;100;0
0;34;"yubia";34;0;100
0;10;"yubin";10;0;100
43;12;"yuchen";55;78.1818181818182;21.8181818181818
5;0;"yucheng";5;100;0
16;0;"yuda";16;100;0
0;10;"yudani";10;0;100
0;28;"yudany";28;0;100
0;6;"yudelca";6;0;100
0;29;"yudelka";29;0;100
0;26;"yudi";26;0;100
6;0;"yudiel";6;100;0
0;62;"yudit";62;0;100
0;426;"yudith";426;0;100
81;47;"yue";128;63.28125;36.71875
0;5;"yuen";5;0;100
5;0;"yuepeng";5;100;0
64;0;"yuepheng";64;100;0
0;113;"yuette";113;0;100
0;11;"yufei";11;0;100
319;0;"yug";319;100;0
5;0;"yuga";5;100;0
16;0;"yugan";16;100;0
35;0;"yugo";35;100;0
0;29;"yuhan";29;0;100
5;0;"yuhanna";5;100;0
0;395;"yui";395;0;100
0;13;"yuika";13;0;100
0;5;"yuina";5;0;100
0;11;"yuisa";11;0;100
10;0;"yuito";10;100;0
221;0;"yuji";221;100;0
0;35;"yujin";35;0;100
0;363;"yuka";363;0;100
0;169;"yukari";169;0;100
0;5;"yukary";5;0;100
467;834;"yuki";1301;35.8954650269024;64.1045349730976
0;17;"yukia";17;0;100
0;243;"yukie";243;0;100
0;470;"yukiko";470;0;100
0;15;"yukina";15;0;100
0;18;"yukino";18;0;100
431;0;"yukio";431;100;0
0;40;"yukiye";40;0;100
0;151;"yuko";151;0;100
5;0;"yukon";5;100;0
0;37;"yukta";37;0;100
0;71;"yuktha";71;0;100
0;10;"yukti";10;0;100
638;0;"yul";638;100;0
0;89;"yula";89;0;100
0;1087;"yulanda";1087;0;100
0;10;"yulander";10;0;100
0;5;"yulani";5;0;100
5;0;"yule";5;100;0
0;36;"yuleidi";36;0;100
0;75;"yuleidy";75;0;100
0;5;"yuleiky";5;0;100
0;10;"yuleimi";10;0;100
0;33;"yuleimy";33;0;100
0;5;"yuleisi";5;0;100
0;26;"yuleisy";26;0;100
0;6;"yulema";6;0;100
0;5;"yulemi";5;0;100
0;11;"yulemni";11;0;100
0;6;"yulene";6;0;100
0;62;"yuleni";62;0;100
0;6;"yulexi";6;0;100
0;10;"yuleydi";10;0;100
0;6;"yuleysi";6;0;100
0;257;"yuli";257;0;100
0;410;"yulia";410;0;100
311;0;"yulian";311;100;0
0;5341;"yuliana";5341;0;100
0;6;"yuliani";6;0;100
0;1082;"yulianna";1082;0;100
0;38;"yulie";38;0;100
0;134;"yuliet";134;0;100
0;82;"yulieth";82;0;100
0;6;"yuliett";6;0;100
0;10;"yuliette";10;0;100
0;28;"yulinda";28;0;100
0;1851;"yulisa";1851;0;100
0;3525;"yulissa";3525;0;100
0;163;"yulitza";163;0;100
0;5;"yulitzy";5;0;100
0;50;"yuliya";50;0;100
0;546;"yuliza";546;0;100
0;8;"yulizza";8;0;100
0;5;"yulliana";5;0;100
0;26;"yulma";26;0;100
0;962;"yulonda";962;0;100
0;11;"yulunda";11;0;100
0;27;"yuly";27;0;100
260;69;"yuma";329;79.0273556231003;20.9726443768997
0;5;"yumaira";5;0;100
0;35;"yumalai";35;0;100
0;80;"yumalay";80;0;100
0;5;"yumara";5;0;100
0;19;"yume";19;0;100
0;46;"yumeka";46;0;100
0;669;"yumi";669;0;100
0;20;"yumika";20;0;100
0;224;"yumiko";224;0;100
5;0;"yumin";5;100;0
0;5;"yumira";5;0;100
0;280;"yumna";280;0;100
26;78;"yun";104;25;75
0;1323;"yuna";1323;0;100
0;35;"yunalesca";35;0;100
6;0;"yunay";6;100;0
0;5;"yuneicy";5;0;100
0;21;"yuneisy";21;0;100
10;0;"yunes";10;100;0
11;0;"yung";11;100;0
0;12;"yuni";12;0;100
98;0;"yuniel";98;100;0
5;0;"yunier";5;100;0
247;0;"yunior";247;100;0
0;97;"yunique";97;0;100
173;0;"yunis";173;100;0
0;5;"yunnuen";5;0;100
8;0;"yunqi";8;100;0
5;275;"yunuen";280;1.78571428571429;98.2142857142857
469;0;"yunus";469;100;0
0;11;"yunxi";11;0;100
7;0;"yupheng";7;100;0
0;10;"yura";10;0;100
0;22;"yuraima";22;0;100
0;101;"yurani";101;0;100
0;8;"yuranni";8;0;100
0;18;"yurany";18;0;100
0;5;"yureimy";5;0;100
0;35;"yureli";35;0;100
0;11;"yurely";11;0;100
755;0;"yurem";755;100;0
57;0;"yuren";57;100;0
1693;2608;"yuri";4301;39.3629388514299;60.6370611485701
0;13;"yuria";13;0;100
32;37;"yuriah";69;46.3768115942029;53.6231884057971
0;465;"yuriana";465;0;100
0;69;"yurianna";69;0;100
0;45;"yurico";45;0;100
0;2449;"yuridia";2449;0;100
0;103;"yuridiana";103;0;100
0;17;"yurie";17;0;100
177;0;"yuriel";177;100;0
5;0;"yurik";5;100;0
0;105;"yurika";105;0;100
0;741;"yuriko";741;0;100
0;34;"yuriria";34;0;100
0;10;"yurisa";10;0;100
0;6;"yurith";6;0;100
0;284;"yuritza";284;0;100
0;581;"yuritzi";581;0;100
0;5;"yuritzia";5;0;100
0;353;"yuritzy";353;0;100
0;6;"yurivia";6;0;100
172;0;"yuriy";172;100;0
17;190;"yury";207;8.21256038647343;91.7874396135266
0;5;"yusayrah";5;0;100
2511;0;"yusef";2511;100;0
11;0;"yuseff";11;100;0
44;0;"yusei";44;100;0
38;0;"yusha";38;100;0
0;5;"yushica";5;0;100
5;0;"yushin";5;100;0
280;0;"yusif";280;100;0
0;5;"yusmeri";5;0;100
6;0;"yusof";6;100;0
0;1186;"yusra";1186;0;100
0;7;"yusrah";7;0;100
156;0;"yussef";156;100;0
131;0;"yussuf";131;100;0
11;0;"yustin";11;100;0
6505;0;"yusuf";6505;100;0
5;0;"yusufbek";5;100;0
272;0;"yusuke";272;100;0
6;0;"yusupha";6;100;0
355;0;"yuta";355;100;0
274;0;"yutaka";274;100;0
44;0;"yutaro";44;100;0
0;5;"yuting";5;0;100
287;0;"yuto";287;100;0
0;26;"yutong";26;0;100
0;6;"yutzil";6;0;100
0;10;"yuuka";10;0;100
180;16;"yuuki";196;91.8367346938776;8.16326530612245
0;5;"yuuna";5;0;100
7;0;"yuuta";7;100;0
5;0;"yuv";5;100;0
11;0;"yuva";11;100;0
173;0;"yuvaan";173;100;0
333;167;"yuval";500;66.6;33.4
374;0;"yuvan";374;100;0
6;0;"yuvansh";6;100;0
0;6;"yuvawn";6;0;100
5;0;"yuven";5;100;0
0;54;"yuvette";54;0;100
6;0;"yuvi";6;100;0
0;426;"yuvia";426;0;100
0;20;"yuvika";20;0;100
34;0;"yuvin";34;100;0
0;5;"yuvonda";5;0;100
0;6;"yuvonka";6;0;100
0;240;"yuvonne";240;0;100
13;0;"yuvraaj";13;100;0
743;0;"yuvraj";743;100;0
0;26;"yuxi";26;0;100
0;31;"yuxin";31;0;100
19;10;"yuxuan";29;65.5172413793103;34.4827586206897
83;0;"yuya";83;100;0
5;0;"yuyang";5;100;0
6;0;"yuze";6;100;0
0;5;"yuzu";5;0;100
0;31;"yuzuki";31;0;100
0;18;"yva";18;0;100
5;0;"yvain";5;100;0
0;94;"yvaine";94;0;100
0;5;"yvalondra";5;0;100
392;5;"yvan";397;98.7405541561713;1.25944584382872
0;71;"yvana";71;0;100
0;367;"yvanna";367;0;100
0;5;"yvannah";5;0;100
0;5;"yvannia";5;0;100
0;6;"yveline";6;0;100
0;38;"yvelisse";38;0;100
0;5;"yvelle";5;0;100
31;0;"yvens";31;100;0
1051;34;"yves";1085;96.8663594470046;3.13364055299539
0;8;"yveth";8;0;100
0;333;"yvett";333;0;100
0;480;"yvetta";480;0;100
186;62946;"yvette";63132;0.294620794525756;99.7053792054742
0;6;"yvianna";6;0;100
0;6;"yvie";6;0;100
229;47;"yvon";276;82.9710144927536;17.0289855072464
0;343;"yvonda";343;0;100
0;156;"yvone";156;0;100
0;11;"yvonia";11;0;100
0;1136;"yvonna";1136;0;100
0;21;"yvonnda";21;0;100
619;154887;"yvonne";155506;0.398055380499788;99.6019446195002
0;65;"yvonnia";65;0;100
0;488;"yvonnie";488;0;100
10;0;"ywa";10;100;0
0;56;"yzabel";56;0;100
0;418;"yzabella";418;0;100
0;77;"yzabelle";77;0;100
0;6;"yzamar";6;0;100
5;0;"za";5;100;0
5;0;"zaafir";5;100;0
160;0;"zaahir";160;100;0
10;0;"zaaire";10;100;0
42;0;"zaakir";42;100;0
0;13;"zaakira";13;0;100
0;69;"zaakirah";69;0;100
0;5;"zaakiyah";5;0;100
0;24;"zaaliyah";24;0;100
0;517;"zaara";517;0;100
16;0;"zaaron";16;100;0
16;0;"zaavan";16;100;0
33;129;"zabdi";162;20.3703703703704;79.6296296296296
510;0;"zabdiel";510;100;0
0;6;"zabdy";6;0;100
0;7;"zabel";7;0;100
0;83;"zabella";83;0;100
0;21;"zabelle";21;0;100
164;0;"zabian";164;100;0
21;0;"zabien";21;100;0
0;55;"zabria";55;0;100
12;0;"zabrian";12;100;0
43;0;"zabriel";43;100;0
10;0;"zabrien";10;100;0
0;1293;"zabrina";1293;0;100
0;6;"zabryna";6;0;100
1151;0;"zac";1151;100;0
18;0;"zacai";18;100;0
0;26;"zacara";26;0;100
11;0;"zacardi";11;100;0
222;101;"zacari";323;68.7306501547988;31.2693498452012
27;115;"zacaria";142;19.0140845070423;80.9859154929577
377;5;"zacariah";382;98.6910994764398;1.30890052356021
815;0;"zacarias";815;100;0
6;0;"zacarion";6;100;0
27;0;"zacarius";27;100;0
17;0;"zacarri";17;100;0
1131;0;"zacary";1131;100;0
149;0;"zaccai";149;100;0
20;0;"zaccari";20;100;0
10;0;"zaccaria";10;100;0
10;0;"zaccariah";10;100;0
234;0;"zaccary";234;100;0
1507;0;"zacchaeus";1507;100;0
138;0;"zacchary";138;100;0
85;0;"zaccheaus";85;100;0
454;0;"zaccheus";454;100;0
5;0;"zace";5;100;0
17;0;"zacery";17;100;0
2253;0;"zach";2253;100;0
10;0;"zachaery";10;100;0
7;0;"zachaeus";7;100;0
17;0;"zachai";17;100;0
27;0;"zacharay";27;100;0
97;5;"zacharee";102;95.0980392156863;4.90196078431373
446;0;"zacharey";446;100;0
793;0;"zachari";793;100;0
1596;22;"zacharia";1618;98.6402966625464;1.35970333745365
26006;37;"zachariah";26043;99.8579272741236;0.142072725876435
49;0;"zacharian";49;100;0
1616;0;"zacharias";1616;100;0
1078;0;"zacharie";1078;100;0
116;0;"zacharius";116;100;0
5;0;"zachariyah";5;100;0
22;0;"zacharry";22;100;0
527858;1513;"zachary";529371;99.7141891036721;0.285810896327906
5;0;"zacharya";5;100;0
28;0;"zacharyah";28;100;0
16;0;"zacherey";16;100;0
21;0;"zacheri";21;100;0
34;0;"zacheria";34;100;0
619;0;"zacheriah";619;100;0
77;0;"zacherie";77;100;0
29296;38;"zachery";29334;99.8704574896025;0.129542510397491
33;0;"zacheus";33;100;0
11;0;"zachi";11;100;0
5;0;"zachiary";5;100;0
732;0;"zachory";732;100;0
219;0;"zachrey";219;100;0
10;0;"zachriah";10;100;0
946;0;"zachry";946;100;0
7309;0;"zack";7309;100;0
29;0;"zackaree";29;100;0
63;0;"zackarey";63;100;0
207;0;"zackari";207;100;0
309;0;"zackaria";309;100;0
1120;0;"zackariah";1120;100;0
5;0;"zackarias";5;100;0
217;0;"zackarie";217;100;0
29;0;"zackariya";29;100;0
6;0;"zackariyah";6;100;0
29987;7;"zackary";29994;99.9766619990665;0.02333800093352
30;0;"zackeri";30;100;0
6;0;"zackeria";6;100;0
94;0;"zackeriah";94;100;0
71;0;"zackerie";71;100;0
17249;5;"zackery";17254;99.9710212124725;0.0289787875275298
15;0;"zackhary";15;100;0
50;0;"zackie";50;100;0
5;0;"zackorie";5;100;0
460;0;"zackory";460;100;0
170;0;"zackrey";170;100;0
374;0;"zackry";374;100;0
0;10;"zacora";10;0;100
38;0;"zacorey";38;100;0
10;0;"zacori";10;100;0
0;33;"zacoria";33;0;100
15;0;"zacorian";15;100;0
66;0;"zacory";66;100;0
0;2546;"zada";2546;0;100
0;7;"zadah";7;0;100
27;0;"zadan";27;100;0
31;0;"zadarius";31;100;0
0;49;"zadaya";49;0;100
0;11;"zaddie";11;0;100
1024;17;"zade";1041;98.3669548511047;1.63304514889529
0;17;"zadee";17;0;100
1722;0;"zaden";1722;100;0
0;5;"zadey";5;0;100
0;11;"zadi";11;0;100
0;85;"zadia";85;0;100
22;0;"zadian";22;100;0
0;2227;"zadie";2227;0;100
39;0;"zadiel";39;100;0
27;0;"zadien";27;100;0
88;0;"zadin";88;100;0
157;0;"zadkiel";157;100;0
301;0;"zadok";301;100;0
10;0;"zadon";10;100;0
18;0;"zadquiel";18;100;0
253;0;"zadrian";253;100;0
11;0;"zadrien";11;100;0
0;12;"zady";12;0;100
251;0;"zadyn";251;100;0
62;0;"zae";62;100;0
0;101;"zaeda";101;0;100
5;0;"zaedan";5;100;0
303;0;"zaeden";303;100;0
34;0;"zaedin";34;100;0
26;0;"zaedon";26;100;0
375;5;"zaedyn";380;98.6842105263158;1.31578947368421
180;0;"zaeem";180;100;0
122;0;"zael";122;100;0
0;58;"zaela";58;0;100
0;20;"zaelah";20;0;100
0;37;"zaelee";37;0;100
0;34;"zaeleigh";34;0;100
30;0;"zaelen";30;100;0
0;13;"zaelia";13;0;100
0;5;"zaelie";5;0;100
14;0;"zaelin";14;100;0
7;0;"zaelon";7;100;0
0;11;"zaely";11;0;100
182;154;"zaelyn";336;54.1666666666667;45.8333333333333
0;202;"zaelynn";202;0;100
6;0;"zaen";6;100;0
0;15;"zaena";15;0;100
34;0;"zaequan";34;100;0
11;0;"zaeveon";11;100;0
16;0;"zaevian";16;100;0
199;0;"zaevion";199;100;0
5;0;"zaevon";5;100;0
0;5;"zaeya";5;0;100
76;0;"zafar";76;100;0
5;0;"zafer";5;100;0
0;17;"zafina";17;0;100
200;0;"zafir";200;100;0
0;46;"zafira";46;0;100
0;143;"zafirah";143;0;100
0;55;"zafiro";55;0;100
0;5;"zafreen";5;0;100
0;6;"zaha";6;0;100
22;0;"zahair";22;100;0
0;47;"zahaira";47;0;100
5;0;"zahan";5;100;0
28;0;"zahar";28;100;0
0;2008;"zahara";2008;0;100
0;81;"zaharah";81;0;100
71;102;"zahari";173;41.0404624277457;58.9595375722543
0;43;"zaharia";43;0;100
0;47;"zaharra";47;0;100
0;550;"zahava";550;0;100
5;0;"zahcary";5;100;0
41;0;"zaheem";41;100;0
5;0;"zaheen";5;100;0
171;0;"zaheer";171;100;0
11;0;"zaheim";11;100;0
10;0;"zaher";10;100;0
61;0;"zahi";61;100;0
0;23;"zahia";23;0;100
694;0;"zahid";694;100;0
0;10;"zahida";10;0;100
0;5;"zahidah";5;0;100
10;0;"zahiem";10;100;0
12;0;"zahier";12;100;0
21;0;"zahin";21;100;0
2250;7;"zahir";2257;99.6898537882144;0.310146211785556
0;891;"zahira";891;0;100
0;238;"zahirah";238;0;100
6;0;"zahire";6;100;0
0;16;"zahiya";16;0;100
0;15;"zahiyah";15;0;100
34;0;"zahkai";34;100;0
5;0;"zahkari";5;100;0
5;0;"zahkee";5;100;0
10;0;"zahkeem";10;100;0
87;0;"zahki";87;100;0
6;0;"zahkir";6;100;0
0;6;"zahlia";6;0;100
30;5;"zahmari";35;85.7142857142857;14.2857142857143
0;5;"zahmaria";5;0;100
11;0;"zahmere";11;100;0
6;0;"zahmier";6;100;0
307;0;"zahmir";307;100;0
0;6;"zahmira";6;0;100
0;5;"zahmiya";5;0;100
0;21;"zahmya";21;0;100
28;0;"zahn";28;100;0
0;19;"zahna";19;0;100
0;6;"zahnae";6;0;100
0;5;"zahnia";5;0;100
0;12;"zahniah";12;0;100
0;81;"zahniya";81;0;100
0;53;"zahniyah";53;0;100
0;20;"zahnya";20;0;100
0;4839;"zahra";4839;0;100
0;771;"zahraa";771;0;100
0;271;"zahrah";271;0;100
14;0;"zahran";14;100;0
0;10;"zahrea";10;0;100
0;5;"zahri";5;0;100
0;834;"zahria";834;0;100
0;72;"zahriah";72;0;100
0;44;"zahriya";44;0;100
0;63;"zahriyah";63;0;100
0;10;"zahro";10;0;100
0;25;"zahrya";25;0;100
6;0;"zahyan";6;100;0
16;0;"zahyir";16;100;0
5;0;"zahyr";5;100;0
0;47;"zahyra";47;0;100
0;5;"zahyrah";5;0;100
74;25;"zai";99;74.7474747474748;25.2525252525253
0;109;"zaia";109;0;100
76;104;"zaiah";180;42.2222222222222;57.7777777777778
0;5;"zaiana";5;0;100
3853;0;"zaid";3853;100;0
0;3172;"zaida";3172;0;100
0;28;"zaidah";28;0;100
268;0;"zaidan";268;100;0
131;100;"zaide";231;56.7099567099567;43.2900432900433
0;206;"zaidee";206;0;100
6121;34;"zaiden";6155;99.4476035743298;0.552396425670187
82;0;"zaidin";82;100;0
46;0;"zaidon";46;100;0
0;80;"zaidy";80;0;100
753;31;"zaidyn";784;96.0459183673469;3.95408163265306
13;0;"zaier";13;100;0
5;0;"zaiiden";5;100;0
0;369;"zaila";369;0;100
0;95;"zailah";95;0;100
7;0;"zailan";7;100;0
0;186;"zailee";186;0;100
0;37;"zaileigh";37;0;100
84;0;"zailen";84;100;0
0;547;"zailey";547;0;100
0;5;"zailie";5;0;100
5;0;"zailin";5;100;0
0;42;"zaily";42;0;100
86;176;"zailyn";262;32.824427480916;67.175572519084
0;153;"zailynn";153;0;100
106;0;"zaim";106;100;0
0;48;"zaima";48;0;100
0;5;"zaimah";5;0;100
5;0;"zaimar";5;100;0
5441;210;"zain";5651;96.2838435675102;3.71615643248982
0;1848;"zaina";1848;0;100
0;4627;"zainab";4627;0;100
0;163;"zainah";163;0;100
6;0;"zainaldeen";6;100;0
0;5;"zainb";5;0;100
1347;16;"zaine";1363;98.8261188554659;1.17388114453412
0;232;"zaineb";232;0;100
0;40;"zainub";40;0;100
61;0;"zaion";61;100;0
0;10;"zaionna";10;0;100
341;0;"zair";341;100;0
0;3398;"zaira";3398;0;100
0;168;"zairah";168;0;100
4626;1280;"zaire";5906;78.3271249576702;21.6728750423298
0;13;"zairia";13;0;100
0;11;"zairy";11;0;100
0;6;"zaisha";6;0;100
29;0;"zaith";29;100;0
23;0;"zaiven";23;100;0
12;0;"zaiveon";12;100;0
5;0;"zaivian";5;100;0
5;0;"zaivier";5;100;0
69;0;"zaivion";69;100;0
0;248;"zaiya";248;0;100
0;72;"zaiyah";72;0;100
5;0;"zaiyan";5;100;0
0;5;"zaiyanna";5;0;100
61;0;"zaiyden";61;100;0
12;0;"zaiyon";12;100;0
1350;0;"zak";1350;100;0
1023;5;"zakai";1028;99.5136186770428;0.486381322957198
5;0;"zakaiden";5;100;0
0;6;"zakaira";6;0;100
0;66;"zakaiya";66;0;100
0;12;"zakaiyah";12;0;100
57;0;"zakar";57;100;0
0;77;"zakara";77;0;100
0;6;"zakarah";6;0;100
56;0;"zakaree";56;100;0
5;0;"zakarey";5;100;0
902;138;"zakari";1040;86.7307692307692;13.2692307692308
1866;373;"zakaria";2239;83.3407771326485;16.6592228673515
637;76;"zakariah";713;89.3408134642356;10.6591865357644
10;0;"zakarian";10;100;0
35;0;"zakarias";35;100;0
148;0;"zakarie";148;100;0
1278;47;"zakariya";1325;96.4528301886793;3.54716981132075
73;19;"zakariyah";92;79.3478260869565;20.6521739130435
139;0;"zakariye";139;100;0
171;0;"zakariyya";171;100;0
11;0;"zakarri";11;100;0
5311;0;"zakary";5311;100;0
42;0;"zakarya";42;100;0
12;0;"zakaryah";12;100;0
0;60;"zakaya";60;0;100
0;6;"zakayah";6;0;100
5;0;"zakayden";5;100;0
0;348;"zakayla";348;0;100
0;6;"zakaylah";6;0;100
5;0;"zake";5;100;0
543;0;"zakee";543;100;0
0;9;"zakeea";9;0;100
15;0;"zakeem";15;100;0
0;9;"zakeia";9;0;100
0;21;"zakera";21;0;100
6;0;"zakeri";6;100;0
5;213;"zakeria";218;2.29357798165138;97.7064220183486
0;10;"zakerria";10;0;100
1328;0;"zakery";1328;100;0
0;178;"zakeya";178;0;100
0;5;"zakeyah";5;0;100
0;5;"zakeyia";5;0;100
53;0;"zakhai";53;100;0
18;0;"zakhar";18;100;0
83;5;"zakhari";88;94.3181818181818;5.68181818181818
0;15;"zakharia";15;0;100
31;0;"zakhary";31;100;0
241;0;"zakhi";241;100;0
0;191;"zakhia";191;0;100
0;5;"zakhiya";5;0;100
0;12;"zakhya";12;0;100
1033;0;"zaki";1033;100;0
16;1601;"zakia";1617;0.989486703772418;99.0105132962276
126;352;"zakiah";478;26.3598326359833;73.6401673640167
5;0;"zakiel";5;100;0
408;0;"zakir";408;100;0
0;391;"zakira";391;0;100
0;196;"zakirah";196;0;100
0;7;"zakiria";7;0;100
0;2983;"zakiya";2983;0;100
0;1546;"zakiyah";1546;0;100
0;39;"zakiyya";39;0;100
0;1152;"zakiyyah";1152;0;100
473;0;"zakk";473;100;0
29;0;"zakkai";29;100;0
6;0;"zakkariah";6;100;0
1132;0;"zakkary";1132;100;0
306;0;"zakkery";306;100;0
0;16;"zakkiyah";16;0;100
0;75;"zakkiyya";75;0;100
10;0;"zakori";10;100;0
0;17;"zakoria";17;0;100
28;0;"zakory";28;100;0
6;0;"zakrey";6;100;0
5;0;"zakri";5;100;0
16;0;"zakria";16;100;0
244;0;"zakry";244;100;0
5;0;"zakwon";5;100;0
5;0;"zaky";5;100;0
0;185;"zakya";185;0;100
0;173;"zakyah";173;0;100
67;0;"zakye";67;100;0
0;131;"zakyia";131;0;100
0;47;"zakyiah";47;0;100
0;127;"zakyla";127;0;100
0;13;"zakylah";13;0;100
0;287;"zakyra";287;0;100
0;52;"zakyrah";52;0;100
0;59;"zakyria";59;0;100
0;6;"zakyriah";6;0;100
7;0;"zakyrie";7;100;0
0;101;"zala";101;0;100
0;5;"zalaiya";5;0;100
0;11;"zalaiyah";11;0;100
54;0;"zalan";54;100;0
0;177;"zalaya";177;0;100
0;192;"zalayah";192;0;100
0;8;"zalaysia";8;0;100
95;0;"zale";95;100;0
0;89;"zalea";89;0;100
0;170;"zaleah";170;0;100
0;6;"zalee";6;0;100
0;7;"zaleena";7;0;100
0;6;"zaleia";6;0;100
0;111;"zaleigh";111;0;100
0;18;"zaleigha";18;0;100
310;0;"zalen";310;100;0
0;30;"zalena";30;0;100
0;5;"zalet";5;0;100
0;7;"zaleth";7;0;100
0;135;"zaley";135;0;100
0;16;"zaleyah";16;0;100
0;37;"zali";37;0;100
0;211;"zalia";211;0;100
0;69;"zaliah";69;0;100
0;34;"zalie";34;0;100
0;219;"zalika";219;0;100
0;31;"zalina";31;0;100
0;30;"zaliya";30;0;100
0;500;"zaliyah";500;0;100
0;89;"zalma";89;0;100
499;0;"zalman";499;100;0
478;0;"zalmen";478;100;0
11;0;"zalon";11;100;0
67;6;"zalyn";73;91.7808219178082;8.21917808219178
10;33;"zalynn";43;23.2558139534884;76.7441860465116
17;0;"zam";17;100;0
5;0;"zamair";5;100;0
0;5;"zamaira";5;0;100
0;10;"zamaiya";10;0;100
0;5;"zamaiyah";5;0;100
28;0;"zaman";28;100;0
12;91;"zamani";103;11.6504854368932;88.3495145631068
0;15;"zamanta";15;0;100
0;289;"zamantha";289;0;100
366;0;"zamar";366;100;0
0;400;"zamara";400;0;100
0;51;"zamarah";51;0;100
6;0;"zamarcus";6;100;0
12;0;"zamare";12;100;0
10;0;"zamaree";10;100;0
5;0;"zamareon";5;100;0
690;323;"zamari";1013;68.1145113524186;31.8854886475814
0;634;"zamaria";634;0;100
0;209;"zamariah";209;0;100
76;0;"zamarian";76;100;0
5;13;"zamarie";18;27.7777777777778;72.2222222222222
14;0;"zamarien";14;100;0
6;0;"zamarii";6;100;0
822;0;"zamarion";822;100;0
5;0;"zamarious";5;100;0
26;0;"zamarius";26;100;0
0;79;"zamariya";79;0;100
0;91;"zamariyah";91;0;100
0;12;"zamarria";12;0;100
19;0;"zamarrion";19;100;0
64;6;"zamauri";70;91.4285714285714;8.57142857142857
0;34;"zamauria";34;0;100
8;0;"zamaurion";8;100;0
0;442;"zamaya";442;0;100
0;43;"zamayah";43;0;100
0;5;"zamayra";5;0;100
136;0;"zameer";136;100;0
22;0;"zameir";22;100;0
0;12;"zamera";12;0;100
96;0;"zamere";96;100;0
0;76;"zameria";76;0;100
0;228;"zamia";228;0;100
0;342;"zamiah";342;0;100
10;0;"zamian";10;100;0
0;5;"zamiaya";5;0;100
5;0;"zamiel";5;100;0
11;0;"zamien";11;100;0
103;0;"zamier";103;100;0
5;0;"zamiere";5;100;0
11;0;"zamil";11;100;0
0;6;"zamina";6;0;100
5;0;"zamion";5;100;0
1964;0;"zamir";1964;100;0
0;708;"zamira";708;0;100
0;253;"zamirah";253;0;100
63;0;"zamire";63;100;0
0;11;"zamirra";11;0;100
0;542;"zamiya";542;0;100
0;765;"zamiyah";765;0;100
26;0;"zamon";26;100;0
0;26;"zamoni";26;0;100
11;0;"zamonte";11;100;0
0;528;"zamora";528;0;100
0;48;"zamorah";48;0;100
0;81;"zamoria";81;0;100
6;0;"zamorion";6;100;0
19;0;"zamuel";19;100;0
0;925;"zamya";925;0;100
0;192;"zamyah";192;0;100
0;94;"zamyia";94;0;100
0;78;"zamyiah";78;0;100
0;7;"zamyla";7;0;100
0;177;"zamyra";177;0;100
0;50;"zamyrah";50;0;100
0;44;"zamyria";44;0;100
0;21;"zamyriah";21;0;100
0;196;"zamzam";196;0;100
602;114;"zan";716;84.0782122905028;15.9217877094972
0;2040;"zana";2040;0;100
0;10;"zanaa";10;0;100
0;25;"zanab";25;0;100
0;225;"zanae";225;0;100
0;31;"zanah";31;0;100
0;167;"zanai";167;0;100
0;6;"zanaia";6;0;100
0;10;"zanaiah";10;0;100
0;5;"zanaii";5;0;100
0;101;"zanaiya";101;0;100
0;30;"zanaiyah";30;0;100
0;10;"zanajah";10;0;100
0;35;"zanari";35;0;100
0;176;"zanaria";176;0;100
0;31;"zanariah";31;0;100
0;67;"zanasia";67;0;100
0;47;"zanay";47;0;100
0;492;"zanaya";492;0;100
0;187;"zanayah";187;0;100
0;5;"zanayla";5;0;100
0;7;"zanda";7;0;100
0;33;"zandalee";33;0;100
5;0;"zandar";5;100;0
0;22;"zandaya";22;0;100
5;0;"zandel";5;100;0
111;0;"zanden";111;100;0
18387;26;"zander";18413;99.858795416282;0.141204583718025
110;0;"zandon";110;100;0
0;3508;"zandra";3508;0;100
32;0;"zandre";32;100;0
0;208;"zandrea";208;0;100
0;537;"zandria";537;0;100
5;0;"zandur";5;100;0
32;0;"zandyn";32;100;0
83;0;"zandyr";83;100;0
43403;490;"zane";43893;98.8836488733967;1.11635112660333
0;24;"zanea";24;0;100
0;15;"zaneb";15;0;100
0;6;"zanelle";6;0;100
0;5;"zaneria";5;0;100
0;939;"zaneta";939;0;100
0;377;"zanetta";377;0;100
0;10;"zanette";10;0;100
0;5;"zaney";5;0;100
0;11;"zaneya";11;0;100
45;86;"zani";131;34.3511450381679;65.6488549618321
0;717;"zania";717;0;100
0;1302;"zaniah";1302;0;100
0;14;"zaniaya";14;0;100
0;50;"zanib";50;0;100
0;26;"zanie";26;0;100
197;0;"zaniel";197;100;0
0;5;"zanieya";5;0;100
0;5;"zaniiya";5;0;100
0;28;"zanijah";28;0;100
0;17;"zanilah";17;0;100
0;21;"zanique";21;0;100
0;6;"zanisha";6;0;100
0;102;"zanita";102;0;100
0;2776;"zaniya";2776;0;100
0;4329;"zaniyah";4329;0;100
0;33;"zaniyha";33;0;100
0;37;"zaniyla";37;0;100
0;28;"zaniylah";28;0;100
0;18;"zaniyyah";18;0;100
10;0;"zann";10;100;0
0;519;"zanna";519;0;100
0;71;"zannah";71;0;100
144;140;"zannie";284;50.7042253521127;49.2957746478873
0;5;"zanniyah";5;0;100
0;79;"zanobia";79;0;100
0;70;"zanovia";70;0;100
0;6;"zanoviah";6;0;100
0;5;"zanquisha";5;0;100
0;6;"zantasia";6;0;100
8;0;"zantavious";8;100;0
0;5;"zanteria";5;0;100
0;12;"zanthia";12;0;100
17;0;"zanthony";17;100;0
6;0;"zantiago";6;100;0
0;520;"zanya";520;0;100
0;409;"zanyah";409;0;100
0;6;"zanye";6;0;100
0;209;"zanyia";209;0;100
0;202;"zanyiah";202;0;100
0;205;"zanyla";205;0;100
0;118;"zanylah";118;0;100
0;5;"zanyra";5;0;100
0;6;"zanyria";6;0;100
0;5;"zanyyah";5;0;100
22;0;"zao";22;100;0
5;0;"zaon";5;100;0
0;6;"zaory";6;0;100
0;24;"zaphira";24;0;100
503;0;"zaquan";503;100;0
5;0;"zaquavious";5;100;0
0;8899;"zara";8899;0;100
6;0;"zaraan";6;100;0
0;43;"zarae";43;0;100
5;0;"zaragosa";5;100;0
60;0;"zaragoza";60;100;0
0;1566;"zarah";1566;0;100
0;162;"zarahi";162;0;100
0;10;"zarahy";10;0;100
0;215;"zarai";215;0;100
0;18;"zaraiah";18;0;100
0;5;"zaraiyah";5;0;100
29;0;"zarak";29;100;0
5;0;"zarar";5;100;0
8;0;"zaravion";8;100;0
0;66;"zaray";66;0;100
0;158;"zaraya";158;0;100
0;101;"zarayah";101;0;100
6;0;"zarchary";6;100;0
0;84;"zarea";84;0;100
0;62;"zareah";62;0;100
5;0;"zareb";5;100;0
116;0;"zared";116;100;0
0;170;"zareen";170;0;100
0;66;"zareena";66;0;100
17;0;"zareh";17;100;0
0;14;"zareia";14;0;100
858;0;"zarek";858;100;0
0;39;"zarela";39;0;100
0;5;"zarelia";5;0;100
0;6;"zarella";6;0;100
0;5;"zarely";5;0;100
30;0;"zaren";30;100;0
0;15;"zarena";15;0;100
5;0;"zareon";5;100;0
0;10;"zaret";10;0;100
12;60;"zareth";72;16.6666666666667;83.3333333333333
0;62;"zareya";62;0;100
0;52;"zareyah";52;0;100
0;15;"zarhia";15;0;100
0;5;"zarhianna";5;0;100
0;11;"zarhiya";11;0;100
15;752;"zari";767;1.95567144719687;98.0443285528031
0;8211;"zaria";8211;0;100
61;7971;"zariah";8032;0.759462151394422;99.2405378486056
0;42;"zariaha";42;0;100
292;28;"zarian";320;91.25;8.75
0;177;"zariana";177;0;100
0;220;"zarianna";220;0;100
0;61;"zarie";61;0;100
0;17;"zariea";17;0;100
24;170;"zariel";194;12.3711340206186;87.6288659793814
0;102;"zarielle";102;0;100
20;0;"zarien";20;100;0
118;0;"zarif";118;100;0
0;24;"zarifa";24;0;100
0;27;"zariha";27;0;100
0;20;"zarihanna";20;0;100
0;12;"zarihya";12;0;100
19;0;"zarik";19;100;0
111;99;"zarin";210;52.8571428571429;47.1428571428571
0;1030;"zarina";1030;0;100
0;177;"zarinah";177;0;100
333;0;"zarion";333;100;0
0;10;"zariona";10;0;100
0;40;"zarionna";40;0;100
7;0;"zarious";7;100;0
0;14;"zarita";14;0;100
262;0;"zarius";262;100;0
0;1272;"zariya";1272;0;100
0;3590;"zariyah";3590;0;100
5;0;"zariyan";5;100;0
0;19;"zariyana";19;0;100
0;32;"zariyha";32;0;100
0;5;"zarlish";5;0;100
0;5;"zarmeen";5;0;100
0;6;"zarmina";6;0;100
151;0;"zaron";151;100;0
14;0;"zaroon";14;100;0
0;39;"zarra";39;0;100
0;70;"zarrah";70;0;100
13;0;"zarrar";13;100;0
0;14;"zarrea";14;0;100
0;5;"zarreah";5;0;100
21;0;"zarren";21;100;0
0;562;"zarria";562;0;100
0;359;"zarriah";359;0;100
11;0;"zarrian";11;100;0
5;0;"zarrien";5;100;0
0;5;"zarrin";5;0;100
10;0;"zarrion";10;100;0
6;0;"zarrius";6;100;0
0;39;"zarriyah";39;0;100
0;366;"zarya";366;0;100
5;0;"zaryab";5;100;0
0;598;"zaryah";598;0;100
148;0;"zaryan";148;100;0
0;5;"zaryha";5;0;100
0;74;"zaryia";74;0;100
0;204;"zaryiah";204;0;100
5;0;"zaryk";5;100;0
27;28;"zaryn";55;49.0909090909091;50.9090909090909
0;183;"zasha";183;0;100
39;0;"zashawn";39;100;0
0;6;"zasia";6;0;100
0;23;"zatanna";23;0;100
0;5;"zatara";5;0;100
0;6;"zatavia";6;0;100
39;0;"zathan";39;100;0
0;27;"zatoria";27;0;100
218;0;"zaul";218;100;0
0;10;"zaundra";10;0;100
0;76;"zauria";76;0;100
0;5;"zavaeh";5;0;100
0;24;"zavanna";24;0;100
0;105;"zavannah";105;0;100
0;22;"zaveah";22;0;100
54;0;"zaveion";54;100;0
364;0;"zaven";364;100;0
252;0;"zaveon";252;100;0
46;5;"zavery";51;90.1960784313726;9.80392156862745
6;0;"zavhary";6;100;0
10;0;"zavi";10;100;0
6;121;"zavia";127;4.7244094488189;95.2755905511811
1066;0;"zavian";1066;100;0
34;0;"zaviar";34;100;0
633;0;"zavien";633;100;0
4876;5;"zavier";4881;99.8975619750051;0.102438024994878
0;25;"zaviera";25;0;100
5;0;"zaviere";5;100;0
40;0;"zavin";40;100;0
2435;0;"zavion";2435;100;0
208;0;"zavior";208;100;0
11;0;"zavious";11;100;0
17;0;"zavius";17;100;0
36;0;"zaviyar";36;100;0
10;0;"zaviyon";10;100;0
187;0;"zavon";187;100;0
16;0;"zavyer";16;100;0
5;0;"zavyn";5;100;0
12;0;"zavyon";12;100;0
0;108;"zawadi";108;0;100
5;0;"zawdie";5;100;0
5;0;"zaxon";5;100;0
114;0;"zaxton";114;100;0
5;0;"zaxtyn";5;100;0
52;6;"zay";58;89.6551724137931;10.3448275862069
24;971;"zaya";995;2.41206030150754;97.5879396984925
201;0;"zayaan";201;100;0
16;356;"zayah";372;4.3010752688172;95.6989247311828
774;0;"zayan";774;100;0
0;157;"zayana";157;0;100
0;5;"zayanah";5;0;100
0;5;"zayani";5;0;100
0;122;"zayanna";122;0;100
0;5;"zayannah";5;0;100
0;18;"zaybree";18;0;100
5;0;"zaybrien";5;100;0
5;0;"zayceon";5;100;0
1970;0;"zayd";1970;100;0
0;1500;"zayda";1500;0;100
0;54;"zaydah";54;0;100
286;0;"zaydan";286;100;0
177;25;"zayde";202;87.6237623762376;12.3762376237624
0;178;"zaydee";178;0;100
14576;129;"zayden";14705;99.1227473648419;0.877252635158109
54;0;"zaydenn";54;100;0
0;35;"zaydi";35;0;100
12;0;"zaydian";12;100;0
0;27;"zaydie";27;0;100
11;0;"zaydien";11;100;0
370;0;"zaydin";370;100;0
65;0;"zaydn";65;100;0
212;0;"zaydon";212;100;0
5;0;"zaydren";5;100;0
110;0;"zaydrian";110;100;0
133;0;"zaydyn";133;100;0
5;0;"zaye";5;100;0
199;0;"zayed";199;100;0
28;0;"zayen";28;100;0
0;11;"zayia";11;0;100
0;15;"zayiah";15;0;100
21;0;"zayid";21;100;0
123;0;"zayin";123;100;0
29;0;"zayion";29;100;0
13;0;"zayir";13;100;0
13;0;"zaykeese";13;100;0
0;1596;"zayla";1596;0;100
0;23;"zaylaa";23;0;100
0;336;"zaylah";336;0;100
265;0;"zaylan";265;100;0
5;0;"zayland";5;100;0
0;18;"zaylani";18;0;100
0;8;"zaylea";8;0;100
0;15;"zayleah";15;0;100
0;1907;"zaylee";1907;0;100
0;22;"zayleen";22;0;100
0;41;"zaylei";41;0;100
0;351;"zayleigh";351;0;100
1147;33;"zaylen";1180;97.2033898305085;2.79661016949153
0;5;"zaylene";5;0;100
0;124;"zayley";124;0;100
0;115;"zayli";115;0;100
0;54;"zaylia";54;0;100
0;18;"zayliah";18;0;100
0;22;"zayliana";22;0;100
0;511;"zaylie";511;0;100
323;197;"zaylin";520;62.1153846153846;37.8846153846154
288;0;"zaylon";288;100;0
34;0;"zaylor";34;100;0
71;39;"zaylyn";110;64.5454545454545;35.4545454545455
16;147;"zaylynn";163;9.8159509202454;90.1840490797546
5;0;"zaymar";5;100;0
5;0;"zaymere";5;100;0
10;0;"zaymir";10;100;0
2353;23;"zayn";2376;99.0319865319865;0.968013468013468
0;1164;"zayna";1164;0;100
0;1363;"zaynab";1363;0;100
0;756;"zaynah";756;0;100
5912;123;"zayne";6035;97.9618889809445;2.03811101905551
0;75;"zayneb";75;0;100
5;0;"zaynn";5;100;0
163;0;"zayon";163;100;0
0;5;"zayona";5;0;100
0;92;"zayonna";92;0;100
168;0;"zayquan";168;100;0
0;1320;"zayra";1320;0;100
0;10;"zayriah";10;0;100
5;0;"zaysean";5;100;0
0;13;"zaysha";13;0;100
11;0;"zayshaun";11;100;0
41;0;"zayshawn";41;100;0
0;5;"zaysia";5;0;100
0;46;"zayuri";46;0;100
95;0;"zayven";95;100;0
283;0;"zayveon";283;100;0
189;0;"zayvian";189;100;0
91;0;"zayvien";91;100;0
161;0;"zayvier";161;100;0
21;0;"zayvin";21;100;0
1128;0;"zayvion";1128;100;0
93;0;"zayvon";93;100;0
101;0;"zayyan";101;100;0
0;5;"zazil";5;0;100
28;0;"zbigniew";28;100;0
0;16;"zdenka";16;0;100
22;0;"ze";22;100;0
0;223;"zea";223;0;100
0;63;"zeah";63;0;100
6;0;"zeak";6;100;0
43;11;"zeal";54;79.6296296296296;20.3703703703704
5;0;"zealan";5;100;0
238;20;"zealand";258;92.2480620155039;7.75193798449612
0;5;"zealyn";5;0;100
12;0;"zean";12;100;0
0;31;"zeana";31;0;100
49;0;"zeandre";49;100;0
0;120;"zeanna";120;0;100
11;0;"zearl";11;100;0
0;5;"zeasia";5;0;100
2441;0;"zeb";2441;100;0
0;113;"zeba";113;0;100
927;0;"zebadiah";927;100;0
5;0;"zebariah";5;100;0
127;0;"zebastian";127;100;0
99;6;"zebbie";105;94.2857142857143;5.71428571428571
5;0;"zebdee";5;100;0
1109;0;"zebedee";1109;100;0
479;0;"zebediah";479;100;0
5;0;"zebidiah";5;100;0
0;5;"zeborah";5;0;100
0;5;"zebra";5;0;100
0;5;"zebrina";5;0;100
6;0;"zebula";6;100;0
7;0;"zebulah";7;100;0
102;0;"zebulan";102;100;0
56;0;"zebulen";56;100;0
77;0;"zebulin";77;100;0
1925;0;"zebulon";1925;100;0
729;0;"zebulun";729;100;0
45;0;"zecharia";45;100;0
8890;13;"zechariah";8903;99.8539818038863;0.14601819611367
25;0;"zechary";25;100;0
5;0;"zecharya";5;100;0
5;0;"zecharyah";5;100;0
25;0;"zecheriah";25;100;0
325;0;"zed";325;100;0
0;244;"zeda";244;0;100
5;0;"zedan";5;100;0
40;0;"zeddicus";40;100;0
63;15;"zeddie";78;80.7692307692308;19.2307692307692
5;0;"zedek";5;100;0
431;0;"zedekiah";431;100;0
5;0;"zederick";5;100;0
182;0;"zedric";182;100;0
403;0;"zedrick";403;100;0
43;32;"zee";75;57.3333333333333;42.6666666666667
132;0;"zeek";132;100;0
0;10;"zeel";10;0;100
0;419;"zeena";419;0;100
0;10;"zeenah";10;0;100
0;165;"zeenat";165;0;100
0;6;"zeenia";6;0;100
479;0;"zeeshan";479;100;0
60;0;"zeev";60;100;0
0;69;"zeeva";69;0;100
39;0;"zef";39;100;0
318;0;"zeferino";318;100;0
0;124;"zeffie";124;0;100
10;0;"zefram";10;100;0
0;83;"zehava";83;0;100
0;524;"zehra";524;0;100
49;0;"zeid";49;100;0
0;28;"zeida";28;0;100
5;0;"zeidan";5;100;0
9;0;"zeiden";9;100;0
0;5;"zeidi";5;0;100
0;84;"zeidy";84;0;100
21;0;"zeik";21;100;0
0;30;"zeila";30;0;100
0;5;"zeilah";5;0;100
0;6;"zeilin";6;0;100
0;5;"zeily";5;0;100
0;5;"zeilyn";5;0;100
227;0;"zein";227;100;0
0;703;"zeina";703;0;100
0;1074;"zeinab";1074;0;100
0;10;"zeinabou";10;0;100
0;10;"zeinah";10;0;100
0;5;"zeineb";5;0;100
12;0;"zek";12;100;0
24;0;"zekai";24;100;0
20;0;"zekariah";20;100;0
4691;0;"zeke";4691;100;0
5;0;"zekeriah";5;100;0
6;0;"zekharyah";6;100;0
51;0;"zekhi";51;100;0
56;0;"zeki";56;100;0
0;54;"zekia";54;0;100
161;82;"zekiah";243;66.2551440329218;33.7448559670782
6;0;"zekial";6;100;0
286;0;"zekiel";286;100;0
0;6;"zekira";6;0;100
0;7;"zekiyah";7;0;100
5;0;"zel";5;100;0
0;469;"zela";469;0;100
0;15;"zelah";15;0;100
5;0;"zelan";5;100;0
0;23;"zelaya";23;0;100
5;0;"zelbert";5;100;0
5;12515;"zelda";12520;0.0399361022364217;99.9600638977636
0;5;"zelder";5;0;100
0;5;"zeldia";5;0;100
5;0;"zeldon";5;100;0
0;50;"zeldy";50;0;100
0;130;"zelena";130;0;100
0;93;"zelene";93;0;100
0;5;"zelenia";5;0;100
0;855;"zelia";855;0;100
0;292;"zelie";292;0;100
110;0;"zelig";110;100;0
0;188;"zelina";188;0;100
0;47;"zelinda";47;0;100
0;12;"zeline";12;0;100
6;0;"zeljko";6;100;0
193;365;"zell";558;34.5878136200717;65.4121863799283
0;10233;"zella";10233;0;100
0;10;"zellah";10;0;100
0;5;"zellamae";5;0;100
0;5;"zellar";5;0;100
0;10;"zelle";10;0;100
0;6;"zellia";6;0;100
5;170;"zellie";175;2.85714285714286;97.1428571428571
0;5;"zelline";5;0;100
107;15651;"zelma";15758;0.679020180225917;99.3209798197741
0;5;"zelmadene";5;0;100
0;6;"zelmarie";6;0;100
52;16;"zelmer";68;76.4705882352941;23.5294117647059
0;10;"zelmodene";10;0;100
0;45;"zelna";45;0;100
0;841;"zelpha";841;0;100
0;403;"zelphia";403;0;100
0;164;"zelta";164;0;100
0;34;"zeltzin";34;0;100
0;24;"zelva";24;0;100
0;37;"zema";37;0;100
10;0;"zemar";10;100;0
11;0;"zemarion";11;100;0
0;263;"zemira";263;0;100
0;318;"zemirah";318;0;100
0;5;"zemiyah";5;0;100
0;22;"zemora";22;0;100
1133;186;"zen";1319;85.8984078847612;14.1015921152388
0;5025;"zena";5025;0;100
0;167;"zenab";167;0;100
0;24;"zenae";24;0;100
0;10;"zenah";10;0;100
0;10;"zenai";10;0;100
0;2494;"zenaida";2494;0;100
35;0;"zenaido";35;100;0
0;5;"zenaiya";5;0;100
0;8;"zenani";8;0;100
426;5;"zenas";431;98.8399071925754;1.16009280742459
0;95;"zenaya";95;0;100
0;13;"zenayah";13;0;100
0;35;"zenayda";35;0;100
0;324;"zenda";324;0;100
0;11;"zendaiya";11;0;100
0;1280;"zendaya";1280;0;100
0;78;"zendayah";78;0;100
11;0;"zende";11;100;0
12;0;"zendell";12;100;0
6;0;"zenden";6;100;0
6;0;"zender";6;100;0
0;15;"zendeya";15;0;100
0;5;"zendiya";5;0;100
0;20;"zendra";20;0;100
0;35;"zendre";35;0;100
0;5;"zendy";5;0;100
0;15;"zene";15;0;100
0;15;"zeneida";15;0;100
7;0;"zenen";7;100;0
0;15;"zenetta";15;0;100
0;51;"zeni";51;0;100
0;1569;"zenia";1569;0;100
0;240;"zeniah";240;0;100
0;10;"zenida";10;0;100
5;0;"zenis";5;100;0
0;56;"zenita";56;0;100
94;304;"zenith";398;23.6180904522613;76.3819095477387
0;165;"zeniya";165;0;100
0;216;"zeniyah";216;0;100
0;47;"zenja";47;0;100
0;391;"zenna";391;0;100
0;25;"zennia";25;0;100
10;105;"zennie";115;8.69565217391304;91.304347826087
23;0;"zennon";23;100;0
1086;0;"zeno";1086;100;0
0;12;"zenoba";12;0;100
0;4135;"zenobia";4135;0;100
0;101;"zenola";101;0;100
0;5;"zenolia";5;0;100
1152;0;"zenon";1152;100;0
0;10;"zenona";10;0;100
0;72;"zenora";72;0;100
0;5;"zenorah";5;0;100
6;0;"zenos";6;100;0
0;304;"zenovia";304;0;100
5;0;"zentavious";5;100;0
5;0;"zenus";5;100;0
0;5;"zeny";5;0;100
0;120;"zenya";120;0;100
0;11;"zenzele";11;0;100
0;552;"zeola";552;0;100
32;0;"zeon";32;100;0
0;5;"zeonna";5;0;100
69;0;"zeph";69;100;0
0;38;"zepha";38;0;100
407;0;"zephan";407;100;0
0;10;"zephania";10;0;100
2135;301;"zephaniah";2436;87.6436781609195;12.3563218390805
31;0;"zephen";31;100;0
0;5;"zepher";5;0;100
5;0;"zephery";5;100;0
0;12;"zephora";12;0;100
10;0;"zephram";10;100;0
5;0;"zephyn";5;100;0
1047;358;"zephyr";1405;74.5195729537367;25.4804270462633
0;51;"zephyra";51;0;100
18;0;"zephyrus";18;100;0
45;0;"zeplin";45;100;0
0;6;"zeplyn";6;0;100
0;5;"zeplynn";5;0;100
0;5;"zeporia";5;0;100
390;46;"zeppelin";436;89.4495412844037;10.5504587155963
0;7;"zeppelyn";7;0;100
37;0;"zepplin";37;100;0
26;0;"zequan";26;100;0
0;17;"zer";17;0;100
10;527;"zera";537;1.86219739292365;98.1378026070764
0;57;"zerah";57;0;100
0;5;"zerayah";5;0;100
221;0;"zerek";221;100;0
0;44;"zerelda";44;0;100
0;20;"zerena";20;0;100
0;149;"zerenity";149;0;100
11;0;"zereon";11;100;0
5;207;"zeriah";212;2.35849056603774;97.6415094339623
115;0;"zeric";115;100;0
155;0;"zerick";155;100;0
42;0;"zerik";42;100;0
34;0;"zerin";34;100;0
0;149;"zerina";149;0;100
23;0;"zerion";23;100;0
0;51;"zerita";51;0;100
0;51;"zeriyah";51;0;100
0;15;"zerlene";15;0;100
0;58;"zerlina";58;0;100
0;66;"zerline";66;0;100
6;0;"zeron";6;100;0
0;5;"zerriah";5;0;100
334;0;"zerrick";334;100;0
12;0;"zerrion";12;100;0
0;26;"zeruiah";26;0;100
5;0;"zeryk";5;100;0
5;0;"zesar";5;100;0
250;0;"zeshan";250;100;0
5;0;"zeshaun";5;100;0
36;0;"zeshawn";36;100;0
0;1158;"zeta";1158;0;100
1105;0;"zeth";1105;100;0
0;64;"zetha";64;0;100
66;0;"zethan";66;100;0
0;1678;"zetta";1678;0;100
10;1272;"zettie";1282;0.78003120124805;99.2199687987519
1177;0;"zeus";1177;100;0
3022;0;"zev";3022;100;0
0;185;"zeva";185;0;100
0;18;"zevaeh";18;0;100
7;0;"zevan";7;100;0
110;0;"zeven";110;100;0
36;0;"zevi";36;100;0
188;0;"zevin";188;100;0
24;0;"zevion";24;100;0
49;0;"zevon";49;100;0
7;0;"zevulun";7;100;0
7;0;"zevyn";7;100;0
0;55;"zeya";55;0;100
332;0;"zeyad";332;100;0
0;16;"zeyah";16;0;100
0;5;"zeyana";5;0;100
18;0;"zeyd";18;100;0
0;27;"zeyda";27;0;100
22;0;"zeyden";22;100;0
0;19;"zeyla";19;0;100
0;5;"zeylah";5;0;100
0;47;"zeyna";47;0;100
0;96;"zeynab";96;0;100
0;16;"zeyneb";16;0;100
0;633;"zeynep";633;0;100
0;5;"zeza";5;0;100
16;0;"zhaiden";16;100;0
5;0;"zhair";5;100;0
0;5;"zhaira";5;0;100
105;0;"zhaire";105;100;0
11;0;"zhaki";11;100;0
0;6;"zhakira";6;0;100
5;0;"zhalen";5;100;0
74;0;"zhamir";74;100;0
0;6;"zhamira";6;0;100
0;159;"zhana";159;0;100
0;124;"zhanae";124;0;100
0;5;"zhanasia";5;0;100
0;5;"zhanaya";5;0;100
5;0;"zhander";5;100;0
278;1843;"zhane";2121;13.1070249882131;86.8929750117869
0;5;"zhanea";5;0;100
0;23;"zhanee";23;0;100
0;5;"zhanel";5;0;100
0;5;"zhanelle";5;0;100
0;79;"zhania";79;0;100
0;78;"zhaniya";78;0;100
0;32;"zhaniyah";32;0;100
0;90;"zhanna";90;0;100
0;11;"zhanya";11;0;100
0;145;"zhara";145;0;100
0;12;"zhari";12;0;100
0;850;"zharia";850;0;100
0;32;"zhariah";32;0;100
0;29;"zharick";29;0;100
0;18;"zhariya";18;0;100
0;36;"zhariyah";36;0;100
0;5;"zharya";5;0;100
0;5;"zharyah";5;0;100
40;0;"zhayden";40;100;0
20;0;"zhayne";20;100;0
28;5;"zhen";33;84.8484848484848;15.1515151515152
0;16;"zheneavia";16;0;100
6;0;"zheng";6;100;0
144;17;"zhi";161;89.4409937888199;10.5590062111801
0;30;"zhia";30;0;100
5;0;"zhian";5;100;0
0;5;"zhianna";5;0;100
70;0;"zhion";70;100;0
5;0;"zhivago";5;100;0
0;6;"zhiya";6;0;100
0;120;"zhoe";120;0;100
0;7;"zhoemi";7;0;100
0;72;"zhoey";72;0;100
0;53;"zhoie";53;0;100
0;127;"zhuri";127;0;100
5;0;"zhyair";5;100;0
41;0;"zhyaire";41;100;0
5;0;"zhyier";5;100;0
5;0;"zhyir";5;100;0
13;0;"zhymir";13;100;0
55;12;"zhyon";67;82.089552238806;17.910447761194
60;57;"zi";117;51.2820512820513;48.7179487179487
201;1754;"zia";1955;10.2813299232737;89.7186700767264
790;0;"ziad";790;100;0
140;491;"ziah";631;22.1870047543582;77.8129952456418
146;0;"ziair";146;100;0
0;30;"ziaira";30;0;100
362;59;"ziaire";421;85.9857482185273;14.0142517814727
403;146;"zian";549;73.4061930783242;26.5938069216758
0;346;"ziana";346;0;100
0;5;"zianah";5;0;100
0;13;"ziane";13;0;100
0;7;"ziani";7;0;100
0;38;"ziann";38;0;100
0;416;"zianna";416;0;100
0;14;"ziannah";14;0;100
0;68;"zianne";68;0;100
0;5;"zianny";5;0;100
0;17;"zianya";17;0;100
10;0;"ziar";10;100;0
0;390;"ziara";390;0;100
0;28;"ziarah";28;0;100
366;84;"ziare";450;81.3333333333333;18.6666666666667
0;24;"ziarra";24;0;100
0;5;"ziarre";5;0;100
0;105;"ziasia";105;0;100
5;0;"ziba";5;100;0
17;0;"zichen";17;100;0
0;7;"ziclali";7;0;100
0;5;"ziclaly";5;0;100
12;0;"zico";12;100;0
0;5;"zida";5;0;100
51;0;"zidaan";51;100;0
215;0;"zidan";215;100;0
349;0;"zidane";349;100;0
5;0;"ziden";5;100;0
7;0;"zidon";7;100;0
18;12;"ziel";30;60;40
31;0;"zien";31;100;0
0;5;"ziena";5;0;100
0;66;"zienna";66;0;100
28;0;"zier";28;100;0
0;18;"ziera";18;0;100
53;0;"ziere";53;100;0
0;138;"zierra";138;0;100
53;0;"zierre";53;100;0
5;0;"ziggie";5;100;0
423;21;"ziggy";444;95.2702702702703;4.72972972972973
144;0;"zigmond";144;100;0
39;0;"zigmont";39;100;0
723;0;"zigmund";723;100;0
49;0;"zigmunt";49;100;0
0;35;"ziham";35;0;100
30;28;"zihan";58;51.7241379310345;48.2758620689655
0;10;"zihanna";10;0;100
22;0;"zihao";22;100;0
5;0;"ziheir";5;100;0
11;0;"ziheng";11;100;0
18;0;"ziion";18;100;0
5;0;"zijun";5;100;0
0;5;"zikayla";5;0;100
5;0;"zikee";5;100;0
0;88;"zikeria";88;0;100
0;7;"zikeya";7;0;100
0;5;"zikeyah";5;0;100
0;39;"zikia";39;0;100
0;16;"zikira";16;0;100
0;5;"zikiria";5;0;100
0;5;"zikiya";5;0;100
5;0;"zikomo";5;100;0
25;6;"zikora";31;80.6451612903226;19.3548387096774
0;10;"zikra";10;0;100
0;38;"zila";38;0;100
0;79;"zilah";79;0;100
5;0;"zilas";5;100;0
0;61;"zilda";61;0;100
31;0;"zildjian";31;100;0
0;11;"ziley";11;0;100
0;6;"zilin";6;0;100
0;218;"zilla";218;0;100
0;340;"zillah";340;0;100
0;39;"zillie";39;0;100
0;419;"zilpha";419;0;100
0;188;"zilphia";188;0;100
0;10;"zilynn";10;0;100
6;0;"zim";6;100;0
0;47;"zimal";47;0;100
0;5;"zimaria";5;0;100
6;0;"zimarion";6;100;0
0;5;"zimaya";5;0;100
5;0;"zimbabwe";5;100;0
13;0;"zimbalist";13;100;0
67;0;"zimere";67;100;0
61;0;"zimir";61;100;0
0;10;"zimmie";10;0;100
5;0;"zimo";5;100;0
0;27;"zimora";27;0;100
106;11;"zimri";117;90.5982905982906;9.4017094017094
0;10;"zimya";10;0;100
10;4674;"zina";4684;0.213492741246798;99.7865072587532
0;46;"zinab";46;0;100
0;24;"zinachidi";24;0;100
0;15;"zinachimdi";15;0;100
0;25;"zinaya";25;0;100
0;31;"zinda";31;0;100
0;95;"zineb";95;0;100
5;0;"zinedin";5;100;0
105;0;"zinedine";105;100;0
0;5;"zing";5;0;100
0;53;"zinia";53;0;100
0;5;"ziniah";5;0;100
0;11;"ziniya";11;0;100
0;21;"ziniyah";21;0;100
17;0;"zinn";17;100;0
0;22;"zinna";22;0;100
0;1271;"zinnia";1271;0;100
0;211;"ziomara";211;0;100
24388;5472;"zion";29860;81.6744809109176;18.3255190890824
0;455;"ziona";455;0;100
0;118;"zionah";118;0;100
5;0;"zione";5;100;0
5;0;"zionn";5;100;0
0;567;"zionna";567;0;100
0;54;"zionnah";54;0;100
0;5;"zionne";5;0;100
0;40;"zipora";40;0;100
0;21;"ziporah";21;0;100
0;1973;"zipporah";1973;0;100
0;25;"ziqi";25;0;100
65;0;"ziquan";65;100;0
0;65;"zira";65;0;100
0;21;"zirah";21;0;100
0;13;"ziraili";13;0;100
0;7;"ziraily";7;0;100
0;18;"zirel";18;0;100
10;0;"zirui";10;100;0
0;7;"zirwa";7;0;100
0;39;"zisel";39;0;100
8;0;"zisha";8;100;0
34;0;"zishan";34;100;0
5;0;"zishe";5;100;0
0;191;"zissel";191;0;100
0;550;"zissy";550;0;100
0;2691;"zita";2691;0;100
0;12;"zithlaly";12;0;100
0;417;"zitlali";417;0;100
0;51;"zitlalic";51;0;100
0;38;"zitlalli";38;0;100
0;54;"zitlally";54;0;100
0;531;"zitlaly";531;0;100
0;11;"zitong";11;0;100
137;0;"ziv";137;100;0
0;1312;"ziva";1312;0;100
0;123;"zivah";123;0;100
39;0;"ziven";39;100;0
10;0;"zivon";10;100;0
0;15;"zixi";15;0;100
0;7;"zixin";7;0;100
31;24;"zixuan";55;56.3636363636364;43.6363636363636
22;691;"ziya";713;3.08555399719495;96.9144460028051
16;0;"ziyaad";16;100;0
669;0;"ziyad";669;100;0
0;5;"ziyadah";5;0;100
18;654;"ziyah";672;2.67857142857143;97.3214285714286
152;119;"ziyan";271;56.0885608856088;43.9114391143911
0;189;"ziyana";189;0;100
0;10;"ziyanah";10;0;100
21;0;"ziyang";21;100;0
0;141;"ziyanna";141;0;100
5;0;"ziyear";5;100;0
5;5;"ziyi";10;50;50
0;5;"ziyla";5;0;100
520;109;"ziyon";629;82.670906200318;17.329093799682
0;47;"ziyona";47;0;100
0;189;"ziyonna";189;0;100
5;0;"ziyu";5;100;0
11;0;"ziyun";11;100;0
0;79;"ziza";79;0;100
0;10;"zizi";10;0;100
5;0;"zkai";5;100;0
5;0;"zkye";5;100;0
0;193;"zlata";193;0;100
104;0;"zlatan";104;100;0
0;129;"zlaty";129;0;100
16;0;"zmari";16;100;0
11;0;"zmarion";11;100;0
0;13;"zmaya";13;0;100
0;10;"zmiyah";10;0;100
0;58;"zmya";58;0;100
0;5;"zniah";5;0;100
0;94;"zniya";94;0;100
0;158;"zniyah";158;0;100
0;69;"znya";69;0;100
0;12;"znyah";12;0;100
16;92;"zo";108;14.8148148148148;85.1851851851852
0;320;"zoa";320;0;100
0;56;"zoann";56;0;100
0;6;"zoanna";6;0;100
0;61;"zoanne";61;0;100
0;26;"zobeida";26;0;100
0;21;"zobia";21;0;100
0;5;"zody";5;0;100
448;115987;"zoe";116435;0.384764031433847;99.6152359685662
0;117;"zoeann";117;0;100
0;5;"zoeanna";5;0;100
0;5;"zoeanne";5;0;100
0;1715;"zoee";1715;0;100
0;20;"zoeey";20;0;100
0;11;"zoegrace";11;0;100
0;42;"zoeh";42;0;100
0;674;"zoei";674;0;100
0;66;"zoeie";66;0;100
0;50;"zoeigh";50;0;100
0;38;"zoeii";38;0;100
0;5;"zoeiy";5;0;100
0;115;"zoejane";115;0;100
43;23;"zoel";66;65.1515151515152;34.8484848484849
0;18;"zoelie";18;0;100
0;74;"zoella";74;0;100
0;278;"zoelle";278;0;100
0;19;"zoely";19;0;100
0;6;"zoelyn";6;0;100
0;40;"zoelynn";40;0;100
0;8;"zoelys";8;0;100
0;16;"zoemarie";16;0;100
16;0;"zoen";16;100;0
194;71128;"zoey";71322;0.272005832702392;99.7279941672976
0;51;"zoeya";51;0;100
0;36;"zoeyann";36;0;100
0;10;"zoeygrace";10;0;100
0;44;"zoeyjane";44;0;100
0;23;"zoeylynn";23;0;100
0;10;"zoeymarie";10;0;100
0;1299;"zofia";1299;0;100
0;6;"zofie";6;0;100
0;659;"zoha";659;0;100
385;0;"zohaib";385;100;0
161;0;"zohair";161;100;0
0;72;"zohal";72;0;100
49;0;"zohan";49;100;0
71;130;"zohar";201;35.3233830845771;64.6766169154229
0;46;"zohara";46;0;100
0;5;"zohe";5;0;100
5;0;"zoheb";5;100;0
0;26;"zohie";26;0;100
0;278;"zohra";278;0;100
5;0;"zohrab";5;100;0
0;665;"zoi";665;0;100
0;6;"zoia";6;0;100
0;8979;"zoie";8979;0;100
0;109;"zoiee";109;0;100
0;83;"zoiey";83;0;100
0;91;"zoii";91;0;100
0;7;"zoiie";7;0;100
0;1734;"zoila";1734;0;100
15;0;"zoilo";15;100;0
0;5;"zoja";5;0;100
21;6516;"zola";6537;0.321248279027077;99.6787517209729
0;27;"zolah";27;0;100
25;0;"zolan";25;100;0
0;5;"zolar";5;0;100
0;15;"zolee";15;0;100
0;18;"zoli";18;0;100
0;47;"zolie";47;0;100
6;0;"zolin";6;100;0
757;122;"zollie";879;86.1205915813424;13.8794084186576
926;0;"zoltan";926;100;0
138;0;"zolton";138;100;0
0;17;"zoma";17;0;100
15;0;"zon";15;100;0
0;4021;"zona";4021;0;100
0;49;"zonda";49;0;100
0;472;"zondra";472;0;100
95;22;"zong";117;81.1965811965812;18.8034188034188
0;499;"zonia";499;0;100
0;66;"zonie";66;0;100
0;23;"zonna";23;0;100
11;165;"zonnie";176;6.25;93.75
0;38;"zonnique";38;0;100
0;70;"zonya";70;0;100
0;886;"zooey";886;0;100
0;436;"zophia";436;0;100
0;11;"zophie";11;0;100
16;6484;"zora";6500;0.246153846153846;99.7538461538462
0;201;"zorah";201;0;100
0;2006;"zoraida";2006;0;100
21;0;"zoraiz";21;100;0
343;0;"zoran";343;100;0
0;102;"zorana";102;0;100
16;0;"zoravar";16;100;0
7;0;"zoraver";7;100;0
45;0;"zorawar";45;100;0
0;399;"zoraya";399;0;100
0;5;"zorayda";5;0;100
0;5;"zoree";5;0;100
35;0;"zoren";35;100;0
0;370;"zori";370;0;100
0;346;"zoria";346;0;100
0;449;"zoriah";449;0;100
204;0;"zorian";204;100;0
0;94;"zoriana";94;0;100
0;113;"zorianna";113;0;100
0;14;"zoribel";14;0;100
0;16;"zorica";16;0;100
0;45;"zorie";45;0;100
5;0;"zorien";5;100;0
0;155;"zorina";155;0;100
147;0;"zorion";147;100;0
0;10;"zorita";10;0;100
0;56;"zoriyah";56;0;100
0;45;"zorka";45;0;100
0;40;"zorria";40;0;100
0;5;"zorriah";5;0;100
0;5;"zorrie";5;0;100
0;10;"zory";10;0;100
0;5;"zorya";5;0;100
0;17;"zoryana";17;0;100
0;5;"zosha";5;0;100
0;252;"zosia";252;0;100
0;142;"zoua";142;0;100
0;5;"zowee";5;0;100
0;10;"zowey";10;0;100
0;733;"zowie";733;0;100
0;6;"zowii";6;0;100
0;2506;"zoya";2506;0;100
0;10;"zoyah";10;0;100
0;65;"zoye";65;0;100
0;15;"zoyla";15;0;100
0;7;"zriah";7;0;100
0;76;"zriyah";76;0;100
0;17;"zsa";17;0;100
0;289;"zsazsa";289;0;100
0;5;"zshakira";5;0;100
0;124;"zsofia";124;0;100
6;0;"zsolt";6;100;0
0;5;"zsophia";5;0;100
0;23;"zubaida";23;0;100
0;10;"zubaidah";10;0;100
438;0;"zubair";438;100;0
97;0;"zubayr";97;100;0
19;0;"zuberi";19;100;0
11;0;"zubeyr";11;100;0
0;5;"zubie";5;0;100
310;0;"zubin";310;100;0
0;51;"zudora";51;0;100
0;26;"zuella";26;0;100
0;78;"zuha";78;0;100
37;0;"zuhaib";37;100;0
222;0;"zuhair";222;100;0
0;10;"zuhal";10;0;100
144;0;"zuhayr";144;100;0
0;10;"zuheily";10;0;100
0;17;"zuhey";17;0;100
0;5;"zuheyla";5;0;100
0;19;"zuhra";19;0;100
0;22;"zuhur";22;0;100
6;0;"zui";6;100;0
0;5;"zujeily";5;0;100
0;28;"zujey";28;0;100
29;0;"zuko";29;100;0
0;3354;"zula";3354;0;100
0;10;"zulai";10;0;100
0;10;"zulaika";10;0;100
0;5;"zular";5;0;100
0;354;"zulay";354;0;100
0;170;"zuleica";170;0;100
0;38;"zuleidy";38;0;100
0;1086;"zuleika";1086;0;100
0;5;"zuleikha";5;0;100
0;654;"zuleima";654;0;100
0;34;"zuleimy";34;0;100
0;14;"zulekha";14;0;100
0;3459;"zulema";3459;0;100
0;10;"zulene";10;0;100
0;100;"zuley";100;0;100
0;13;"zuleyca";13;0;100
0;1214;"zuleyka";1214;0;100
0;749;"zuleyma";749;0;100
0;10;"zuleymi";10;0;100
0;16;"zuli";16;0;100
0;5;"zulia";5;0;100
0;17;"zuliana";17;0;100
0;20;"zulie";20;0;100
0;11;"zulimar";11;0;100
0;5;"zulla";5;0;100
0;673;"zully";673;0;100
0;1611;"zulma";1611;0;100
0;5;"zulmarie";5;0;100
0;5;"zulmira";5;0;100
0;33;"zulmy";33;0;100
0;398;"zuly";398;0;100
0;125;"zuma";125;0;100
0;5;"zumra";5;0;100
0;170;"zunaira";170;0;100
0;217;"zunairah";217;0;100
0;6;"zunilda";6;0;100
0;11;"zura";11;0;100
0;30;"zuree";30;0;100
546;5861;"zuri";6407;8.52192914000312;91.4780708599969
0;324;"zuria";324;0;100
6;176;"zuriah";182;3.2967032967033;96.7032967032967
0;11;"zuriana";11;0;100
0;5;"zurianna";5;0;100
47;0;"zurich";47;100;0
0;226;"zurie";226;0;100
1336;266;"zuriel";1602;83.3957553058677;16.6042446941323
0;11;"zuriela";11;0;100
0;42;"zurielle";42;0;100
0;44;"zurii";44;0;100
0;6;"zurina";6;0;100
0;483;"zurisadai";483;0;100
0;41;"zurisaday";41;0;100
0;37;"zuriya";37;0;100
0;62;"zuriyah";62;0;100
0;42;"zurri";42;0;100
0;494;"zury";494;0;100
0;5;"zuszeth";5;0;100
0;12;"zuwena";12;0;100
0;24;"zuzana";24;0;100
0;542;"zuzanna";542;0;100
0;173;"zuzu";173;0;100
571;0;"zvi";571;100;0
5;0;"zxavian";5;100;0
34;6;"zy";40;85;15
0;544;"zya";544;0;100
115;0;"zyad";115;100;0
11;269;"zyah";280;3.92857142857143;96.0714285714286
5;0;"zyahir";5;100;0
0;6;"zyahna";6;0;100
797;103;"zyair";900;88.5555555555556;11.4444444444444
0;256;"zyaira";256;0;100
0;138;"zyairah";138;0;100
2011;479;"zyaire";2490;80.7630522088353;19.2369477911647
5;0;"zyairr";5;100;0
0;6;"zyairra";6;0;100
807;276;"zyan";1083;74.5152354570637;25.4847645429363
0;606;"zyana";606;0;100
0;33;"zyanah";33;0;100
0;5;"zyani";5;0;100
0;176;"zyann";176;0;100
0;462;"zyanna";462;0;100
0;45;"zyannah";45;0;100
0;92;"zyanne";92;0;100
0;376;"zyanya";376;0;100
0;87;"zyara";87;0;100
0;19;"zyarah";19;0;100
5;0;"zyare";5;100;0
0;49;"zyaria";49;0;100
0;6;"zyariah";6;0;100
0;6;"zyashia";6;0;100
0;532;"zyasia";532;0;100
5;0;"zyaun";5;100;0
0;15;"zyauna";15;0;100
0;5;"zyda";5;0;100
31;0;"zydarius";31;100;0
67;0;"zyden";67;100;0
0;5;"zydia";5;0;100
12;0;"zye";12;100;0
5;0;"zyeer";5;100;0
91;0;"zyeir";91;100;0
5;0;"zyeire";5;100;0
29;0;"zyel";29;100;0
6;0;"zyell";6;100;0
0;20;"zyelle";20;0;100
76;0;"zyen";76;100;0
0;23;"zyera";23;0;100
172;0;"zyere";172;100;0
0;40;"zyeria";40;0;100
6;0;"zyerre";6;100;0
0;10;"zyesha";10;0;100
10;0;"zygmond";10;100;0
50;0;"zygmont";50;100;0
168;0;"zygmund";168;100;0
368;0;"zygmunt";368;100;0
7;0;"zyhaire";7;100;0
13;0;"zyheem";13;100;0
25;0;"zyheim";25;100;0
89;0;"zyheir";89;100;0
11;0;"zyhier";11;100;0
145;0;"zyhir";145;100;0
0;96;"zyia";96;0;100
0;138;"zyiah";138;0;100
35;49;"zyian";84;41.6666666666667;58.3333333333333
0;13;"zyiana";13;0;100
0;16;"zyianna";16;0;100
54;12;"zyien";66;81.8181818181818;18.1818181818182
241;0;"zyier";241;100;0
60;0;"zyiere";60;100;0
6;0;"zyin";6;100;0
772;151;"zyion";923;83.6403033586132;16.3596966413868
0;32;"zyiona";32;0;100
0;47;"zyionna";47;0;100
278;0;"zyir";278;100;0
0;5;"zyira";5;0;100
183;0;"zyire";183;100;0
0;10;"zykaria";10;0;100
0;13;"zykayla";13;0;100
72;0;"zykee";72;100;0
78;0;"zykeem";78;100;0
5;0;"zykei";5;100;0
0;21;"zykeia";21;0;100
0;19;"zykeira";19;0;100
20;0;"zykeith";20;100;0
35;0;"zykel";35;100;0
21;0;"zykell";21;100;0
0;77;"zykera";77;0;100
0;882;"zykeria";882;0;100
0;83;"zykeriah";83;0;100
16;0;"zykerion";16;100;0
0;5;"zykeriya";5;0;100
0;259;"zykerria";259;0;100
0;6;"zykerriah";6;0;100
5;0;"zykevious";5;100;0
0;438;"zykia";438;0;100
0;18;"zykiah";18;0;100
0;11;"zykiera";11;0;100
0;12;"zykierra";12;0;100
22;0;"zyking";22;100;0
5;0;"zykir";5;100;0
0;253;"zykira";253;0;100
0;32;"zykirah";32;0;100
0;88;"zykiria";88;0;100
0;671;"zyla";671;0;100
0;417;"zylah";417;0;100
241;0;"zylan";241;100;0
48;0;"zylar";48;100;0
5;0;"zylas";5;100;0
0;30;"zyleah";30;0;100
0;85;"zylee";85;0;100
0;31;"zyleigh";31;0;100
248;0;"zylen";248;100;0
908;0;"zyler";908;100;0
0;13;"zylia";13;0;100
0;46;"zyliah";46;0;100
0;70;"zylie";70;0;100
47;0;"zylin";47;100;0
14;0;"zylis";14;100;0
0;15;"zyliyah";15;0;100
0;12;"zyllah";12;0;100
77;0;"zylon";77;100;0
0;62;"zylpha";62;0;100
0;29;"zylphia";29;0;100
7;0;"zylus";7;100;0
5;0;"zylyn";5;100;0
0;19;"zylynn";19;0;100
6;0;"zymair";6;100;0
5;0;"zymaire";5;100;0
0;15;"zymal";15;0;100
54;0;"zymari";54;100;0
0;13;"zymaria";13;0;100
110;0;"zymarion";110;100;0
32;0;"zymeer";32;100;0
110;0;"zymeir";110;100;0
6;0;"zymeire";6;100;0
350;0;"zymere";350;100;0
0;55;"zymeria";55;0;100
0;33;"zymia";33;0;100
0;11;"zymiah";11;0;100
146;0;"zymier";146;100;0
76;0;"zymiere";76;100;0
689;0;"zymir";689;100;0
0;44;"zymira";44;0;100
0;38;"zymirah";38;0;100
112;0;"zymire";112;100;0
0;6;"zymya";6;0;100
0;5;"zynab";5;0;100
0;24;"zynae";24;0;100
0;36;"zynah";36;0;100
0;10;"zynaria";10;0;100
0;74;"zynasia";74;0;100
14;0;"zyndall";14;100;0
0;5;"zyndaya";5;0;100
0;180;"zynia";180;0;100
0;173;"zyniah";173;0;100
0;44;"zynique";44;0;100
0;22;"zyniya";22;0;100
0;52;"zyniyah";52;0;100
0;6;"zynovia";6;0;100
2277;569;"zyon";2846;80.0070274068868;19.9929725931131
0;104;"zyona";104;0;100
0;12;"zyonah";12;0;100
16;0;"zyonn";16;100;0
0;428;"zyonna";428;0;100
0;20;"zyonnah";20;0;100
5;0;"zyonne";5;100;0
280;0;"zyquan";280;100;0
29;0;"zyquarius";29;100;0
11;0;"zyquavion";11;100;0
20;0;"zyquavious";20;100;0
38;0;"zyquez";38;100;0
0;438;"zyra";438;0;100
0;171;"zyrah";171;0;100
26;0;"zyran";26;100;0
67;16;"zyree";83;80.7228915662651;19.2771084337349
5;0;"zyreion";5;100;0
5;0;"zyrek";5;100;0
116;0;"zyrell";116;100;0
103;0;"zyren";103;100;0
14;0;"zyreon";14;100;0
5;0;"zyrese";5;100;0
0;6;"zyrhiana";6;0;100
0;6;"zyri";6;0;100
0;356;"zyria";356;0;100
0;372;"zyriah";372;0;100
10;0;"zyrian";10;100;0
0;30;"zyriana";30;0;100
0;41;"zyrianna";41;0;100
6;19;"zyrie";25;24;76
0;16;"zyriel";16;0;100
0;27;"zyrielle";27;0;100
0;45;"zyrihanna";45;0;100
10;0;"zyrin";10;100;0
101;0;"zyrion";101;100;0
0;16;"zyriyah";16;0;100
188;0;"zyron";188;100;0
62;0;"zyrus";62;100;0
5;0;"zysean";5;100;0
34;0;"zyshaun";34;100;0
146;0;"zyshawn";146;100;0
19;0;"zyshon";19;100;0
101;0;"zyshonne";101;100;0
5;0;"zytaevius";5;100;0
16;0;"zytaveon";16;100;0
5;0;"zytavion";5;100;0
43;0;"zytavious";43;100;0
5;0;"zyus";5;100;0
0;8;"zyva";8;0;100
5;0;"zyvion";5;100;0
6;0;"zyvon";6;100;0
0;6;"zyyanna";6;0;100
6;0;"zyyon";6;100;0
5;0;"zzyzx";5;100;0
